LAUS Code, State FIPS, County FIPS, County, State, Period, Labor Force, Employed, Unemployment Level, Unemployment Rate
CN2716700000000,27,167,Wilkin County, MN,Mar-17,3603,3458,145,4.0
CN2716700000000,27,167,Wilkin County, MN,Apr-17,3608,3511,97,2.7
CN2716700000000,27,167,Wilkin County, MN,May-17,3597,3503,94,2.6
CN2716700000000,27,167,Wilkin County, MN,Jun-17,3599,3480,119,3.3
CN2716700000000,27,167,Wilkin County, MN,Jul-17,3558,3444,114,3.2
CN2716700000000,27,167,Wilkin County, MN,Aug-17,3437,3326,111,3.2
CN2716700000000,27,167,Wilkin County, MN,Sep-17,3472,3388,84,2.4
CN2716700000000,27,167,Wilkin County, MN,Oct-17,3649,3583,66,1.8
CN2716700000000,27,167,Wilkin County, MN,Nov-17,3570,3497,73,2.0
CN2716700000000,27,167,Wilkin County, MN,Dec-17,3559,3446,113,3.2
CN2716700000000,27,167,Wilkin County, MN,Jan-18,3513,3369,144,4.1
CN2716700000000,27,167,Wilkin County, MN,Feb-18,3559,3408,151,4.2
CN2716700000000,27,167,Wilkin County, MN,Mar-18,3568,3430,138,3.9
CN2716700000000,27,167,Wilkin County, MN,Apr-18(p),3604,3488,116,3.2
CN3912700000000,39,127,Perry County, OH,Mar-17,16197,15072,1125,6.9
CN3912700000000,39,127,Perry County, OH,Apr-17,16022,15126,896,5.6
CN3912700000000,39,127,Perry County, OH,May-17,16020,15205,815,5.1
CN3912700000000,39,127,Perry County, OH,Jun-17,16176,15274,902,5.6
CN3912700000000,39,127,Perry County, OH,Jul-17,16278,15352,926,5.7
CN3912700000000,39,127,Perry County, OH,Aug-17,16263,15371,892,5.5
CN3912700000000,39,127,Perry County, OH,Sep-17,16056,15247,809,5.0
CN3912700000000,39,127,Perry County, OH,Oct-17,16047,15245,802,5.0
CN3912700000000,39,127,Perry County, OH,Nov-17,16124,15242,882,5.5
CN3912700000000,39,127,Perry County, OH,Dec-17,16150,15209,941,5.8
CN3912700000000,39,127,Perry County, OH,Jan-18,16035,14909,1126,7.0
CN3912700000000,39,127,Perry County, OH,Feb-18,16225,15186,1039,6.4
CN3912700000000,39,127,Perry County, OH,Mar-18,16376,15421,955,5.8
CN3912700000000,39,127,Perry County, OH,Apr-18(p),16198,15373,825,5.1
CN1330700000000,13,307,Webster County, GA,Mar-17,983,911,72,7.3
CN1330700000000,13,307,Webster County, GA,Apr-17,975,902,73,7.5
CN1330700000000,13,307,Webster County, GA,May-17,985,911,74,7.5
CN1330700000000,13,307,Webster County, GA,Jun-17,989,912,77,7.8
CN1330700000000,13,307,Webster County, GA,Jul-17,984,901,83,8.4
CN1330700000000,13,307,Webster County, GA,Aug-17,980,903,77,7.9
CN1330700000000,13,307,Webster County, GA,Sep-17,980,910,70,7.1
CN1330700000000,13,307,Webster County, GA,Oct-17,994,928,66,6.6
CN1330700000000,13,307,Webster County, GA,Nov-17,992,930,62,6.3
CN1330700000000,13,307,Webster County, GA,Dec-17,997,931,66,6.6
CN1330700000000,13,307,Webster County, GA,Jan-18,1013,934,79,7.8
CN1330700000000,13,307,Webster County, GA,Feb-18,989,919,70,7.1
CN1330700000000,13,307,Webster County, GA,Mar-18,982,920,62,6.3
CN1330700000000,13,307,Webster County, GA,Apr-18(p),974,916,58,6.0
CN1324500000000,13,245,Richmond County, GA,Mar-17,86548,81447,5101,5.9
CN1324500000000,13,245,Richmond County, GA,Apr-17,86795,82012,4783,5.5
CN1324500000000,13,245,Richmond County, GA,May-17,85871,80928,4943,5.8
CN1324500000000,13,245,Richmond County, GA,Jun-17,85810,80515,5295,6.2
CN1324500000000,13,245,Richmond County, GA,Jul-17,86425,80844,5581,6.5
CN1324500000000,13,245,Richmond County, GA,Aug-17,86138,80802,5336,6.2
CN1324500000000,13,245,Richmond County, GA,Sep-17,86749,81987,4762,5.5
CN1324500000000,13,245,Richmond County, GA,Oct-17,87033,82121,4912,5.6
CN1324500000000,13,245,Richmond County, GA,Nov-17,87283,82701,4582,5.2
CN1324500000000,13,245,Richmond County, GA,Dec-17,88174,83376,4798,5.4
CN1324500000000,13,245,Richmond County, GA,Jan-18,89268,83854,5414,6.1
CN1324500000000,13,245,Richmond County, GA,Feb-18,89884,84947,4937,5.5
CN1324500000000,13,245,Richmond County, GA,Mar-18,90133,85463,4670,5.2
CN1324500000000,13,245,Richmond County, GA,Apr-18(p),89958,85859,4099,4.6
CN4609300000000,46,093,Meade County, SD,Mar-17,13542,13034,508,3.8
CN4609300000000,46,093,Meade County, SD,Apr-17,13692,13234,458,3.3
CN4609300000000,46,093,Meade County, SD,May-17,13918,13464,454,3.3
CN4609300000000,46,093,Meade County, SD,Jun-17,14288,13821,467,3.3
CN4609300000000,46,093,Meade County, SD,Jul-17,14438,13990,448,3.1
CN4609300000000,46,093,Meade County, SD,Aug-17,14542,14078,464,3.2
CN4609300000000,46,093,Meade County, SD,Sep-17,13966,13522,444,3.2
CN4609300000000,46,093,Meade County, SD,Oct-17,13978,13538,440,3.1
CN4609300000000,46,093,Meade County, SD,Nov-17,13859,13379,480,3.5
CN4609300000000,46,093,Meade County, SD,Dec-17,13707,13194,513,3.7
CN4609300000000,46,093,Meade County, SD,Jan-18,13770,13158,612,4.4
CN4609300000000,46,093,Meade County, SD,Feb-18,13952,13328,624,4.5
CN4609300000000,46,093,Meade County, SD,Mar-18,13936,13384,552,4.0
CN4609300000000,46,093,Meade County, SD,Apr-18(p),14026,13509,517,3.7
CN1318300000000,13,183,Long County, GA,Mar-17,7725,7330,395,5.1
CN1318300000000,13,183,Long County, GA,Apr-17,7689,7335,354,4.6
CN1318300000000,13,183,Long County, GA,May-17,7705,7346,359,4.7
CN1318300000000,13,183,Long County, GA,Jun-17,7653,7261,392,5.1
CN1318300000000,13,183,Long County, GA,Jul-17,7714,7321,393,5.1
CN1318300000000,13,183,Long County, GA,Aug-17,7749,7353,396,5.1
CN1318300000000,13,183,Long County, GA,Sep-17,7727,7365,362,4.7
CN1318300000000,13,183,Long County, GA,Oct-17,7702,7351,351,4.6
CN1318300000000,13,183,Long County, GA,Nov-17,7717,7369,348,4.5
CN1318300000000,13,183,Long County, GA,Dec-17,7721,7379,342,4.4
CN1318300000000,13,183,Long County, GA,Jan-18,7806,7448,358,4.6
CN1318300000000,13,183,Long County, GA,Feb-18,7842,7478,364,4.6
CN1318300000000,13,183,Long County, GA,Mar-18,7817,7488,329,4.2
CN1318300000000,13,183,Long County, GA,Apr-18(p),7727,7435,292,3.8
CN3906500000000,39,065,Hardin County, OH,Mar-17,14853,14130,723,4.9
CN3906500000000,39,065,Hardin County, OH,Apr-17,14720,14075,645,4.4
CN3906500000000,39,065,Hardin County, OH,May-17,14561,13925,636,4.4
CN3906500000000,39,065,Hardin County, OH,Jun-17,14141,13352,789,5.6
CN3906500000000,39,065,Hardin County, OH,Jul-17,14026,13214,812,5.8
CN3906500000000,39,065,Hardin County, OH,Aug-17,14151,13415,736,5.2
CN3906500000000,39,065,Hardin County, OH,Sep-17,14364,13694,670,4.7
CN3906500000000,39,065,Hardin County, OH,Oct-17,14444,13823,621,4.3
CN3906500000000,39,065,Hardin County, OH,Nov-17,14386,13775,611,4.2
CN3906500000000,39,065,Hardin County, OH,Dec-17,14155,13525,630,4.5
CN3906500000000,39,065,Hardin County, OH,Jan-18,13747,13062,685,5.0
CN3906500000000,39,065,Hardin County, OH,Feb-18,14340,13730,610,4.3
CN3906500000000,39,065,Hardin County, OH,Mar-18,14577,14019,558,3.8
CN3906500000000,39,065,Hardin County, OH,Apr-18(p),14425,13906,519,3.6
CN3704100000000,37,041,Chowan County, NC,Mar-17,5714,5415,299,5.2
CN3704100000000,37,041,Chowan County, NC,Apr-17,5625,5360,265,4.7
CN3704100000000,37,041,Chowan County, NC,May-17,5599,5298,301,5.4
CN3704100000000,37,041,Chowan County, NC,Jun-17,5613,5307,306,5.5
CN3704100000000,37,041,Chowan County, NC,Jul-17,5683,5369,314,5.5
CN3704100000000,37,041,Chowan County, NC,Aug-17,5559,5241,318,5.7
CN3704100000000,37,041,Chowan County, NC,Sep-17,5572,5290,282,5.1
CN3704100000000,37,041,Chowan County, NC,Oct-17,5578,5300,278,5.0
CN3704100000000,37,041,Chowan County, NC,Nov-17,5579,5278,301,5.4
CN3704100000000,37,041,Chowan County, NC,Dec-17,5617,5318,299,5.3
CN3704100000000,37,041,Chowan County, NC,Jan-18,5590,5273,317,5.7
CN3704100000000,37,041,Chowan County, NC,Feb-18,5650,5340,310,5.5
CN3704100000000,37,041,Chowan County, NC,Mar-18,5632,5342,290,5.1
CN3704100000000,37,041,Chowan County, NC,Apr-18(p),5591,5359,232,4.1
CN4817900000000,48,179,Gray County, TX,Mar-17,8383,7881,502,6.0
CN4817900000000,48,179,Gray County, TX,Apr-17,8357,7903,454,5.4
CN4817900000000,48,179,Gray County, TX,May-17,8327,7879,448,5.4
CN4817900000000,48,179,Gray County, TX,Jun-17,8366,7918,448,5.4
CN4817900000000,48,179,Gray County, TX,Jul-17,8247,7813,434,5.3
CN4817900000000,48,179,Gray County, TX,Aug-17,8201,7788,413,5.0
CN4817900000000,48,179,Gray County, TX,Sep-17,8158,7783,375,4.6
CN4817900000000,48,179,Gray County, TX,Oct-17,8033,7693,340,4.2
CN4817900000000,48,179,Gray County, TX,Nov-17,7976,7628,348,4.4
CN4817900000000,48,179,Gray County, TX,Dec-17,7994,7651,343,4.3
CN4817900000000,48,179,Gray County, TX,Jan-18,7977,7595,382,4.8
CN4817900000000,48,179,Gray County, TX,Feb-18,8028,7638,390,4.9
CN4817900000000,48,179,Gray County, TX,Mar-18,8067,7702,365,4.5
CN4817900000000,48,179,Gray County, TX,Apr-18(p),8051,7735,316,3.9
CN1805300000000,18,053,Grant County, IN,Mar-17,32244,30961,1283,4.0
CN1805300000000,18,053,Grant County, IN,Apr-17,32305,31257,1048,3.2
CN1805300000000,18,053,Grant County, IN,May-17,32263,31148,1115,3.5
CN1805300000000,18,053,Grant County, IN,Jun-17,31540,30293,1247,4.0
CN1805300000000,18,053,Grant County, IN,Jul-17,31085,29858,1227,3.9
CN1805300000000,18,053,Grant County, IN,Aug-17,31077,29665,1412,4.5
CN1805300000000,18,053,Grant County, IN,Sep-17,31567,30386,1181,3.7
CN1805300000000,18,053,Grant County, IN,Oct-17,32035,30919,1116,3.5
CN1805300000000,18,053,Grant County, IN,Nov-17,32107,30950,1157,3.6
CN1805300000000,18,053,Grant County, IN,Dec-17,31837,30767,1070,3.4
CN1805300000000,18,053,Grant County, IN,Jan-18,30259,29017,1242,4.1
CN1805300000000,18,053,Grant County, IN,Feb-18,32254,30928,1326,4.1
CN1805300000000,18,053,Grant County, IN,Mar-18,32703,31515,1188,3.6
CN1805300000000,18,053,Grant County, IN,Apr-18(p),32564,31498,1066,3.3
CN0609300000000,06,093,Siskiyou County, CA,Mar-17,17768,16048,1720,9.7
CN0609300000000,06,093,Siskiyou County, CA,Apr-17,17777,16437,1340,7.5
CN0609300000000,06,093,Siskiyou County, CA,May-17,17881,16759,1122,6.3
CN0609300000000,06,093,Siskiyou County, CA,Jun-17,18361,17217,1144,6.2
CN0609300000000,06,093,Siskiyou County, CA,Jul-17,18228,17032,1196,6.6
CN0609300000000,06,093,Siskiyou County, CA,Aug-17,18200,17056,1144,6.3
CN0609300000000,06,093,Siskiyou County, CA,Sep-17,18372,17393,979,5.3
CN0609300000000,06,093,Siskiyou County, CA,Oct-17,18414,17426,988,5.4
CN0609300000000,06,093,Siskiyou County, CA,Nov-17,17722,16644,1078,6.1
CN0609300000000,06,093,Siskiyou County, CA,Dec-17,17555,16260,1295,7.4
CN0609300000000,06,093,Siskiyou County, CA,Jan-18,17719,16224,1495,8.4
CN0609300000000,06,093,Siskiyou County, CA,Feb-18,17843,16251,1592,8.9
CN0609300000000,06,093,Siskiyou County, CA,Mar-18,17758,16264,1494,8.4
CN0609300000000,06,093,Siskiyou County, CA,Apr-18(p),17758,16575,1183,6.7
CN0900100000000,09,001,Fairfield County, CT,Mar-17,487285,463570,23715,4.9
CN0900100000000,09,001,Fairfield County, CT,Apr-17,485848,464045,21803,4.5
CN0900100000000,09,001,Fairfield County, CT,May-17,489010,466942,22068,4.5
CN0900100000000,09,001,Fairfield County, CT,Jun-17,492315,469187,23128,4.7
CN0900100000000,09,001,Fairfield County, CT,Jul-17,496931,473785,23146,4.7
CN0900100000000,09,001,Fairfield County, CT,Aug-17,487582,465809,21773,4.5
CN0900100000000,09,001,Fairfield County, CT,Sep-17,480344,460694,19650,4.1
CN0900100000000,09,001,Fairfield County, CT,Oct-17,477114,458047,19067,4.0
CN0900100000000,09,001,Fairfield County, CT,Nov-17,480124,461289,18835,3.9
CN0900100000000,09,001,Fairfield County, CT,Dec-17,477877,459806,18071,3.8
CN0900100000000,09,001,Fairfield County, CT,Jan-18,475897,452083,23814,5.0
CN0900100000000,09,001,Fairfield County, CT,Feb-18,476469,453095,23374,4.9
CN0900100000000,09,001,Fairfield County, CT,Mar-18,476731,455606,21125,4.4
CN0900100000000,09,001,Fairfield County, CT,Apr-18(p),475629,455991,19638,4.1
CN4839700000000,48,397,Rockwall County, TX,Mar-17,48184,46494,1690,3.5
CN4839700000000,48,397,Rockwall County, TX,Apr-17,48313,46793,1520,3.1
CN4839700000000,48,397,Rockwall County, TX,May-17,48226,46680,1546,3.2
CN4839700000000,48,397,Rockwall County, TX,Jun-17,48495,46800,1695,3.5
CN4839700000000,48,397,Rockwall County, TX,Jul-17,48841,47130,1711,3.5
CN4839700000000,48,397,Rockwall County, TX,Aug-17,48692,47012,1680,3.5
CN4839700000000,48,397,Rockwall County, TX,Sep-17,49126,47591,1535,3.1
CN4839700000000,48,397,Rockwall County, TX,Oct-17,48908,47471,1437,2.9
CN4839700000000,48,397,Rockwall County, TX,Nov-17,49344,47849,1495,3.0
CN4839700000000,48,397,Rockwall County, TX,Dec-17,49132,47688,1444,2.9
CN4839700000000,48,397,Rockwall County, TX,Jan-18,49163,47539,1624,3.3
CN4839700000000,48,397,Rockwall County, TX,Feb-18,49888,48187,1701,3.4
CN4839700000000,48,397,Rockwall County, TX,Mar-18,49949,48246,1703,3.4
CN4839700000000,48,397,Rockwall County, TX,Apr-18(p),50096,48566,1530,3.1
CN0503100000000,05,031,Craighead County, AR,Mar-17,53223,51747,1476,2.8
CN0503100000000,05,031,Craighead County, AR,Apr-17,53409,52046,1363,2.6
CN0503100000000,05,031,Craighead County, AR,May-17,53654,52099,1555,2.9
CN0503100000000,05,031,Craighead County, AR,Jun-17,53962,52178,1784,3.3
CN0503100000000,05,031,Craighead County, AR,Jul-17,54893,52990,1903,3.5
CN0503100000000,05,031,Craighead County, AR,Aug-17,54302,52577,1725,3.2
CN0503100000000,05,031,Craighead County, AR,Sep-17,54393,52828,1565,2.9
CN0503100000000,05,031,Craighead County, AR,Oct-17,54026,52636,1390,2.6
CN0503100000000,05,031,Craighead County, AR,Nov-17,54016,52613,1403,2.6
CN0503100000000,05,031,Craighead County, AR,Dec-17,53454,51955,1499,2.8
CN0503100000000,05,031,Craighead County, AR,Jan-18,52948,51037,1911,3.6
CN0503100000000,05,031,Craighead County, AR,Feb-18,53769,51911,1858,3.5
CN0503100000000,05,031,Craighead County, AR,Mar-18,53869,52160,1709,3.2
CN0503100000000,05,031,Craighead County, AR,Apr-18(p),53930,52427,1503,2.8
CN4845900000000,48,459,Upshur County, TX,Mar-17,17756,16704,1052,5.9
CN4845900000000,48,459,Upshur County, TX,Apr-17,17693,16738,955,5.4
CN4845900000000,48,459,Upshur County, TX,May-17,17544,16639,905,5.2
CN4845900000000,48,459,Upshur County, TX,Jun-17,17629,16689,940,5.3
CN4845900000000,48,459,Upshur County, TX,Jul-17,17598,16684,914,5.2
CN4845900000000,48,459,Upshur County, TX,Aug-17,17532,16641,891,5.1
CN4845900000000,48,459,Upshur County, TX,Sep-17,17586,16784,802,4.6
CN4845900000000,48,459,Upshur County, TX,Oct-17,17508,16758,750,4.3
CN4845900000000,48,459,Upshur County, TX,Nov-17,17577,16801,776,4.4
CN4845900000000,48,459,Upshur County, TX,Dec-17,17536,16800,736,4.2
CN4845900000000,48,459,Upshur County, TX,Jan-18,17561,16748,813,4.6
CN4845900000000,48,459,Upshur County, TX,Feb-18,17690,16869,821,4.6
CN4845900000000,48,459,Upshur County, TX,Mar-18,17720,16912,808,4.6
CN4845900000000,48,459,Upshur County, TX,Apr-18(p),17656,16916,740,4.2
CN2911300000000,29,113,Lincoln County, MO,Mar-17,26929,25859,1070,4.0
CN2911300000000,29,113,Lincoln County, MO,Apr-17,27074,26132,942,3.5
CN2911300000000,29,113,Lincoln County, MO,May-17,27069,26119,950,3.5
CN2911300000000,29,113,Lincoln County, MO,Jun-17,27272,26322,950,3.5
CN2911300000000,29,113,Lincoln County, MO,Jul-17,27447,26400,1047,3.8
CN2911300000000,29,113,Lincoln County, MO,Aug-17,27044,26020,1024,3.8
CN2911300000000,29,113,Lincoln County, MO,Sep-17,26893,26058,835,3.1
CN2911300000000,29,113,Lincoln County, MO,Oct-17,26723,26064,659,2.5
CN2911300000000,29,113,Lincoln County, MO,Nov-17,26832,26006,826,3.1
CN2911300000000,29,113,Lincoln County, MO,Dec-17,26690,25788,902,3.4
CN2911300000000,29,113,Lincoln County, MO,Jan-18,26585,25385,1200,4.5
CN2911300000000,29,113,Lincoln County, MO,Feb-18,26962,25812,1150,4.3
CN2911300000000,29,113,Lincoln County, MO,Mar-18,26908,25852,1056,3.9
CN2911300000000,29,113,Lincoln County, MO,Apr-18(p),26992,26092,900,3.3
CN0810100000000,08,101,Pueblo County, CO,Mar-17,74077,70947,3130,4.2
CN0810100000000,08,101,Pueblo County, CO,Apr-17,74299,71474,2825,3.8
CN0810100000000,08,101,Pueblo County, CO,May-17,74298,71483,2815,3.8
CN0810100000000,08,101,Pueblo County, CO,Jun-17,74736,71415,3321,4.4
CN0810100000000,08,101,Pueblo County, CO,Jul-17,74265,70858,3407,4.6
CN0810100000000,08,101,Pueblo County, CO,Aug-17,73992,70672,3320,4.5
CN0810100000000,08,101,Pueblo County, CO,Sep-17,75355,72203,3152,4.2
CN0810100000000,08,101,Pueblo County, CO,Oct-17,75435,72300,3135,4.2
CN0810100000000,08,101,Pueblo County, CO,Nov-17,75398,72078,3320,4.4
CN0810100000000,08,101,Pueblo County, CO,Dec-17,75134,71676,3458,4.6
CN0810100000000,08,101,Pueblo County, CO,Jan-18,74665,70832,3833,5.1
CN0810100000000,08,101,Pueblo County, CO,Feb-18,75215,71500,3715,4.9
CN0810100000000,08,101,Pueblo County, CO,Mar-18,75132,71811,3321,4.4
CN0810100000000,08,101,Pueblo County, CO,Apr-18(p),75027,72082,2945,3.9
CN2604900000000,26,049,Genesee County, MI,Mar-17,181934,171287,10647,5.9
CN2604900000000,26,049,Genesee County, MI,Apr-17,182012,173102,8910,4.9
CN2604900000000,26,049,Genesee County, MI,May-17,183667,174406,9261,5.0
CN2604900000000,26,049,Genesee County, MI,Jun-17,186516,176017,10499,5.6
CN2604900000000,26,049,Genesee County, MI,Jul-17,185916,172962,12954,7.0
CN2604900000000,26,049,Genesee County, MI,Aug-17,184871,173540,11331,6.1
CN2604900000000,26,049,Genesee County, MI,Sep-17,182317,172424,9893,5.4
CN2604900000000,26,049,Genesee County, MI,Oct-17,181678,172567,9111,5.0
CN2604900000000,26,049,Genesee County, MI,Nov-17,182901,173520,9381,5.1
CN2604900000000,26,049,Genesee County, MI,Dec-17,182447,172013,10434,5.7
CN2604900000000,26,049,Genesee County, MI,Jan-18,181221,169214,12007,6.6
CN2604900000000,26,049,Genesee County, MI,Feb-18,182896,170947,11949,6.5
CN2604900000000,26,049,Genesee County, MI,Mar-18,183080,172477,10603,5.8
CN2604900000000,26,049,Genesee County, MI,Apr-18(p),182851,173692,9159,5.0
CN4810100000000,48,101,Cottle County, TX,Mar-17,531,507,24,4.5
CN4810100000000,48,101,Cottle County, TX,Apr-17,539,519,20,3.7
CN4810100000000,48,101,Cottle County, TX,May-17,549,528,21,3.8
CN4810100000000,48,101,Cottle County, TX,Jun-17,529,507,22,4.2
CN4810100000000,48,101,Cottle County, TX,Jul-17,516,496,20,3.9
CN4810100000000,48,101,Cottle County, TX,Aug-17,521,502,19,3.6
CN4810100000000,48,101,Cottle County, TX,Sep-17,500,479,21,4.2
CN4810100000000,48,101,Cottle County, TX,Oct-17,518,500,18,3.5
CN4810100000000,48,101,Cottle County, TX,Nov-17,510,487,23,4.5
CN4810100000000,48,101,Cottle County, TX,Dec-17,506,487,19,3.8
CN4810100000000,48,101,Cottle County, TX,Jan-18,506,484,22,4.3
CN4810100000000,48,101,Cottle County, TX,Feb-18,518,493,25,4.8
CN4810100000000,48,101,Cottle County, TX,Mar-18,542,515,27,5.0
CN4810100000000,48,101,Cottle County, TX,Apr-18(p),532,504,28,5.3
CN1917100000000,19,171,Tama County, IA,Mar-17,9651,9207,444,4.6
CN1917100000000,19,171,Tama County, IA,Apr-17,9648,9326,322,3.3
CN1917100000000,19,171,Tama County, IA,May-17,9604,9312,292,3.0
CN1917100000000,19,171,Tama County, IA,Jun-17,9752,9437,315,3.2
CN1917100000000,19,171,Tama County, IA,Jul-17,9799,9501,298,3.0
CN1917100000000,19,171,Tama County, IA,Aug-17,9495,9215,280,2.9
CN1917100000000,19,171,Tama County, IA,Sep-17,9481,9238,243,2.6
CN1917100000000,19,171,Tama County, IA,Oct-17,9596,9369,227,2.4
CN1917100000000,19,171,Tama County, IA,Nov-17,9576,9344,232,2.4
CN1917100000000,19,171,Tama County, IA,Dec-17,9641,9281,360,3.7
CN1917100000000,19,171,Tama County, IA,Jan-18,9588,9124,464,4.8
CN1917100000000,19,171,Tama County, IA,Feb-18,9665,9227,438,4.5
CN1917100000000,19,171,Tama County, IA,Mar-18,9573,9199,374,3.9
CN1917100000000,19,171,Tama County, IA,Apr-18(p),9565,9284,281,2.9
CN1212700000000,12,127,Volusia County, FL,Mar-17,252189,241265,10924,4.3
CN1212700000000,12,127,Volusia County, FL,Apr-17,251271,240850,10421,4.1
CN1212700000000,12,127,Volusia County, FL,May-17,252361,241673,10688,4.2
CN1212700000000,12,127,Volusia County, FL,Jun-17,252371,241025,11346,4.5
CN1212700000000,12,127,Volusia County, FL,Jul-17,253134,241780,11354,4.5
CN1212700000000,12,127,Volusia County, FL,Aug-17,251896,240726,11170,4.4
CN1212700000000,12,127,Volusia County, FL,Sep-17,254868,244492,10376,4.1
CN1212700000000,12,127,Volusia County, FL,Oct-17,252826,242830,9996,4.0
CN1212700000000,12,127,Volusia County, FL,Nov-17,251077,240986,10091,4.0
CN1212700000000,12,127,Volusia County, FL,Dec-17,250729,241172,9557,3.8
CN1212700000000,12,127,Volusia County, FL,Jan-18,252128,241200,10928,4.3
CN1212700000000,12,127,Volusia County, FL,Feb-18,255095,245062,10033,3.9
CN1212700000000,12,127,Volusia County, FL,Mar-18,254775,244894,9881,3.9
CN1212700000000,12,127,Volusia County, FL,Apr-18(p),253926,245075,8851,3.5
CN4503700000000,45,037,Edgefield County, SC,Mar-17,10446,9993,453,4.3
CN4503700000000,45,037,Edgefield County, SC,Apr-17,10558,10140,418,4.0
CN4503700000000,45,037,Edgefield County, SC,May-17,10478,10041,437,4.2
CN4503700000000,45,037,Edgefield County, SC,Jun-17,10627,10134,493,4.6
CN4503700000000,45,037,Edgefield County, SC,Jul-17,10619,10134,485,4.6
CN4503700000000,45,037,Edgefield County, SC,Aug-17,10635,10108,527,5.0
CN4503700000000,45,037,Edgefield County, SC,Sep-17,10567,10083,484,4.6
CN4503700000000,45,037,Edgefield County, SC,Oct-17,10564,10084,480,4.5
CN4503700000000,45,037,Edgefield County, SC,Nov-17,10542,10095,447,4.2
CN4503700000000,45,037,Edgefield County, SC,Dec-17,10676,10216,460,4.3
CN4503700000000,45,037,Edgefield County, SC,Jan-18,10795,10259,536,5.0
CN4503700000000,45,037,Edgefield County, SC,Feb-18,10774,10278,496,4.6
CN4503700000000,45,037,Edgefield County, SC,Mar-18,10682,10224,458,4.3
CN4503700000000,45,037,Edgefield County, SC,Apr-18(p),10644,10349,295,2.8
CN1709100000000,17,091,Kankakee County, IL,Mar-17,55447,52247,3200,5.8
CN1709100000000,17,091,Kankakee County, IL,Apr-17,55338,52750,2588,4.7
CN1709100000000,17,091,Kankakee County, IL,May-17,54943,52395,2548,4.6
CN1709100000000,17,091,Kankakee County, IL,Jun-17,55609,52837,2772,5.0
CN1709100000000,17,091,Kankakee County, IL,Jul-17,56073,53213,2860,5.1
CN1709100000000,17,091,Kankakee County, IL,Aug-17,55790,52932,2858,5.1
CN1709100000000,17,091,Kankakee County, IL,Sep-17,55880,53348,2532,4.5
CN1709100000000,17,091,Kankakee County, IL,Oct-17,56096,53638,2458,4.4
CN1709100000000,17,091,Kankakee County, IL,Nov-17,56909,54261,2648,4.7
CN1709100000000,17,091,Kankakee County, IL,Dec-17,56742,53918,2824,5.0
CN1709100000000,17,091,Kankakee County, IL,Jan-18,55967,52927,3040,5.4
CN1709100000000,17,091,Kankakee County, IL,Feb-18,56705,53829,2876,5.1
CN1709100000000,17,091,Kankakee County, IL,Mar-18,57741,54751,2990,5.2
CN1709100000000,17,091,Kankakee County, IL,Apr-18(p),57759,55358,2401,4.2
CN3111500000000,31,115,Loup County, NE,Mar-17,381,371,10,2.6
CN3111500000000,31,115,Loup County, NE,Apr-17,400,389,11,2.8
CN3111500000000,31,115,Loup County, NE,May-17,404,393,11,2.7
CN3111500000000,31,115,Loup County, NE,Jun-17,425,412,13,3.1
CN3111500000000,31,115,Loup County, NE,Jul-17,420,406,14,3.3
CN3111500000000,31,115,Loup County, NE,Aug-17,406,393,13,3.2
CN3111500000000,31,115,Loup County, NE,Sep-17,374,362,12,3.2
CN3111500000000,31,115,Loup County, NE,Oct-17,382,371,11,2.9
CN3111500000000,31,115,Loup County, NE,Nov-17,386,375,11,2.8
CN3111500000000,31,115,Loup County, NE,Dec-17,379,365,14,3.7
CN3111500000000,31,115,Loup County, NE,Jan-18,385,375,10,2.6
CN3111500000000,31,115,Loup County, NE,Feb-18,375,365,10,2.7
CN3111500000000,31,115,Loup County, NE,Mar-18,384,371,13,3.4
CN3111500000000,31,115,Loup County, NE,Apr-18(p),390,379,11,2.8
CN1302100000000,13,021,Bibb County, GA,Mar-17,69838,66089,3749,5.4
CN1302100000000,13,021,Bibb County, GA,Apr-17,69335,65768,3567,5.1
CN1302100000000,13,021,Bibb County, GA,May-17,69382,65793,3589,5.2
CN1302100000000,13,021,Bibb County, GA,Jun-17,69781,65951,3830,5.5
CN1302100000000,13,021,Bibb County, GA,Jul-17,69846,65971,3875,5.5
CN1302100000000,13,021,Bibb County, GA,Aug-17,69618,65729,3889,5.6
CN1302100000000,13,021,Bibb County, GA,Sep-17,69917,66333,3584,5.1
CN1302100000000,13,021,Bibb County, GA,Oct-17,69481,65855,3626,5.2
CN1302100000000,13,021,Bibb County, GA,Nov-17,69598,66181,3417,4.9
CN1302100000000,13,021,Bibb County, GA,Dec-17,69761,66335,3426,4.9
CN1302100000000,13,021,Bibb County, GA,Jan-18,70125,66444,3681,5.2
CN1302100000000,13,021,Bibb County, GA,Feb-18,70631,67115,3516,5.0
CN1302100000000,13,021,Bibb County, GA,Mar-18,70627,67314,3313,4.7
CN1302100000000,13,021,Bibb County, GA,Apr-18(p),69954,66976,2978,4.3
CN2011100000000,20,111,Lyon County, KS,Mar-17,16955,16261,694,4.1
CN2011100000000,20,111,Lyon County, KS,Apr-17,16809,16199,610,3.6
CN2011100000000,20,111,Lyon County, KS,May-17,16762,16151,611,3.6
CN2011100000000,20,111,Lyon County, KS,Jun-17,16924,16240,684,4.0
CN2011100000000,20,111,Lyon County, KS,Jul-17,16798,16077,721,4.3
CN2011100000000,20,111,Lyon County, KS,Aug-17,16576,15899,677,4.1
CN2011100000000,20,111,Lyon County, KS,Sep-17,16799,16257,542,3.2
CN2011100000000,20,111,Lyon County, KS,Oct-17,16771,16282,489,2.9
CN2011100000000,20,111,Lyon County, KS,Nov-17,16790,16261,529,3.2
CN2011100000000,20,111,Lyon County, KS,Dec-17,16644,16109,535,3.2
CN2011100000000,20,111,Lyon County, KS,Jan-18,16589,15964,625,3.8
CN2011100000000,20,111,Lyon County, KS,Feb-18,16792,16118,674,4.0
CN2011100000000,20,111,Lyon County, KS,Mar-18,16777,16163,614,3.7
CN2011100000000,20,111,Lyon County, KS,Apr-18(p),16733,16178,555,3.3
CN3403300000000,34,033,Salem County, NJ,Mar-17,30026,28223,1803,6.0
CN3403300000000,34,033,Salem County, NJ,Apr-17,29741,28134,1607,5.4
CN3403300000000,34,033,Salem County, NJ,May-17,29736,28076,1660,5.6
CN3403300000000,34,033,Salem County, NJ,Jun-17,29527,27690,1837,6.2
CN3403300000000,34,033,Salem County, NJ,Jul-17,30050,28035,2015,6.7
CN3403300000000,34,033,Salem County, NJ,Aug-17,29807,27830,1977,6.6
CN3403300000000,34,033,Salem County, NJ,Sep-17,29651,27811,1840,6.2
CN3403300000000,34,033,Salem County, NJ,Oct-17,29904,28193,1711,5.7
CN3403300000000,34,033,Salem County, NJ,Nov-17,30039,28270,1769,5.9
CN3403300000000,34,033,Salem County, NJ,Dec-17,29874,28137,1737,5.8
CN3403300000000,34,033,Salem County, NJ,Jan-18,29614,27665,1949,6.6
CN3403300000000,34,033,Salem County, NJ,Feb-18,29584,27610,1974,6.7
CN3403300000000,34,033,Salem County, NJ,Mar-18,29399,27555,1844,6.3
CN3403300000000,34,033,Salem County, NJ,Apr-18(p),29315,27748,1567,5.3
CN5302100000000,53,021,Franklin County, WA,Mar-17,39301,36363,2938,7.5
CN5302100000000,53,021,Franklin County, WA,Apr-17,40425,38037,2388,5.9
CN5302100000000,53,021,Franklin County, WA,May-17,40876,38608,2268,5.5
CN5302100000000,53,021,Franklin County, WA,Jun-17,43663,41518,2145,4.9
CN5302100000000,53,021,Franklin County, WA,Jul-17,44263,42138,2125,4.8
CN5302100000000,53,021,Franklin County, WA,Aug-17,42154,40018,2136,5.1
CN5302100000000,53,021,Franklin County, WA,Sep-17,42171,40204,1967,4.7
CN5302100000000,53,021,Franklin County, WA,Oct-17,40940,38923,2017,4.9
CN5302100000000,53,021,Franklin County, WA,Nov-17,40134,37727,2407,6.0
CN5302100000000,53,021,Franklin County, WA,Dec-17,39639,36476,3163,8.0
CN5302100000000,53,021,Franklin County, WA,Jan-18,39057,35710,3347,8.6
CN5302100000000,53,021,Franklin County, WA,Feb-18,39346,36029,3317,8.4
CN5302100000000,53,021,Franklin County, WA,Mar-18,40191,37103,3088,7.7
CN5302100000000,53,021,Franklin County, WA,Apr-18(p),40566,38042,2524,6.2
CN0112300000000,01,123,Tallapoosa County, AL,Mar-17,18329,17465,864,4.7
CN0112300000000,01,123,Tallapoosa County, AL,Apr-17,18400,17703,697,3.8
CN0112300000000,01,123,Tallapoosa County, AL,May-17,18413,17753,660,3.6
CN0112300000000,01,123,Tallapoosa County, AL,Jun-17,18440,17640,800,4.3
CN0112300000000,01,123,Tallapoosa County, AL,Jul-17,18504,17655,849,4.6
CN0112300000000,01,123,Tallapoosa County, AL,Aug-17,18370,17650,720,3.9
CN0112300000000,01,123,Tallapoosa County, AL,Sep-17,18401,17755,646,3.5
CN0112300000000,01,123,Tallapoosa County, AL,Oct-17,18255,17599,656,3.6
CN0112300000000,01,123,Tallapoosa County, AL,Nov-17,18113,17503,610,3.4
CN0112300000000,01,123,Tallapoosa County, AL,Dec-17,18049,17443,606,3.4
CN0112300000000,01,123,Tallapoosa County, AL,Jan-18,17832,17082,750,4.2
CN0112300000000,01,123,Tallapoosa County, AL,Feb-18,17798,17024,774,4.3
CN0112300000000,01,123,Tallapoosa County, AL,Mar-18,17899,17175,724,4.0
CN0112300000000,01,123,Tallapoosa County, AL,Apr-18(p),18044,17382,662,3.7
CN1706900000000,17,069,Hardin County, IL,Mar-17,1328,1231,97,7.3
CN1706900000000,17,069,Hardin County, IL,Apr-17,1341,1255,86,6.4
CN1706900000000,17,069,Hardin County, IL,May-17,1349,1251,98,7.3
CN1706900000000,17,069,Hardin County, IL,Jun-17,1348,1241,107,7.9
CN1706900000000,17,069,Hardin County, IL,Jul-17,1330,1216,114,8.6
CN1706900000000,17,069,Hardin County, IL,Aug-17,1334,1231,103,7.7
CN1706900000000,17,069,Hardin County, IL,Sep-17,1336,1248,88,6.6
CN1706900000000,17,069,Hardin County, IL,Oct-17,1307,1223,84,6.4
CN1706900000000,17,069,Hardin County, IL,Nov-17,1311,1225,86,6.6
CN1706900000000,17,069,Hardin County, IL,Dec-17,1352,1259,93,6.9
CN1706900000000,17,069,Hardin County, IL,Jan-18,1296,1197,99,7.6
CN1706900000000,17,069,Hardin County, IL,Feb-18,1292,1203,89,6.9
CN1706900000000,17,069,Hardin County, IL,Mar-18,1322,1236,86,6.5
CN1706900000000,17,069,Hardin County, IL,Apr-18(p),1331,1253,78,5.9
CN3605700000000,36,057,Montgomery County, NY,Mar-17,22590,21159,1431,6.3
CN3605700000000,36,057,Montgomery County, NY,Apr-17,22514,21265,1249,5.5
CN3605700000000,36,057,Montgomery County, NY,May-17,22408,21224,1184,5.3
CN3605700000000,36,057,Montgomery County, NY,Jun-17,22881,21686,1195,5.2
CN3605700000000,36,057,Montgomery County, NY,Jul-17,22767,21489,1278,5.6
CN3605700000000,36,057,Montgomery County, NY,Aug-17,22746,21499,1247,5.5
CN3605700000000,36,057,Montgomery County, NY,Sep-17,22816,21578,1238,5.4
CN3605700000000,36,057,Montgomery County, NY,Oct-17,22604,21452,1152,5.1
CN3605700000000,36,057,Montgomery County, NY,Nov-17,22779,21550,1229,5.4
CN3605700000000,36,057,Montgomery County, NY,Dec-17,22591,21235,1356,6.0
CN3605700000000,36,057,Montgomery County, NY,Jan-18,22970,21248,1722,7.5
CN3605700000000,36,057,Montgomery County, NY,Feb-18,22680,20908,1772,7.8
CN3605700000000,36,057,Montgomery County, NY,Mar-18,22390,20816,1574,7.0
CN3605700000000,36,057,Montgomery County, NY,Apr-18(p),22291,21021,1270,5.7
CN5504500000000,55,045,Green County, WI,Mar-17,21409,20704,705,3.3
CN5504500000000,55,045,Green County, WI,Apr-17,21449,20913,536,2.5
CN5504500000000,55,045,Green County, WI,May-17,21450,20908,542,2.5
CN5504500000000,55,045,Green County, WI,Jun-17,21958,21308,650,3.0
CN5504500000000,55,045,Green County, WI,Jul-17,21798,21204,594,2.7
CN5504500000000,55,045,Green County, WI,Aug-17,21487,20948,539,2.5
CN5504500000000,55,045,Green County, WI,Sep-17,21415,20941,474,2.2
CN5504500000000,55,045,Green County, WI,Oct-17,21706,21249,457,2.1
CN5504500000000,55,045,Green County, WI,Nov-17,21844,21384,460,2.1
CN5504500000000,55,045,Green County, WI,Dec-17,21715,21265,450,2.1
CN5504500000000,55,045,Green County, WI,Jan-18,21697,21101,596,2.7
CN5504500000000,55,045,Green County, WI,Feb-18,21859,21174,685,3.1
CN5504500000000,55,045,Green County, WI,Mar-18,22034,21395,639,2.9
CN5504500000000,55,045,Green County, WI,Apr-18(p),21970,21489,481,2.2
CN4202900000000,42,029,Chester County, PA,Mar-17,280436,270516,9920,3.5
CN4202900000000,42,029,Chester County, PA,Apr-17,281863,272610,9253,3.3
CN4202900000000,42,029,Chester County, PA,May-17,282931,272718,10213,3.6
CN4202900000000,42,029,Chester County, PA,Jun-17,286843,276184,10659,3.7
CN4202900000000,42,029,Chester County, PA,Jul-17,288861,277199,11662,4.0
CN4202900000000,42,029,Chester County, PA,Aug-17,285168,273528,11640,4.1
CN4202900000000,42,029,Chester County, PA,Sep-17,280676,271216,9460,3.4
CN4202900000000,42,029,Chester County, PA,Oct-17,278573,269601,8972,3.2
CN4202900000000,42,029,Chester County, PA,Nov-17,276917,267892,9025,3.3
CN4202900000000,42,029,Chester County, PA,Dec-17,276319,267875,8444,3.1
CN4202900000000,42,029,Chester County, PA,Jan-18,275483,265400,10083,3.7
CN4202900000000,42,029,Chester County, PA,Feb-18,277239,267074,10165,3.7
CN4202900000000,42,029,Chester County, PA,Mar-18,274651,265864,8787,3.2
CN4202900000000,42,029,Chester County, PA,Apr-18(p),275414,267403,8011,2.9
CN1901500000000,19,015,Boone County, IA,Mar-17,14790,14390,400,2.7
CN1901500000000,19,015,Boone County, IA,Apr-17,14868,14536,332,2.2
CN1901500000000,19,015,Boone County, IA,May-17,14760,14415,345,2.3
CN1901500000000,19,015,Boone County, IA,Jun-17,14862,14482,380,2.6
CN1901500000000,19,015,Boone County, IA,Jul-17,14951,14570,381,2.5
CN1901500000000,19,015,Boone County, IA,Aug-17,14736,14346,390,2.6
CN1901500000000,19,015,Boone County, IA,Sep-17,14913,14573,340,2.3
CN1901500000000,19,015,Boone County, IA,Oct-17,14874,14601,273,1.8
CN1901500000000,19,015,Boone County, IA,Nov-17,14801,14512,289,2.0
CN1901500000000,19,015,Boone County, IA,Dec-17,14701,14376,325,2.2
CN1901500000000,19,015,Boone County, IA,Jan-18,14582,14163,419,2.9
CN1901500000000,19,015,Boone County, IA,Feb-18,14810,14369,441,3.0
CN1901500000000,19,015,Boone County, IA,Mar-18,14697,14320,377,2.6
CN1901500000000,19,015,Boone County, IA,Apr-18(p),14755,14430,325,2.2
CN3800300000000,38,003,Barnes County, ND,Mar-17,5648,5462,186,3.3
CN3800300000000,38,003,Barnes County, ND,Apr-17,5575,5429,146,2.6
CN3800300000000,38,003,Barnes County, ND,May-17,5643,5448,195,3.5
CN3800300000000,38,003,Barnes County, ND,Jun-17,5660,5465,195,3.4
CN3800300000000,38,003,Barnes County, ND,Jul-17,5523,5366,157,2.8
CN3800300000000,38,003,Barnes County, ND,Aug-17,5482,5331,151,2.8
CN3800300000000,38,003,Barnes County, ND,Sep-17,5494,5390,104,1.9
CN3800300000000,38,003,Barnes County, ND,Oct-17,5484,5403,81,1.5
CN3800300000000,38,003,Barnes County, ND,Nov-17,5384,5281,103,1.9
CN3800300000000,38,003,Barnes County, ND,Dec-17,5371,5251,120,2.2
CN3800300000000,38,003,Barnes County, ND,Jan-18,5286,5117,169,3.2
CN3800300000000,38,003,Barnes County, ND,Feb-18,5353,5183,170,3.2
CN3800300000000,38,003,Barnes County, ND,Mar-18,5407,5247,160,3.0
CN3800300000000,38,003,Barnes County, ND,Apr-18(p),5298,5159,139,2.6
CN5161000000000,51,610,Falls Church city, VA,Mar-17,8150,7923,227,2.8
CN5161000000000,51,610,Falls Church city, VA,Apr-17,8134,7932,202,2.5
CN5161000000000,51,610,Falls Church city, VA,May-17,8186,7966,220,2.7
CN5161000000000,51,610,Falls Church city, VA,Jun-17,8238,8003,235,2.9
CN5161000000000,51,610,Falls Church city, VA,Jul-17,8275,8043,232,2.8
CN5161000000000,51,610,Falls Church city, VA,Aug-17,8157,7927,230,2.8
CN5161000000000,51,610,Falls Church city, VA,Sep-17,8168,7953,215,2.6
CN5161000000000,51,610,Falls Church city, VA,Oct-17,8159,7953,206,2.5
CN5161000000000,51,610,Falls Church city, VA,Nov-17,8180,7969,211,2.6
CN5161000000000,51,610,Falls Church city, VA,Dec-17,8138,7953,185,2.3
CN5161000000000,51,610,Falls Church city, VA,Jan-18,8210,7998,212,2.6
CN5161000000000,51,610,Falls Church city, VA,Feb-18,8268,8089,179,2.2
CN5161000000000,51,610,Falls Church city, VA,Mar-18,8310,8121,189,2.3
CN5161000000000,51,610,Falls Church city, VA,Apr-18(p),8298,8126,172,2.1
CN0106700000000,01,067,Henry County, AL,Mar-17,6722,6356,366,5.4
CN0106700000000,01,067,Henry County, AL,Apr-17,6687,6374,313,4.7
CN0106700000000,01,067,Henry County, AL,May-17,6654,6362,292,4.4
CN0106700000000,01,067,Henry County, AL,Jun-17,6715,6371,344,5.1
CN0106700000000,01,067,Henry County, AL,Jul-17,6749,6433,316,4.7
CN0106700000000,01,067,Henry County, AL,Aug-17,6742,6428,314,4.7
CN0106700000000,01,067,Henry County, AL,Sep-17,6760,6485,275,4.1
CN0106700000000,01,067,Henry County, AL,Oct-17,6737,6472,265,3.9
CN0106700000000,01,067,Henry County, AL,Nov-17,6652,6396,256,3.8
CN0106700000000,01,067,Henry County, AL,Dec-17,6568,6312,256,3.9
CN0106700000000,01,067,Henry County, AL,Jan-18,6514,6213,301,4.6
CN0106700000000,01,067,Henry County, AL,Feb-18,6653,6325,328,4.9
CN0106700000000,01,067,Henry County, AL,Mar-18,6685,6399,286,4.3
CN0106700000000,01,067,Henry County, AL,Apr-18(p),6737,6475,262,3.9
CN2005500000000,20,055,Finney County, KS,Mar-17,20380,19831,549,2.7
CN2005500000000,20,055,Finney County, KS,Apr-17,20365,19822,543,2.7
CN2005500000000,20,055,Finney County, KS,May-17,20238,19682,556,2.7
CN2005500000000,20,055,Finney County, KS,Jun-17,20651,20033,618,3.0
CN2005500000000,20,055,Finney County, KS,Jul-17,20462,19812,650,3.2
CN2005500000000,20,055,Finney County, KS,Aug-17,20035,19445,590,2.9
CN2005500000000,20,055,Finney County, KS,Sep-17,20327,19825,502,2.5
CN2005500000000,20,055,Finney County, KS,Oct-17,20361,19930,431,2.1
CN2005500000000,20,055,Finney County, KS,Nov-17,20422,19943,479,2.3
CN2005500000000,20,055,Finney County, KS,Dec-17,20299,19861,438,2.2
CN2005500000000,20,055,Finney County, KS,Jan-18,20259,19806,453,2.2
CN2005500000000,20,055,Finney County, KS,Feb-18,20354,19849,505,2.5
CN2005500000000,20,055,Finney County, KS,Mar-18,20357,19855,502,2.5
CN2005500000000,20,055,Finney County, KS,Apr-18(p),20141,19653,488,2.4
CN1330100000000,13,301,Warren County, GA,Mar-17,2717,2568,149,5.5
CN1330100000000,13,301,Warren County, GA,Apr-17,2707,2566,141,5.2
CN1330100000000,13,301,Warren County, GA,May-17,2712,2553,159,5.9
CN1330100000000,13,301,Warren County, GA,Jun-17,2709,2546,163,6.0
CN1330100000000,13,301,Warren County, GA,Jul-17,2735,2547,188,6.9
CN1330100000000,13,301,Warren County, GA,Aug-17,2697,2539,158,5.9
CN1330100000000,13,301,Warren County, GA,Sep-17,2742,2579,163,5.9
CN1330100000000,13,301,Warren County, GA,Oct-17,2729,2576,153,5.6
CN1330100000000,13,301,Warren County, GA,Nov-17,2732,2586,146,5.3
CN1330100000000,13,301,Warren County, GA,Dec-17,2740,2597,143,5.2
CN1330100000000,13,301,Warren County, GA,Jan-18,2763,2611,152,5.5
CN1330100000000,13,301,Warren County, GA,Feb-18,2787,2651,136,4.9
CN1330100000000,13,301,Warren County, GA,Mar-18,2788,2661,127,4.6
CN1330100000000,13,301,Warren County, GA,Apr-18(p),2781,2661,120,4.3
CN2610500000000,26,105,Mason County, MI,Mar-17,13761,12802,959,7.0
CN2610500000000,26,105,Mason County, MI,Apr-17,13792,13087,705,5.1
CN2610500000000,26,105,Mason County, MI,May-17,14121,13452,669,4.7
CN2610500000000,26,105,Mason County, MI,Jun-17,14681,13961,720,4.9
CN2610500000000,26,105,Mason County, MI,Jul-17,15023,14207,816,5.4
CN2610500000000,26,105,Mason County, MI,Aug-17,14688,13911,777,5.3
CN2610500000000,26,105,Mason County, MI,Sep-17,14367,13684,683,4.8
CN2610500000000,26,105,Mason County, MI,Oct-17,14177,13543,634,4.5
CN2610500000000,26,105,Mason County, MI,Nov-17,13875,13150,725,5.2
CN2610500000000,26,105,Mason County, MI,Dec-17,13868,12962,906,6.5
CN2610500000000,26,105,Mason County, MI,Jan-18,13693,12680,1013,7.4
CN2610500000000,26,105,Mason County, MI,Feb-18,13747,12692,1055,7.7
CN2610500000000,26,105,Mason County, MI,Mar-18,13740,12850,890,6.5
CN2610500000000,26,105,Mason County, MI,Apr-18(p),13856,13148,708,5.1
CN4000500000000,40,005,Atoka County, OK,Mar-17,5162,4869,293,5.7
CN4000500000000,40,005,Atoka County, OK,Apr-17,5130,4865,265,5.2
CN4000500000000,40,005,Atoka County, OK,May-17,5126,4846,280,5.5
CN4000500000000,40,005,Atoka County, OK,Jun-17,5211,4914,297,5.7
CN4000500000000,40,005,Atoka County, OK,Jul-17,5088,4820,268,5.3
CN4000500000000,40,005,Atoka County, OK,Aug-17,5296,5035,261,4.9
CN4000500000000,40,005,Atoka County, OK,Sep-17,5315,5053,262,4.9
CN4000500000000,40,005,Atoka County, OK,Oct-17,5310,5042,268,5.0
CN4000500000000,40,005,Atoka County, OK,Nov-17,5341,5084,257,4.8
CN4000500000000,40,005,Atoka County, OK,Dec-17,5315,5060,255,4.8
CN4000500000000,40,005,Atoka County, OK,Jan-18,5301,5000,301,5.7
CN4000500000000,40,005,Atoka County, OK,Feb-18,5361,5097,264,4.9
CN4000500000000,40,005,Atoka County, OK,Mar-18,5369,5124,245,4.6
CN4000500000000,40,005,Atoka County, OK,Apr-18(p),5330,5085,245,4.6
CN0218500000000,02,185,North Slope Borough, AK,Mar-17,3822,3551,271,7.1
CN0218500000000,02,185,North Slope Borough, AK,Apr-17,3679,3409,270,7.3
CN0218500000000,02,185,North Slope Borough, AK,May-17,3621,3343,278,7.7
CN0218500000000,02,185,North Slope Borough, AK,Jun-17,3485,3177,308,8.8
CN0218500000000,02,185,North Slope Borough, AK,Jul-17,3540,3248,292,8.2
CN0218500000000,02,185,North Slope Borough, AK,Aug-17,3550,3269,281,7.9
CN0218500000000,02,185,North Slope Borough, AK,Sep-17,3530,3246,284,8.0
CN0218500000000,02,185,North Slope Borough, AK,Oct-17,3661,3390,271,7.4
CN0218500000000,02,185,North Slope Borough, AK,Nov-17,3726,3472,254,6.8
CN0218500000000,02,185,North Slope Borough, AK,Dec-17,3767,3543,224,5.9
CN0218500000000,02,185,North Slope Borough, AK,Jan-18,3779,3523,256,6.8
CN0218500000000,02,185,North Slope Borough, AK,Feb-18,3817,3543,274,7.2
CN0218500000000,02,185,North Slope Borough, AK,Mar-18,3794,3537,257,6.8
CN0218500000000,02,185,North Slope Borough, AK,Apr-18(p),3631,3370,261,7.2
CN2117300000000,21,173,Montgomery County, KY,Mar-17,11925,11059,866,7.3
CN2117300000000,21,173,Montgomery County, KY,Apr-17,11833,11110,723,6.1
CN2117300000000,21,173,Montgomery County, KY,May-17,11911,11147,764,6.4
CN2117300000000,21,173,Montgomery County, KY,Jun-17,12011,11173,838,7.0
CN2117300000000,21,173,Montgomery County, KY,Jul-17,11890,11061,829,7.0
CN2117300000000,21,173,Montgomery County, KY,Aug-17,11790,10994,796,6.8
CN2117300000000,21,173,Montgomery County, KY,Sep-17,11943,11203,740,6.2
CN2117300000000,21,173,Montgomery County, KY,Oct-17,11771,11117,654,5.6
CN2117300000000,21,173,Montgomery County, KY,Nov-17,11714,11095,619,5.3
CN2117300000000,21,173,Montgomery County, KY,Dec-17,11616,10984,632,5.4
CN2117300000000,21,173,Montgomery County, KY,Jan-18,11519,10764,755,6.6
CN2117300000000,21,173,Montgomery County, KY,Feb-18,11632,10767,865,7.4
CN2117300000000,21,173,Montgomery County, KY,Mar-18,11677,10920,757,6.5
CN2117300000000,21,173,Montgomery County, KY,Apr-18(p),11725,11062,663,5.7
CN2101700000000,21,017,Bourbon County, KY,Mar-17,9941,9396,545,5.5
CN2101700000000,21,017,Bourbon County, KY,Apr-17,10261,9796,465,4.5
CN2101700000000,21,017,Bourbon County, KY,May-17,10188,9712,476,4.7
CN2101700000000,21,017,Bourbon County, KY,Jun-17,10192,9683,509,5.0
CN2101700000000,21,017,Bourbon County, KY,Jul-17,9783,9319,464,4.7
CN2101700000000,21,017,Bourbon County, KY,Aug-17,9620,9215,405,4.2
CN2101700000000,21,017,Bourbon County, KY,Sep-17,9560,9174,386,4.0
CN2101700000000,21,017,Bourbon County, KY,Oct-17,9773,9414,359,3.7
CN2101700000000,21,017,Bourbon County, KY,Nov-17,9950,9604,346,3.5
CN2101700000000,21,017,Bourbon County, KY,Dec-17,9800,9455,345,3.5
CN2101700000000,21,017,Bourbon County, KY,Jan-18,9787,9397,390,4.0
CN2101700000000,21,017,Bourbon County, KY,Feb-18,9491,9052,439,4.6
CN2101700000000,21,017,Bourbon County, KY,Mar-18,9490,9083,407,4.3
CN2101700000000,21,017,Bourbon County, KY,Apr-18(p),9683,9321,362,3.7
CN5408300000000,54,083,Randolph County, WV,Mar-17,12003,11308,695,5.8
CN5408300000000,54,083,Randolph County, WV,Apr-17,12177,11538,639,5.2
CN5408300000000,54,083,Randolph County, WV,May-17,12069,11473,596,4.9
CN5408300000000,54,083,Randolph County, WV,Jun-17,12209,11579,630,5.2
CN5408300000000,54,083,Randolph County, WV,Jul-17,12273,11648,625,5.1
CN5408300000000,54,083,Randolph County, WV,Aug-17,12155,11493,662,5.4
CN5408300000000,54,083,Randolph County, WV,Sep-17,12210,11622,588,4.8
CN5408300000000,54,083,Randolph County, WV,Oct-17,12146,11569,577,4.8
CN5408300000000,54,083,Randolph County, WV,Nov-17,12020,11373,647,5.4
CN5408300000000,54,083,Randolph County, WV,Dec-17,11871,11215,656,5.5
CN5408300000000,54,083,Randolph County, WV,Jan-18,12020,11287,733,6.1
CN5408300000000,54,083,Randolph County, WV,Feb-18,12159,11370,789,6.5
CN5408300000000,54,083,Randolph County, WV,Mar-18,12057,11328,729,6.0
CN5408300000000,54,083,Randolph County, WV,Apr-18(p),12329,11583,746,6.1
CN2207900000000,22,079,Rapides Parish, LA,Mar-17,55874,52621,3253,5.8
CN2207900000000,22,079,Rapides Parish, LA,Apr-17,56236,53134,3102,5.5
CN2207900000000,22,079,Rapides Parish, LA,May-17,55931,52697,3234,5.8
CN2207900000000,22,079,Rapides Parish, LA,Jun-17,56961,53297,3664,6.4
CN2207900000000,22,079,Rapides Parish, LA,Jul-17,57240,53738,3502,6.1
CN2207900000000,22,079,Rapides Parish, LA,Aug-17,56666,53207,3459,6.1
CN2207900000000,22,079,Rapides Parish, LA,Sep-17,56744,53677,3067,5.4
CN2207900000000,22,079,Rapides Parish, LA,Oct-17,56640,54008,2632,4.6
CN2207900000000,22,079,Rapides Parish, LA,Nov-17,56480,53922,2558,4.5
CN2207900000000,22,079,Rapides Parish, LA,Dec-17,56242,53761,2481,4.4
CN2207900000000,22,079,Rapides Parish, LA,Jan-18,56601,53866,2735,4.8
CN2207900000000,22,079,Rapides Parish, LA,Feb-18,56779,54317,2462,4.3
CN2207900000000,22,079,Rapides Parish, LA,Mar-18,56849,54197,2652,4.7
CN2207900000000,22,079,Rapides Parish, LA,Apr-18(p),56678,54095,2583,4.6
CN4106700000000,41,067,Washington County, OR,Mar-17,318784,307600,11184,3.5
CN4106700000000,41,067,Washington County, OR,Apr-17,320355,310336,10019,3.1
CN4106700000000,41,067,Washington County, OR,May-17,320701,310655,10046,3.1
CN4106700000000,41,067,Washington County, OR,Jun-17,323601,311497,12104,3.7
CN4106700000000,41,067,Washington County, OR,Jul-17,327255,314536,12719,3.9
CN4106700000000,41,067,Washington County, OR,Aug-17,326575,313656,12919,4.0
CN4106700000000,41,067,Washington County, OR,Sep-17,326979,315293,11686,3.6
CN4106700000000,41,067,Washington County, OR,Oct-17,327017,315543,11474,3.5
CN4106700000000,41,067,Washington County, OR,Nov-17,327230,316239,10991,3.4
CN4106700000000,41,067,Washington County, OR,Dec-17,326168,315928,10240,3.1
CN4106700000000,41,067,Washington County, OR,Jan-18,324886,314070,10816,3.3
CN4106700000000,41,067,Washington County, OR,Feb-18,326413,314866,11547,3.5
CN4106700000000,41,067,Washington County, OR,Mar-18,325266,313747,11519,3.5
CN4106700000000,41,067,Washington County, OR,Apr-18(p),322645,312356,10289,3.2
CN0503700000000,05,037,Cross County, AR,Mar-17,7770,7466,304,3.9
CN0503700000000,05,037,Cross County, AR,Apr-17,7804,7541,263,3.4
CN0503700000000,05,037,Cross County, AR,May-17,7841,7549,292,3.7
CN0503700000000,05,037,Cross County, AR,Jun-17,8006,7682,324,4.0
CN0503700000000,05,037,Cross County, AR,Jul-17,7557,7239,318,4.2
CN0503700000000,05,037,Cross County, AR,Aug-17,7722,7422,300,3.9
CN0503700000000,05,037,Cross County, AR,Sep-17,7632,7348,284,3.7
CN0503700000000,05,037,Cross County, AR,Oct-17,7710,7450,260,3.4
CN0503700000000,05,037,Cross County, AR,Nov-17,7645,7371,274,3.6
CN0503700000000,05,037,Cross County, AR,Dec-17,7614,7312,302,4.0
CN0503700000000,05,037,Cross County, AR,Jan-18,7474,7083,391,5.2
CN0503700000000,05,037,Cross County, AR,Feb-18,7382,7016,366,5.0
CN0503700000000,05,037,Cross County, AR,Mar-18,7446,7114,332,4.5
CN0503700000000,05,037,Cross County, AR,Apr-18(p),7444,7173,271,3.6
CN2812900000000,28,129,Smith County, MS,Mar-17,6774,6462,312,4.6
CN2812900000000,28,129,Smith County, MS,Apr-17,6839,6555,284,4.2
CN2812900000000,28,129,Smith County, MS,May-17,6829,6489,340,5.0
CN2812900000000,28,129,Smith County, MS,Jun-17,6896,6515,381,5.5
CN2812900000000,28,129,Smith County, MS,Jul-17,6877,6518,359,5.2
CN2812900000000,28,129,Smith County, MS,Aug-17,6722,6414,308,4.6
CN2812900000000,28,129,Smith County, MS,Sep-17,6742,6444,298,4.4
CN2812900000000,28,129,Smith County, MS,Oct-17,6688,6409,279,4.2
CN2812900000000,28,129,Smith County, MS,Nov-17,6600,6330,270,4.1
CN2812900000000,28,129,Smith County, MS,Dec-17,6625,6347,278,4.2
CN2812900000000,28,129,Smith County, MS,Jan-18,6577,6291,286,4.3
CN2812900000000,28,129,Smith County, MS,Feb-18,6614,6352,262,4.0
CN2812900000000,28,129,Smith County, MS,Mar-18,6695,6446,249,3.7
CN2812900000000,28,129,Smith County, MS,Apr-18(p),6685,6428,257,3.8
CN2815100000000,28,151,Washington County, MS,Mar-17,17498,16183,1315,7.5
CN2815100000000,28,151,Washington County, MS,Apr-17,17365,16191,1174,6.8
CN2815100000000,28,151,Washington County, MS,May-17,17411,16145,1266,7.3
CN2815100000000,28,151,Washington County, MS,Jun-17,17656,16149,1507,8.5
CN2815100000000,28,151,Washington County, MS,Jul-17,17511,16082,1429,8.2
CN2815100000000,28,151,Washington County, MS,Aug-17,17109,15851,1258,7.4
CN2815100000000,28,151,Washington County, MS,Sep-17,17038,15955,1083,6.4
CN2815100000000,28,151,Washington County, MS,Oct-17,16872,15813,1059,6.3
CN2815100000000,28,151,Washington County, MS,Nov-17,16828,15708,1120,6.7
CN2815100000000,28,151,Washington County, MS,Dec-17,16893,15695,1198,7.1
CN2815100000000,28,151,Washington County, MS,Jan-18,16557,15354,1203,7.3
CN2815100000000,28,151,Washington County, MS,Feb-18,16670,15496,1174,7.0
CN2815100000000,28,151,Washington County, MS,Mar-18,16825,15710,1115,6.6
CN2815100000000,28,151,Washington County, MS,Apr-18(p),16772,15769,1003,6.0
CN0609900000000,06,099,Stanislaus County, CA,Mar-17,244362,222787,21575,8.8
CN0609900000000,06,099,Stanislaus County, CA,Apr-17,243336,223854,19482,8.0
CN0609900000000,06,099,Stanislaus County, CA,May-17,244152,226480,17672,7.2
CN0609900000000,06,099,Stanislaus County, CA,Jun-17,243165,224588,18577,7.6
CN0609900000000,06,099,Stanislaus County, CA,Jul-17,245173,226457,18716,7.6
CN0609900000000,06,099,Stanislaus County, CA,Aug-17,247382,230358,17024,6.9
CN0609900000000,06,099,Stanislaus County, CA,Sep-17,244722,230073,14649,6.0
CN0609900000000,06,099,Stanislaus County, CA,Oct-17,241602,227033,14569,6.0
CN0609900000000,06,099,Stanislaus County, CA,Nov-17,241618,226006,15612,6.5
CN0609900000000,06,099,Stanislaus County, CA,Dec-17,240634,224373,16261,6.8
CN0609900000000,06,099,Stanislaus County, CA,Jan-18,241404,223514,17890,7.4
CN0609900000000,06,099,Stanislaus County, CA,Feb-18,242881,224909,17972,7.4
CN0609900000000,06,099,Stanislaus County, CA,Mar-18,242496,225261,17235,7.1
CN0609900000000,06,099,Stanislaus County, CA,Apr-18(p),239029,223754,15275,6.4
CN2200100000000,22,001,Acadia Parish, LA,Mar-17,24160,22651,1509,6.2
CN2200100000000,22,001,Acadia Parish, LA,Apr-17,24142,22738,1404,5.8
CN2200100000000,22,001,Acadia Parish, LA,May-17,24294,22860,1434,5.9
CN2200100000000,22,001,Acadia Parish, LA,Jun-17,24750,23139,1611,6.5
CN2200100000000,22,001,Acadia Parish, LA,Jul-17,24719,23207,1512,6.1
CN2200100000000,22,001,Acadia Parish, LA,Aug-17,24297,22783,1514,6.2
CN2200100000000,22,001,Acadia Parish, LA,Sep-17,24125,22739,1386,5.7
CN2200100000000,22,001,Acadia Parish, LA,Oct-17,23944,22741,1203,5.0
CN2200100000000,22,001,Acadia Parish, LA,Nov-17,23901,22730,1171,4.9
CN2200100000000,22,001,Acadia Parish, LA,Dec-17,23720,22626,1094,4.6
CN2200100000000,22,001,Acadia Parish, LA,Jan-18,23881,22670,1211,5.1
CN2200100000000,22,001,Acadia Parish, LA,Feb-18,23951,22857,1094,4.6
CN2200100000000,22,001,Acadia Parish, LA,Mar-18,24200,23024,1176,4.9
CN2200100000000,22,001,Acadia Parish, LA,Apr-18(p),24136,22988,1148,4.8
CN4823500000000,48,235,Irion County, TX,Mar-17,793,766,27,3.4
CN4823500000000,48,235,Irion County, TX,Apr-17,784,761,23,2.9
CN4823500000000,48,235,Irion County, TX,May-17,786,762,24,3.1
CN4823500000000,48,235,Irion County, TX,Jun-17,785,762,23,2.9
CN4823500000000,48,235,Irion County, TX,Jul-17,760,738,22,2.9
CN4823500000000,48,235,Irion County, TX,Aug-17,766,745,21,2.7
CN4823500000000,48,235,Irion County, TX,Sep-17,762,742,20,2.6
CN4823500000000,48,235,Irion County, TX,Oct-17,772,752,20,2.6
CN4823500000000,48,235,Irion County, TX,Nov-17,770,746,24,3.1
CN4823500000000,48,235,Irion County, TX,Dec-17,777,755,22,2.8
CN4823500000000,48,235,Irion County, TX,Jan-18,770,747,23,3.0
CN4823500000000,48,235,Irion County, TX,Feb-18,785,758,27,3.4
CN4823500000000,48,235,Irion County, TX,Mar-18,810,782,28,3.5
CN4823500000000,48,235,Irion County, TX,Apr-18(p),797,771,26,3.3
CN2402500000000,24,025,Harford County, MD,Mar-17,137790,132306,5484,4.0
CN2402500000000,24,025,Harford County, MD,Apr-17,137964,133038,4926,3.6
CN2402500000000,24,025,Harford County, MD,May-17,138639,133537,5102,3.7
CN2402500000000,24,025,Harford County, MD,Jun-17,140204,134258,5946,4.2
CN2402500000000,24,025,Harford County, MD,Jul-17,141397,135497,5900,4.2
CN2402500000000,24,025,Harford County, MD,Aug-17,139764,134002,5762,4.1
CN2402500000000,24,025,Harford County, MD,Sep-17,139079,134047,5032,3.6
CN2402500000000,24,025,Harford County, MD,Oct-17,139043,133998,5045,3.6
CN2402500000000,24,025,Harford County, MD,Nov-17,138786,133814,4972,3.6
CN2402500000000,24,025,Harford County, MD,Dec-17,137651,133039,4612,3.4
CN2402500000000,24,025,Harford County, MD,Jan-18,138279,132360,5919,4.3
CN2402500000000,24,025,Harford County, MD,Feb-18,138684,132673,6011,4.3
CN2402500000000,24,025,Harford County, MD,Mar-18,139207,133362,5845,4.2
CN2402500000000,24,025,Harford County, MD,Apr-18(p),138626,133659,4967,3.6
CN4711700000000,47,117,Marshall County, TN,Mar-17,15484,14938,546,3.5
CN4711700000000,47,117,Marshall County, TN,Apr-17,15377,14910,467,3.0
CN4711700000000,47,117,Marshall County, TN,May-17,15431,14987,444,2.9
CN4711700000000,47,117,Marshall County, TN,Jun-17,15595,15004,591,3.8
CN4711700000000,47,117,Marshall County, TN,Jul-17,15571,15004,567,3.6
CN4711700000000,47,117,Marshall County, TN,Aug-17,15608,15093,515,3.3
CN4711700000000,47,117,Marshall County, TN,Sep-17,15670,15221,449,2.9
CN4711700000000,47,117,Marshall County, TN,Oct-17,15681,15237,444,2.8
CN4711700000000,47,117,Marshall County, TN,Nov-17,15615,15179,436,2.8
CN4711700000000,47,117,Marshall County, TN,Dec-17,15649,15191,458,2.9
CN4711700000000,47,117,Marshall County, TN,Jan-18,15759,15194,565,3.6
CN4711700000000,47,117,Marshall County, TN,Feb-18,15914,15383,531,3.3
CN4711700000000,47,117,Marshall County, TN,Mar-18,15949,15434,515,3.2
CN4711700000000,47,117,Marshall County, TN,Apr-18(p),16018,15583,435,2.7
CN1603500000000,16,035,Clearwater County, ID,Mar-17,3085,2689,396,12.8
CN1603500000000,16,035,Clearwater County, ID,Apr-17,3055,2712,343,11.2
CN1603500000000,16,035,Clearwater County, ID,May-17,3020,2822,198,6.6
CN1603500000000,16,035,Clearwater County, ID,Jun-17,3079,2920,159,5.2
CN1603500000000,16,035,Clearwater County, ID,Jul-17,3116,2960,156,5.0
CN1603500000000,16,035,Clearwater County, ID,Aug-17,3085,2928,157,5.1
CN1603500000000,16,035,Clearwater County, ID,Sep-17,3047,2909,138,4.5
CN1603500000000,16,035,Clearwater County, ID,Oct-17,3037,2902,135,4.4
CN1603500000000,16,035,Clearwater County, ID,Nov-17,3063,2894,169,5.5
CN1603500000000,16,035,Clearwater County, ID,Dec-17,2999,2819,180,6.0
CN1603500000000,16,035,Clearwater County, ID,Jan-18,2954,2733,221,7.5
CN1603500000000,16,035,Clearwater County, ID,Feb-18,2946,2707,239,8.1
CN1603500000000,16,035,Clearwater County, ID,Mar-18,3001,2689,312,10.4
CN1603500000000,16,035,Clearwater County, ID,Apr-18(p),2979,2685,294,9.9
CN5401100000000,54,011,Cabell County, WV,Mar-17,40935,39081,1854,4.5
CN5401100000000,54,011,Cabell County, WV,Apr-17,41362,39638,1724,4.2
CN5401100000000,54,011,Cabell County, WV,May-17,41450,39752,1698,4.1
CN5401100000000,54,011,Cabell County, WV,Jun-17,41988,39961,2027,4.8
CN5401100000000,54,011,Cabell County, WV,Jul-17,41812,39848,1964,4.7
CN5401100000000,54,011,Cabell County, WV,Aug-17,41731,39697,2034,4.9
CN5401100000000,54,011,Cabell County, WV,Sep-17,41998,40251,1747,4.2
CN5401100000000,54,011,Cabell County, WV,Oct-17,41873,40119,1754,4.2
CN5401100000000,54,011,Cabell County, WV,Nov-17,41635,39793,1842,4.4
CN5401100000000,54,011,Cabell County, WV,Dec-17,41386,39535,1851,4.5
CN5401100000000,54,011,Cabell County, WV,Jan-18,40927,38895,2032,5.0
CN5401100000000,54,011,Cabell County, WV,Feb-18,41472,39160,2312,5.6
CN5401100000000,54,011,Cabell County, WV,Mar-18,41018,38902,2116,5.2
CN5401100000000,54,011,Cabell County, WV,Apr-18(p),41352,39375,1977,4.8
CN4848100000000,48,481,Wharton County, TX,Mar-17,21235,20244,991,4.7
CN4848100000000,48,481,Wharton County, TX,Apr-17,21255,20338,917,4.3
CN4848100000000,48,481,Wharton County, TX,May-17,21282,20392,890,4.2
CN4848100000000,48,481,Wharton County, TX,Jun-17,21159,20164,995,4.7
CN4848100000000,48,481,Wharton County, TX,Jul-17,21194,20221,973,4.6
CN4848100000000,48,481,Wharton County, TX,Aug-17,21228,20265,963,4.5
CN4848100000000,48,481,Wharton County, TX,Sep-17,21030,20100,930,4.4
CN4848100000000,48,481,Wharton County, TX,Oct-17,21027,20216,811,3.9
CN4848100000000,48,481,Wharton County, TX,Nov-17,20937,20091,846,4.0
CN4848100000000,48,481,Wharton County, TX,Dec-17,20909,20109,800,3.8
CN4848100000000,48,481,Wharton County, TX,Jan-18,20762,19866,896,4.3
CN4848100000000,48,481,Wharton County, TX,Feb-18,21131,20250,881,4.2
CN4848100000000,48,481,Wharton County, TX,Mar-18,21478,20632,846,3.9
CN4848100000000,48,481,Wharton County, TX,Apr-18(p),21426,20641,785,3.7
CN1600700000000,16,007,Bear Lake County, ID,Mar-17,2725,2612,113,4.1
CN1600700000000,16,007,Bear Lake County, ID,Apr-17,2727,2646,81,3.0
CN1600700000000,16,007,Bear Lake County, ID,May-17,2822,2745,77,2.7
CN1600700000000,16,007,Bear Lake County, ID,Jun-17,2935,2854,81,2.8
CN1600700000000,16,007,Bear Lake County, ID,Jul-17,2918,2840,78,2.7
CN1600700000000,16,007,Bear Lake County, ID,Aug-17,2898,2822,76,2.6
CN1600700000000,16,007,Bear Lake County, ID,Sep-17,2841,2772,69,2.4
CN1600700000000,16,007,Bear Lake County, ID,Oct-17,2835,2766,69,2.4
CN1600700000000,16,007,Bear Lake County, ID,Nov-17,2756,2665,91,3.3
CN1600700000000,16,007,Bear Lake County, ID,Dec-17,2744,2647,97,3.5
CN1600700000000,16,007,Bear Lake County, ID,Jan-18,2741,2618,123,4.5
CN1600700000000,16,007,Bear Lake County, ID,Feb-18,2769,2666,103,3.7
CN1600700000000,16,007,Bear Lake County, ID,Mar-18,2799,2699,100,3.6
CN1600700000000,16,007,Bear Lake County, ID,Apr-18(p),2812,2722,90,3.2
CN1805900000000,18,059,Hancock County, IN,Mar-17,38480,37292,1188,3.1
CN1805900000000,18,059,Hancock County, IN,Apr-17,38683,37751,932,2.4
CN1805900000000,18,059,Hancock County, IN,May-17,38960,37908,1052,2.7
CN1805900000000,18,059,Hancock County, IN,Jun-17,39440,38241,1199,3.0
CN1805900000000,18,059,Hancock County, IN,Jul-17,39430,38202,1228,3.1
CN1805900000000,18,059,Hancock County, IN,Aug-17,39100,37757,1343,3.4
CN1805900000000,18,059,Hancock County, IN,Sep-17,38847,37723,1124,2.9
CN1805900000000,18,059,Hancock County, IN,Oct-17,38632,37571,1061,2.7
CN1805900000000,18,059,Hancock County, IN,Nov-17,38723,37641,1082,2.8
CN1805900000000,18,059,Hancock County, IN,Dec-17,38337,37351,986,2.6
CN1805900000000,18,059,Hancock County, IN,Jan-18,38399,37208,1191,3.1
CN1805900000000,18,059,Hancock County, IN,Feb-18,38927,37673,1254,3.2
CN1805900000000,18,059,Hancock County, IN,Mar-18,39313,38196,1117,2.8
CN1805900000000,18,059,Hancock County, IN,Apr-18(p),39425,38405,1020,2.6
CN4845300000000,48,453,Travis County, TX,Mar-17,694569,672341,22228,3.2
CN4845300000000,48,453,Travis County, TX,Apr-17,696624,677024,19600,2.8
CN4845300000000,48,453,Travis County, TX,May-17,696711,676501,20210,2.9
CN4845300000000,48,453,Travis County, TX,Jun-17,698886,676951,21935,3.1
CN4845300000000,48,453,Travis County, TX,Jul-17,702105,679810,22295,3.2
CN4845300000000,48,453,Travis County, TX,Aug-17,697869,675666,22203,3.2
CN4845300000000,48,453,Travis County, TX,Sep-17,703846,683934,19912,2.8
CN4845300000000,48,453,Travis County, TX,Oct-17,700225,681727,18498,2.6
CN4845300000000,48,453,Travis County, TX,Nov-17,707154,687989,19165,2.7
CN4845300000000,48,453,Travis County, TX,Dec-17,706258,687982,18276,2.6
CN4845300000000,48,453,Travis County, TX,Jan-18,709769,689260,20509,2.9
CN4845300000000,48,453,Travis County, TX,Feb-18,721109,699955,21154,2.9
CN4845300000000,48,453,Travis County, TX,Mar-18,721930,700358,21572,3.0
CN4845300000000,48,453,Travis County, TX,Apr-18(p),722564,703320,19244,2.7
CN5603500000000,56,035,Sublette County, WY,Mar-17,4024,3792,232,5.8
CN5603500000000,56,035,Sublette County, WY,Apr-17,3996,3811,185,4.6
CN5603500000000,56,035,Sublette County, WY,May-17,4171,3993,178,4.3
CN5603500000000,56,035,Sublette County, WY,Jun-17,4518,4340,178,3.9
CN5603500000000,56,035,Sublette County, WY,Jul-17,4470,4310,160,3.6
CN5603500000000,56,035,Sublette County, WY,Aug-17,4444,4297,147,3.3
CN5603500000000,56,035,Sublette County, WY,Sep-17,4397,4241,156,3.5
CN5603500000000,56,035,Sublette County, WY,Oct-17,4371,4214,157,3.6
CN5603500000000,56,035,Sublette County, WY,Nov-17,4339,4176,163,3.8
CN5603500000000,56,035,Sublette County, WY,Dec-17,4192,4026,166,4.0
CN5603500000000,56,035,Sublette County, WY,Jan-18,4302,4117,185,4.3
CN5603500000000,56,035,Sublette County, WY,Feb-18,4220,4045,175,4.1
CN5603500000000,56,035,Sublette County, WY,Mar-18,4283,4110,173,4.0
CN5603500000000,56,035,Sublette County, WY,Apr-18(p),4154,3994,160,3.9
CN2110100000000,21,101,Henderson County, KY,Mar-17,21884,20681,1203,5.5
CN2110100000000,21,101,Henderson County, KY,Apr-17,21727,20711,1016,4.7
CN2110100000000,21,101,Henderson County, KY,May-17,21717,20663,1054,4.9
CN2110100000000,21,101,Henderson County, KY,Jun-17,21983,20847,1136,5.2
CN2110100000000,21,101,Henderson County, KY,Jul-17,22068,20995,1073,4.9
CN2110100000000,21,101,Henderson County, KY,Aug-17,21786,20834,952,4.4
CN2110100000000,21,101,Henderson County, KY,Sep-17,22130,21253,877,4.0
CN2110100000000,21,101,Henderson County, KY,Oct-17,21993,21205,788,3.6
CN2110100000000,21,101,Henderson County, KY,Nov-17,22052,21276,776,3.5
CN2110100000000,21,101,Henderson County, KY,Dec-17,21898,21152,746,3.4
CN2110100000000,21,101,Henderson County, KY,Jan-18,21644,20855,789,3.6
CN2110100000000,21,101,Henderson County, KY,Feb-18,21952,21043,909,4.1
CN2110100000000,21,101,Henderson County, KY,Mar-18,22237,21348,889,4.0
CN2110100000000,21,101,Henderson County, KY,Apr-18(p),22236,21425,811,3.6
CN2101100000000,21,011,Bath County, KY,Mar-17,4829,4414,415,8.6
CN2101100000000,21,011,Bath County, KY,Apr-17,4811,4480,331,6.9
CN2101100000000,21,011,Bath County, KY,May-17,4822,4478,344,7.1
CN2101100000000,21,011,Bath County, KY,Jun-17,4836,4460,376,7.8
CN2101100000000,21,011,Bath County, KY,Jul-17,4725,4342,383,8.1
CN2101100000000,21,011,Bath County, KY,Aug-17,4662,4299,363,7.8
CN2101100000000,21,011,Bath County, KY,Sep-17,4698,4358,340,7.2
CN2101100000000,21,011,Bath County, KY,Oct-17,4704,4390,314,6.7
CN2101100000000,21,011,Bath County, KY,Nov-17,4693,4395,298,6.3
CN2101100000000,21,011,Bath County, KY,Dec-17,4674,4347,327,7.0
CN2101100000000,21,011,Bath County, KY,Jan-18,4689,4279,410,8.7
CN2101100000000,21,011,Bath County, KY,Feb-18,4625,4225,400,8.6
CN2101100000000,21,011,Bath County, KY,Mar-18,4634,4297,337,7.3
CN2101100000000,21,011,Bath County, KY,Apr-18(p),4662,4367,295,6.3
CN4817300000000,48,173,Glasscock County, TX,Mar-17,729,709,20,2.7
CN4817300000000,48,173,Glasscock County, TX,Apr-17,714,697,17,2.4
CN4817300000000,48,173,Glasscock County, TX,May-17,727,710,17,2.3
CN4817300000000,48,173,Glasscock County, TX,Jun-17,713,692,21,2.9
CN4817300000000,48,173,Glasscock County, TX,Jul-17,673,655,18,2.7
CN4817300000000,48,173,Glasscock County, TX,Aug-17,700,681,19,2.7
CN4817300000000,48,173,Glasscock County, TX,Sep-17,675,659,16,2.4
CN4817300000000,48,173,Glasscock County, TX,Oct-17,684,670,14,2.0
CN4817300000000,48,173,Glasscock County, TX,Nov-17,655,640,15,2.3
CN4817300000000,48,173,Glasscock County, TX,Dec-17,664,649,15,2.3
CN4817300000000,48,173,Glasscock County, TX,Jan-18,677,660,17,2.5
CN4817300000000,48,173,Glasscock County, TX,Feb-18,700,683,17,2.4
CN4817300000000,48,173,Glasscock County, TX,Mar-18,744,726,18,2.4
CN4817300000000,48,173,Glasscock County, TX,Apr-18(p),737,721,16,2.2
CN5600700000000,56,007,Carbon County, WY,Mar-17,7720,7334,386,5.0
CN5600700000000,56,007,Carbon County, WY,Apr-17,7735,7419,316,4.1
CN5600700000000,56,007,Carbon County, WY,May-17,7941,7645,296,3.7
CN5600700000000,56,007,Carbon County, WY,Jun-17,8402,8096,306,3.6
CN5600700000000,56,007,Carbon County, WY,Jul-17,8214,7934,280,3.4
CN5600700000000,56,007,Carbon County, WY,Aug-17,8074,7810,264,3.3
CN5600700000000,56,007,Carbon County, WY,Sep-17,8079,7818,261,3.2
CN5600700000000,56,007,Carbon County, WY,Oct-17,8041,7760,281,3.5
CN5600700000000,56,007,Carbon County, WY,Nov-17,7943,7639,304,3.8
CN5600700000000,56,007,Carbon County, WY,Dec-17,7701,7408,293,3.8
CN5600700000000,56,007,Carbon County, WY,Jan-18,7697,7360,337,4.4
CN5600700000000,56,007,Carbon County, WY,Feb-18,7605,7301,304,4.0
CN5600700000000,56,007,Carbon County, WY,Mar-18,7495,7189,306,4.1
CN5600700000000,56,007,Carbon County, WY,Apr-18(p),7405,7134,271,3.7
CN1309900000000,13,099,Early County, GA,Mar-17,4574,4328,246,5.4
CN1309900000000,13,099,Early County, GA,Apr-17,4512,4280,232,5.1
CN1309900000000,13,099,Early County, GA,May-17,4536,4294,242,5.3
CN1309900000000,13,099,Early County, GA,Jun-17,4547,4288,259,5.7
CN1309900000000,13,099,Early County, GA,Jul-17,4539,4276,263,5.8
CN1309900000000,13,099,Early County, GA,Aug-17,4522,4266,256,5.7
CN1309900000000,13,099,Early County, GA,Sep-17,4520,4295,225,5.0
CN1309900000000,13,099,Early County, GA,Oct-17,4561,4329,232,5.1
CN1309900000000,13,099,Early County, GA,Nov-17,4543,4319,224,4.9
CN1309900000000,13,099,Early County, GA,Dec-17,4567,4325,242,5.3
CN1309900000000,13,099,Early County, GA,Jan-18,4649,4394,255,5.5
CN1309900000000,13,099,Early County, GA,Feb-18,4570,4330,240,5.3
CN1309900000000,13,099,Early County, GA,Mar-18,4571,4350,221,4.8
CN1309900000000,13,099,Early County, GA,Apr-18(p),4526,4331,195,4.3
CN3912100000000,39,121,Noble County, OH,Mar-17,4812,4433,379,7.9
CN3912100000000,39,121,Noble County, OH,Apr-17,4809,4493,316,6.6
CN3912100000000,39,121,Noble County, OH,May-17,4794,4510,284,5.9
CN3912100000000,39,121,Noble County, OH,Jun-17,4836,4528,308,6.4
CN3912100000000,39,121,Noble County, OH,Jul-17,4841,4532,309,6.4
CN3912100000000,39,121,Noble County, OH,Aug-17,4823,4531,292,6.1
CN3912100000000,39,121,Noble County, OH,Sep-17,4795,4523,272,5.7
CN3912100000000,39,121,Noble County, OH,Oct-17,4783,4494,289,6.0
CN3912100000000,39,121,Noble County, OH,Nov-17,4761,4432,329,6.9
CN3912100000000,39,121,Noble County, OH,Dec-17,4765,4382,383,8.0
CN3912100000000,39,121,Noble County, OH,Jan-18,4748,4296,452,9.5
CN3912100000000,39,121,Noble County, OH,Feb-18,4694,4290,404,8.6
CN3912100000000,39,121,Noble County, OH,Mar-18,4734,4385,349,7.4
CN3912100000000,39,121,Noble County, OH,Apr-18(p),4712,4412,300,6.4
CN5100900000000,51,009,Amherst County, VA,Mar-17,15067,14444,623,4.1
CN5100900000000,51,009,Amherst County, VA,Apr-17,15093,14535,558,3.7
CN5100900000000,51,009,Amherst County, VA,May-17,15004,14404,600,4.0
CN5100900000000,51,009,Amherst County, VA,Jun-17,15120,14427,693,4.6
CN5100900000000,51,009,Amherst County, VA,Jul-17,15302,14600,702,4.6
CN5100900000000,51,009,Amherst County, VA,Aug-17,15190,14491,699,4.6
CN5100900000000,51,009,Amherst County, VA,Sep-17,15214,14601,613,4.0
CN5100900000000,51,009,Amherst County, VA,Oct-17,15067,14494,573,3.8
CN5100900000000,51,009,Amherst County, VA,Nov-17,15064,14481,583,3.9
CN5100900000000,51,009,Amherst County, VA,Dec-17,15027,14460,567,3.8
CN5100900000000,51,009,Amherst County, VA,Jan-18,14948,14324,624,4.2
CN5100900000000,51,009,Amherst County, VA,Feb-18,15176,14630,546,3.6
CN5100900000000,51,009,Amherst County, VA,Mar-18,15240,14689,551,3.6
CN5100900000000,51,009,Amherst County, VA,Apr-18(p),15330,14863,467,3.0
CN5107500000000,51,075,Goochland County, VA,Mar-17,10984,10570,414,3.8
CN5107500000000,51,075,Goochland County, VA,Apr-17,10959,10606,353,3.2
CN5107500000000,51,075,Goochland County, VA,May-17,11001,10614,387,3.5
CN5107500000000,51,075,Goochland County, VA,Jun-17,11093,10699,394,3.6
CN5107500000000,51,075,Goochland County, VA,Jul-17,11125,10734,391,3.5
CN5107500000000,51,075,Goochland County, VA,Aug-17,11008,10595,413,3.8
CN5107500000000,51,075,Goochland County, VA,Sep-17,11028,10653,375,3.4
CN5107500000000,51,075,Goochland County, VA,Oct-17,10932,10592,340,3.1
CN5107500000000,51,075,Goochland County, VA,Nov-17,10886,10550,336,3.1
CN5107500000000,51,075,Goochland County, VA,Dec-17,10883,10556,327,3.0
CN5107500000000,51,075,Goochland County, VA,Jan-18,10884,10495,389,3.6
CN5107500000000,51,075,Goochland County, VA,Feb-18,11023,10667,356,3.2
CN5107500000000,51,075,Goochland County, VA,Mar-18,11089,10733,356,3.2
CN5107500000000,51,075,Goochland County, VA,Apr-18(p),11112,10806,306,2.8
CN4711100000000,47,111,Macon County, TN,Mar-17,10500,10125,375,3.6
CN4711100000000,47,111,Macon County, TN,Apr-17,10507,10181,326,3.1
CN4711100000000,47,111,Macon County, TN,May-17,10426,10105,321,3.1
CN4711100000000,47,111,Macon County, TN,Jun-17,10655,10224,431,4.0
CN4711100000000,47,111,Macon County, TN,Jul-17,10725,10308,417,3.9
CN4711100000000,47,111,Macon County, TN,Aug-17,10761,10393,368,3.4
CN4711100000000,47,111,Macon County, TN,Sep-17,10836,10501,335,3.1
CN4711100000000,47,111,Macon County, TN,Oct-17,10720,10419,301,2.8
CN4711100000000,47,111,Macon County, TN,Nov-17,10716,10401,315,2.9
CN4711100000000,47,111,Macon County, TN,Dec-17,10672,10387,285,2.7
CN4711100000000,47,111,Macon County, TN,Jan-18,10596,10244,352,3.3
CN4711100000000,47,111,Macon County, TN,Feb-18,10768,10421,347,3.2
CN4711100000000,47,111,Macon County, TN,Mar-18,10701,10365,336,3.1
CN4711100000000,47,111,Macon County, TN,Apr-18(p),10779,10502,277,2.6
CN3710900000000,37,109,Lincoln County, NC,Mar-17,41989,40301,1688,4.0
CN3710900000000,37,109,Lincoln County, NC,Apr-17,41874,40362,1512,3.6
CN3710900000000,37,109,Lincoln County, NC,May-17,42059,40466,1593,3.8
CN3710900000000,37,109,Lincoln County, NC,Jun-17,42258,40569,1689,4.0
CN3710900000000,37,109,Lincoln County, NC,Jul-17,42577,40814,1763,4.1
CN3710900000000,37,109,Lincoln County, NC,Aug-17,42180,40398,1782,4.2
CN3710900000000,37,109,Lincoln County, NC,Sep-17,42702,41115,1587,3.7
CN3710900000000,37,109,Lincoln County, NC,Oct-17,42742,41162,1580,3.7
CN3710900000000,37,109,Lincoln County, NC,Nov-17,42695,41003,1692,4.0
CN3710900000000,37,109,Lincoln County, NC,Dec-17,42572,40917,1655,3.9
CN3710900000000,37,109,Lincoln County, NC,Jan-18,42556,40801,1755,4.1
CN3710900000000,37,109,Lincoln County, NC,Feb-18,42821,41147,1674,3.9
CN3710900000000,37,109,Lincoln County, NC,Mar-18,43057,41477,1580,3.7
CN3710900000000,37,109,Lincoln County, NC,Apr-18(p),42894,41537,1357,3.2
CN2806100000000,28,061,Jasper County, MS,Mar-17,6137,5702,435,7.1
CN2806100000000,28,061,Jasper County, MS,Apr-17,6118,5756,362,5.9
CN2806100000000,28,061,Jasper County, MS,May-17,6124,5717,407,6.6
CN2806100000000,28,061,Jasper County, MS,Jun-17,6274,5793,481,7.7
CN2806100000000,28,061,Jasper County, MS,Jul-17,6261,5795,466,7.4
CN2806100000000,28,061,Jasper County, MS,Aug-17,6071,5705,366,6.0
CN2806100000000,28,061,Jasper County, MS,Sep-17,6051,5714,337,5.6
CN2806100000000,28,061,Jasper County, MS,Oct-17,5982,5654,328,5.5
CN2806100000000,28,061,Jasper County, MS,Nov-17,5965,5640,325,5.4
CN2806100000000,28,061,Jasper County, MS,Dec-17,5971,5634,337,5.6
CN2806100000000,28,061,Jasper County, MS,Jan-18,5939,5580,359,6.0
CN2806100000000,28,061,Jasper County, MS,Feb-18,5959,5603,356,6.0
CN2806100000000,28,061,Jasper County, MS,Mar-18,5965,5637,328,5.5
CN2806100000000,28,061,Jasper County, MS,Apr-18(p),5958,5645,313,5.3
CN4826300000000,48,263,Kent County, TX,Mar-17,463,449,14,3.0
CN4826300000000,48,263,Kent County, TX,Apr-17,451,439,12,2.7
CN4826300000000,48,263,Kent County, TX,May-17,457,445,12,2.6
CN4826300000000,48,263,Kent County, TX,Jun-17,468,457,11,2.4
CN4826300000000,48,263,Kent County, TX,Jul-17,467,456,11,2.4
CN4826300000000,48,263,Kent County, TX,Aug-17,478,467,11,2.3
CN4826300000000,48,263,Kent County, TX,Sep-17,471,459,12,2.5
CN4826300000000,48,263,Kent County, TX,Oct-17,465,456,9,1.9
CN4826300000000,48,263,Kent County, TX,Nov-17,455,444,11,2.4
CN4826300000000,48,263,Kent County, TX,Dec-17,463,453,10,2.2
CN4826300000000,48,263,Kent County, TX,Jan-18,458,445,13,2.8
CN4826300000000,48,263,Kent County, TX,Feb-18,465,452,13,2.8
CN4826300000000,48,263,Kent County, TX,Mar-18,490,476,14,2.9
CN4826300000000,48,263,Kent County, TX,Apr-18(p),468,458,10,2.1
CN2117900000000,21,179,Nelson County, KY,Mar-17,22514,21369,1145,5.1
CN2117900000000,21,179,Nelson County, KY,Apr-17,22475,21515,960,4.3
CN2117900000000,21,179,Nelson County, KY,May-17,22461,21488,973,4.3
CN2117900000000,21,179,Nelson County, KY,Jun-17,22923,21847,1076,4.7
CN2117900000000,21,179,Nelson County, KY,Jul-17,22670,21533,1137,5.0
CN2117900000000,21,179,Nelson County, KY,Aug-17,22265,21350,915,4.1
CN2117900000000,21,179,Nelson County, KY,Sep-17,22694,21850,844,3.7
CN2117900000000,21,179,Nelson County, KY,Oct-17,22431,21657,774,3.5
CN2117900000000,21,179,Nelson County, KY,Nov-17,22523,21760,763,3.4
CN2117900000000,21,179,Nelson County, KY,Dec-17,22515,21775,740,3.3
CN2117900000000,21,179,Nelson County, KY,Jan-18,22304,21410,894,4.0
CN2117900000000,21,179,Nelson County, KY,Feb-18,22475,21480,995,4.4
CN2117900000000,21,179,Nelson County, KY,Mar-18,22771,21855,916,4.0
CN2117900000000,21,179,Nelson County, KY,Apr-18(p),22902,22091,811,3.5
CN2905100000000,29,051,Cole County, MO,Mar-17,39197,38013,1184,3.0
CN2905100000000,29,051,Cole County, MO,Apr-17,39079,38025,1054,2.7
CN2905100000000,29,051,Cole County, MO,May-17,39151,38076,1075,2.7
CN2905100000000,29,051,Cole County, MO,Jun-17,39005,37776,1229,3.2
CN2905100000000,29,051,Cole County, MO,Jul-17,39454,38093,1361,3.4
CN2905100000000,29,051,Cole County, MO,Aug-17,38794,37379,1415,3.6
CN2905100000000,29,051,Cole County, MO,Sep-17,38671,37647,1024,2.6
CN2905100000000,29,051,Cole County, MO,Oct-17,38331,37594,737,1.9
CN2905100000000,29,051,Cole County, MO,Nov-17,38357,37418,939,2.4
CN2905100000000,29,051,Cole County, MO,Dec-17,38092,37124,968,2.5
CN2905100000000,29,051,Cole County, MO,Jan-18,37972,36744,1228,3.2
CN2905100000000,29,051,Cole County, MO,Feb-18,38214,37053,1161,3.0
CN2905100000000,29,051,Cole County, MO,Mar-18,38402,37314,1088,2.8
CN2905100000000,29,051,Cole County, MO,Apr-18(p),38625,37636,989,2.6
CN2108900000000,21,089,Greenup County, KY,Mar-17,14092,12824,1268,9.0
CN2108900000000,21,089,Greenup County, KY,Apr-17,13863,12811,1052,7.6
CN2108900000000,21,089,Greenup County, KY,May-17,13875,12818,1057,7.6
CN2108900000000,21,089,Greenup County, KY,Jun-17,13950,12805,1145,8.2
CN2108900000000,21,089,Greenup County, KY,Jul-17,13862,12798,1064,7.7
CN2108900000000,21,089,Greenup County, KY,Aug-17,13737,12739,998,7.3
CN2108900000000,21,089,Greenup County, KY,Sep-17,13834,12949,885,6.4
CN2108900000000,21,089,Greenup County, KY,Oct-17,13666,12879,787,5.8
CN2108900000000,21,089,Greenup County, KY,Nov-17,13681,12867,814,5.9
CN2108900000000,21,089,Greenup County, KY,Dec-17,13661,12804,857,6.3
CN2108900000000,21,089,Greenup County, KY,Jan-18,13605,12527,1078,7.9
CN2108900000000,21,089,Greenup County, KY,Feb-18,13764,12721,1043,7.6
CN2108900000000,21,089,Greenup County, KY,Mar-18,13789,12843,946,6.9
CN2108900000000,21,089,Greenup County, KY,Apr-18(p),13719,12909,810,5.9
CN5408900000000,54,089,Summers County, WV,Mar-17,4406,4118,288,6.5
CN5408900000000,54,089,Summers County, WV,Apr-17,4518,4273,245,5.4
CN5408900000000,54,089,Summers County, WV,May-17,4518,4292,226,5.0
CN5408900000000,54,089,Summers County, WV,Jun-17,4712,4475,237,5.0
CN5408900000000,54,089,Summers County, WV,Jul-17,4679,4446,233,5.0
CN5408900000000,54,089,Summers County, WV,Aug-17,4643,4394,249,5.4
CN5408900000000,54,089,Summers County, WV,Sep-17,4652,4431,221,4.8
CN5408900000000,54,089,Summers County, WV,Oct-17,4577,4363,214,4.7
CN5408900000000,54,089,Summers County, WV,Nov-17,4501,4257,244,5.4
CN5408900000000,54,089,Summers County, WV,Dec-17,4451,4176,275,6.2
CN5408900000000,54,089,Summers County, WV,Jan-18,4505,4195,310,6.9
CN5408900000000,54,089,Summers County, WV,Feb-18,4550,4225,325,7.1
CN5408900000000,54,089,Summers County, WV,Mar-18,4513,4198,315,7.0
CN5408900000000,54,089,Summers County, WV,Apr-18(p),4579,4315,264,5.8
CN5507300000000,55,073,Marathon County, WI,Mar-17,73695,71270,2425,3.3
CN5507300000000,55,073,Marathon County, WI,Apr-17,73407,71424,1983,2.7
CN5507300000000,55,073,Marathon County, WI,May-17,73885,71858,2027,2.7
CN5507300000000,55,073,Marathon County, WI,Jun-17,75666,73180,2486,3.3
CN5507300000000,55,073,Marathon County, WI,Jul-17,75147,72814,2333,3.1
CN5507300000000,55,073,Marathon County, WI,Aug-17,74547,72227,2320,3.1
CN5507300000000,55,073,Marathon County, WI,Sep-17,74118,72151,1967,2.7
CN5507300000000,55,073,Marathon County, WI,Oct-17,74257,72440,1817,2.4
CN5507300000000,55,073,Marathon County, WI,Nov-17,74746,72883,1863,2.5
CN5507300000000,55,073,Marathon County, WI,Dec-17,75022,73234,1788,2.4
CN5507300000000,55,073,Marathon County, WI,Jan-18,75132,73106,2026,2.7
CN5507300000000,55,073,Marathon County, WI,Feb-18,75873,73658,2215,2.9
CN5507300000000,55,073,Marathon County, WI,Mar-18,76126,73907,2219,2.9
CN5507300000000,55,073,Marathon County, WI,Apr-18(p),75708,73845,1863,2.5
CN2911900000000,29,119,McDonald County, MO,Mar-17,10561,10170,391,3.7
CN2911900000000,29,119,McDonald County, MO,Apr-17,10632,10290,342,3.2
CN2911900000000,29,119,McDonald County, MO,May-17,10578,10197,381,3.6
CN2911900000000,29,119,McDonald County, MO,Jun-17,10626,10187,439,4.1
CN2911900000000,29,119,McDonald County, MO,Jul-17,10691,10207,484,4.5
CN2911900000000,29,119,McDonald County, MO,Aug-17,10561,10141,420,4.0
CN2911900000000,29,119,McDonald County, MO,Sep-17,10584,10248,336,3.2
CN2911900000000,29,119,McDonald County, MO,Oct-17,10609,10349,260,2.5
CN2911900000000,29,119,McDonald County, MO,Nov-17,10588,10262,326,3.1
CN2911900000000,29,119,McDonald County, MO,Dec-17,10467,10150,317,3.0
CN2911900000000,29,119,McDonald County, MO,Jan-18,10481,10100,381,3.6
CN2911900000000,29,119,McDonald County, MO,Feb-18,10662,10307,355,3.3
CN2911900000000,29,119,McDonald County, MO,Mar-18,10663,10303,360,3.4
CN2911900000000,29,119,McDonald County, MO,Apr-18(p),10767,10409,358,3.3
CN2207300000000,22,073,Ouachita Parish, LA,Mar-17,70781,66914,3867,5.5
CN2207300000000,22,073,Ouachita Parish, LA,Apr-17,70863,67186,3677,5.2
CN2207300000000,22,073,Ouachita Parish, LA,May-17,70580,66830,3750,5.3
CN2207300000000,22,073,Ouachita Parish, LA,Jun-17,71403,67195,4208,5.9
CN2207300000000,22,073,Ouachita Parish, LA,Jul-17,71370,67387,3983,5.6
CN2207300000000,22,073,Ouachita Parish, LA,Aug-17,70721,66729,3992,5.6
CN2207300000000,22,073,Ouachita Parish, LA,Sep-17,71022,67401,3621,5.1
CN2207300000000,22,073,Ouachita Parish, LA,Oct-17,71547,68383,3164,4.4
CN2207300000000,22,073,Ouachita Parish, LA,Nov-17,71618,68510,3108,4.3
CN2207300000000,22,073,Ouachita Parish, LA,Dec-17,71103,68138,2965,4.2
CN2207300000000,22,073,Ouachita Parish, LA,Jan-18,71146,67849,3297,4.6
CN2207300000000,22,073,Ouachita Parish, LA,Feb-18,71789,68710,3079,4.3
CN2207300000000,22,073,Ouachita Parish, LA,Mar-18,72201,68847,3354,4.6
CN2207300000000,22,073,Ouachita Parish, LA,Apr-18(p),71917,68629,3288,4.6
CN2700500000000,27,005,Becker County, MN,Mar-17,18327,17297,1030,5.6
CN2700500000000,27,005,Becker County, MN,Apr-17,18246,17493,753,4.1
CN2700500000000,27,005,Becker County, MN,May-17,18431,17848,583,3.2
CN2700500000000,27,005,Becker County, MN,Jun-17,18871,18220,651,3.4
CN2700500000000,27,005,Becker County, MN,Jul-17,18647,17998,649,3.5
CN2700500000000,27,005,Becker County, MN,Aug-17,18802,18170,632,3.4
CN2700500000000,27,005,Becker County, MN,Sep-17,18504,17992,512,2.8
CN2700500000000,27,005,Becker County, MN,Oct-17,18618,18176,442,2.4
CN2700500000000,27,005,Becker County, MN,Nov-17,18849,18101,748,4.0
CN2700500000000,27,005,Becker County, MN,Dec-17,18989,18050,939,4.9
CN2700500000000,27,005,Becker County, MN,Jan-18,19040,17941,1099,5.8
CN2700500000000,27,005,Becker County, MN,Feb-18,19102,18094,1008,5.3
CN2700500000000,27,005,Becker County, MN,Mar-18,19081,18069,1012,5.3
CN2700500000000,27,005,Becker County, MN,Apr-18(p),19075,18298,777,4.1
CN1302700000000,13,027,Brooks County, GA,Mar-17,7152,6825,327,4.6
CN1302700000000,13,027,Brooks County, GA,Apr-17,7130,6831,299,4.2
CN1302700000000,13,027,Brooks County, GA,May-17,7178,6869,309,4.3
CN1302700000000,13,027,Brooks County, GA,Jun-17,7235,6905,330,4.6
CN1302700000000,13,027,Brooks County, GA,Jul-17,7104,6770,334,4.7
CN1302700000000,13,027,Brooks County, GA,Aug-17,7099,6753,346,4.9
CN1302700000000,13,027,Brooks County, GA,Sep-17,7076,6770,306,4.3
CN1302700000000,13,027,Brooks County, GA,Oct-17,7181,6877,304,4.2
CN1302700000000,13,027,Brooks County, GA,Nov-17,7202,6920,282,3.9
CN1302700000000,13,027,Brooks County, GA,Dec-17,7203,6913,290,4.0
CN1302700000000,13,027,Brooks County, GA,Jan-18,7348,7027,321,4.4
CN1302700000000,13,027,Brooks County, GA,Feb-18,7213,6865,348,4.8
CN1302700000000,13,027,Brooks County, GA,Mar-18,7190,6884,306,4.3
CN1302700000000,13,027,Brooks County, GA,Apr-18(p),7201,6933,268,3.7
CN1904300000000,19,043,Clayton County, IA,Mar-17,10042,9446,596,5.9
CN1904300000000,19,043,Clayton County, IA,Apr-17,10157,9772,385,3.8
CN1904300000000,19,043,Clayton County, IA,May-17,10265,9958,307,3.0
CN1904300000000,19,043,Clayton County, IA,Jun-17,10455,10125,330,3.2
CN1904300000000,19,043,Clayton County, IA,Jul-17,10502,10195,307,2.9
CN1904300000000,19,043,Clayton County, IA,Aug-17,10335,10003,332,3.2
CN1904300000000,19,043,Clayton County, IA,Sep-17,10184,9903,281,2.8
CN1904300000000,19,043,Clayton County, IA,Oct-17,10142,9910,232,2.3
CN1904300000000,19,043,Clayton County, IA,Nov-17,9995,9729,266,2.7
CN1904300000000,19,043,Clayton County, IA,Dec-17,10037,9624,413,4.1
CN1904300000000,19,043,Clayton County, IA,Jan-18,9920,9311,609,6.1
CN1904300000000,19,043,Clayton County, IA,Feb-18,9968,9417,551,5.5
CN1904300000000,19,043,Clayton County, IA,Mar-18,9860,9393,467,4.7
CN1904300000000,19,043,Clayton County, IA,Apr-18(p),9959,9601,358,3.6
CN2604300000000,26,043,Dickinson County, MI,Mar-17,12594,11935,659,5.2
CN2604300000000,26,043,Dickinson County, MI,Apr-17,12375,11812,563,4.5
CN2604300000000,26,043,Dickinson County, MI,May-17,12670,12122,548,4.3
CN2604300000000,26,043,Dickinson County, MI,Jun-17,12860,12274,586,4.6
CN2604300000000,26,043,Dickinson County, MI,Jul-17,12723,12059,664,5.2
CN2604300000000,26,043,Dickinson County, MI,Aug-17,12731,12105,626,4.9
CN2604300000000,26,043,Dickinson County, MI,Sep-17,12536,11998,538,4.3
CN2604300000000,26,043,Dickinson County, MI,Oct-17,12408,11900,508,4.1
CN2604300000000,26,043,Dickinson County, MI,Nov-17,12343,11810,533,4.3
CN2604300000000,26,043,Dickinson County, MI,Dec-17,12347,11728,619,5.0
CN2604300000000,26,043,Dickinson County, MI,Jan-18,12483,11832,651,5.2
CN2604300000000,26,043,Dickinson County, MI,Feb-18,12580,11875,705,5.6
CN2604300000000,26,043,Dickinson County, MI,Mar-18,12677,12059,618,4.9
CN2604300000000,26,043,Dickinson County, MI,Apr-18(p),12505,11945,560,4.5
CN4718900000000,47,189,Wilson County, TN,Mar-17,69762,67503,2259,3.2
CN4718900000000,47,189,Wilson County, TN,Apr-17,69781,67913,1868,2.7
CN4718900000000,47,189,Wilson County, TN,May-17,69846,68085,1761,2.5
CN4718900000000,47,189,Wilson County, TN,Jun-17,71075,68787,2288,3.2
CN4718900000000,47,189,Wilson County, TN,Jul-17,71378,69190,2188,3.1
CN4718900000000,47,189,Wilson County, TN,Aug-17,70597,68515,2082,2.9
CN4718900000000,47,189,Wilson County, TN,Sep-17,71254,69393,1861,2.6
CN4718900000000,47,189,Wilson County, TN,Oct-17,71050,69278,1772,2.5
CN4718900000000,47,189,Wilson County, TN,Nov-17,70874,69065,1809,2.6
CN4718900000000,47,189,Wilson County, TN,Dec-17,70665,68986,1679,2.4
CN4718900000000,47,189,Wilson County, TN,Jan-18,70461,68453,2008,2.8
CN4718900000000,47,189,Wilson County, TN,Feb-18,71346,69358,1988,2.8
CN4718900000000,47,189,Wilson County, TN,Mar-18,71492,69554,1938,2.7
CN4718900000000,47,189,Wilson County, TN,Apr-18(p),71923,70317,1606,2.2
CN2902900000000,29,029,Camden County, MO,Mar-17,17693,16720,973,5.5
CN2902900000000,29,029,Camden County, MO,Apr-17,18287,17485,802,4.4
CN2902900000000,29,029,Camden County, MO,May-17,18786,17994,792,4.2
CN2902900000000,29,029,Camden County, MO,Jun-17,19903,19116,787,4.0
CN2902900000000,29,029,Camden County, MO,Jul-17,20290,19473,817,4.0
CN2902900000000,29,029,Camden County, MO,Aug-17,19444,18570,874,4.5
CN2902900000000,29,029,Camden County, MO,Sep-17,18787,18074,713,3.8
CN2902900000000,29,029,Camden County, MO,Oct-17,18135,17576,559,3.1
CN2902900000000,29,029,Camden County, MO,Nov-17,17771,17007,764,4.3
CN2902900000000,29,029,Camden County, MO,Dec-17,17696,16732,964,5.4
CN2902900000000,29,029,Camden County, MO,Jan-18,17116,15934,1182,6.9
CN2902900000000,29,029,Camden County, MO,Feb-18,16939,15742,1197,7.1
CN2902900000000,29,029,Camden County, MO,Mar-18,17283,16310,973,5.6
CN2902900000000,29,029,Camden County, MO,Apr-18(p),17927,17171,756,4.2
CN3611900000000,36,119,Westchester County, NY,Mar-17,483152,462035,21117,4.4
CN3611900000000,36,119,Westchester County, NY,Apr-17,482413,462368,20045,4.2
CN3611900000000,36,119,Westchester County, NY,May-17,485442,464554,20888,4.3
CN3611900000000,36,119,Westchester County, NY,Jun-17,493694,471235,22459,4.5
CN3611900000000,36,119,Westchester County, NY,Jul-17,497952,474385,23567,4.7
CN3611900000000,36,119,Westchester County, NY,Aug-17,489368,465901,23467,4.8
CN3611900000000,36,119,Westchester County, NY,Sep-17,485650,463111,22539,4.6
CN3611900000000,36,119,Westchester County, NY,Oct-17,481232,459747,21485,4.5
CN3611900000000,36,119,Westchester County, NY,Nov-17,478823,457193,21630,4.5
CN3611900000000,36,119,Westchester County, NY,Dec-17,475488,454556,20932,4.4
CN3611900000000,36,119,Westchester County, NY,Jan-18,476899,453421,23478,4.9
CN3611900000000,36,119,Westchester County, NY,Feb-18,472995,448412,24583,5.2
CN3611900000000,36,119,Westchester County, NY,Mar-18,473987,451771,22216,4.7
CN3611900000000,36,119,Westchester County, NY,Apr-18(p),477520,457488,20032,4.2
CN1709700000000,17,097,Lake County, IL,Mar-17,367010,347955,19055,5.2
CN1709700000000,17,097,Lake County, IL,Apr-17,366992,352430,14562,4.0
CN1709700000000,17,097,Lake County, IL,May-17,366142,352237,13905,3.8
CN1709700000000,17,097,Lake County, IL,Jun-17,376737,361347,15390,4.1
CN1709700000000,17,097,Lake County, IL,Jul-17,379812,363755,16057,4.2
CN1709700000000,17,097,Lake County, IL,Aug-17,374530,358694,15836,4.2
CN1709700000000,17,097,Lake County, IL,Sep-17,371805,357882,13923,3.7
CN1709700000000,17,097,Lake County, IL,Oct-17,370109,356389,13720,3.7
CN1709700000000,17,097,Lake County, IL,Nov-17,370858,356545,14313,3.9
CN1709700000000,17,097,Lake County, IL,Dec-17,369854,354169,15685,4.2
CN1709700000000,17,097,Lake County, IL,Jan-18,367181,349920,17261,4.7
CN1709700000000,17,097,Lake County, IL,Feb-18,369904,353572,16332,4.4
CN1709700000000,17,097,Lake County, IL,Mar-18,376328,358931,17397,4.6
CN1709700000000,17,097,Lake County, IL,Apr-18(p),377444,364246,13198,3.5
CN2806700000000,28,067,Jones County, MS,Mar-17,25450,24124,1326,5.2
CN2806700000000,28,067,Jones County, MS,Apr-17,25561,24342,1219,4.8
CN2806700000000,28,067,Jones County, MS,May-17,25625,24176,1449,5.7
CN2806700000000,28,067,Jones County, MS,Jun-17,26086,24503,1583,6.1
CN2806700000000,28,067,Jones County, MS,Jul-17,26012,24541,1471,5.7
CN2806700000000,28,067,Jones County, MS,Aug-17,25409,24163,1246,4.9
CN2806700000000,28,067,Jones County, MS,Sep-17,25423,24207,1216,4.8
CN2806700000000,28,067,Jones County, MS,Oct-17,25177,24046,1131,4.5
CN2806700000000,28,067,Jones County, MS,Nov-17,25083,24002,1081,4.3
CN2806700000000,28,067,Jones County, MS,Dec-17,25096,23989,1107,4.4
CN2806700000000,28,067,Jones County, MS,Jan-18,24862,23737,1125,4.5
CN2806700000000,28,067,Jones County, MS,Feb-18,24953,23803,1150,4.6
CN2806700000000,28,067,Jones County, MS,Mar-18,25005,23887,1118,4.5
CN2806700000000,28,067,Jones County, MS,Apr-18(p),25096,23973,1123,4.5
CN5001900000000,50,019,Orleans County, VT,Mar-17,13844,12896,948,6.8
CN5001900000000,50,019,Orleans County, VT,Apr-17,13655,12781,874,6.4
CN5001900000000,50,019,Orleans County, VT,May-17,13565,12957,608,4.5
CN5001900000000,50,019,Orleans County, VT,Jun-17,13750,13134,616,4.5
CN5001900000000,50,019,Orleans County, VT,Jul-17,13824,13239,585,4.2
CN5001900000000,50,019,Orleans County, VT,Aug-17,13696,13094,602,4.4
CN5001900000000,50,019,Orleans County, VT,Sep-17,13526,13014,512,3.8
CN5001900000000,50,019,Orleans County, VT,Oct-17,13546,13124,422,3.1
CN5001900000000,50,019,Orleans County, VT,Nov-17,13711,13170,541,3.9
CN5001900000000,50,019,Orleans County, VT,Dec-17,13636,13020,616,4.5
CN5001900000000,50,019,Orleans County, VT,Jan-18,13849,12987,862,6.2
CN5001900000000,50,019,Orleans County, VT,Feb-18,13938,13117,821,5.9
CN5001900000000,50,019,Orleans County, VT,Mar-18,13883,13075,808,5.8
CN5001900000000,50,019,Orleans County, VT,Apr-18(p),13798,12993,805,5.8
CN0207000000000,02,070,Dillingham Census Area, AK,Mar-17,2048,1848,200,9.8
CN0207000000000,02,070,Dillingham Census Area, AK,Apr-17,1964,1767,197,10.0
CN0207000000000,02,070,Dillingham Census Area, AK,May-17,1981,1778,203,10.2
CN0207000000000,02,070,Dillingham Census Area, AK,Jun-17,2477,2271,206,8.3
CN0207000000000,02,070,Dillingham Census Area, AK,Jul-17,2688,2496,192,7.1
CN0207000000000,02,070,Dillingham Census Area, AK,Aug-17,2395,2209,186,7.8
CN0207000000000,02,070,Dillingham Census Area, AK,Sep-17,1920,1750,170,8.9
CN0207000000000,02,070,Dillingham Census Area, AK,Oct-17,1807,1633,174,9.6
CN0207000000000,02,070,Dillingham Census Area, AK,Nov-17,1753,1578,175,10.0
CN0207000000000,02,070,Dillingham Census Area, AK,Dec-17,1690,1512,178,10.5
CN0207000000000,02,070,Dillingham Census Area, AK,Jan-18,1922,1725,197,10.2
CN0207000000000,02,070,Dillingham Census Area, AK,Feb-18,2089,1870,219,10.5
CN0207000000000,02,070,Dillingham Census Area, AK,Mar-18,2065,1865,200,9.7
CN0207000000000,02,070,Dillingham Census Area, AK,Apr-18(p),2021,1821,200,9.9
CN5302700000000,53,027,Grays Harbor County, WA,Mar-17,27567,25382,2185,7.9
CN5302700000000,53,027,Grays Harbor County, WA,Apr-17,27380,25325,2055,7.5
CN5302700000000,53,027,Grays Harbor County, WA,May-17,27889,25972,1917,6.9
CN5302700000000,53,027,Grays Harbor County, WA,Jun-17,28198,26402,1796,6.4
CN5302700000000,53,027,Grays Harbor County, WA,Jul-17,28091,26263,1828,6.5
CN5302700000000,53,027,Grays Harbor County, WA,Aug-17,28119,26280,1839,6.5
CN5302700000000,53,027,Grays Harbor County, WA,Sep-17,28098,26335,1763,6.3
CN5302700000000,53,027,Grays Harbor County, WA,Oct-17,28312,26551,1761,6.2
CN5302700000000,53,027,Grays Harbor County, WA,Nov-17,28281,26442,1839,6.5
CN5302700000000,53,027,Grays Harbor County, WA,Dec-17,28188,26146,2042,7.2
CN5302700000000,53,027,Grays Harbor County, WA,Jan-18,27938,25705,2233,8.0
CN5302700000000,53,027,Grays Harbor County, WA,Feb-18,27812,25605,2207,7.9
CN5302700000000,53,027,Grays Harbor County, WA,Mar-18,28097,25943,2154,7.7
CN5302700000000,53,027,Grays Harbor County, WA,Apr-18(p),28008,26001,2007,7.2
CN2011700000000,20,117,Marshall County, KS,Mar-17,5467,5311,156,2.9
CN2011700000000,20,117,Marshall County, KS,Apr-17,5358,5215,143,2.7
CN2011700000000,20,117,Marshall County, KS,May-17,5356,5204,152,2.8
CN2011700000000,20,117,Marshall County, KS,Jun-17,5525,5367,158,2.9
CN2011700000000,20,117,Marshall County, KS,Jul-17,5601,5433,168,3.0
CN2011700000000,20,117,Marshall County, KS,Aug-17,5575,5419,156,2.8
CN2011700000000,20,117,Marshall County, KS,Sep-17,5520,5393,127,2.3
CN2011700000000,20,117,Marshall County, KS,Oct-17,5546,5429,117,2.1
CN2011700000000,20,117,Marshall County, KS,Nov-17,5519,5392,127,2.3
CN2011700000000,20,117,Marshall County, KS,Dec-17,5485,5350,135,2.5
CN2011700000000,20,117,Marshall County, KS,Jan-18,5436,5277,159,2.9
CN2011700000000,20,117,Marshall County, KS,Feb-18,5412,5250,162,3.0
CN2011700000000,20,117,Marshall County, KS,Mar-18,5411,5257,154,2.8
CN2011700000000,20,117,Marshall County, KS,Apr-18(p),5276,5141,135,2.6
CN1206500000000,12,065,Jefferson County, FL,Mar-17,5443,5201,242,4.4
CN1206500000000,12,065,Jefferson County, FL,Apr-17,5482,5260,222,4.0
CN1206500000000,12,065,Jefferson County, FL,May-17,5446,5212,234,4.3
CN1206500000000,12,065,Jefferson County, FL,Jun-17,5396,5151,245,4.5
CN1206500000000,12,065,Jefferson County, FL,Jul-17,5429,5184,245,4.5
CN1206500000000,12,065,Jefferson County, FL,Aug-17,5357,5117,240,4.5
CN1206500000000,12,065,Jefferson County, FL,Sep-17,5583,5361,222,4.0
CN1206500000000,12,065,Jefferson County, FL,Oct-17,5490,5282,208,3.8
CN1206500000000,12,065,Jefferson County, FL,Nov-17,5445,5237,208,3.8
CN1206500000000,12,065,Jefferson County, FL,Dec-17,5415,5214,201,3.7
CN1206500000000,12,065,Jefferson County, FL,Jan-18,5466,5237,229,4.2
CN1206500000000,12,065,Jefferson County, FL,Feb-18,5508,5302,206,3.7
CN1206500000000,12,065,Jefferson County, FL,Mar-18,5502,5292,210,3.8
CN1206500000000,12,065,Jefferson County, FL,Apr-18(p),5511,5320,191,3.5
CN3710300000000,37,103,Jones County, NC,Mar-17,4622,4426,196,4.2
CN3710300000000,37,103,Jones County, NC,Apr-17,4543,4375,168,3.7
CN3710300000000,37,103,Jones County, NC,May-17,4490,4305,185,4.1
CN3710300000000,37,103,Jones County, NC,Jun-17,4460,4262,198,4.4
CN3710300000000,37,103,Jones County, NC,Jul-17,4602,4395,207,4.5
CN3710300000000,37,103,Jones County, NC,Aug-17,4475,4260,215,4.8
CN3710300000000,37,103,Jones County, NC,Sep-17,4480,4284,196,4.4
CN3710300000000,37,103,Jones County, NC,Oct-17,4468,4278,190,4.3
CN3710300000000,37,103,Jones County, NC,Nov-17,4402,4197,205,4.7
CN3710300000000,37,103,Jones County, NC,Dec-17,4423,4220,203,4.6
CN3710300000000,37,103,Jones County, NC,Jan-18,4427,4213,214,4.8
CN3710300000000,37,103,Jones County, NC,Feb-18,4534,4323,211,4.7
CN3710300000000,37,103,Jones County, NC,Mar-18,4501,4303,198,4.4
CN3710300000000,37,103,Jones County, NC,Apr-18(p),4500,4331,169,3.8
CN5100300000000,51,003,Albemarle County, VA,Mar-17,55789,53929,1860,3.3
CN5100300000000,51,003,Albemarle County, VA,Apr-17,56120,54458,1662,3.0
CN5100300000000,51,003,Albemarle County, VA,May-17,55927,54105,1822,3.3
CN5100300000000,51,003,Albemarle County, VA,Jun-17,56148,54106,2042,3.6
CN5100300000000,51,003,Albemarle County, VA,Jul-17,55514,53518,1996,3.6
CN5100300000000,51,003,Albemarle County, VA,Aug-17,54766,52800,1966,3.6
CN5100300000000,51,003,Albemarle County, VA,Sep-17,56864,55042,1822,3.2
CN5100300000000,51,003,Albemarle County, VA,Oct-17,56030,54355,1675,3.0
CN5100300000000,51,003,Albemarle County, VA,Nov-17,56369,54630,1739,3.1
CN5100300000000,51,003,Albemarle County, VA,Dec-17,55982,54399,1583,2.8
CN5100300000000,51,003,Albemarle County, VA,Jan-18,55387,53578,1809,3.3
CN5100300000000,51,003,Albemarle County, VA,Feb-18,57028,55424,1604,2.8
CN5100300000000,51,003,Albemarle County, VA,Mar-18,57421,55779,1642,2.9
CN5100300000000,51,003,Albemarle County, VA,Apr-18(p),57972,56594,1378,2.4
CN7214900000000,72,149,Villalba Municipio, PR,Mar-17,8014,6232,1782,22.2
CN7214900000000,72,149,Villalba Municipio, PR,Apr-17,7884,6160,1724,21.9
CN7214900000000,72,149,Villalba Municipio, PR,May-17,7596,6133,1463,19.3
CN7214900000000,72,149,Villalba Municipio, PR,Jun-17,7247,6083,1164,16.1
CN7214900000000,72,149,Villalba Municipio, PR,Jul-17,7409,6088,1321,17.8
CN7214900000000,72,149,Villalba Municipio, PR,Aug-17,7472,5985,1487,19.9
CN7214900000000,72,149,Villalba Municipio, PR,Sep-17(y),7370,6030,1340,18.2
CN7214900000000,72,149,Villalba Municipio, PR,Oct-17,7119,5875,1244,17.5
CN7214900000000,72,149,Villalba Municipio, PR,Nov-17,7530,6218,1312,17.4
CN7214900000000,72,149,Villalba Municipio, PR,Dec-17,7683,6294,1389,18.1
CN7214900000000,72,149,Villalba Municipio, PR,Jan-18,7752,6182,1570,20.3
CN7214900000000,72,149,Villalba Municipio, PR,Feb-18,7565,6141,1424,18.8
CN7214900000000,72,149,Villalba Municipio, PR,Mar-18,7563,6139,1424,18.8
CN7214900000000,72,149,Villalba Municipio, PR,Apr-18(p),7477,6219,1258,16.8
CN4826900000000,48,269,King County, TX,Mar-17,178,172,6,3.4
CN4826900000000,48,269,King County, TX,Apr-17,170,166,4,2.4
CN4826900000000,48,269,King County, TX,May-17,177,170,7,4.0
CN4826900000000,48,269,King County, TX,Jun-17,176,169,7,4.0
CN4826900000000,48,269,King County, TX,Jul-17,158,151,7,4.4
CN4826900000000,48,269,King County, TX,Aug-17,170,163,7,4.1
CN4826900000000,48,269,King County, TX,Sep-17,161,154,7,4.3
CN4826900000000,48,269,King County, TX,Oct-17,158,152,6,3.8
CN4826900000000,48,269,King County, TX,Nov-17,149,143,6,4.0
CN4826900000000,48,269,King County, TX,Dec-17,150,145,5,3.3
CN4826900000000,48,269,King County, TX,Jan-18,136,130,6,4.4
CN4826900000000,48,269,King County, TX,Feb-18,145,138,7,4.8
CN4826900000000,48,269,King County, TX,Mar-18,164,158,6,3.7
CN4826900000000,48,269,King County, TX,Apr-18(p),161,155,6,3.7
CN5113100000000,51,131,Northampton County, VA,Mar-17,5433,5085,348,6.4
CN5113100000000,51,131,Northampton County, VA,Apr-17,5378,5073,305,5.7
CN5113100000000,51,131,Northampton County, VA,May-17,5401,5118,283,5.2
CN5113100000000,51,131,Northampton County, VA,Jun-17,5641,5359,282,5.0
CN5113100000000,51,131,Northampton County, VA,Jul-17,5656,5367,289,5.1
CN5113100000000,51,131,Northampton County, VA,Aug-17,5473,5157,316,5.8
CN5113100000000,51,131,Northampton County, VA,Sep-17,5278,5016,262,5.0
CN5113100000000,51,131,Northampton County, VA,Oct-17,5228,4987,241,4.6
CN5113100000000,51,131,Northampton County, VA,Nov-17,5163,4899,264,5.1
CN5113100000000,51,131,Northampton County, VA,Dec-17,5340,4999,341,6.4
CN5113100000000,51,131,Northampton County, VA,Jan-18,5104,4703,401,7.9
CN5113100000000,51,131,Northampton County, VA,Feb-18,5100,4686,414,8.1
CN5113100000000,51,131,Northampton County, VA,Mar-18,5007,4643,364,7.3
CN5113100000000,51,131,Northampton County, VA,Apr-18(p),5133,4825,308,6.0
CN4808900000000,48,089,Colorado County, TX,Mar-17,10056,9626,430,4.3
CN4808900000000,48,089,Colorado County, TX,Apr-17,9957,9580,377,3.8
CN4808900000000,48,089,Colorado County, TX,May-17,10047,9677,370,3.7
CN4808900000000,48,089,Colorado County, TX,Jun-17,10206,9812,394,3.9
CN4808900000000,48,089,Colorado County, TX,Jul-17,10053,9667,386,3.8
CN4808900000000,48,089,Colorado County, TX,Aug-17,10310,9936,374,3.6
CN4808900000000,48,089,Colorado County, TX,Sep-17,10208,9858,350,3.4
CN4808900000000,48,089,Colorado County, TX,Oct-17,10130,9804,326,3.2
CN4808900000000,48,089,Colorado County, TX,Nov-17,10087,9739,348,3.4
CN4808900000000,48,089,Colorado County, TX,Dec-17,10135,9805,330,3.3
CN4808900000000,48,089,Colorado County, TX,Jan-18,10163,9804,359,3.5
CN4808900000000,48,089,Colorado County, TX,Feb-18,10274,9913,361,3.5
CN4808900000000,48,089,Colorado County, TX,Mar-18,10403,10044,359,3.5
CN4808900000000,48,089,Colorado County, TX,Apr-18(p),10252,9928,324,3.2
CN2110700000000,21,107,Hopkins County, KY,Mar-17,20437,19281,1156,5.7
CN2110700000000,21,107,Hopkins County, KY,Apr-17,20405,19435,970,4.8
CN2110700000000,21,107,Hopkins County, KY,May-17,20346,19311,1035,5.1
CN2110700000000,21,107,Hopkins County, KY,Jun-17,20424,19339,1085,5.3
CN2110700000000,21,107,Hopkins County, KY,Jul-17,20343,19345,998,4.9
CN2110700000000,21,107,Hopkins County, KY,Aug-17,20136,19239,897,4.5
CN2110700000000,21,107,Hopkins County, KY,Sep-17,20071,19215,856,4.3
CN2110700000000,21,107,Hopkins County, KY,Oct-17,19870,19082,788,4.0
CN2110700000000,21,107,Hopkins County, KY,Nov-17,19864,19109,755,3.8
CN2110700000000,21,107,Hopkins County, KY,Dec-17,19774,19049,725,3.7
CN2110700000000,21,107,Hopkins County, KY,Jan-18,20030,19193,837,4.2
CN2110700000000,21,107,Hopkins County, KY,Feb-18,19953,19018,935,4.7
CN2110700000000,21,107,Hopkins County, KY,Mar-18,20153,19222,931,4.6
CN2110700000000,21,107,Hopkins County, KY,Apr-18(p),20058,19243,815,4.1
CN2104500000000,21,045,Casey County, KY,Mar-17,7052,6670,382,5.4
CN2104500000000,21,045,Casey County, KY,Apr-17,7153,6830,323,4.5
CN2104500000000,21,045,Casey County, KY,May-17,7108,6781,327,4.6
CN2104500000000,21,045,Casey County, KY,Jun-17,7106,6751,355,5.0
CN2104500000000,21,045,Casey County, KY,Jul-17,6956,6611,345,5.0
CN2104500000000,21,045,Casey County, KY,Aug-17,6799,6500,299,4.4
CN2104500000000,21,045,Casey County, KY,Sep-17,6768,6489,279,4.1
CN2104500000000,21,045,Casey County, KY,Oct-17,6774,6518,256,3.8
CN2104500000000,21,045,Casey County, KY,Nov-17,6807,6554,253,3.7
CN2104500000000,21,045,Casey County, KY,Dec-17,6778,6520,258,3.8
CN2104500000000,21,045,Casey County, KY,Jan-18,6878,6583,295,4.3
CN2104500000000,21,045,Casey County, KY,Feb-18,6821,6479,342,5.0
CN2104500000000,21,045,Casey County, KY,Mar-18,6877,6544,333,4.8
CN2104500000000,21,045,Casey County, KY,Apr-18(p),6904,6621,283,4.1
CN1808100000000,18,081,Johnson County, IN,Mar-17,79952,77468,2484,3.1
CN1808100000000,18,081,Johnson County, IN,Apr-17,80420,78429,1991,2.5
CN1808100000000,18,081,Johnson County, IN,May-17,80823,78665,2158,2.7
CN1808100000000,18,081,Johnson County, IN,Jun-17,81860,79445,2415,3.0
CN1808100000000,18,081,Johnson County, IN,Jul-17,81943,79455,2488,3.0
CN1808100000000,18,081,Johnson County, IN,Aug-17,81232,78548,2684,3.3
CN1808100000000,18,081,Johnson County, IN,Sep-17,80695,78486,2209,2.7
CN1808100000000,18,081,Johnson County, IN,Oct-17,80208,78099,2109,2.6
CN1808100000000,18,081,Johnson County, IN,Nov-17,80351,78208,2143,2.7
CN1808100000000,18,081,Johnson County, IN,Dec-17,79653,77641,2012,2.5
CN1808100000000,18,081,Johnson County, IN,Jan-18,79742,77367,2375,3.0
CN1808100000000,18,081,Johnson County, IN,Feb-18,80790,78290,2500,3.1
CN1808100000000,18,081,Johnson County, IN,Mar-18,81606,79387,2219,2.7
CN1808100000000,18,081,Johnson County, IN,Apr-18(p),81917,79861,2056,2.5
CN1814300000000,18,143,Scott County, IN,Mar-17,10388,9982,406,3.9
CN1814300000000,18,143,Scott County, IN,Apr-17,10423,10084,339,3.3
CN1814300000000,18,143,Scott County, IN,May-17,10455,10084,371,3.5
CN1814300000000,18,143,Scott County, IN,Jun-17,10649,10255,394,3.7
CN1814300000000,18,143,Scott County, IN,Jul-17,10723,10316,407,3.8
CN1814300000000,18,143,Scott County, IN,Aug-17,10556,10113,443,4.2
CN1814300000000,18,143,Scott County, IN,Sep-17,10486,10118,368,3.5
CN1814300000000,18,143,Scott County, IN,Oct-17,10439,10073,366,3.5
CN1814300000000,18,143,Scott County, IN,Nov-17,10457,10094,363,3.5
CN1814300000000,18,143,Scott County, IN,Dec-17,10426,10075,351,3.4
CN1814300000000,18,143,Scott County, IN,Jan-18,10324,9921,403,3.9
CN1814300000000,18,143,Scott County, IN,Feb-18,10467,10040,427,4.1
CN1814300000000,18,143,Scott County, IN,Mar-18,10584,10179,405,3.8
CN1814300000000,18,143,Scott County, IN,Apr-18(p),10669,10300,369,3.5
CN3502900000000,35,029,Luna County, NM,Mar-17,10184,8399,1785,17.5
CN3502900000000,35,029,Luna County, NM,Apr-17,10188,8479,1709,16.8
CN3502900000000,35,029,Luna County, NM,May-17,10206,8833,1373,13.5
CN3502900000000,35,029,Luna County, NM,Jun-17,11013,9694,1319,12.0
CN3502900000000,35,029,Luna County, NM,Jul-17,11599,10418,1181,10.2
CN3502900000000,35,029,Luna County, NM,Aug-17,10834,9750,1084,10.0
CN3502900000000,35,029,Luna County, NM,Sep-17,10584,9528,1056,10.0
CN3502900000000,35,029,Luna County, NM,Oct-17,10314,9255,1059,10.3
CN3502900000000,35,029,Luna County, NM,Nov-17,9789,8363,1426,14.6
CN3502900000000,35,029,Luna County, NM,Dec-17,9988,8296,1692,16.9
CN3502900000000,35,029,Luna County, NM,Jan-18,10066,8268,1798,17.9
CN3502900000000,35,029,Luna County, NM,Feb-18,10139,8376,1763,17.4
CN3502900000000,35,029,Luna County, NM,Mar-18,10158,8532,1626,16.0
CN3502900000000,35,029,Luna County, NM,Apr-18(p),9997,8602,1395,14.0
CN7214300000000,72,143,Vega Alta Municipio, PR,Mar-17,9951,8896,1055,10.6
CN7214300000000,72,143,Vega Alta Municipio, PR,Apr-17,9924,8800,1124,11.3
CN7214300000000,72,143,Vega Alta Municipio, PR,May-17,9730,8757,973,10.0
CN7214300000000,72,143,Vega Alta Municipio, PR,Jun-17,9614,8699,915,9.5
CN7214300000000,72,143,Vega Alta Municipio, PR,Jul-17,9718,8666,1052,10.8
CN7214300000000,72,143,Vega Alta Municipio, PR,Aug-17,9763,8545,1218,12.5
CN7214300000000,72,143,Vega Alta Municipio, PR,Sep-17(y),9756,8643,1113,11.4
CN7214300000000,72,143,Vega Alta Municipio, PR,Oct-17,9346,8315,1031,11.0
CN7214300000000,72,143,Vega Alta Municipio, PR,Nov-17,9757,8762,995,10.2
CN7214300000000,72,143,Vega Alta Municipio, PR,Dec-17,9741,8820,921,9.5
CN7214300000000,72,143,Vega Alta Municipio, PR,Jan-18,9642,8659,983,10.2
CN7214300000000,72,143,Vega Alta Municipio, PR,Feb-18,9617,8706,911,9.5
CN7214300000000,72,143,Vega Alta Municipio, PR,Mar-18,9599,8721,878,9.1
CN7214300000000,72,143,Vega Alta Municipio, PR,Apr-18(p),9625,8758,867,9.0
CN4848700000000,48,487,Wilbarger County, TX,Mar-17,5140,4869,271,5.3
CN4848700000000,48,487,Wilbarger County, TX,Apr-17,5035,4807,228,4.5
CN4848700000000,48,487,Wilbarger County, TX,May-17,4977,4754,223,4.5
CN4848700000000,48,487,Wilbarger County, TX,Jun-17,4927,4689,238,4.8
CN4848700000000,48,487,Wilbarger County, TX,Jul-17,4920,4687,233,4.7
CN4848700000000,48,487,Wilbarger County, TX,Aug-17,4865,4632,233,4.8
CN4848700000000,48,487,Wilbarger County, TX,Sep-17,4891,4682,209,4.3
CN4848700000000,48,487,Wilbarger County, TX,Oct-17,4849,4656,193,4.0
CN4848700000000,48,487,Wilbarger County, TX,Nov-17,4824,4621,203,4.2
CN4848700000000,48,487,Wilbarger County, TX,Dec-17,4836,4635,201,4.2
CN4848700000000,48,487,Wilbarger County, TX,Jan-18,4913,4671,242,4.9
CN4848700000000,48,487,Wilbarger County, TX,Feb-18,4935,4712,223,4.5
CN4848700000000,48,487,Wilbarger County, TX,Mar-18,5004,4780,224,4.5
CN4848700000000,48,487,Wilbarger County, TX,Apr-18(p),5001,4786,215,4.3
CN2020700000000,20,207,Woodson County, KS,Mar-17,1599,1530,69,4.3
CN2020700000000,20,207,Woodson County, KS,Apr-17,1575,1510,65,4.1
CN2020700000000,20,207,Woodson County, KS,May-17,1617,1545,72,4.5
CN2020700000000,20,207,Woodson County, KS,Jun-17,1616,1538,78,4.8
CN2020700000000,20,207,Woodson County, KS,Jul-17,1563,1483,80,5.1
CN2020700000000,20,207,Woodson County, KS,Aug-17,1563,1491,72,4.6
CN2020700000000,20,207,Woodson County, KS,Sep-17,1621,1550,71,4.4
CN2020700000000,20,207,Woodson County, KS,Oct-17,1616,1555,61,3.8
CN2020700000000,20,207,Woodson County, KS,Nov-17,1590,1529,61,3.8
CN2020700000000,20,207,Woodson County, KS,Dec-17,1590,1533,57,3.6
CN2020700000000,20,207,Woodson County, KS,Jan-18,1560,1499,61,3.9
CN2020700000000,20,207,Woodson County, KS,Feb-18,1591,1522,69,4.3
CN2020700000000,20,207,Woodson County, KS,Mar-18,1671,1577,94,5.6
CN2020700000000,20,207,Woodson County, KS,Apr-18(p),1620,1557,63,3.9
CN1311700000000,13,117,Forsyth County, GA,Mar-17,114081,109772,4309,3.8
CN1311700000000,13,117,Forsyth County, GA,Apr-17,114140,110045,4095,3.6
CN1311700000000,13,117,Forsyth County, GA,May-17,114442,110254,4188,3.7
CN1311700000000,13,117,Forsyth County, GA,Jun-17,114809,110173,4636,4.0
CN1311700000000,13,117,Forsyth County, GA,Jul-17,115537,110905,4632,4.0
CN1311700000000,13,117,Forsyth County, GA,Aug-17,114877,110352,4525,3.9
CN1311700000000,13,117,Forsyth County, GA,Sep-17,115980,111835,4145,3.6
CN1311700000000,13,117,Forsyth County, GA,Oct-17,115510,111414,4096,3.5
CN1311700000000,13,117,Forsyth County, GA,Nov-17,115752,111784,3968,3.4
CN1311700000000,13,117,Forsyth County, GA,Dec-17,115694,111744,3950,3.4
CN1311700000000,13,117,Forsyth County, GA,Jan-18,115578,111576,4002,3.5
CN1311700000000,13,117,Forsyth County, GA,Feb-18,117528,113336,4192,3.6
CN1311700000000,13,117,Forsyth County, GA,Mar-18,117574,113718,3856,3.3
CN1311700000000,13,117,Forsyth County, GA,Apr-18(p),116870,113444,3426,2.9
CN4602700000000,46,027,Clay County, SD,Mar-17,7332,7115,217,3.0
CN4602700000000,46,027,Clay County, SD,Apr-17,7386,7145,241,3.3
CN4602700000000,46,027,Clay County, SD,May-17,6785,6538,247,3.6
CN4602700000000,46,027,Clay County, SD,Jun-17,6719,6449,270,4.0
CN4602700000000,46,027,Clay County, SD,Jul-17,6781,6517,264,3.9
CN4602700000000,46,027,Clay County, SD,Aug-17,6710,6461,249,3.7
CN4602700000000,46,027,Clay County, SD,Sep-17,7277,7044,233,3.2
CN4602700000000,46,027,Clay County, SD,Oct-17,7499,7274,225,3.0
CN4602700000000,46,027,Clay County, SD,Nov-17,7546,7325,221,2.9
CN4602700000000,46,027,Clay County, SD,Dec-17,7195,6959,236,3.3
CN4602700000000,46,027,Clay County, SD,Jan-18,7404,7174,230,3.1
CN4602700000000,46,027,Clay County, SD,Feb-18,7612,7374,238,3.1
CN4602700000000,46,027,Clay County, SD,Mar-18,7522,7319,203,2.7
CN4602700000000,46,027,Clay County, SD,Apr-18(p),7597,7355,242,3.2
CN5103100000000,51,031,Campbell County, VA,Mar-17,26162,25050,1112,4.3
CN5103100000000,51,031,Campbell County, VA,Apr-17,26149,25142,1007,3.9
CN5103100000000,51,031,Campbell County, VA,May-17,26018,24942,1076,4.1
CN5103100000000,51,031,Campbell County, VA,Jun-17,26117,24949,1168,4.5
CN5103100000000,51,031,Campbell County, VA,Jul-17,26414,25243,1171,4.4
CN5103100000000,51,031,Campbell County, VA,Aug-17,26279,25088,1191,4.5
CN5103100000000,51,031,Campbell County, VA,Sep-17,26295,25256,1039,4.0
CN5103100000000,51,031,Campbell County, VA,Oct-17,26075,25095,980,3.8
CN5103100000000,51,031,Campbell County, VA,Nov-17,26085,25100,985,3.8
CN5103100000000,51,031,Campbell County, VA,Dec-17,26010,25034,976,3.8
CN5103100000000,51,031,Campbell County, VA,Jan-18,25992,24856,1136,4.4
CN5103100000000,51,031,Campbell County, VA,Feb-18,26380,25380,1000,3.8
CN5103100000000,51,031,Campbell County, VA,Mar-18,26518,25518,1000,3.8
CN5103100000000,51,031,Campbell County, VA,Apr-18(p),26596,25764,832,3.1
CN2501500000000,25,015,Hampshire County, MA,Mar-17,89124,85688,3436,3.9
CN2501500000000,25,015,Hampshire County, MA,Apr-17,88919,86024,2895,3.3
CN2501500000000,25,015,Hampshire County, MA,May-17,88342,85380,2962,3.4
CN2501500000000,25,015,Hampshire County, MA,Jun-17,89224,85616,3608,4.0
CN2501500000000,25,015,Hampshire County, MA,Jul-17,88789,85113,3676,4.1
CN2501500000000,25,015,Hampshire County, MA,Aug-17,88091,85051,3040,3.5
CN2501500000000,25,015,Hampshire County, MA,Sep-17,87950,85207,2743,3.1
CN2501500000000,25,015,Hampshire County, MA,Oct-17,88219,85857,2362,2.7
CN2501500000000,25,015,Hampshire County, MA,Nov-17,88747,86475,2272,2.6
CN2501500000000,25,015,Hampshire County, MA,Dec-17,88308,86052,2256,2.6
CN2501500000000,25,015,Hampshire County, MA,Jan-18,87957,84972,2985,3.4
CN2501500000000,25,015,Hampshire County, MA,Feb-18,89998,86878,3120,3.5
CN2501500000000,25,015,Hampshire County, MA,Mar-18,90848,87738,3110,3.4
CN2501500000000,25,015,Hampshire County, MA,Apr-18(p),91104,88456,2648,2.9
CN7210500000000,72,105,Naranjito Municipio, PR,Mar-17,7240,6401,839,11.6
CN7210500000000,72,105,Naranjito Municipio, PR,Apr-17,7225,6322,903,12.5
CN7210500000000,72,105,Naranjito Municipio, PR,May-17,7119,6325,794,11.2
CN7210500000000,72,105,Naranjito Municipio, PR,Jun-17,7079,6296,783,11.1
CN7210500000000,72,105,Naranjito Municipio, PR,Jul-17,7181,6296,885,12.3
CN7210500000000,72,105,Naranjito Municipio, PR,Aug-17,7209,6208,1001,13.9
CN7210500000000,72,105,Naranjito Municipio, PR,Sep-17(y),7161,6248,913,12.7
CN7210500000000,72,105,Naranjito Municipio, PR,Oct-17,6817,5993,824,12.1
CN7210500000000,72,105,Naranjito Municipio, PR,Nov-17,7107,6331,776,10.9
CN7210500000000,72,105,Naranjito Municipio, PR,Dec-17,7106,6366,740,10.4
CN7210500000000,72,105,Naranjito Municipio, PR,Jan-18,7059,6255,804,11.4
CN7210500000000,72,105,Naranjito Municipio, PR,Feb-18,6990,6262,728,10.4
CN7210500000000,72,105,Naranjito Municipio, PR,Mar-18,6999,6278,721,10.3
CN7210500000000,72,105,Naranjito Municipio, PR,Apr-18(p),6999,6314,685,9.8
CN7204300000000,72,043,Coamo Municipio, PR,Mar-17,10578,8921,1657,15.7
CN7204300000000,72,043,Coamo Municipio, PR,Apr-17,10488,8818,1670,15.9
CN7204300000000,72,043,Coamo Municipio, PR,May-17,10509,8823,1686,16.0
CN7204300000000,72,043,Coamo Municipio, PR,Jun-17,10223,8783,1440,14.1
CN7204300000000,72,043,Coamo Municipio, PR,Jul-17,10491,8888,1603,15.3
CN7204300000000,72,043,Coamo Municipio, PR,Aug-17,10704,8761,1943,18.2
CN7204300000000,72,043,Coamo Municipio, PR,Sep-17(y),10706,8808,1898,17.7
CN7204300000000,72,043,Coamo Municipio, PR,Oct-17,10473,8583,1890,18.0
CN7204300000000,72,043,Coamo Municipio, PR,Nov-17,10759,9099,1660,15.4
CN7204300000000,72,043,Coamo Municipio, PR,Dec-17,10851,9229,1622,14.9
CN7204300000000,72,043,Coamo Municipio, PR,Jan-18,10643,8962,1681,15.8
CN7204300000000,72,043,Coamo Municipio, PR,Feb-18,10478,8895,1583,15.1
CN7204300000000,72,043,Coamo Municipio, PR,Mar-18,10313,8821,1492,14.5
CN7204300000000,72,043,Coamo Municipio, PR,Apr-18(p),10343,8917,1426,13.8
CN4205700000000,42,057,Fulton County, PA,Mar-17,7230,6780,450,6.2
CN4205700000000,42,057,Fulton County, PA,Apr-17,7164,6841,323,4.5
CN4205700000000,42,057,Fulton County, PA,May-17,7191,6857,334,4.6
CN4205700000000,42,057,Fulton County, PA,Jun-17,7328,6987,341,4.7
CN4205700000000,42,057,Fulton County, PA,Jul-17,7402,7045,357,4.8
CN4205700000000,42,057,Fulton County, PA,Aug-17,7324,6963,361,4.9
CN4205700000000,42,057,Fulton County, PA,Sep-17,7162,6856,306,4.3
CN4205700000000,42,057,Fulton County, PA,Oct-17,7070,6778,292,4.1
CN4205700000000,42,057,Fulton County, PA,Nov-17,7043,6734,309,4.4
CN4205700000000,42,057,Fulton County, PA,Dec-17,7074,6726,348,4.9
CN4205700000000,42,057,Fulton County, PA,Jan-18,7135,6685,450,6.3
CN4205700000000,42,057,Fulton County, PA,Feb-18,7168,6733,435,6.1
CN4205700000000,42,057,Fulton County, PA,Mar-18,7039,6689,350,5.0
CN4205700000000,42,057,Fulton County, PA,Apr-18(p),6955,6686,269,3.9
CN2815700000000,28,157,Wilkinson County, MS,Mar-17,2876,2611,265,9.2
CN2815700000000,28,157,Wilkinson County, MS,Apr-17,2845,2611,234,8.2
CN2815700000000,28,157,Wilkinson County, MS,May-17,2832,2601,231,8.2
CN2815700000000,28,157,Wilkinson County, MS,Jun-17,2876,2589,287,10.0
CN2815700000000,28,157,Wilkinson County, MS,Jul-17,2797,2507,290,10.4
CN2815700000000,28,157,Wilkinson County, MS,Aug-17,2845,2582,263,9.2
CN2815700000000,28,157,Wilkinson County, MS,Sep-17,2824,2600,224,7.9
CN2815700000000,28,157,Wilkinson County, MS,Oct-17,2786,2589,197,7.1
CN2815700000000,28,157,Wilkinson County, MS,Nov-17,2810,2604,206,7.3
CN2815700000000,28,157,Wilkinson County, MS,Dec-17,2821,2597,224,7.9
CN2815700000000,28,157,Wilkinson County, MS,Jan-18,2777,2551,226,8.1
CN2815700000000,28,157,Wilkinson County, MS,Feb-18,2780,2563,217,7.8
CN2815700000000,28,157,Wilkinson County, MS,Mar-18,2789,2574,215,7.7
CN2815700000000,28,157,Wilkinson County, MS,Apr-18(p),2776,2578,198,7.1
CN3713100000000,37,131,Northampton County, NC,Mar-17,7902,7415,487,6.2
CN3713100000000,37,131,Northampton County, NC,Apr-17,7841,7398,443,5.6
CN3713100000000,37,131,Northampton County, NC,May-17,7774,7320,454,5.8
CN3713100000000,37,131,Northampton County, NC,Jun-17,7724,7249,475,6.1
CN3713100000000,37,131,Northampton County, NC,Jul-17,7796,7295,501,6.4
CN3713100000000,37,131,Northampton County, NC,Aug-17,7624,7111,513,6.7
CN3713100000000,37,131,Northampton County, NC,Sep-17,7764,7302,462,6.0
CN3713100000000,37,131,Northampton County, NC,Oct-17,7781,7306,475,6.1
CN3713100000000,37,131,Northampton County, NC,Nov-17,7713,7221,492,6.4
CN3713100000000,37,131,Northampton County, NC,Dec-17,7700,7228,472,6.1
CN3713100000000,37,131,Northampton County, NC,Jan-18,7701,7191,510,6.6
CN3713100000000,37,131,Northampton County, NC,Feb-18,7772,7274,498,6.4
CN3713100000000,37,131,Northampton County, NC,Mar-18,7749,7295,454,5.9
CN3713100000000,37,131,Northampton County, NC,Apr-18(p),7733,7346,387,5.0
CN5401700000000,54,017,Doddridge County, WV,Mar-17,3779,3591,188,5.0
CN5401700000000,54,017,Doddridge County, WV,Apr-17,3841,3685,156,4.1
CN5401700000000,54,017,Doddridge County, WV,May-17,3871,3730,141,3.6
CN5401700000000,54,017,Doddridge County, WV,Jun-17,4029,3862,167,4.1
CN5401700000000,54,017,Doddridge County, WV,Jul-17,3968,3815,153,3.9
CN5401700000000,54,017,Doddridge County, WV,Aug-17,3954,3795,159,4.0
CN5401700000000,54,017,Doddridge County, WV,Sep-17,4012,3872,140,3.5
CN5401700000000,54,017,Doddridge County, WV,Oct-17,3985,3858,127,3.2
CN5401700000000,54,017,Doddridge County, WV,Nov-17,3939,3805,134,3.4
CN5401700000000,54,017,Doddridge County, WV,Dec-17,3881,3728,153,3.9
CN5401700000000,54,017,Doddridge County, WV,Jan-18,3915,3739,176,4.5
CN5401700000000,54,017,Doddridge County, WV,Feb-18,3962,3770,192,4.8
CN5401700000000,54,017,Doddridge County, WV,Mar-18,3941,3765,176,4.5
CN5401700000000,54,017,Doddridge County, WV,Apr-18(p),4000,3847,153,3.8
CN3807500000000,38,075,Renville County, ND,Mar-17,1283,1240,43,3.4
CN3807500000000,38,075,Renville County, ND,Apr-17,1313,1280,33,2.5
CN3807500000000,38,075,Renville County, ND,May-17,1317,1289,28,2.1
CN3807500000000,38,075,Renville County, ND,Jun-17,1323,1289,34,2.6
CN3807500000000,38,075,Renville County, ND,Jul-17,1322,1296,26,2.0
CN3807500000000,38,075,Renville County, ND,Aug-17,1326,1299,27,2.0
CN3807500000000,38,075,Renville County, ND,Sep-17,1331,1303,28,2.1
CN3807500000000,38,075,Renville County, ND,Oct-17,1350,1325,25,1.9
CN3807500000000,38,075,Renville County, ND,Nov-17,1297,1266,31,2.4
CN3807500000000,38,075,Renville County, ND,Dec-17,1289,1262,27,2.1
CN3807500000000,38,075,Renville County, ND,Jan-18,1255,1220,35,2.8
CN3807500000000,38,075,Renville County, ND,Feb-18,1229,1193,36,2.9
CN3807500000000,38,075,Renville County, ND,Mar-18,1245,1211,34,2.7
CN3807500000000,38,075,Renville County, ND,Apr-18(p),1251,1224,27,2.2
CN4714500000000,47,145,Roane County, TN,Mar-17,23089,21966,1123,4.9
CN4714500000000,47,145,Roane County, TN,Apr-17,23049,22135,914,4.0
CN4714500000000,47,145,Roane County, TN,May-17,23057,22189,868,3.8
CN4714500000000,47,145,Roane County, TN,Jun-17,23300,22212,1088,4.7
CN4714500000000,47,145,Roane County, TN,Jul-17,23390,22336,1054,4.5
CN4714500000000,47,145,Roane County, TN,Aug-17,23086,22113,973,4.2
CN4714500000000,47,145,Roane County, TN,Sep-17,23287,22421,866,3.7
CN4714500000000,47,145,Roane County, TN,Oct-17,23160,22299,861,3.7
CN4714500000000,47,145,Roane County, TN,Nov-17,23194,22356,838,3.6
CN4714500000000,47,145,Roane County, TN,Dec-17,23008,22176,832,3.6
CN4714500000000,47,145,Roane County, TN,Jan-18,22991,21953,1038,4.5
CN4714500000000,47,145,Roane County, TN,Feb-18,23411,22361,1050,4.5
CN4714500000000,47,145,Roane County, TN,Mar-18,23274,22344,930,4.0
CN4714500000000,47,145,Roane County, TN,Apr-18(p),23219,22457,762,3.3
CN2108300000000,21,083,Graves County, KY,Mar-17,16258,15197,1061,6.5
CN2108300000000,21,083,Graves County, KY,Apr-17,16376,15420,956,5.8
CN2108300000000,21,083,Graves County, KY,May-17,16301,15308,993,6.1
CN2108300000000,21,083,Graves County, KY,Jun-17,16361,15308,1053,6.4
CN2108300000000,21,083,Graves County, KY,Jul-17,15993,14986,1007,6.3
CN2108300000000,21,083,Graves County, KY,Aug-17,15791,14886,905,5.7
CN2108300000000,21,083,Graves County, KY,Sep-17,15835,15026,809,5.1
CN2108300000000,21,083,Graves County, KY,Oct-17,15805,15073,732,4.6
CN2108300000000,21,083,Graves County, KY,Nov-17,15910,15150,760,4.8
CN2108300000000,21,083,Graves County, KY,Dec-17,15870,15120,750,4.7
CN2108300000000,21,083,Graves County, KY,Jan-18,15840,15051,789,5.0
CN2108300000000,21,083,Graves County, KY,Feb-18,15795,14937,858,5.4
CN2108300000000,21,083,Graves County, KY,Mar-18,16042,15215,827,5.2
CN2108300000000,21,083,Graves County, KY,Apr-18(p),16046,15322,724,4.5
CN1908700000000,19,087,Henry County, IA,Mar-17,9582,9280,302,3.2
CN1908700000000,19,087,Henry County, IA,Apr-17,9589,9316,273,2.8
CN1908700000000,19,087,Henry County, IA,May-17,9608,9335,273,2.8
CN1908700000000,19,087,Henry County, IA,Jun-17,9626,9313,313,3.3
CN1908700000000,19,087,Henry County, IA,Jul-17,9694,9400,294,3.0
CN1908700000000,19,087,Henry County, IA,Aug-17,9513,9209,304,3.2
CN1908700000000,19,087,Henry County, IA,Sep-17,9899,9631,268,2.7
CN1908700000000,19,087,Henry County, IA,Oct-17,9908,9692,216,2.2
CN1908700000000,19,087,Henry County, IA,Nov-17,9885,9645,240,2.4
CN1908700000000,19,087,Henry County, IA,Dec-17,9729,9468,261,2.7
CN1908700000000,19,087,Henry County, IA,Jan-18,9669,9327,342,3.5
CN1908700000000,19,087,Henry County, IA,Feb-18,9810,9482,328,3.3
CN1908700000000,19,087,Henry County, IA,Mar-18,9757,9498,259,2.7
CN1908700000000,19,087,Henry County, IA,Apr-18(p),9677,9453,224,2.3
CN2114500000000,21,145,McCracken County, KY,Mar-17,29864,27944,1920,6.4
CN2114500000000,21,145,McCracken County, KY,Apr-17,29775,27969,1806,6.1
CN2114500000000,21,145,McCracken County, KY,May-17,29706,27811,1895,6.4
CN2114500000000,21,145,McCracken County, KY,Jun-17,30020,28081,1939,6.5
CN2114500000000,21,145,McCracken County, KY,Jul-17,29891,27975,1916,6.4
CN2114500000000,21,145,McCracken County, KY,Aug-17,29648,27863,1785,6.0
CN2114500000000,21,145,McCracken County, KY,Sep-17,29657,28032,1625,5.5
CN2114500000000,21,145,McCracken County, KY,Oct-17,29440,27924,1516,5.1
CN2114500000000,21,145,McCracken County, KY,Nov-17,29446,27883,1563,5.3
CN2114500000000,21,145,McCracken County, KY,Dec-17,29427,27869,1558,5.3
CN2114500000000,21,145,McCracken County, KY,Jan-18,29248,27532,1716,5.9
CN2114500000000,21,145,McCracken County, KY,Feb-18,29501,27639,1862,6.3
CN2114500000000,21,145,McCracken County, KY,Mar-18,29888,28061,1827,6.1
CN2114500000000,21,145,McCracken County, KY,Apr-18(p),29830,28232,1598,5.4
CN5507900000000,55,079,Milwaukee County, WI,Mar-17,477016,457477,19539,4.1
CN5507900000000,55,079,Milwaukee County, WI,Apr-17,474447,456399,18048,3.8
CN5507900000000,55,079,Milwaukee County, WI,May-17,475602,457371,18231,3.8
CN5507900000000,55,079,Milwaukee County, WI,Jun-17,482397,459865,22532,4.7
CN5507900000000,55,079,Milwaukee County, WI,Jul-17,486721,465064,21657,4.4
CN5507900000000,55,079,Milwaukee County, WI,Aug-17,486475,464275,22200,4.6
CN5507900000000,55,079,Milwaukee County, WI,Sep-17,481770,463299,18471,3.8
CN5507900000000,55,079,Milwaukee County, WI,Oct-17,477058,460317,16741,3.5
CN5507900000000,55,079,Milwaukee County, WI,Nov-17,476215,459577,16638,3.5
CN5507900000000,55,079,Milwaukee County, WI,Dec-17,471738,456966,14772,3.1
CN5507900000000,55,079,Milwaukee County, WI,Jan-18,472792,456820,15972,3.4
CN5507900000000,55,079,Milwaukee County, WI,Feb-18,481278,463991,17287,3.6
CN5507900000000,55,079,Milwaukee County, WI,Mar-18,482819,465784,17035,3.5
CN5507900000000,55,079,Milwaukee County, WI,Apr-18(p),479346,464605,14741,3.1
CN4007100000000,40,071,Kay County, OK,Mar-17,19117,18082,1035,5.4
CN4007100000000,40,071,Kay County, OK,Apr-17,19103,18172,931,4.9
CN4007100000000,40,071,Kay County, OK,May-17,19187,18142,1045,5.4
CN4007100000000,40,071,Kay County, OK,Jun-17,19375,18271,1104,5.7
CN4007100000000,40,071,Kay County, OK,Jul-17,19333,18308,1025,5.3
CN4007100000000,40,071,Kay County, OK,Aug-17,19289,18280,1009,5.2
CN4007100000000,40,071,Kay County, OK,Sep-17,19518,18537,981,5.0
CN4007100000000,40,071,Kay County, OK,Oct-17,19208,18183,1025,5.3
CN4007100000000,40,071,Kay County, OK,Nov-17,19232,18191,1041,5.4
CN4007100000000,40,071,Kay County, OK,Dec-17,19161,18018,1143,6.0
CN4007100000000,40,071,Kay County, OK,Jan-18,19259,17992,1267,6.6
CN4007100000000,40,071,Kay County, OK,Feb-18,19394,18289,1105,5.7
CN4007100000000,40,071,Kay County, OK,Mar-18,19409,18358,1051,5.4
CN4007100000000,40,071,Kay County, OK,Apr-18(p),19207,18213,994,5.2
CN2902300000000,29,023,Butler County, MO,Mar-17,18456,17501,955,5.2
CN2902300000000,29,023,Butler County, MO,Apr-17,18179,17375,804,4.4
CN2902300000000,29,023,Butler County, MO,May-17,18149,17342,807,4.4
CN2902300000000,29,023,Butler County, MO,Jun-17,18244,17378,866,4.7
CN2902300000000,29,023,Butler County, MO,Jul-17,17868,16911,957,5.4
CN2902300000000,29,023,Butler County, MO,Aug-17,18018,16984,1034,5.7
CN2902300000000,29,023,Butler County, MO,Sep-17,18120,17433,687,3.8
CN2902300000000,29,023,Butler County, MO,Oct-17,17688,17139,549,3.1
CN2902300000000,29,023,Butler County, MO,Nov-17,17733,17068,665,3.8
CN2902300000000,29,023,Butler County, MO,Dec-17,17896,17155,741,4.1
CN2902300000000,29,023,Butler County, MO,Jan-18,17821,16800,1021,5.7
CN2902300000000,29,023,Butler County, MO,Feb-18,18103,17248,855,4.7
CN2902300000000,29,023,Butler County, MO,Mar-18,18160,17315,845,4.7
CN2902300000000,29,023,Butler County, MO,Apr-18(p),18463,17371,1092,5.9
CN4013300000000,40,133,Seminole County, OK,Mar-17,9422,8866,556,5.9
CN4013300000000,40,133,Seminole County, OK,Apr-17,9290,8791,499,5.4
CN4013300000000,40,133,Seminole County, OK,May-17,9354,8807,547,5.8
CN4013300000000,40,133,Seminole County, OK,Jun-17,9357,8757,600,6.4
CN4013300000000,40,133,Seminole County, OK,Jul-17,9117,8565,552,6.1
CN4013300000000,40,133,Seminole County, OK,Aug-17,9161,8616,545,5.9
CN4013300000000,40,133,Seminole County, OK,Sep-17,9503,8978,525,5.5
CN4013300000000,40,133,Seminole County, OK,Oct-17,9369,8840,529,5.6
CN4013300000000,40,133,Seminole County, OK,Nov-17,9359,8861,498,5.3
CN4013300000000,40,133,Seminole County, OK,Dec-17,9264,8757,507,5.5
CN4013300000000,40,133,Seminole County, OK,Jan-18,9260,8736,524,5.7
CN4013300000000,40,133,Seminole County, OK,Feb-18,9425,8928,497,5.3
CN4013300000000,40,133,Seminole County, OK,Mar-18,9463,8979,484,5.1
CN4013300000000,40,133,Seminole County, OK,Apr-18(p),9376,8897,479,5.1
CN4211900000000,42,119,Union County, PA,Mar-17,19946,19006,940,4.7
CN4211900000000,42,119,Union County, PA,Apr-17,20065,19137,928,4.6
CN4211900000000,42,119,Union County, PA,May-17,20116,19277,839,4.2
CN4211900000000,42,119,Union County, PA,Jun-17,20057,19171,886,4.4
CN4211900000000,42,119,Union County, PA,Jul-17,20060,19137,923,4.6
CN4211900000000,42,119,Union County, PA,Aug-17,19867,19024,843,4.2
CN4211900000000,42,119,Union County, PA,Sep-17,19896,19188,708,3.6
CN4211900000000,42,119,Union County, PA,Oct-17,19841,19141,700,3.5
CN4211900000000,42,119,Union County, PA,Nov-17,19758,18971,787,4.0
CN4211900000000,42,119,Union County, PA,Dec-17,19697,18883,814,4.1
CN4211900000000,42,119,Union County, PA,Jan-18,19173,18266,907,4.7
CN4211900000000,42,119,Union County, PA,Feb-18,19752,18855,897,4.5
CN4211900000000,42,119,Union County, PA,Mar-18,19567,18824,743,3.8
CN4211900000000,42,119,Union County, PA,Apr-18(p),19633,18985,648,3.3
CN5405500000000,54,055,Mercer County, WV,Mar-17,21177,19864,1313,6.2
CN5405500000000,54,055,Mercer County, WV,Apr-17,21439,20274,1165,5.4
CN5405500000000,54,055,Mercer County, WV,May-17,21360,20229,1131,5.3
CN5405500000000,54,055,Mercer County, WV,Jun-17,21642,20337,1305,6.0
CN5405500000000,54,055,Mercer County, WV,Jul-17,21477,20217,1260,5.9
CN5405500000000,54,055,Mercer County, WV,Aug-17,21322,20019,1303,6.1
CN5405500000000,54,055,Mercer County, WV,Sep-17,21565,20417,1148,5.3
CN5405500000000,54,055,Mercer County, WV,Oct-17,21535,20391,1144,5.3
CN5405500000000,54,055,Mercer County, WV,Nov-17,21448,20260,1188,5.5
CN5405500000000,54,055,Mercer County, WV,Dec-17,21299,20112,1187,5.6
CN5405500000000,54,055,Mercer County, WV,Jan-18,21103,19798,1305,6.2
CN5405500000000,54,055,Mercer County, WV,Feb-18,21471,20000,1471,6.9
CN5405500000000,54,055,Mercer County, WV,Mar-18,21537,20028,1509,7.0
CN5405500000000,54,055,Mercer County, WV,Apr-18(p),21507,20163,1344,6.2
CN4702700000000,47,027,Clay County, TN,Mar-17,3035,2861,174,5.7
CN4702700000000,47,027,Clay County, TN,Apr-17,3098,2963,135,4.4
CN4702700000000,47,027,Clay County, TN,May-17,3123,2983,140,4.5
CN4702700000000,47,027,Clay County, TN,Jun-17,3024,2864,160,5.3
CN4702700000000,47,027,Clay County, TN,Jul-17,3058,2904,154,5.0
CN4702700000000,47,027,Clay County, TN,Aug-17,3180,3047,133,4.2
CN4702700000000,47,027,Clay County, TN,Sep-17,3159,3034,125,4.0
CN4702700000000,47,027,Clay County, TN,Oct-17,3103,2974,129,4.2
CN4702700000000,47,027,Clay County, TN,Nov-17,3071,2935,136,4.4
CN4702700000000,47,027,Clay County, TN,Dec-17,3080,2938,142,4.6
CN4702700000000,47,027,Clay County, TN,Jan-18,3063,2892,171,5.6
CN4702700000000,47,027,Clay County, TN,Feb-18,3109,2945,164,5.3
CN4702700000000,47,027,Clay County, TN,Mar-18,3083,2939,144,4.7
CN4702700000000,47,027,Clay County, TN,Apr-18(p),3183,3049,134,4.2
CN0808900000000,08,089,Otero County, CO,Mar-17,8050,7717,333,4.1
CN0808900000000,08,089,Otero County, CO,Apr-17,8235,7918,317,3.8
CN0808900000000,08,089,Otero County, CO,May-17,8256,7952,304,3.7
CN0808900000000,08,089,Otero County, CO,Jun-17,8310,7932,378,4.5
CN0808900000000,08,089,Otero County, CO,Jul-17,8369,7990,379,4.5
CN0808900000000,08,089,Otero County, CO,Aug-17,8346,7986,360,4.3
CN0808900000000,08,089,Otero County, CO,Sep-17,8435,8109,326,3.9
CN0808900000000,08,089,Otero County, CO,Oct-17,8802,8472,330,3.7
CN0808900000000,08,089,Otero County, CO,Nov-17,8694,8360,334,3.8
CN0808900000000,08,089,Otero County, CO,Dec-17,8510,8151,359,4.2
CN0808900000000,08,089,Otero County, CO,Jan-18,8411,7960,451,5.4
CN0808900000000,08,089,Otero County, CO,Feb-18,8386,7953,433,5.2
CN0808900000000,08,089,Otero County, CO,Mar-18,8318,7945,373,4.5
CN0808900000000,08,089,Otero County, CO,Apr-18(p),8445,8107,338,4.0
CN1802500000000,18,025,Crawford County, IN,Mar-17,4943,4697,246,5.0
CN1802500000000,18,025,Crawford County, IN,Apr-17,4929,4740,189,3.8
CN1802500000000,18,025,Crawford County, IN,May-17,4971,4787,184,3.7
CN1802500000000,18,025,Crawford County, IN,Jun-17,5036,4844,192,3.8
CN1802500000000,18,025,Crawford County, IN,Jul-17,4934,4730,204,4.1
CN1802500000000,18,025,Crawford County, IN,Aug-17,4932,4720,212,4.3
CN1802500000000,18,025,Crawford County, IN,Sep-17,4857,4684,173,3.6
CN1802500000000,18,025,Crawford County, IN,Oct-17,4877,4701,176,3.6
CN1802500000000,18,025,Crawford County, IN,Nov-17,4850,4666,184,3.8
CN1802500000000,18,025,Crawford County, IN,Dec-17,4864,4643,221,4.5
CN1802500000000,18,025,Crawford County, IN,Jan-18,4834,4572,262,5.4
CN1802500000000,18,025,Crawford County, IN,Feb-18,4849,4581,268,5.5
CN1802500000000,18,025,Crawford County, IN,Mar-18,4887,4651,236,4.8
CN1802500000000,18,025,Crawford County, IN,Apr-18(p),4916,4729,187,3.8
CN3701300000000,37,013,Beaufort County, NC,Mar-17,20410,19373,1037,5.1
CN3701300000000,37,013,Beaufort County, NC,Apr-17,20183,19253,930,4.6
CN3701300000000,37,013,Beaufort County, NC,May-17,20108,19126,982,4.9
CN3701300000000,37,013,Beaufort County, NC,Jun-17,20005,18982,1023,5.1
CN3701300000000,37,013,Beaufort County, NC,Jul-17,20396,19331,1065,5.2
CN3701300000000,37,013,Beaufort County, NC,Aug-17,19902,18838,1064,5.3
CN3701300000000,37,013,Beaufort County, NC,Sep-17,20143,19199,944,4.7
CN3701300000000,37,013,Beaufort County, NC,Oct-17,20131,19167,964,4.8
CN3701300000000,37,013,Beaufort County, NC,Nov-17,20030,19001,1029,5.1
CN3701300000000,37,013,Beaufort County, NC,Dec-17,19911,18915,996,5.0
CN3701300000000,37,013,Beaufort County, NC,Jan-18,19844,18781,1063,5.4
CN3701300000000,37,013,Beaufort County, NC,Feb-18,20063,19000,1063,5.3
CN3701300000000,37,013,Beaufort County, NC,Mar-18,20034,19014,1020,5.1
CN3701300000000,37,013,Beaufort County, NC,Apr-18(p),19962,19106,856,4.3
CN2803900000000,28,039,George County, MS,Mar-17,8956,8395,561,6.3
CN2803900000000,28,039,George County, MS,Apr-17,8961,8453,508,5.7
CN2803900000000,28,039,George County, MS,May-17,9032,8419,613,6.8
CN2803900000000,28,039,George County, MS,Jun-17,9226,8468,758,8.2
CN2803900000000,28,039,George County, MS,Jul-17,9117,8344,773,8.5
CN2803900000000,28,039,George County, MS,Aug-17,8869,8215,654,7.4
CN2803900000000,28,039,George County, MS,Sep-17,8845,8255,590,6.7
CN2803900000000,28,039,George County, MS,Oct-17,8672,8156,516,6.0
CN2803900000000,28,039,George County, MS,Nov-17,8642,8127,515,6.0
CN2803900000000,28,039,George County, MS,Dec-17,8720,8127,593,6.8
CN2803900000000,28,039,George County, MS,Jan-18,8585,7998,587,6.8
CN2803900000000,28,039,George County, MS,Feb-18,8596,8091,505,5.9
CN2803900000000,28,039,George County, MS,Mar-18,8643,8204,439,5.1
CN2803900000000,28,039,George County, MS,Apr-18(p),8651,8215,436,5.0
CN1914300000000,19,143,Osceola County, IA,Mar-17,3540,3451,89,2.5
CN1914300000000,19,143,Osceola County, IA,Apr-17,3650,3578,72,2.0
CN1914300000000,19,143,Osceola County, IA,May-17,3653,3587,66,1.8
CN1914300000000,19,143,Osceola County, IA,Jun-17,3652,3583,69,1.9
CN1914300000000,19,143,Osceola County, IA,Jul-17,3708,3637,71,1.9
CN1914300000000,19,143,Osceola County, IA,Aug-17,3615,3534,81,2.2
CN1914300000000,19,143,Osceola County, IA,Sep-17,3535,3467,68,1.9
CN1914300000000,19,143,Osceola County, IA,Oct-17,3579,3523,56,1.6
CN1914300000000,19,143,Osceola County, IA,Nov-17,3498,3442,56,1.6
CN1914300000000,19,143,Osceola County, IA,Dec-17,3494,3417,77,2.2
CN1914300000000,19,143,Osceola County, IA,Jan-18,3415,3329,86,2.5
CN1914300000000,19,143,Osceola County, IA,Feb-18,3435,3349,86,2.5
CN1914300000000,19,143,Osceola County, IA,Mar-18,3426,3341,85,2.5
CN1914300000000,19,143,Osceola County, IA,Apr-18(p),3446,3369,77,2.2
CN5001300000000,50,013,Grand Isle County, VT,Mar-17,4012,3819,193,4.8
CN5001300000000,50,013,Grand Isle County, VT,Apr-17,4011,3851,160,4.0
CN5001300000000,50,013,Grand Isle County, VT,May-17,3956,3847,109,2.8
CN5001300000000,50,013,Grand Isle County, VT,Jun-17,3984,3880,104,2.6
CN5001300000000,50,013,Grand Isle County, VT,Jul-17,4036,3907,129,3.2
CN5001300000000,50,013,Grand Isle County, VT,Aug-17,3999,3882,117,2.9
CN5001300000000,50,013,Grand Isle County, VT,Sep-17,3980,3866,114,2.9
CN5001300000000,50,013,Grand Isle County, VT,Oct-17,3979,3888,91,2.3
CN5001300000000,50,013,Grand Isle County, VT,Nov-17,4005,3869,136,3.4
CN5001300000000,50,013,Grand Isle County, VT,Dec-17,3946,3828,118,3.0
CN5001300000000,50,013,Grand Isle County, VT,Jan-18,3949,3796,153,3.9
CN5001300000000,50,013,Grand Isle County, VT,Feb-18,4028,3859,169,4.2
CN5001300000000,50,013,Grand Isle County, VT,Mar-18,4061,3885,176,4.3
CN5001300000000,50,013,Grand Isle County, VT,Apr-18(p),4077,3919,158,3.9
CN4013900000000,40,139,Texas County, OK,Mar-17,9338,9031,307,3.3
CN4013900000000,40,139,Texas County, OK,Apr-17,9386,9113,273,2.9
CN4013900000000,40,139,Texas County, OK,May-17,9265,8944,321,3.5
CN4013900000000,40,139,Texas County, OK,Jun-17,9220,8865,355,3.9
CN4013900000000,40,139,Texas County, OK,Jul-17,9160,8848,312,3.4
CN4013900000000,40,139,Texas County, OK,Aug-17,9313,9021,292,3.1
CN4013900000000,40,139,Texas County, OK,Sep-17,9273,8990,283,3.1
CN4013900000000,40,139,Texas County, OK,Oct-17,9584,9358,226,2.4
CN4013900000000,40,139,Texas County, OK,Nov-17,9734,9479,255,2.6
CN4013900000000,40,139,Texas County, OK,Dec-17,9505,9236,269,2.8
CN4013900000000,40,139,Texas County, OK,Jan-18,9330,8994,336,3.6
CN4013900000000,40,139,Texas County, OK,Feb-18,9390,9081,309,3.3
CN4013900000000,40,139,Texas County, OK,Mar-18,9270,8963,307,3.3
CN4013900000000,40,139,Texas County, OK,Apr-18(p),9091,8787,304,3.3
CN1311100000000,13,111,Fannin County, GA,Mar-17,10996,10441,555,5.0
CN1311100000000,13,111,Fannin County, GA,Apr-17,10948,10431,517,4.7
CN1311100000000,13,111,Fannin County, GA,May-17,11008,10484,524,4.8
CN1311100000000,13,111,Fannin County, GA,Jun-17,11024,10486,538,4.9
CN1311100000000,13,111,Fannin County, GA,Jul-17,11111,10564,547,4.9
CN1311100000000,13,111,Fannin County, GA,Aug-17,11002,10476,526,4.8
CN1311100000000,13,111,Fannin County, GA,Sep-17,11135,10648,487,4.4
CN1311100000000,13,111,Fannin County, GA,Oct-17,11099,10622,477,4.3
CN1311100000000,13,111,Fannin County, GA,Nov-17,11033,10579,454,4.1
CN1311100000000,13,111,Fannin County, GA,Dec-17,10966,10494,472,4.3
CN1311100000000,13,111,Fannin County, GA,Jan-18,11038,10499,539,4.9
CN1311100000000,13,111,Fannin County, GA,Feb-18,11063,10545,518,4.7
CN1311100000000,13,111,Fannin County, GA,Mar-18,11100,10605,495,4.5
CN1311100000000,13,111,Fannin County, GA,Apr-18(p),11249,10830,419,3.7
CN4801100000000,48,011,Armstrong County, TX,Mar-17,938,916,22,2.3
CN4801100000000,48,011,Armstrong County, TX,Apr-17,938,918,20,2.1
CN4801100000000,48,011,Armstrong County, TX,May-17,936,915,21,2.2
CN4801100000000,48,011,Armstrong County, TX,Jun-17,924,901,23,2.5
CN4801100000000,48,011,Armstrong County, TX,Jul-17,904,879,25,2.8
CN4801100000000,48,011,Armstrong County, TX,Aug-17,910,886,24,2.6
CN4801100000000,48,011,Armstrong County, TX,Sep-17,910,887,23,2.5
CN4801100000000,48,011,Armstrong County, TX,Oct-17,924,901,23,2.5
CN4801100000000,48,011,Armstrong County, TX,Nov-17,913,892,21,2.3
CN4801100000000,48,011,Armstrong County, TX,Dec-17,921,898,23,2.5
CN4801100000000,48,011,Armstrong County, TX,Jan-18,911,885,26,2.9
CN4801100000000,48,011,Armstrong County, TX,Feb-18,927,904,23,2.5
CN4801100000000,48,011,Armstrong County, TX,Mar-18,950,923,27,2.8
CN4801100000000,48,011,Armstrong County, TX,Apr-18(p),947,921,26,2.7
CN2120700000000,21,207,Russell County, KY,Mar-17,6420,5858,562,8.8
CN2120700000000,21,207,Russell County, KY,Apr-17,6339,5888,451,7.1
CN2120700000000,21,207,Russell County, KY,May-17,6444,5902,542,8.4
CN2120700000000,21,207,Russell County, KY,Jun-17,6488,6030,458,7.1
CN2120700000000,21,207,Russell County, KY,Jul-17,6328,5891,437,6.9
CN2120700000000,21,207,Russell County, KY,Aug-17,6090,5702,388,6.4
CN2120700000000,21,207,Russell County, KY,Sep-17,6292,5939,353,5.6
CN2120700000000,21,207,Russell County, KY,Oct-17,6114,5780,334,5.5
CN2120700000000,21,207,Russell County, KY,Nov-17,6086,5764,322,5.3
CN2120700000000,21,207,Russell County, KY,Dec-17,6051,5725,326,5.4
CN2120700000000,21,207,Russell County, KY,Jan-18,6081,5702,379,6.2
CN2120700000000,21,207,Russell County, KY,Feb-18,6168,5750,418,6.8
CN2120700000000,21,207,Russell County, KY,Mar-18,6254,5847,407,6.5
CN2120700000000,21,207,Russell County, KY,Apr-18(p),6245,5908,337,5.4
CN4602100000000,46,021,Campbell County, SD,Mar-17,833,805,28,3.4
CN4602100000000,46,021,Campbell County, SD,Apr-17,823,798,25,3.0
CN4602100000000,46,021,Campbell County, SD,May-17,849,820,29,3.4
CN4602100000000,46,021,Campbell County, SD,Jun-17,877,850,27,3.1
CN4602100000000,46,021,Campbell County, SD,Jul-17,849,824,25,2.9
CN4602100000000,46,021,Campbell County, SD,Aug-17,823,791,32,3.9
CN4602100000000,46,021,Campbell County, SD,Sep-17,805,769,36,4.5
CN4602100000000,46,021,Campbell County, SD,Oct-17,797,769,28,3.5
CN4602100000000,46,021,Campbell County, SD,Nov-17,788,761,27,3.4
CN4602100000000,46,021,Campbell County, SD,Dec-17,828,791,37,4.5
CN4602100000000,46,021,Campbell County, SD,Jan-18,820,782,38,4.6
CN4602100000000,46,021,Campbell County, SD,Feb-18,843,802,41,4.9
CN4602100000000,46,021,Campbell County, SD,Mar-18,849,813,36,4.2
CN4602100000000,46,021,Campbell County, SD,Apr-18(p),818,788,30,3.7
CN1914900000000,19,149,Plymouth County, IA,Mar-17,14419,14048,371,2.6
CN1914900000000,19,149,Plymouth County, IA,Apr-17,14475,14158,317,2.2
CN1914900000000,19,149,Plymouth County, IA,May-17,14574,14265,309,2.1
CN1914900000000,19,149,Plymouth County, IA,Jun-17,14762,14398,364,2.5
CN1914900000000,19,149,Plymouth County, IA,Jul-17,14891,14526,365,2.5
CN1914900000000,19,149,Plymouth County, IA,Aug-17,14660,14296,364,2.5
CN1914900000000,19,149,Plymouth County, IA,Sep-17,14592,14275,317,2.2
CN1914900000000,19,149,Plymouth County, IA,Oct-17,14632,14317,315,2.2
CN1914900000000,19,149,Plymouth County, IA,Nov-17,14574,14207,367,2.5
CN1914900000000,19,149,Plymouth County, IA,Dec-17,14478,14156,322,2.2
CN1914900000000,19,149,Plymouth County, IA,Jan-18,14301,13923,378,2.6
CN1914900000000,19,149,Plymouth County, IA,Feb-18,14428,14070,358,2.5
CN1914900000000,19,149,Plymouth County, IA,Mar-18,14353,14036,317,2.2
CN1914900000000,19,149,Plymouth County, IA,Apr-18(p),14335,14057,278,1.9
CN3611300000000,36,113,Warren County, NY,Mar-17,31795,29830,1965,6.2
CN3611300000000,36,113,Warren County, NY,Apr-17,31574,29834,1740,5.5
CN3611300000000,36,113,Warren County, NY,May-17,32029,30532,1497,4.7
CN3611300000000,36,113,Warren County, NY,Jun-17,33543,32095,1448,4.3
CN3611300000000,36,113,Warren County, NY,Jul-17,33907,32432,1475,4.4
CN3611300000000,36,113,Warren County, NY,Aug-17,33451,32002,1449,4.3
CN3611300000000,36,113,Warren County, NY,Sep-17,32124,30712,1412,4.4
CN3611300000000,36,113,Warren County, NY,Oct-17,31799,30408,1391,4.4
CN3611300000000,36,113,Warren County, NY,Nov-17,31357,29574,1783,5.7
CN3611300000000,36,113,Warren County, NY,Dec-17,31316,29268,2048,6.5
CN3611300000000,36,113,Warren County, NY,Jan-18,31678,29370,2308,7.3
CN3611300000000,36,113,Warren County, NY,Feb-18,31375,29117,2258,7.2
CN3611300000000,36,113,Warren County, NY,Mar-18,31179,29064,2115,6.8
CN3611300000000,36,113,Warren County, NY,Apr-18(p),31228,29447,1781,5.7
CN5510100000000,55,101,Racine County, WI,Mar-17,99787,95395,4392,4.4
CN5510100000000,55,101,Racine County, WI,Apr-17,99329,95466,3863,3.9
CN5510100000000,55,101,Racine County, WI,May-17,99641,95927,3714,3.7
CN5510100000000,55,101,Racine County, WI,Jun-17,101558,97101,4457,4.4
CN5510100000000,55,101,Racine County, WI,Jul-17,102391,97997,4394,4.3
CN5510100000000,55,101,Racine County, WI,Aug-17,102007,97288,4719,4.6
CN5510100000000,55,101,Racine County, WI,Sep-17,100560,96827,3733,3.7
CN5510100000000,55,101,Racine County, WI,Oct-17,99449,96091,3358,3.4
CN5510100000000,55,101,Racine County, WI,Nov-17,99163,95770,3393,3.4
CN5510100000000,55,101,Racine County, WI,Dec-17,98387,95221,3166,3.2
CN5510100000000,55,101,Racine County, WI,Jan-18,98837,95172,3665,3.7
CN5510100000000,55,101,Racine County, WI,Feb-18,100418,96407,4011,4.0
CN5510100000000,55,101,Racine County, WI,Mar-18,100414,96640,3774,3.8
CN5510100000000,55,101,Racine County, WI,Apr-18(p),99441,96249,3192,3.2
CN1209300000000,12,093,Okeechobee County, FL,Mar-17,20508,19743,765,3.7
CN1209300000000,12,093,Okeechobee County, FL,Apr-17,19345,18626,719,3.7
CN1209300000000,12,093,Okeechobee County, FL,May-17,19067,18335,732,3.8
CN1209300000000,12,093,Okeechobee County, FL,Jun-17,18233,17414,819,4.5
CN1209300000000,12,093,Okeechobee County, FL,Jul-17,17626,16772,854,4.8
CN1209300000000,12,093,Okeechobee County, FL,Aug-17,18148,17284,864,4.8
CN1209300000000,12,093,Okeechobee County, FL,Sep-17,17980,17184,796,4.4
CN1209300000000,12,093,Okeechobee County, FL,Oct-17,17807,17079,728,4.1
CN1209300000000,12,093,Okeechobee County, FL,Nov-17,17777,17075,702,3.9
CN1209300000000,12,093,Okeechobee County, FL,Dec-17,17747,17098,649,3.7
CN1209300000000,12,093,Okeechobee County, FL,Jan-18,17932,17193,739,4.1
CN1209300000000,12,093,Okeechobee County, FL,Feb-18,18137,17467,670,3.7
CN1209300000000,12,093,Okeechobee County, FL,Mar-18,18184,17538,646,3.6
CN1209300000000,12,093,Okeechobee County, FL,Apr-18(p),18127,17532,595,3.3
CN2905700000000,29,057,Dade County, MO,Mar-17,3584,3443,141,3.9
CN2905700000000,29,057,Dade County, MO,Apr-17,3726,3614,112,3.0
CN2905700000000,29,057,Dade County, MO,May-17,3657,3544,113,3.1
CN2905700000000,29,057,Dade County, MO,Jun-17,3650,3528,122,3.3
CN2905700000000,29,057,Dade County, MO,Jul-17,3402,3262,140,4.1
CN2905700000000,29,057,Dade County, MO,Aug-17,3372,3242,130,3.9
CN2905700000000,29,057,Dade County, MO,Sep-17,3520,3407,113,3.2
CN2905700000000,29,057,Dade County, MO,Oct-17,3549,3477,72,2.0
CN2905700000000,29,057,Dade County, MO,Nov-17,3561,3466,95,2.7
CN2905700000000,29,057,Dade County, MO,Dec-17,3503,3406,97,2.8
CN2905700000000,29,057,Dade County, MO,Jan-18,3522,3389,133,3.8
CN2905700000000,29,057,Dade County, MO,Feb-18,3575,3461,114,3.2
CN2905700000000,29,057,Dade County, MO,Mar-18,3561,3459,102,2.9
CN2905700000000,29,057,Dade County, MO,Apr-18(p),3638,3548,90,2.5
CN1715900000000,17,159,Richland County, IL,Mar-17,7582,7209,373,4.9
CN1715900000000,17,159,Richland County, IL,Apr-17,7528,7229,299,4.0
CN1715900000000,17,159,Richland County, IL,May-17,7507,7194,313,4.2
CN1715900000000,17,159,Richland County, IL,Jun-17,7591,7252,339,4.5
CN1715900000000,17,159,Richland County, IL,Jul-17,7689,7323,366,4.8
CN1715900000000,17,159,Richland County, IL,Aug-17,7486,7119,367,4.9
CN1715900000000,17,159,Richland County, IL,Sep-17,7473,7146,327,4.4
CN1715900000000,17,159,Richland County, IL,Oct-17,7490,7178,312,4.2
CN1715900000000,17,159,Richland County, IL,Nov-17,7547,7225,322,4.3
CN1715900000000,17,159,Richland County, IL,Dec-17,7454,7149,305,4.1
CN1715900000000,17,159,Richland County, IL,Jan-18,7469,7139,330,4.4
CN1715900000000,17,159,Richland County, IL,Feb-18,7555,7244,311,4.1
CN1715900000000,17,159,Richland County, IL,Mar-18,7682,7358,324,4.2
CN1715900000000,17,159,Richland County, IL,Apr-18(p),7753,7483,270,3.5
CN2020100000000,20,201,Washington County, KS,Mar-17,2932,2838,94,3.2
CN2020100000000,20,201,Washington County, KS,Apr-17,2895,2816,79,2.7
CN2020100000000,20,201,Washington County, KS,May-17,2924,2839,85,2.9
CN2020100000000,20,201,Washington County, KS,Jun-17,3045,2945,100,3.3
CN2020100000000,20,201,Washington County, KS,Jul-17,2955,2854,101,3.4
CN2020100000000,20,201,Washington County, KS,Aug-17,2982,2891,91,3.1
CN2020100000000,20,201,Washington County, KS,Sep-17,2972,2900,72,2.4
CN2020100000000,20,201,Washington County, KS,Oct-17,3036,2975,61,2.0
CN2020100000000,20,201,Washington County, KS,Nov-17,2987,2914,73,2.4
CN2020100000000,20,201,Washington County, KS,Dec-17,2987,2917,70,2.3
CN2020100000000,20,201,Washington County, KS,Jan-18,2909,2828,81,2.8
CN2020100000000,20,201,Washington County, KS,Feb-18,2901,2807,94,3.2
CN2020100000000,20,201,Washington County, KS,Mar-18,2884,2802,82,2.8
CN2020100000000,20,201,Washington County, KS,Apr-18(p),2771,2699,72,2.6
CN4708300000000,47,083,Houston County, TN,Mar-17,3268,3068,200,6.1
CN4708300000000,47,083,Houston County, TN,Apr-17,3199,3039,160,5.0
CN4708300000000,47,083,Houston County, TN,May-17,3200,3046,154,4.8
CN4708300000000,47,083,Houston County, TN,Jun-17,3141,2953,188,6.0
CN4708300000000,47,083,Houston County, TN,Jul-17,3134,2945,189,6.0
CN4708300000000,47,083,Houston County, TN,Aug-17,3214,3035,179,5.6
CN4708300000000,47,083,Houston County, TN,Sep-17,3236,3074,162,5.0
CN4708300000000,47,083,Houston County, TN,Oct-17,3184,3025,159,5.0
CN4708300000000,47,083,Houston County, TN,Nov-17,3175,3014,161,5.1
CN4708300000000,47,083,Houston County, TN,Dec-17,3187,3014,173,5.4
CN4708300000000,47,083,Houston County, TN,Jan-18,3204,2986,218,6.8
CN4708300000000,47,083,Houston County, TN,Feb-18,3242,3021,221,6.8
CN4708300000000,47,083,Houston County, TN,Mar-18,3205,3017,188,5.9
CN4708300000000,47,083,Houston County, TN,Apr-18(p),3211,3051,160,5.0
CN3105900000000,31,059,Fillmore County, NE,Mar-17,3049,2974,75,2.5
CN3105900000000,31,059,Fillmore County, NE,Apr-17,3133,3057,76,2.4
CN3105900000000,31,059,Fillmore County, NE,May-17,3184,3101,83,2.6
CN3105900000000,31,059,Fillmore County, NE,Jun-17,3327,3233,94,2.8
CN3105900000000,31,059,Fillmore County, NE,Jul-17,3263,3177,86,2.6
CN3105900000000,31,059,Fillmore County, NE,Aug-17,3128,3053,75,2.4
CN3105900000000,31,059,Fillmore County, NE,Sep-17,3029,2956,73,2.4
CN3105900000000,31,059,Fillmore County, NE,Oct-17,3071,3000,71,2.3
CN3105900000000,31,059,Fillmore County, NE,Nov-17,3082,3016,66,2.1
CN3105900000000,31,059,Fillmore County, NE,Dec-17,3078,3006,72,2.3
CN3105900000000,31,059,Fillmore County, NE,Jan-18,3101,3019,82,2.6
CN3105900000000,31,059,Fillmore County, NE,Feb-18,3051,2965,86,2.8
CN3105900000000,31,059,Fillmore County, NE,Mar-18,3110,3030,80,2.6
CN3105900000000,31,059,Fillmore County, NE,Apr-18(p),3111,3025,86,2.8
CN2607100000000,26,071,Iron County, MI,Mar-17,5210,4789,421,8.1
CN2607100000000,26,071,Iron County, MI,Apr-17,5055,4710,345,6.8
CN2607100000000,26,071,Iron County, MI,May-17,5134,4825,309,6.0
CN2607100000000,26,071,Iron County, MI,Jun-17,5361,5048,313,5.8
CN2607100000000,26,071,Iron County, MI,Jul-17,5381,5051,330,6.1
CN2607100000000,26,071,Iron County, MI,Aug-17,5345,5035,310,5.8
CN2607100000000,26,071,Iron County, MI,Sep-17,5169,4908,261,5.0
CN2607100000000,26,071,Iron County, MI,Oct-17,5139,4891,248,4.8
CN2607100000000,26,071,Iron County, MI,Nov-17,5093,4810,283,5.6
CN2607100000000,26,071,Iron County, MI,Dec-17,5220,4840,380,7.3
CN2607100000000,26,071,Iron County, MI,Jan-18,5236,4805,431,8.2
CN2607100000000,26,071,Iron County, MI,Feb-18,5279,4818,461,8.7
CN2607100000000,26,071,Iron County, MI,Mar-18,5245,4818,427,8.1
CN2607100000000,26,071,Iron County, MI,Apr-18(p),5108,4743,365,7.1
CN3717500000000,37,175,Transylvania County, NC,Mar-17,13957,13348,609,4.4
CN3717500000000,37,175,Transylvania County, NC,Apr-17,13972,13444,528,3.8
CN3717500000000,37,175,Transylvania County, NC,May-17,14225,13636,589,4.1
CN3717500000000,37,175,Transylvania County, NC,Jun-17,14634,14017,617,4.2
CN3717500000000,37,175,Transylvania County, NC,Jul-17,14961,14289,672,4.5
CN3717500000000,37,175,Transylvania County, NC,Aug-17,14719,14060,659,4.5
CN3717500000000,37,175,Transylvania County, NC,Sep-17,14454,13874,580,4.0
CN3717500000000,37,175,Transylvania County, NC,Oct-17,14244,13675,569,4.0
CN3717500000000,37,175,Transylvania County, NC,Nov-17,14016,13414,602,4.3
CN3717500000000,37,175,Transylvania County, NC,Dec-17,13866,13262,604,4.4
CN3717500000000,37,175,Transylvania County, NC,Jan-18,13870,13218,652,4.7
CN3717500000000,37,175,Transylvania County, NC,Feb-18,14096,13471,625,4.4
CN3717500000000,37,175,Transylvania County, NC,Mar-18,14121,13521,600,4.2
CN3717500000000,37,175,Transylvania County, NC,Apr-18(p),14270,13763,507,3.6
CN4836900000000,48,369,Parmer County, TX,Mar-17,5087,4956,131,2.6
CN4836900000000,48,369,Parmer County, TX,Apr-17,5010,4898,112,2.2
CN4836900000000,48,369,Parmer County, TX,May-17,5021,4902,119,2.4
CN4836900000000,48,369,Parmer County, TX,Jun-17,4977,4844,133,2.7
CN4836900000000,48,369,Parmer County, TX,Jul-17,4878,4744,134,2.7
CN4836900000000,48,369,Parmer County, TX,Aug-17,4909,4782,127,2.6
CN4836900000000,48,369,Parmer County, TX,Sep-17,4809,4694,115,2.4
CN4836900000000,48,369,Parmer County, TX,Oct-17,4905,4798,107,2.2
CN4836900000000,48,369,Parmer County, TX,Nov-17,4815,4701,114,2.4
CN4836900000000,48,369,Parmer County, TX,Dec-17,4840,4736,104,2.1
CN4836900000000,48,369,Parmer County, TX,Jan-18,4785,4665,120,2.5
CN4836900000000,48,369,Parmer County, TX,Feb-18,4914,4796,118,2.4
CN4836900000000,48,369,Parmer County, TX,Mar-18,5088,4965,123,2.4
CN4836900000000,48,369,Parmer County, TX,Apr-18(p),4964,4853,111,2.2
CN0602100000000,06,021,Glenn County, CA,Mar-17,13110,11942,1168,8.9
CN0602100000000,06,021,Glenn County, CA,Apr-17,12982,11947,1035,8.0
CN0602100000000,06,021,Glenn County, CA,May-17,12880,11957,923,7.2
CN0602100000000,06,021,Glenn County, CA,Jun-17,12835,11863,972,7.6
CN0602100000000,06,021,Glenn County, CA,Jul-17,12746,11751,995,7.8
CN0602100000000,06,021,Glenn County, CA,Aug-17,12807,11882,925,7.2
CN0602100000000,06,021,Glenn County, CA,Sep-17,13097,12342,755,5.8
CN0602100000000,06,021,Glenn County, CA,Oct-17,13095,12384,711,5.4
CN0602100000000,06,021,Glenn County, CA,Nov-17,12743,11993,750,5.9
CN0602100000000,06,021,Glenn County, CA,Dec-17,12636,11812,824,6.5
CN0602100000000,06,021,Glenn County, CA,Jan-18,12781,11784,997,7.8
CN0602100000000,06,021,Glenn County, CA,Feb-18,12906,11912,994,7.7
CN0602100000000,06,021,Glenn County, CA,Mar-18,12935,11970,965,7.5
CN0602100000000,06,021,Glenn County, CA,Apr-18(p),12759,11932,827,6.5
CN3502300000000,35,023,Hidalgo County, NM,Mar-17,2049,1937,112,5.5
CN3502300000000,35,023,Hidalgo County, NM,Apr-17,2122,2010,112,5.3
CN3502300000000,35,023,Hidalgo County, NM,May-17,2136,2036,100,4.7
CN3502300000000,35,023,Hidalgo County, NM,Jun-17,2110,1995,115,5.5
CN3502300000000,35,023,Hidalgo County, NM,Jul-17,2153,2033,120,5.6
CN3502300000000,35,023,Hidalgo County, NM,Aug-17,2131,2016,115,5.4
CN3502300000000,35,023,Hidalgo County, NM,Sep-17,2148,2045,103,4.8
CN3502300000000,35,023,Hidalgo County, NM,Oct-17,2147,2050,97,4.5
CN3502300000000,35,023,Hidalgo County, NM,Nov-17,2112,2006,106,5.0
CN3502300000000,35,023,Hidalgo County, NM,Dec-17,2081,1987,94,4.5
CN3502300000000,35,023,Hidalgo County, NM,Jan-18,2086,1971,115,5.5
CN3502300000000,35,023,Hidalgo County, NM,Feb-18,2122,2018,104,4.9
CN3502300000000,35,023,Hidalgo County, NM,Mar-18,2124,2036,88,4.1
CN3502300000000,35,023,Hidalgo County, NM,Apr-18(p),2172,2099,73,3.4
CN3707500000000,37,075,Graham County, NC,Mar-17,3058,2842,216,7.1
CN3707500000000,37,075,Graham County, NC,Apr-17,3199,3003,196,6.1
CN3707500000000,37,075,Graham County, NC,May-17,3246,3055,191,5.9
CN3707500000000,37,075,Graham County, NC,Jun-17,3288,3093,195,5.9
CN3707500000000,37,075,Graham County, NC,Jul-17,3296,3097,199,6.0
CN3707500000000,37,075,Graham County, NC,Aug-17,3223,3020,203,6.3
CN3707500000000,37,075,Graham County, NC,Sep-17,3217,3024,193,6.0
CN3707500000000,37,075,Graham County, NC,Oct-17,3253,3068,185,5.7
CN3707500000000,37,075,Graham County, NC,Nov-17,3189,2978,211,6.6
CN3707500000000,37,075,Graham County, NC,Dec-17,3121,2891,230,7.4
CN3707500000000,37,075,Graham County, NC,Jan-18,3053,2799,254,8.3
CN3707500000000,37,075,Graham County, NC,Feb-18,3024,2757,267,8.8
CN3707500000000,37,075,Graham County, NC,Mar-18,3040,2806,234,7.7
CN3707500000000,37,075,Graham County, NC,Apr-18(p),3088,2898,190,6.2
CN3713700000000,37,137,Pamlico County, NC,Mar-17,5490,5235,255,4.6
CN3713700000000,37,137,Pamlico County, NC,Apr-17,5439,5203,236,4.3
CN3713700000000,37,137,Pamlico County, NC,May-17,5418,5175,243,4.5
CN3713700000000,37,137,Pamlico County, NC,Jun-17,5438,5177,261,4.8
CN3713700000000,37,137,Pamlico County, NC,Jul-17,5505,5232,273,5.0
CN3713700000000,37,137,Pamlico County, NC,Aug-17,5398,5132,266,4.9
CN3713700000000,37,137,Pamlico County, NC,Sep-17,5406,5164,242,4.5
CN3713700000000,37,137,Pamlico County, NC,Oct-17,5383,5135,248,4.6
CN3713700000000,37,137,Pamlico County, NC,Nov-17,5364,5099,265,4.9
CN3713700000000,37,137,Pamlico County, NC,Dec-17,5336,5083,253,4.7
CN3713700000000,37,137,Pamlico County, NC,Jan-18,5356,5081,275,5.1
CN3713700000000,37,137,Pamlico County, NC,Feb-18,5424,5152,272,5.0
CN3713700000000,37,137,Pamlico County, NC,Mar-18,5422,5171,251,4.6
CN3713700000000,37,137,Pamlico County, NC,Apr-18(p),5407,5194,213,3.9
CN0900700000000,09,007,Middlesex County, CT,Mar-17,94307,90042,4265,4.5
CN0900700000000,09,007,Middlesex County, CT,Apr-17,93978,90217,3761,4.0
CN0900700000000,09,007,Middlesex County, CT,May-17,94336,90482,3854,4.1
CN0900700000000,09,007,Middlesex County, CT,Jun-17,94746,90691,4055,4.3
CN0900700000000,09,007,Middlesex County, CT,Jul-17,94536,90660,3876,4.1
CN0900700000000,09,007,Middlesex County, CT,Aug-17,93112,89490,3622,3.9
CN0900700000000,09,007,Middlesex County, CT,Sep-17,93065,89675,3390,3.6
CN0900700000000,09,007,Middlesex County, CT,Oct-17,92959,89701,3258,3.5
CN0900700000000,09,007,Middlesex County, CT,Nov-17,92927,89740,3187,3.4
CN0900700000000,09,007,Middlesex County, CT,Dec-17,92722,89615,3107,3.4
CN0900700000000,09,007,Middlesex County, CT,Jan-18,92622,88249,4373,4.7
CN0900700000000,09,007,Middlesex County, CT,Feb-18,92897,88793,4104,4.4
CN0900700000000,09,007,Middlesex County, CT,Mar-18,92794,89030,3764,4.1
CN0900700000000,09,007,Middlesex County, CT,Apr-18(p),92261,89010,3251,3.5
CN4205100000000,42,051,Fayette County, PA,Mar-17,58195,53537,4658,8.0
CN4205100000000,42,051,Fayette County, PA,Apr-17,57674,53968,3706,6.4
CN4205100000000,42,051,Fayette County, PA,May-17,57662,53937,3725,6.5
CN4205100000000,42,051,Fayette County, PA,Jun-17,58110,54183,3927,6.8
CN4205100000000,42,051,Fayette County, PA,Jul-17,58412,54431,3981,6.8
CN4205100000000,42,051,Fayette County, PA,Aug-17,57831,53810,4021,7.0
CN4205100000000,42,051,Fayette County, PA,Sep-17,57279,54078,3201,5.6
CN4205100000000,42,051,Fayette County, PA,Oct-17,56966,53828,3138,5.5
CN4205100000000,42,051,Fayette County, PA,Nov-17,57506,54031,3475,6.0
CN4205100000000,42,051,Fayette County, PA,Dec-17,57517,53751,3766,6.5
CN4205100000000,42,051,Fayette County, PA,Jan-18,57733,53085,4648,8.1
CN4205100000000,42,051,Fayette County, PA,Feb-18,57540,53143,4397,7.6
CN4205100000000,42,051,Fayette County, PA,Mar-18,56799,52949,3850,6.8
CN4205100000000,42,051,Fayette County, PA,Apr-18(p),56624,53480,3144,5.6
CN4211300000000,42,113,Sullivan County, PA,Mar-17,2711,2526,185,6.8
CN4211300000000,42,113,Sullivan County, PA,Apr-17,2735,2588,147,5.4
CN4211300000000,42,113,Sullivan County, PA,May-17,2771,2624,147,5.3
CN4211300000000,42,113,Sullivan County, PA,Jun-17,2853,2700,153,5.4
CN4211300000000,42,113,Sullivan County, PA,Jul-17,2920,2750,170,5.8
CN4211300000000,42,113,Sullivan County, PA,Aug-17,2880,2717,163,5.7
CN4211300000000,42,113,Sullivan County, PA,Sep-17,2796,2663,133,4.8
CN4211300000000,42,113,Sullivan County, PA,Oct-17,2747,2614,133,4.8
CN4211300000000,42,113,Sullivan County, PA,Nov-17,2744,2606,138,5.0
CN4211300000000,42,113,Sullivan County, PA,Dec-17,2737,2592,145,5.3
CN4211300000000,42,113,Sullivan County, PA,Jan-18,2737,2569,168,6.1
CN4211300000000,42,113,Sullivan County, PA,Feb-18,2745,2562,183,6.7
CN4211300000000,42,113,Sullivan County, PA,Mar-18,2694,2546,148,5.5
CN4211300000000,42,113,Sullivan County, PA,Apr-18(p),2698,2578,120,4.4
CN2909500000000,29,095,Jackson County, MO,Mar-17,363151,345210,17941,4.9
CN2909500000000,29,095,Jackson County, MO,Apr-17,361389,346779,14610,4.0
CN2909500000000,29,095,Jackson County, MO,May-17,361909,346742,15167,4.2
CN2909500000000,29,095,Jackson County, MO,Jun-17,365660,350203,15457,4.2
CN2909500000000,29,095,Jackson County, MO,Jul-17,371850,353654,18196,4.9
CN2909500000000,29,095,Jackson County, MO,Aug-17,366975,348545,18430,5.0
CN2909500000000,29,095,Jackson County, MO,Sep-17,365257,351702,13555,3.7
CN2909500000000,29,095,Jackson County, MO,Oct-17,363343,350127,13216,3.6
CN2909500000000,29,095,Jackson County, MO,Nov-17,361069,348112,12957,3.6
CN2909500000000,29,095,Jackson County, MO,Dec-17,361534,347643,13891,3.8
CN2909500000000,29,095,Jackson County, MO,Jan-18,359525,343336,16189,4.5
CN2909500000000,29,095,Jackson County, MO,Feb-18,361966,346067,15899,4.4
CN2909500000000,29,095,Jackson County, MO,Mar-18,362540,346981,15559,4.3
CN2909500000000,29,095,Jackson County, MO,Apr-18(p),362156,348118,14038,3.9
CN4900700000000,49,007,Carbon County, UT,Mar-17,8347,7879,468,5.6
CN4900700000000,49,007,Carbon County, UT,Apr-17,8350,7944,406,4.9
CN4900700000000,49,007,Carbon County, UT,May-17,8438,8042,396,4.7
CN4900700000000,49,007,Carbon County, UT,Jun-17,8516,8035,481,5.6
CN4900700000000,49,007,Carbon County, UT,Jul-17,8294,7849,445,5.4
CN4900700000000,49,007,Carbon County, UT,Aug-17,8218,7775,443,5.4
CN4900700000000,49,007,Carbon County, UT,Sep-17,8415,8042,373,4.4
CN4900700000000,49,007,Carbon County, UT,Oct-17,8466,8102,364,4.3
CN4900700000000,49,007,Carbon County, UT,Nov-17,8364,8018,346,4.1
CN4900700000000,49,007,Carbon County, UT,Dec-17,8392,8027,365,4.3
CN4900700000000,49,007,Carbon County, UT,Jan-18,8352,7955,397,4.8
CN4900700000000,49,007,Carbon County, UT,Feb-18,8427,7980,447,5.3
CN4900700000000,49,007,Carbon County, UT,Mar-18,8452,8002,450,5.3
CN4900700000000,49,007,Carbon County, UT,Apr-18(p),8397,8009,388,4.6
CN3701900000000,37,019,Brunswick County, NC,Mar-17,50105,47327,2778,5.5
CN3701900000000,37,019,Brunswick County, NC,Apr-17,51415,48883,2532,4.9
CN3701900000000,37,019,Brunswick County, NC,May-17,52217,49562,2655,5.1
CN3701900000000,37,019,Brunswick County, NC,Jun-17,54087,51288,2799,5.2
CN3701900000000,37,019,Brunswick County, NC,Jul-17,54679,51741,2938,5.4
CN3701900000000,37,019,Brunswick County, NC,Aug-17,53013,50069,2944,5.6
CN3701900000000,37,019,Brunswick County, NC,Sep-17,51949,49242,2707,5.2
CN3701900000000,37,019,Brunswick County, NC,Oct-17,50826,48105,2721,5.4
CN3701900000000,37,019,Brunswick County, NC,Nov-17,50486,47532,2954,5.9
CN3701900000000,37,019,Brunswick County, NC,Dec-17,49101,46097,3004,6.1
CN3701900000000,37,019,Brunswick County, NC,Jan-18,49603,46180,3423,6.9
CN3701900000000,37,019,Brunswick County, NC,Feb-18,50390,47182,3208,6.4
CN3701900000000,37,019,Brunswick County, NC,Mar-18,51402,48553,2849,5.5
CN3701900000000,37,019,Brunswick County, NC,Apr-18(p),52366,49921,2445,4.7
CN1318900000000,13,189,McDuffie County, GA,Mar-17,8958,8402,556,6.2
CN1318900000000,13,189,McDuffie County, GA,Apr-17,8967,8462,505,5.6
CN1318900000000,13,189,McDuffie County, GA,May-17,8860,8353,507,5.7
CN1318900000000,13,189,McDuffie County, GA,Jun-17,8875,8317,558,6.3
CN1318900000000,13,189,McDuffie County, GA,Jul-17,8950,8342,608,6.8
CN1318900000000,13,189,McDuffie County, GA,Aug-17,8905,8337,568,6.4
CN1318900000000,13,189,McDuffie County, GA,Sep-17,8982,8455,527,5.9
CN1318900000000,13,189,McDuffie County, GA,Oct-17,8993,8476,517,5.7
CN1318900000000,13,189,McDuffie County, GA,Nov-17,9062,8533,529,5.8
CN1318900000000,13,189,McDuffie County, GA,Dec-17,9137,8605,532,5.8
CN1318900000000,13,189,McDuffie County, GA,Jan-18,9264,8659,605,6.5
CN1318900000000,13,189,McDuffie County, GA,Feb-18,9299,8753,546,5.9
CN1318900000000,13,189,McDuffie County, GA,Mar-18,9289,8804,485,5.2
CN1318900000000,13,189,McDuffie County, GA,Apr-18(p),9284,8849,435,4.7
CN4609900000000,46,099,Minnehaha County, SD,Mar-17,109158,105729,3429,3.1
CN4609900000000,46,099,Minnehaha County, SD,Apr-17,108574,105644,2930,2.7
CN4609900000000,46,099,Minnehaha County, SD,May-17,108542,105599,2943,2.7
CN4609900000000,46,099,Minnehaha County, SD,Jun-17,109178,106206,2972,2.7
CN4609900000000,46,099,Minnehaha County, SD,Jul-17,110567,107726,2841,2.6
CN4609900000000,46,099,Minnehaha County, SD,Aug-17,110138,107060,3078,2.8
CN4609900000000,46,099,Minnehaha County, SD,Sep-17,109046,106199,2847,2.6
CN4609900000000,46,099,Minnehaha County, SD,Oct-17,110897,108062,2835,2.6
CN4609900000000,46,099,Minnehaha County, SD,Nov-17,111063,107899,3164,2.8
CN4609900000000,46,099,Minnehaha County, SD,Dec-17,109909,106575,3334,3.0
CN4609900000000,46,099,Minnehaha County, SD,Jan-18,109968,106102,3866,3.5
CN4609900000000,46,099,Minnehaha County, SD,Feb-18,110638,106773,3865,3.5
CN4609900000000,46,099,Minnehaha County, SD,Mar-18,110643,107109,3534,3.2
CN4609900000000,46,099,Minnehaha County, SD,Apr-18(p),111012,107722,3290,3.0
CN3006300000000,30,063,Missoula County, MT,Mar-17,62291,59671,2620,4.2
CN3006300000000,30,063,Missoula County, MT,Apr-17,62172,60012,2160,3.5
CN3006300000000,30,063,Missoula County, MT,May-17,62407,60502,1905,3.1
CN3006300000000,30,063,Missoula County, MT,Jun-17,62883,60653,2230,3.5
CN3006300000000,30,063,Missoula County, MT,Jul-17,61568,59496,2072,3.4
CN3006300000000,30,063,Missoula County, MT,Aug-17,61856,59827,2029,3.3
CN3006300000000,30,063,Missoula County, MT,Sep-17,62777,60842,1935,3.1
CN3006300000000,30,063,Missoula County, MT,Oct-17,62847,60821,2026,3.2
CN3006300000000,30,063,Missoula County, MT,Nov-17,62735,60563,2172,3.5
CN3006300000000,30,063,Missoula County, MT,Dec-17,62367,59906,2461,3.9
CN3006300000000,30,063,Missoula County, MT,Jan-18,61162,58223,2939,4.8
CN3006300000000,30,063,Missoula County, MT,Feb-18,62378,59492,2886,4.6
CN3006300000000,30,063,Missoula County, MT,Mar-18,62481,59822,2659,4.3
CN3006300000000,30,063,Missoula County, MT,Apr-18(p),62215,60292,1923,3.1
CN2716100000000,27,161,Waseca County, MN,Mar-17,9341,8867,474,5.1
CN2716100000000,27,161,Waseca County, MN,Apr-17,9327,8959,368,3.9
CN2716100000000,27,161,Waseca County, MN,May-17,9313,9002,311,3.3
CN2716100000000,27,161,Waseca County, MN,Jun-17,9465,9114,351,3.7
CN2716100000000,27,161,Waseca County, MN,Jul-17,9382,9059,323,3.4
CN2716100000000,27,161,Waseca County, MN,Aug-17,9355,9024,331,3.5
CN2716100000000,27,161,Waseca County, MN,Sep-17,9308,9034,274,2.9
CN2716100000000,27,161,Waseca County, MN,Oct-17,9486,9249,237,2.5
CN2716100000000,27,161,Waseca County, MN,Nov-17,9470,9176,294,3.1
CN2716100000000,27,161,Waseca County, MN,Dec-17,9518,9120,398,4.2
CN2716100000000,27,161,Waseca County, MN,Jan-18,9659,9022,637,6.6
CN2716100000000,27,161,Waseca County, MN,Feb-18,9615,9045,570,5.9
CN2716100000000,27,161,Waseca County, MN,Mar-18,9595,9038,557,5.8
CN2716100000000,27,161,Waseca County, MN,Apr-18(p),9580,9153,427,4.5
CN4610200000000,46,102,Oglala Lakota County, SD,Mar-17,3571,3179,392,11.0
CN4610200000000,46,102,Oglala Lakota County, SD,Apr-17,3525,3175,350,9.9
CN4610200000000,46,102,Oglala Lakota County, SD,May-17,3490,3153,337,9.7
CN4610200000000,46,102,Oglala Lakota County, SD,Jun-17,3621,3152,469,13.0
CN4610200000000,46,102,Oglala Lakota County, SD,Jul-17,3634,3118,516,14.2
CN4610200000000,46,102,Oglala Lakota County, SD,Aug-17,3824,3306,518,13.5
CN4610200000000,46,102,Oglala Lakota County, SD,Sep-17,3509,3086,423,12.1
CN4610200000000,46,102,Oglala Lakota County, SD,Oct-17,3554,3141,413,11.6
CN4610200000000,46,102,Oglala Lakota County, SD,Nov-17,3613,3159,454,12.6
CN4610200000000,46,102,Oglala Lakota County, SD,Dec-17,3541,3131,410,11.6
CN4610200000000,46,102,Oglala Lakota County, SD,Jan-18,3567,3141,426,11.9
CN4610200000000,46,102,Oglala Lakota County, SD,Feb-18,3664,3275,389,10.6
CN4610200000000,46,102,Oglala Lakota County, SD,Mar-18,3625,3259,366,10.1
CN4610200000000,46,102,Oglala Lakota County, SD,Apr-18(p),3624,3265,359,9.9
CN3601300000000,36,013,Chautauqua County, NY,Mar-17,55765,52132,3633,6.5
CN3601300000000,36,013,Chautauqua County, NY,Apr-17,54918,51622,3296,6.0
CN3601300000000,36,013,Chautauqua County, NY,May-17,55434,52288,3146,5.7
CN3601300000000,36,013,Chautauqua County, NY,Jun-17,56852,53599,3253,5.7
CN3601300000000,36,013,Chautauqua County, NY,Jul-17,58208,54939,3269,5.6
CN3601300000000,36,013,Chautauqua County, NY,Aug-17,57310,54156,3154,5.5
CN3601300000000,36,013,Chautauqua County, NY,Sep-17,56323,53238,3085,5.5
CN3601300000000,36,013,Chautauqua County, NY,Oct-17,54953,51991,2962,5.4
CN3601300000000,36,013,Chautauqua County, NY,Nov-17,54947,51724,3223,5.9
CN3601300000000,36,013,Chautauqua County, NY,Dec-17,54711,51279,3432,6.3
CN3601300000000,36,013,Chautauqua County, NY,Jan-18,54828,50894,3934,7.2
CN3601300000000,36,013,Chautauqua County, NY,Feb-18,54449,50445,4004,7.4
CN3601300000000,36,013,Chautauqua County, NY,Mar-18,53945,50292,3653,6.8
CN3601300000000,36,013,Chautauqua County, NY,Apr-18(p),53361,50222,3139,5.9
CN0106100000000,01,061,Geneva County, AL,Mar-17,10792,10278,514,4.8
CN0106100000000,01,061,Geneva County, AL,Apr-17,10695,10276,419,3.9
CN0106100000000,01,061,Geneva County, AL,May-17,10670,10261,409,3.8
CN0106100000000,01,061,Geneva County, AL,Jun-17,10800,10306,494,4.6
CN0106100000000,01,061,Geneva County, AL,Jul-17,10985,10520,465,4.2
CN0106100000000,01,061,Geneva County, AL,Aug-17,10989,10530,459,4.2
CN0106100000000,01,061,Geneva County, AL,Sep-17,11101,10709,392,3.5
CN0106100000000,01,061,Geneva County, AL,Oct-17,11029,10638,391,3.5
CN0106100000000,01,061,Geneva County, AL,Nov-17,10824,10442,382,3.5
CN0106100000000,01,061,Geneva County, AL,Dec-17,10576,10191,385,3.6
CN0106100000000,01,061,Geneva County, AL,Jan-18,10480,10030,450,4.3
CN0106100000000,01,061,Geneva County, AL,Feb-18,10714,10253,461,4.3
CN0106100000000,01,061,Geneva County, AL,Mar-18,10759,10341,418,3.9
CN0106100000000,01,061,Geneva County, AL,Apr-18(p),10849,10464,385,3.5
CN5103700000000,51,037,Charlotte County, VA,Mar-17,5202,4928,274,5.3
CN5103700000000,51,037,Charlotte County, VA,Apr-17,5347,5108,239,4.5
CN5103700000000,51,037,Charlotte County, VA,May-17,5288,5040,248,4.7
CN5103700000000,51,037,Charlotte County, VA,Jun-17,5337,5069,268,5.0
CN5103700000000,51,037,Charlotte County, VA,Jul-17,5336,5064,272,5.1
CN5103700000000,51,037,Charlotte County, VA,Aug-17,5250,4993,257,4.9
CN5103700000000,51,037,Charlotte County, VA,Sep-17,5287,5057,230,4.4
CN5103700000000,51,037,Charlotte County, VA,Oct-17,5247,5031,216,4.1
CN5103700000000,51,037,Charlotte County, VA,Nov-17,5207,4991,216,4.1
CN5103700000000,51,037,Charlotte County, VA,Dec-17,5243,5032,211,4.0
CN5103700000000,51,037,Charlotte County, VA,Jan-18,5165,4925,240,4.6
CN5103700000000,51,037,Charlotte County, VA,Feb-18,5210,4982,228,4.4
CN5103700000000,51,037,Charlotte County, VA,Mar-18,5191,4975,216,4.2
CN5103700000000,51,037,Charlotte County, VA,Apr-18(p),5266,5086,180,3.4
CN2607700000000,26,077,Kalamazoo County, MI,Mar-17,132217,127252,4965,3.8
CN2607700000000,26,077,Kalamazoo County, MI,Apr-17,131948,127599,4349,3.3
CN2607700000000,26,077,Kalamazoo County, MI,May-17,131834,126892,4942,3.7
CN2607700000000,26,077,Kalamazoo County, MI,Jun-17,133142,127510,5632,4.2
CN2607700000000,26,077,Kalamazoo County, MI,Jul-17,132342,125437,6905,5.2
CN2607700000000,26,077,Kalamazoo County, MI,Aug-17,132468,126139,6329,4.8
CN2607700000000,26,077,Kalamazoo County, MI,Sep-17,132663,127196,5467,4.1
CN2607700000000,26,077,Kalamazoo County, MI,Oct-17,132622,127630,4992,3.8
CN2607700000000,26,077,Kalamazoo County, MI,Nov-17,133410,128340,5070,3.8
CN2607700000000,26,077,Kalamazoo County, MI,Dec-17,132694,127439,5255,4.0
CN2607700000000,26,077,Kalamazoo County, MI,Jan-18,131310,125592,5718,4.4
CN2607700000000,26,077,Kalamazoo County, MI,Feb-18,133452,127550,5902,4.4
CN2607700000000,26,077,Kalamazoo County, MI,Mar-18,133491,128278,5213,3.9
CN2607700000000,26,077,Kalamazoo County, MI,Apr-18(p),133230,128677,4553,3.4
CN2706100000000,27,061,Itasca County, MN,Mar-17,21857,19817,2040,9.3
CN2706100000000,27,061,Itasca County, MN,Apr-17,21561,19802,1759,8.2
CN2706100000000,27,061,Itasca County, MN,May-17,21671,20315,1356,6.3
CN2706100000000,27,061,Itasca County, MN,Jun-17,22209,20788,1421,6.4
CN2706100000000,27,061,Itasca County, MN,Jul-17,21960,20608,1352,6.2
CN2706100000000,27,061,Itasca County, MN,Aug-17,22009,20624,1385,6.3
CN2706100000000,27,061,Itasca County, MN,Sep-17,21500,20446,1054,4.9
CN2706100000000,27,061,Itasca County, MN,Oct-17,21326,20411,915,4.3
CN2706100000000,27,061,Itasca County, MN,Nov-17,21796,20412,1384,6.3
CN2706100000000,27,061,Itasca County, MN,Dec-17,21799,20350,1449,6.6
CN2706100000000,27,061,Itasca County, MN,Jan-18,22111,20382,1729,7.8
CN2706100000000,27,061,Itasca County, MN,Feb-18,22146,20495,1651,7.5
CN2706100000000,27,061,Itasca County, MN,Mar-18,22065,20450,1615,7.3
CN2706100000000,27,061,Itasca County, MN,Apr-18(p),21861,20523,1338,6.1
CN2915700000000,29,157,Perry County, MO,Mar-17,9929,9643,286,2.9
CN2915700000000,29,157,Perry County, MO,Apr-17,10005,9753,252,2.5
CN2915700000000,29,157,Perry County, MO,May-17,9910,9647,263,2.7
CN2915700000000,29,157,Perry County, MO,Jun-17,9999,9721,278,2.8
CN2915700000000,29,157,Perry County, MO,Jul-17,9953,9655,298,3.0
CN2915700000000,29,157,Perry County, MO,Aug-17,9905,9618,287,2.9
CN2915700000000,29,157,Perry County, MO,Sep-17,9800,9562,238,2.4
CN2915700000000,29,157,Perry County, MO,Oct-17,9914,9733,181,1.8
CN2915700000000,29,157,Perry County, MO,Nov-17,9924,9693,231,2.3
CN2915700000000,29,157,Perry County, MO,Dec-17,9914,9674,240,2.4
CN2915700000000,29,157,Perry County, MO,Jan-18,9871,9570,301,3.0
CN2915700000000,29,157,Perry County, MO,Feb-18,9871,9580,291,2.9
CN2915700000000,29,157,Perry County, MO,Mar-18,9864,9594,270,2.7
CN2915700000000,29,157,Perry County, MO,Apr-18(p),9966,9697,269,2.7
CN2920300000000,29,203,Shannon County, MO,Mar-17,3192,2976,216,6.8
CN2920300000000,29,203,Shannon County, MO,Apr-17,3311,3125,186,5.6
CN2920300000000,29,203,Shannon County, MO,May-17,3242,3044,198,6.1
CN2920300000000,29,203,Shannon County, MO,Jun-17,3366,3165,201,6.0
CN2920300000000,29,203,Shannon County, MO,Jul-17,3281,3081,200,6.1
CN2920300000000,29,203,Shannon County, MO,Aug-17,3160,2950,210,6.6
CN2920300000000,29,203,Shannon County, MO,Sep-17,3220,3049,171,5.3
CN2920300000000,29,203,Shannon County, MO,Oct-17,3138,3005,133,4.2
CN2920300000000,29,203,Shannon County, MO,Nov-17,3074,2916,158,5.1
CN2920300000000,29,203,Shannon County, MO,Dec-17,3052,2860,192,6.3
CN2920300000000,29,203,Shannon County, MO,Jan-18,3052,2845,207,6.8
CN2920300000000,29,203,Shannon County, MO,Feb-18,3148,2944,204,6.5
CN2920300000000,29,203,Shannon County, MO,Mar-18,3156,2955,201,6.4
CN2920300000000,29,203,Shannon County, MO,Apr-18(p),3208,3046,162,5.0
CN1908100000000,19,081,Hancock County, IA,Mar-17,6068,5881,187,3.1
CN1908100000000,19,081,Hancock County, IA,Apr-17,6221,6044,177,2.8
CN1908100000000,19,081,Hancock County, IA,May-17,6220,6072,148,2.4
CN1908100000000,19,081,Hancock County, IA,Jun-17,6302,6146,156,2.5
CN1908100000000,19,081,Hancock County, IA,Jul-17,6340,6189,151,2.4
CN1908100000000,19,081,Hancock County, IA,Aug-17,6170,6020,150,2.4
CN1908100000000,19,081,Hancock County, IA,Sep-17,6101,5957,144,2.4
CN1908100000000,19,081,Hancock County, IA,Oct-17,6138,6015,123,2.0
CN1908100000000,19,081,Hancock County, IA,Nov-17,6048,5922,126,2.1
CN1908100000000,19,081,Hancock County, IA,Dec-17,6034,5885,149,2.5
CN1908100000000,19,081,Hancock County, IA,Jan-18,6023,5844,179,3.0
CN1908100000000,19,081,Hancock County, IA,Feb-18,6046,5874,172,2.8
CN1908100000000,19,081,Hancock County, IA,Mar-18,5997,5841,156,2.6
CN1908100000000,19,081,Hancock County, IA,Apr-18(p),6033,5890,143,2.4
CN0801100000000,08,011,Bent County, CO,Mar-17,1821,1775,46,2.5
CN0801100000000,08,011,Bent County, CO,Apr-17,1884,1843,41,2.2
CN0801100000000,08,011,Bent County, CO,May-17,1916,1876,40,2.1
CN0801100000000,08,011,Bent County, CO,Jun-17,1912,1861,51,2.7
CN0801100000000,08,011,Bent County, CO,Jul-17,1938,1891,47,2.4
CN0801100000000,08,011,Bent County, CO,Aug-17,1928,1880,48,2.5
CN0801100000000,08,011,Bent County, CO,Sep-17,1928,1873,55,2.9
CN0801100000000,08,011,Bent County, CO,Oct-17,2049,1990,59,2.9
CN0801100000000,08,011,Bent County, CO,Nov-17,2008,1947,61,3.0
CN0801100000000,08,011,Bent County, CO,Dec-17,1997,1932,65,3.3
CN0801100000000,08,011,Bent County, CO,Jan-18,1940,1867,73,3.8
CN0801100000000,08,011,Bent County, CO,Feb-18,1867,1800,67,3.6
CN0801100000000,08,011,Bent County, CO,Mar-18,1868,1810,58,3.1
CN0801100000000,08,011,Bent County, CO,Apr-18(p),1910,1856,54,2.8
CN3800900000000,38,009,Bottineau County, ND,Mar-17,3115,2976,139,4.5
CN3800900000000,38,009,Bottineau County, ND,Apr-17,3139,3019,120,3.8
CN3800900000000,38,009,Bottineau County, ND,May-17,3192,3094,98,3.1
CN3800900000000,38,009,Bottineau County, ND,Jun-17,3277,3171,106,3.2
CN3800900000000,38,009,Bottineau County, ND,Jul-17,3253,3163,90,2.8
CN3800900000000,38,009,Bottineau County, ND,Aug-17,3233,3141,92,2.8
CN3800900000000,38,009,Bottineau County, ND,Sep-17,3202,3128,74,2.3
CN3800900000000,38,009,Bottineau County, ND,Oct-17,3159,3096,63,2.0
CN3800900000000,38,009,Bottineau County, ND,Nov-17,3065,2988,77,2.5
CN3800900000000,38,009,Bottineau County, ND,Dec-17,2992,2900,92,3.1
CN3800900000000,38,009,Bottineau County, ND,Jan-18,2953,2826,127,4.3
CN3800900000000,38,009,Bottineau County, ND,Feb-18,2962,2827,135,4.6
CN3800900000000,38,009,Bottineau County, ND,Mar-18,2987,2849,138,4.6
CN3800900000000,38,009,Bottineau County, ND,Apr-18(p),3003,2870,133,4.4
CN1703500000000,17,035,Cumberland County, IL,Mar-17,6162,5894,268,4.3
CN1703500000000,17,035,Cumberland County, IL,Apr-17,6127,5932,195,3.2
CN1703500000000,17,035,Cumberland County, IL,May-17,6072,5873,199,3.3
CN1703500000000,17,035,Cumberland County, IL,Jun-17,6050,5831,219,3.6
CN1703500000000,17,035,Cumberland County, IL,Jul-17,6029,5804,225,3.7
CN1703500000000,17,035,Cumberland County, IL,Aug-17,6056,5822,234,3.9
CN1703500000000,17,035,Cumberland County, IL,Sep-17,6126,5915,211,3.4
CN1703500000000,17,035,Cumberland County, IL,Oct-17,6112,5921,191,3.1
CN1703500000000,17,035,Cumberland County, IL,Nov-17,6129,5925,204,3.3
CN1703500000000,17,035,Cumberland County, IL,Dec-17,6077,5868,209,3.4
CN1703500000000,17,035,Cumberland County, IL,Jan-18,6146,5874,272,4.4
CN1703500000000,17,035,Cumberland County, IL,Feb-18,6180,5935,245,4.0
CN1703500000000,17,035,Cumberland County, IL,Mar-18,6335,6093,242,3.8
CN1703500000000,17,035,Cumberland County, IL,Apr-18(p),6367,6181,186,2.9
CN4813500000000,48,135,Ector County, TX,Mar-17,76564,72797,3767,4.9
CN4813500000000,48,135,Ector County, TX,Apr-17,77224,73887,3337,4.3
CN4813500000000,48,135,Ector County, TX,May-17,77333,74137,3196,4.1
CN4813500000000,48,135,Ector County, TX,Jun-17,77761,74487,3274,4.2
CN4813500000000,48,135,Ector County, TX,Jul-17,78897,75715,3182,4.0
CN4813500000000,48,135,Ector County, TX,Aug-17,78693,75591,3102,3.9
CN4813500000000,48,135,Ector County, TX,Sep-17,80082,77352,2730,3.4
CN4813500000000,48,135,Ector County, TX,Oct-17,79357,76852,2505,3.2
CN4813500000000,48,135,Ector County, TX,Nov-17,79553,77001,2552,3.2
CN4813500000000,48,135,Ector County, TX,Dec-17,79431,77028,2403,3.0
CN4813500000000,48,135,Ector County, TX,Jan-18,79807,77190,2617,3.3
CN4813500000000,48,135,Ector County, TX,Feb-18,80833,78264,2569,3.2
CN4813500000000,48,135,Ector County, TX,Mar-18,80613,78075,2538,3.1
CN4813500000000,48,135,Ector County, TX,Apr-18(p),81328,79077,2251,2.8
CN4007700000000,40,077,Latimer County, OK,Mar-17,3477,3213,264,7.6
CN4007700000000,40,077,Latimer County, OK,Apr-17,3425,3194,231,6.7
CN4007700000000,40,077,Latimer County, OK,May-17,3403,3161,242,7.1
CN4007700000000,40,077,Latimer County, OK,Jun-17,3417,3152,265,7.8
CN4007700000000,40,077,Latimer County, OK,Jul-17,3357,3103,254,7.6
CN4007700000000,40,077,Latimer County, OK,Aug-17,3392,3143,249,7.3
CN4007700000000,40,077,Latimer County, OK,Sep-17,3392,3153,239,7.0
CN4007700000000,40,077,Latimer County, OK,Oct-17,3392,3142,250,7.4
CN4007700000000,40,077,Latimer County, OK,Nov-17,3394,3155,239,7.0
CN4007700000000,40,077,Latimer County, OK,Dec-17,3350,3107,243,7.3
CN4007700000000,40,077,Latimer County, OK,Jan-18,3269,3017,252,7.7
CN4007700000000,40,077,Latimer County, OK,Feb-18,3282,3063,219,6.7
CN4007700000000,40,077,Latimer County, OK,Mar-18,3256,3051,205,6.3
CN4007700000000,40,077,Latimer County, OK,Apr-18(p),3232,3034,198,6.1
CN0801700000000,08,017,Cheyenne County, CO,Mar-17,1056,1037,19,1.8
CN0801700000000,08,017,Cheyenne County, CO,Apr-17,1119,1101,18,1.6
CN0801700000000,08,017,Cheyenne County, CO,May-17,1157,1137,20,1.7
CN0801700000000,08,017,Cheyenne County, CO,Jun-17,1157,1136,21,1.8
CN0801700000000,08,017,Cheyenne County, CO,Jul-17,1166,1149,17,1.5
CN0801700000000,08,017,Cheyenne County, CO,Aug-17,1135,1116,19,1.7
CN0801700000000,08,017,Cheyenne County, CO,Sep-17,1128,1107,21,1.9
CN0801700000000,08,017,Cheyenne County, CO,Oct-17,1249,1228,21,1.7
CN0801700000000,08,017,Cheyenne County, CO,Nov-17,1206,1184,22,1.8
CN0801700000000,08,017,Cheyenne County, CO,Dec-17,1202,1180,22,1.8
CN0801700000000,08,017,Cheyenne County, CO,Jan-18,1164,1142,22,1.9
CN0801700000000,08,017,Cheyenne County, CO,Feb-18,1108,1087,21,1.9
CN0801700000000,08,017,Cheyenne County, CO,Mar-18,1114,1095,19,1.7
CN0801700000000,08,017,Cheyenne County, CO,Apr-18(p),1155,1141,14,1.2
CN1809700000000,18,097,Marion County, IN,Mar-17,478678,460936,17742,3.7
CN1809700000000,18,097,Marion County, IN,Apr-17,482184,467001,15183,3.1
CN1809700000000,18,097,Marion County, IN,May-17,482561,466291,16270,3.4
CN1809700000000,18,097,Marion County, IN,Jun-17,489392,472085,17307,3.5
CN1809700000000,18,097,Marion County, IN,Jul-17,491092,472940,18152,3.7
CN1809700000000,18,097,Marion County, IN,Aug-17,486970,467401,19569,4.0
CN1809700000000,18,097,Marion County, IN,Sep-17,484821,467985,16836,3.5
CN1809700000000,18,097,Marion County, IN,Oct-17,481028,465280,15748,3.3
CN1809700000000,18,097,Marion County, IN,Nov-17,480597,465016,15581,3.2
CN1809700000000,18,097,Marion County, IN,Dec-17,477090,462287,14803,3.1
CN1809700000000,18,097,Marion County, IN,Jan-18,477734,461461,16273,3.4
CN1809700000000,18,097,Marion County, IN,Feb-18,483955,466573,17382,3.6
CN1809700000000,18,097,Marion County, IN,Mar-18,488818,472789,16029,3.3
CN1809700000000,18,097,Marion County, IN,Apr-18(p),491042,476101,14941,3.0
CN4106100000000,41,061,Union County, OR,Mar-17,12013,11292,721,6.0
CN4106100000000,41,061,Union County, OR,Apr-17,11985,11373,612,5.1
CN4106100000000,41,061,Union County, OR,May-17,12071,11509,562,4.7
CN4106100000000,41,061,Union County, OR,Jun-17,12175,11579,596,4.9
CN4106100000000,41,061,Union County, OR,Jul-17,12324,11730,594,4.8
CN4106100000000,41,061,Union County, OR,Aug-17,12178,11562,616,5.1
CN4106100000000,41,061,Union County, OR,Sep-17,12040,11489,551,4.6
CN4106100000000,41,061,Union County, OR,Oct-17,12158,11586,572,4.7
CN4106100000000,41,061,Union County, OR,Nov-17,12065,11472,593,4.9
CN4106100000000,41,061,Union County, OR,Dec-17,12010,11372,638,5.3
CN4106100000000,41,061,Union County, OR,Jan-18,12014,11232,782,6.5
CN4106100000000,41,061,Union County, OR,Feb-18,12120,11331,789,6.5
CN4106100000000,41,061,Union County, OR,Mar-18,12094,11374,720,6.0
CN4106100000000,41,061,Union County, OR,Apr-18(p),12009,11385,624,5.2
CN1212100000000,12,121,Suwannee County, FL,Mar-17,18282,17483,799,4.4
CN1212100000000,12,121,Suwannee County, FL,Apr-17,18224,17484,740,4.1
CN1212100000000,12,121,Suwannee County, FL,May-17,18454,17707,747,4.0
CN1212100000000,12,121,Suwannee County, FL,Jun-17,18328,17530,798,4.4
CN1212100000000,12,121,Suwannee County, FL,Jul-17,17994,17191,803,4.5
CN1212100000000,12,121,Suwannee County, FL,Aug-17,18197,17418,779,4.3
CN1212100000000,12,121,Suwannee County, FL,Sep-17,18287,17563,724,4.0
CN1212100000000,12,121,Suwannee County, FL,Oct-17,17809,17133,676,3.8
CN1212100000000,12,121,Suwannee County, FL,Nov-17,17684,16973,711,4.0
CN1212100000000,12,121,Suwannee County, FL,Dec-17,17437,16765,672,3.9
CN1212100000000,12,121,Suwannee County, FL,Jan-18,17521,16736,785,4.5
CN1212100000000,12,121,Suwannee County, FL,Feb-18,17602,16883,719,4.1
CN1212100000000,12,121,Suwannee County, FL,Mar-18,17708,16988,720,4.1
CN1212100000000,12,121,Suwannee County, FL,Apr-18(p),17710,17074,636,3.6
CN4801700000000,48,017,Bailey County, TX,Mar-17,2827,2696,131,4.6
CN4801700000000,48,017,Bailey County, TX,Apr-17,2775,2666,109,3.9
CN4801700000000,48,017,Bailey County, TX,May-17,2785,2671,114,4.1
CN4801700000000,48,017,Bailey County, TX,Jun-17,2787,2654,133,4.8
CN4801700000000,48,017,Bailey County, TX,Jul-17,2630,2500,130,4.9
CN4801700000000,48,017,Bailey County, TX,Aug-17,2677,2551,126,4.7
CN4801700000000,48,017,Bailey County, TX,Sep-17,2553,2458,95,3.7
CN4801700000000,48,017,Bailey County, TX,Oct-17,2623,2534,89,3.4
CN4801700000000,48,017,Bailey County, TX,Nov-17,2539,2448,91,3.6
CN4801700000000,48,017,Bailey County, TX,Dec-17,2565,2478,87,3.4
CN4801700000000,48,017,Bailey County, TX,Jan-18,2542,2437,105,4.1
CN4801700000000,48,017,Bailey County, TX,Feb-18,2628,2502,126,4.8
CN4801700000000,48,017,Bailey County, TX,Mar-18,2786,2655,131,4.7
CN4801700000000,48,017,Bailey County, TX,Apr-18(p),2713,2592,121,4.5
CN5510700000000,55,107,Rusk County, WI,Mar-17,6973,6562,411,5.9
CN5510700000000,55,107,Rusk County, WI,Apr-17,7066,6751,315,4.5
CN5510700000000,55,107,Rusk County, WI,May-17,7014,6747,267,3.8
CN5510700000000,55,107,Rusk County, WI,Jun-17,7119,6802,317,4.5
CN5510700000000,55,107,Rusk County, WI,Jul-17,6959,6689,270,3.9
CN5510700000000,55,107,Rusk County, WI,Aug-17,6954,6685,269,3.9
CN5510700000000,55,107,Rusk County, WI,Sep-17,6902,6653,249,3.6
CN5510700000000,55,107,Rusk County, WI,Oct-17,7032,6798,234,3.3
CN5510700000000,55,107,Rusk County, WI,Nov-17,7043,6797,246,3.5
CN5510700000000,55,107,Rusk County, WI,Dec-17,7037,6752,285,4.1
CN5510700000000,55,107,Rusk County, WI,Jan-18,7233,6907,326,4.5
CN5510700000000,55,107,Rusk County, WI,Feb-18,7189,6845,344,4.8
CN5510700000000,55,107,Rusk County, WI,Mar-18,7079,6743,336,4.7
CN5510700000000,55,107,Rusk County, WI,Apr-18(p),7094,6816,278,3.9
CN3006900000000,30,069,Petroleum County, MT,Mar-17,272,255,17,6.3
CN3006900000000,30,069,Petroleum County, MT,Apr-17,283,270,13,4.6
CN3006900000000,30,069,Petroleum County, MT,May-17,282,274,8,2.8
CN3006900000000,30,069,Petroleum County, MT,Jun-17,277,268,9,3.2
CN3006900000000,30,069,Petroleum County, MT,Jul-17,288,279,9,3.1
CN3006900000000,30,069,Petroleum County, MT,Aug-17,276,266,10,3.6
CN3006900000000,30,069,Petroleum County, MT,Sep-17,270,261,9,3.3
CN3006900000000,30,069,Petroleum County, MT,Oct-17,274,262,12,4.4
CN3006900000000,30,069,Petroleum County, MT,Nov-17,272,260,12,4.4
CN3006900000000,30,069,Petroleum County, MT,Dec-17,270,255,15,5.6
CN3006900000000,30,069,Petroleum County, MT,Jan-18,279,260,19,6.8
CN3006900000000,30,069,Petroleum County, MT,Feb-18,275,259,16,5.8
CN3006900000000,30,069,Petroleum County, MT,Mar-18,265,250,15,5.7
CN3006900000000,30,069,Petroleum County, MT,Apr-18(p),265,253,12,4.5
CN4841500000000,48,415,Scurry County, TX,Mar-17,7102,6738,364,5.1
CN4841500000000,48,415,Scurry County, TX,Apr-17,7127,6818,309,4.3
CN4841500000000,48,415,Scurry County, TX,May-17,7112,6803,309,4.3
CN4841500000000,48,415,Scurry County, TX,Jun-17,7116,6785,331,4.7
CN4841500000000,48,415,Scurry County, TX,Jul-17,7098,6768,330,4.6
CN4841500000000,48,415,Scurry County, TX,Aug-17,6993,6687,306,4.4
CN4841500000000,48,415,Scurry County, TX,Sep-17,6811,6559,252,3.7
CN4841500000000,48,415,Scurry County, TX,Oct-17,6737,6511,226,3.4
CN4841500000000,48,415,Scurry County, TX,Nov-17,6746,6510,236,3.5
CN4841500000000,48,415,Scurry County, TX,Dec-17,6741,6512,229,3.4
CN4841500000000,48,415,Scurry County, TX,Jan-18,6666,6401,265,4.0
CN4841500000000,48,415,Scurry County, TX,Feb-18,6675,6418,257,3.9
CN4841500000000,48,415,Scurry County, TX,Mar-18,6677,6391,286,4.3
CN4841500000000,48,415,Scurry County, TX,Apr-18(p),6743,6507,236,3.5
CN3608500000000,36,085,Richmond County, NY,Mar-17,227366,217243,10123,4.5
CN3608500000000,36,085,Richmond County, NY,Apr-17,226314,216840,9474,4.2
CN3608500000000,36,085,Richmond County, NY,May-17,226030,216272,9758,4.3
CN3608500000000,36,085,Richmond County, NY,Jun-17,226828,216332,10496,4.6
CN3608500000000,36,085,Richmond County, NY,Jul-17,229934,217687,12247,5.3
CN3608500000000,36,085,Richmond County, NY,Aug-17,228622,216545,12077,5.3
CN3608500000000,36,085,Richmond County, NY,Sep-17,228021,217691,10330,4.5
CN3608500000000,36,085,Richmond County, NY,Oct-17,227003,217056,9947,4.4
CN3608500000000,36,085,Richmond County, NY,Nov-17,225479,216349,9130,4.0
CN3608500000000,36,085,Richmond County, NY,Dec-17,224825,216131,8694,3.9
CN3608500000000,36,085,Richmond County, NY,Jan-18,226841,216486,10355,4.6
CN3608500000000,36,085,Richmond County, NY,Feb-18,229210,219338,9872,4.3
CN3608500000000,36,085,Richmond County, NY,Mar-18,227583,218187,9396,4.1
CN3608500000000,36,085,Richmond County, NY,Apr-18(p),225647,216511,9136,4.0
CN4503100000000,45,031,Darlington County, SC,Mar-17,29850,28425,1425,4.8
CN4503100000000,45,031,Darlington County, SC,Apr-17,29664,28326,1338,4.5
CN4503100000000,45,031,Darlington County, SC,May-17,29784,28355,1429,4.8
CN4503100000000,45,031,Darlington County, SC,Jun-17,30177,28483,1694,5.6
CN4503100000000,45,031,Darlington County, SC,Jul-17,30068,28385,1683,5.6
CN4503100000000,45,031,Darlington County, SC,Aug-17,30022,28218,1804,6.0
CN4503100000000,45,031,Darlington County, SC,Sep-17,29878,28307,1571,5.3
CN4503100000000,45,031,Darlington County, SC,Oct-17,29651,28080,1571,5.3
CN4503100000000,45,031,Darlington County, SC,Nov-17,29541,28063,1478,5.0
CN4503100000000,45,031,Darlington County, SC,Dec-17,29701,28154,1547,5.2
CN4503100000000,45,031,Darlington County, SC,Jan-18,29894,28117,1777,5.9
CN4503100000000,45,031,Darlington County, SC,Feb-18,29943,28335,1608,5.4
CN4503100000000,45,031,Darlington County, SC,Mar-18,29860,28443,1417,4.7
CN4503100000000,45,031,Darlington County, SC,Apr-18(p),29361,28387,974,3.3
CN5113700000000,51,137,Orange County, VA,Mar-17,16479,15796,683,4.1
CN5113700000000,51,137,Orange County, VA,Apr-17,16538,15949,589,3.6
CN5113700000000,51,137,Orange County, VA,May-17,16581,15955,626,3.8
CN5113700000000,51,137,Orange County, VA,Jun-17,16785,16133,652,3.9
CN5113700000000,51,137,Orange County, VA,Jul-17,16787,16128,659,3.9
CN5113700000000,51,137,Orange County, VA,Aug-17,16495,15836,659,4.0
CN5113700000000,51,137,Orange County, VA,Sep-17,16578,15965,613,3.7
CN5113700000000,51,137,Orange County, VA,Oct-17,16567,15999,568,3.4
CN5113700000000,51,137,Orange County, VA,Nov-17,16544,15987,557,3.4
CN5113700000000,51,137,Orange County, VA,Dec-17,16540,16002,538,3.3
CN5113700000000,51,137,Orange County, VA,Jan-18,16420,15807,613,3.7
CN5113700000000,51,137,Orange County, VA,Feb-18,16505,15962,543,3.3
CN5113700000000,51,137,Orange County, VA,Mar-18,16598,16034,564,3.4
CN5113700000000,51,137,Orange County, VA,Apr-18(p),16729,16263,466,2.8
CN4900100000000,49,001,Beaver County, UT,Mar-17,3340,3187,153,4.6
CN4900100000000,49,001,Beaver County, UT,Apr-17,3210,3078,132,4.1
CN4900100000000,49,001,Beaver County, UT,May-17,2992,2866,126,4.2
CN4900100000000,49,001,Beaver County, UT,Jun-17,3094,2961,133,4.3
CN4900100000000,49,001,Beaver County, UT,Jul-17,3014,2901,113,3.7
CN4900100000000,49,001,Beaver County, UT,Aug-17,3098,2984,114,3.7
CN4900100000000,49,001,Beaver County, UT,Sep-17,3056,2947,109,3.6
CN4900100000000,49,001,Beaver County, UT,Oct-17,3136,3028,108,3.4
CN4900100000000,49,001,Beaver County, UT,Nov-17,2925,2817,108,3.7
CN4900100000000,49,001,Beaver County, UT,Dec-17,3045,2940,105,3.4
CN4900100000000,49,001,Beaver County, UT,Jan-18,3110,2997,113,3.6
CN4900100000000,49,001,Beaver County, UT,Feb-18,3016,2891,125,4.1
CN4900100000000,49,001,Beaver County, UT,Mar-18,3217,3094,123,3.8
CN4900100000000,49,001,Beaver County, UT,Apr-18(p),3062,2943,119,3.9
CN0112900000000,01,129,Washington County, AL,Mar-17,6773,6266,507,7.5
CN0112900000000,01,129,Washington County, AL,Apr-17,6726,6285,441,6.6
CN0112900000000,01,129,Washington County, AL,May-17,6641,6221,420,6.3
CN0112900000000,01,129,Washington County, AL,Jun-17,6669,6145,524,7.9
CN0112900000000,01,129,Washington County, AL,Jul-17,6605,6100,505,7.6
CN0112900000000,01,129,Washington County, AL,Aug-17,6533,6084,449,6.9
CN0112900000000,01,129,Washington County, AL,Sep-17,6658,6279,379,5.7
CN0112900000000,01,129,Washington County, AL,Oct-17,6636,6290,346,5.2
CN0112900000000,01,129,Washington County, AL,Nov-17,6583,6250,333,5.1
CN0112900000000,01,129,Washington County, AL,Dec-17,6521,6174,347,5.3
CN0112900000000,01,129,Washington County, AL,Jan-18,6493,6077,416,6.4
CN0112900000000,01,129,Washington County, AL,Feb-18,6590,6184,406,6.2
CN0112900000000,01,129,Washington County, AL,Mar-18,6604,6220,384,5.8
CN0112900000000,01,129,Washington County, AL,Apr-18(p),6617,6280,337,5.1
CN1715300000000,17,153,Pulaski County, IL,Mar-17,2061,1893,168,8.2
CN1715300000000,17,153,Pulaski County, IL,Apr-17,2094,1937,157,7.5
CN1715300000000,17,153,Pulaski County, IL,May-17,2086,1932,154,7.4
CN1715300000000,17,153,Pulaski County, IL,Jun-17,2117,1953,164,7.7
CN1715300000000,17,153,Pulaski County, IL,Jul-17,2090,1924,166,7.9
CN1715300000000,17,153,Pulaski County, IL,Aug-17,2132,1962,170,8.0
CN1715300000000,17,153,Pulaski County, IL,Sep-17,2132,1981,151,7.1
CN1715300000000,17,153,Pulaski County, IL,Oct-17,2163,2023,140,6.5
CN1715300000000,17,153,Pulaski County, IL,Nov-17,2118,1963,155,7.3
CN1715300000000,17,153,Pulaski County, IL,Dec-17,2101,1941,160,7.6
CN1715300000000,17,153,Pulaski County, IL,Jan-18,2069,1912,157,7.6
CN1715300000000,17,153,Pulaski County, IL,Feb-18,2106,1957,149,7.1
CN1715300000000,17,153,Pulaski County, IL,Mar-18,2172,2002,170,7.8
CN1715300000000,17,153,Pulaski County, IL,Apr-18(p),2175,2037,138,6.3
CN3403900000000,34,039,Union County, NJ,Mar-17,277933,264764,13169,4.7
CN3403900000000,34,039,Union County, NJ,Apr-17,277649,265479,12170,4.4
CN3403900000000,34,039,Union County, NJ,May-17,277129,264481,12648,4.6
CN3403900000000,34,039,Union County, NJ,Jun-17,279937,266582,13355,4.8
CN3403900000000,34,039,Union County, NJ,Jul-17,281189,266278,14911,5.3
CN3403900000000,34,039,Union County, NJ,Aug-17,277953,263650,14303,5.1
CN3403900000000,34,039,Union County, NJ,Sep-17,275620,262235,13385,4.9
CN3403900000000,34,039,Union County, NJ,Oct-17,274983,262370,12613,4.6
CN3403900000000,34,039,Union County, NJ,Nov-17,273799,261667,12132,4.4
CN3403900000000,34,039,Union County, NJ,Dec-17,272847,261377,11470,4.2
CN3403900000000,34,039,Union County, NJ,Jan-18,272790,259414,13376,4.9
CN3403900000000,34,039,Union County, NJ,Feb-18,276143,262234,13909,5.0
CN3403900000000,34,039,Union County, NJ,Mar-18,273581,260263,13318,4.9
CN3403900000000,34,039,Union County, NJ,Apr-18(p),270811,259128,11683,4.3
CN3105300000000,31,053,Dodge County, NE,Mar-17,19111,18552,559,2.9
CN3105300000000,31,053,Dodge County, NE,Apr-17,19211,18707,504,2.6
CN3105300000000,31,053,Dodge County, NE,May-17,19288,18776,512,2.7
CN3105300000000,31,053,Dodge County, NE,Jun-17,19430,18848,582,3.0
CN3105300000000,31,053,Dodge County, NE,Jul-17,19557,18988,569,2.9
CN3105300000000,31,053,Dodge County, NE,Aug-17,19320,18799,521,2.7
CN3105300000000,31,053,Dodge County, NE,Sep-17,19284,18786,498,2.6
CN3105300000000,31,053,Dodge County, NE,Oct-17,19415,18939,476,2.5
CN3105300000000,31,053,Dodge County, NE,Nov-17,19376,18902,474,2.4
CN3105300000000,31,053,Dodge County, NE,Dec-17,19289,18744,545,2.8
CN3105300000000,31,053,Dodge County, NE,Jan-18,19248,18658,590,3.1
CN3105300000000,31,053,Dodge County, NE,Feb-18,19434,18879,555,2.9
CN3105300000000,31,053,Dodge County, NE,Mar-18,19580,19014,566,2.9
CN3105300000000,31,053,Dodge County, NE,Apr-18(p),19588,19032,556,2.8
CN0401300000000,04,013,Maricopa County, AZ,Mar-17,2121163,2030200,90963,4.3
CN0401300000000,04,013,Maricopa County, AZ,Apr-17,2120161,2035183,84978,4.0
CN0401300000000,04,013,Maricopa County, AZ,May-17,2114677,2030279,84398,4.0
CN0401300000000,04,013,Maricopa County, AZ,Jun-17,2130410,2038363,92047,4.3
CN0401300000000,04,013,Maricopa County, AZ,Jul-17,2136525,2045168,91357,4.3
CN0401300000000,04,013,Maricopa County, AZ,Aug-17,2139149,2046676,92473,4.3
CN0401300000000,04,013,Maricopa County, AZ,Sep-17,2158997,2070025,88972,4.1
CN0401300000000,04,013,Maricopa County, AZ,Oct-17,2149620,2064296,85324,4.0
CN0401300000000,04,013,Maricopa County, AZ,Nov-17,2165579,2080831,84748,3.9
CN0401300000000,04,013,Maricopa County, AZ,Dec-17,2161548,2076266,85282,3.9
CN0401300000000,04,013,Maricopa County, AZ,Jan-18,2165170,2069218,95952,4.4
CN0401300000000,04,013,Maricopa County, AZ,Feb-18,2198244,2102935,95309,4.3
CN0401300000000,04,013,Maricopa County, AZ,Mar-18,2196909,2109216,87693,4.0
CN0401300000000,04,013,Maricopa County, AZ,Apr-18(p),2185494,2103164,82330,3.8
CN2300100000000,23,001,Androscoggin County, ME,Mar-17,55456,53506,1950,3.5
CN2300100000000,23,001,Androscoggin County, ME,Apr-17,55554,53754,1800,3.2
CN2300100000000,23,001,Androscoggin County, ME,May-17,55582,53798,1784,3.2
CN2300100000000,23,001,Androscoggin County, ME,Jun-17,55978,54106,1872,3.3
CN2300100000000,23,001,Androscoggin County, ME,Jul-17,56025,54153,1872,3.3
CN2300100000000,23,001,Androscoggin County, ME,Aug-17,55740,54126,1614,2.9
CN2300100000000,23,001,Androscoggin County, ME,Sep-17,55443,53909,1534,2.8
CN2300100000000,23,001,Androscoggin County, ME,Oct-17,56055,54513,1542,2.8
CN2300100000000,23,001,Androscoggin County, ME,Nov-17,55842,54298,1544,2.8
CN2300100000000,23,001,Androscoggin County, ME,Dec-17,55561,54248,1313,2.4
CN2300100000000,23,001,Androscoggin County, ME,Jan-18,55385,53687,1698,3.1
CN2300100000000,23,001,Androscoggin County, ME,Feb-18,55299,53616,1683,3.0
CN2300100000000,23,001,Androscoggin County, ME,Mar-18,55652,54018,1634,2.9
CN2300100000000,23,001,Androscoggin County, ME,Apr-18(p),55990,54364,1626,2.9
CN4835900000000,48,359,Oldham County, TX,Mar-17,915,891,24,2.6
CN4835900000000,48,359,Oldham County, TX,Apr-17,911,891,20,2.2
CN4835900000000,48,359,Oldham County, TX,May-17,913,889,24,2.6
CN4835900000000,48,359,Oldham County, TX,Jun-17,897,874,23,2.6
CN4835900000000,48,359,Oldham County, TX,Jul-17,874,850,24,2.7
CN4835900000000,48,359,Oldham County, TX,Aug-17,880,857,23,2.6
CN4835900000000,48,359,Oldham County, TX,Sep-17,880,857,23,2.6
CN4835900000000,48,359,Oldham County, TX,Oct-17,891,872,19,2.1
CN4835900000000,48,359,Oldham County, TX,Nov-17,882,862,20,2.3
CN4835900000000,48,359,Oldham County, TX,Dec-17,884,865,19,2.1
CN4835900000000,48,359,Oldham County, TX,Jan-18,875,853,22,2.5
CN4835900000000,48,359,Oldham County, TX,Feb-18,894,872,22,2.5
CN4835900000000,48,359,Oldham County, TX,Mar-18,920,895,25,2.7
CN4835900000000,48,359,Oldham County, TX,Apr-18(p),911,889,22,2.4
CN5151000000000,51,510,Alexandria city, VA,Mar-17,98406,95457,2949,3.0
CN5151000000000,51,510,Alexandria city, VA,Apr-17,98396,95729,2667,2.7
CN5151000000000,51,510,Alexandria city, VA,May-17,98943,96078,2865,2.9
CN5151000000000,51,510,Alexandria city, VA,Jun-17,99342,96475,2867,2.9
CN5151000000000,51,510,Alexandria city, VA,Jul-17,100044,97091,2953,3.0
CN5151000000000,51,510,Alexandria city, VA,Aug-17,98598,95663,2935,3.0
CN5151000000000,51,510,Alexandria city, VA,Sep-17,98698,96011,2687,2.7
CN5151000000000,51,510,Alexandria city, VA,Oct-17,98645,96025,2620,2.7
CN5151000000000,51,510,Alexandria city, VA,Nov-17,98627,96051,2576,2.6
CN5151000000000,51,510,Alexandria city, VA,Dec-17,98370,95810,2560,2.6
CN5151000000000,51,510,Alexandria city, VA,Jan-18,99099,96359,2740,2.8
CN5151000000000,51,510,Alexandria city, VA,Feb-18,99866,97419,2447,2.5
CN5151000000000,51,510,Alexandria city, VA,Mar-18,100240,97710,2530,2.5
CN5151000000000,51,510,Alexandria city, VA,Apr-18(p),100034,97857,2177,2.2
CN2009300000000,20,093,Kearny County, KS,Mar-17,2065,2013,52,2.5
CN2009300000000,20,093,Kearny County, KS,Apr-17,2008,1957,51,2.5
CN2009300000000,20,093,Kearny County, KS,May-17,2049,1994,55,2.7
CN2009300000000,20,093,Kearny County, KS,Jun-17,2163,2106,57,2.6
CN2009300000000,20,093,Kearny County, KS,Jul-17,2040,1975,65,3.2
CN2009300000000,20,093,Kearny County, KS,Aug-17,1992,1932,60,3.0
CN2009300000000,20,093,Kearny County, KS,Sep-17,2064,2015,49,2.4
CN2009300000000,20,093,Kearny County, KS,Oct-17,2087,2053,34,1.6
CN2009300000000,20,093,Kearny County, KS,Nov-17,2066,2022,44,2.1
CN2009300000000,20,093,Kearny County, KS,Dec-17,2048,2010,38,1.9
CN2009300000000,20,093,Kearny County, KS,Jan-18,1990,1950,40,2.0
CN2009300000000,20,093,Kearny County, KS,Feb-18,2010,1964,46,2.3
CN2009300000000,20,093,Kearny County, KS,Mar-18,2031,1981,50,2.5
CN2009300000000,20,093,Kearny County, KS,Apr-18(p),1915,1871,44,2.3
CN4208500000000,42,085,Mercer County, PA,Mar-17,51343,48335,3008,5.9
CN4208500000000,42,085,Mercer County, PA,Apr-17,51211,48625,2586,5.0
CN4208500000000,42,085,Mercer County, PA,May-17,51285,48585,2700,5.3
CN4208500000000,42,085,Mercer County, PA,Jun-17,51709,48819,2890,5.6
CN4208500000000,42,085,Mercer County, PA,Jul-17,51645,48547,3098,6.0
CN4208500000000,42,085,Mercer County, PA,Aug-17,51277,48338,2939,5.7
CN4208500000000,42,085,Mercer County, PA,Sep-17,50554,48115,2439,4.8
CN4208500000000,42,085,Mercer County, PA,Oct-17,50363,48052,2311,4.6
CN4208500000000,42,085,Mercer County, PA,Nov-17,50363,47927,2436,4.8
CN4208500000000,42,085,Mercer County, PA,Dec-17,49826,47368,2458,4.9
CN4208500000000,42,085,Mercer County, PA,Jan-18,49801,46748,3053,6.1
CN4208500000000,42,085,Mercer County, PA,Feb-18,50016,47071,2945,5.9
CN4208500000000,42,085,Mercer County, PA,Mar-18,49195,46641,2554,5.2
CN4208500000000,42,085,Mercer County, PA,Apr-18(p),49198,47051,2147,4.4
CN7205300000000,72,053,Fajardo Municipio, PR,Mar-17,11259,9890,1369,12.2
CN7205300000000,72,053,Fajardo Municipio, PR,Apr-17,11246,9816,1430,12.7
CN7205300000000,72,053,Fajardo Municipio, PR,May-17,11035,9749,1286,11.7
CN7205300000000,72,053,Fajardo Municipio, PR,Jun-17,10869,9699,1170,10.8
CN7205300000000,72,053,Fajardo Municipio, PR,Jul-17,11048,9644,1404,12.7
CN7205300000000,72,053,Fajardo Municipio, PR,Aug-17,11036,9516,1520,13.8
CN7205300000000,72,053,Fajardo Municipio, PR,Sep-17(y),11022,9636,1386,12.6
CN7205300000000,72,053,Fajardo Municipio, PR,Oct-17,11117,9237,1880,16.9
CN7205300000000,72,053,Fajardo Municipio, PR,Nov-17,11546,9801,1745,15.1
CN7205300000000,72,053,Fajardo Municipio, PR,Dec-17,11595,9885,1710,14.7
CN7205300000000,72,053,Fajardo Municipio, PR,Jan-18,11546,9701,1845,16.0
CN7205300000000,72,053,Fajardo Municipio, PR,Feb-18,11395,9722,1673,14.7
CN7205300000000,72,053,Fajardo Municipio, PR,Mar-18,11508,9730,1778,15.5
CN7205300000000,72,053,Fajardo Municipio, PR,Apr-18(p),11496,9811,1685,14.7
CN7211500000000,72,115,Quebradillas Municipio, PR,Mar-17,6186,5184,1002,16.2
CN7211500000000,72,115,Quebradillas Municipio, PR,Apr-17,6137,5139,998,16.3
CN7211500000000,72,115,Quebradillas Municipio, PR,May-17,6009,5145,864,14.4
CN7211500000000,72,115,Quebradillas Municipio, PR,Jun-17,5909,5120,789,13.4
CN7211500000000,72,115,Quebradillas Municipio, PR,Jul-17,6072,5137,935,15.4
CN7211500000000,72,115,Quebradillas Municipio, PR,Aug-17,6126,5087,1039,17.0
CN7211500000000,72,115,Quebradillas Municipio, PR,Sep-17(y),6081,5120,961,15.8
CN7211500000000,72,115,Quebradillas Municipio, PR,Oct-17,5889,4930,959,16.3
CN7211500000000,72,115,Quebradillas Municipio, PR,Nov-17,6173,5225,948,15.4
CN7211500000000,72,115,Quebradillas Municipio, PR,Dec-17,6169,5258,911,14.8
CN7211500000000,72,115,Quebradillas Municipio, PR,Jan-18,6144,5133,1011,16.5
CN7211500000000,72,115,Quebradillas Municipio, PR,Feb-18,6079,5120,959,15.8
CN7211500000000,72,115,Quebradillas Municipio, PR,Mar-18,6069,5130,939,15.5
CN7211500000000,72,115,Quebradillas Municipio, PR,Apr-18(p),6098,5193,905,14.8
CN5410700000000,54,107,Wood County, WV,Mar-17,36031,33917,2114,5.9
CN5410700000000,54,107,Wood County, WV,Apr-17,36151,34289,1862,5.2
CN5410700000000,54,107,Wood County, WV,May-17,36104,34369,1735,4.8
CN5410700000000,54,107,Wood County, WV,Jun-17,36916,34944,1972,5.3
CN5410700000000,54,107,Wood County, WV,Jul-17,36686,34699,1987,5.4
CN5410700000000,54,107,Wood County, WV,Aug-17,36440,34394,2046,5.6
CN5410700000000,54,107,Wood County, WV,Sep-17,36347,34605,1742,4.8
CN5410700000000,54,107,Wood County, WV,Oct-17,36152,34430,1722,4.8
CN5410700000000,54,107,Wood County, WV,Nov-17,36032,34179,1853,5.1
CN5410700000000,54,107,Wood County, WV,Dec-17,36109,34081,2028,5.6
CN5410700000000,54,107,Wood County, WV,Jan-18,35948,33709,2239,6.2
CN5410700000000,54,107,Wood County, WV,Feb-18,36232,33744,2488,6.9
CN5410700000000,54,107,Wood County, WV,Mar-18,35961,33790,2171,6.0
CN5410700000000,54,107,Wood County, WV,Apr-18(p),36110,34122,1988,5.5
CN1606900000000,16,069,Nez Perce County, ID,Mar-17,21115,20318,797,3.8
CN1606900000000,16,069,Nez Perce County, ID,Apr-17,21056,20453,603,2.9
CN1606900000000,16,069,Nez Perce County, ID,May-17,21257,20745,512,2.4
CN1606900000000,16,069,Nez Perce County, ID,Jun-17,21476,20936,540,2.5
CN1606900000000,16,069,Nez Perce County, ID,Jul-17,21406,20857,549,2.6
CN1606900000000,16,069,Nez Perce County, ID,Aug-17,21303,20750,553,2.6
CN1606900000000,16,069,Nez Perce County, ID,Sep-17,21211,20685,526,2.5
CN1606900000000,16,069,Nez Perce County, ID,Oct-17,21289,20758,531,2.5
CN1606900000000,16,069,Nez Perce County, ID,Nov-17,21492,20898,594,2.8
CN1606900000000,16,069,Nez Perce County, ID,Dec-17,21487,20973,514,2.4
CN1606900000000,16,069,Nez Perce County, ID,Jan-18,21761,21017,744,3.4
CN1606900000000,16,069,Nez Perce County, ID,Feb-18,21760,21067,693,3.2
CN1606900000000,16,069,Nez Perce County, ID,Mar-18,21799,21153,646,3.0
CN1606900000000,16,069,Nez Perce County, ID,Apr-18(p),21681,21113,568,2.6
CN4603700000000,46,037,Day County, SD,Mar-17,2813,2656,157,5.6
CN4603700000000,46,037,Day County, SD,Apr-17,2863,2742,121,4.2
CN4603700000000,46,037,Day County, SD,May-17,2897,2803,94,3.2
CN4603700000000,46,037,Day County, SD,Jun-17,2995,2890,105,3.5
CN4603700000000,46,037,Day County, SD,Jul-17,2928,2833,95,3.2
CN4603700000000,46,037,Day County, SD,Aug-17,2848,2739,109,3.8
CN4603700000000,46,037,Day County, SD,Sep-17,2776,2690,86,3.1
CN4603700000000,46,037,Day County, SD,Oct-17,2772,2689,83,3.0
CN4603700000000,46,037,Day County, SD,Nov-17,2736,2647,89,3.3
CN4603700000000,46,037,Day County, SD,Dec-17,2808,2667,141,5.0
CN4603700000000,46,037,Day County, SD,Jan-18,2842,2665,177,6.2
CN4603700000000,46,037,Day County, SD,Feb-18,2855,2670,185,6.5
CN4603700000000,46,037,Day County, SD,Mar-18,2876,2702,174,6.1
CN4603700000000,46,037,Day County, SD,Apr-18(p),2840,2690,150,5.3
CN5306500000000,53,065,Stevens County, WA,Mar-17,18408,16731,1677,9.1
CN5306500000000,53,065,Stevens County, WA,Apr-17,18280,16871,1409,7.7
CN5306500000000,53,065,Stevens County, WA,May-17,18250,16996,1254,6.9
CN5306500000000,53,065,Stevens County, WA,Jun-17,18252,17149,1103,6.0
CN5306500000000,53,065,Stevens County, WA,Jul-17,18123,16994,1129,6.2
CN5306500000000,53,065,Stevens County, WA,Aug-17,18009,16884,1125,6.2
CN5306500000000,53,065,Stevens County, WA,Sep-17,18136,17063,1073,5.9
CN5306500000000,53,065,Stevens County, WA,Oct-17,18330,17249,1081,5.9
CN5306500000000,53,065,Stevens County, WA,Nov-17,18510,17298,1212,6.5
CN5306500000000,53,065,Stevens County, WA,Dec-17,18425,16971,1454,7.9
CN5306500000000,53,065,Stevens County, WA,Jan-18,18116,16462,1654,9.1
CN5306500000000,53,065,Stevens County, WA,Feb-18,18316,16462,1854,10.1
CN5306500000000,53,065,Stevens County, WA,Mar-18,18349,16593,1756,9.6
CN5306500000000,53,065,Stevens County, WA,Apr-18(p),18116,16644,1472,8.1
CN5404500000000,54,045,Logan County, WV,Mar-17,10796,9986,810,7.5
CN5404500000000,54,045,Logan County, WV,Apr-17,10855,10061,794,7.3
CN5404500000000,54,045,Logan County, WV,May-17,10793,10053,740,6.9
CN5404500000000,54,045,Logan County, WV,Jun-17,10996,10166,830,7.5
CN5404500000000,54,045,Logan County, WV,Jul-17,10683,9879,804,7.5
CN5404500000000,54,045,Logan County, WV,Aug-17,10607,9786,821,7.7
CN5404500000000,54,045,Logan County, WV,Sep-17,10705,9979,726,6.8
CN5404500000000,54,045,Logan County, WV,Oct-17,10692,9948,744,7.0
CN5404500000000,54,045,Logan County, WV,Nov-17,10693,9906,787,7.4
CN5404500000000,54,045,Logan County, WV,Dec-17,10615,9822,793,7.5
CN5404500000000,54,045,Logan County, WV,Jan-18,10668,9860,808,7.6
CN5404500000000,54,045,Logan County, WV,Feb-18,10703,9832,871,8.1
CN5404500000000,54,045,Logan County, WV,Mar-18,10681,9828,853,8.0
CN5404500000000,54,045,Logan County, WV,Apr-18(p),10737,9941,796,7.4
CN2802900000000,28,029,Copiah County, MS,Mar-17,11332,10704,628,5.5
CN2802900000000,28,029,Copiah County, MS,Apr-17,11317,10731,586,5.2
CN2802900000000,28,029,Copiah County, MS,May-17,11339,10663,676,6.0
CN2802900000000,28,029,Copiah County, MS,Jun-17,11468,10694,774,6.7
CN2802900000000,28,029,Copiah County, MS,Jul-17,11437,10709,728,6.4
CN2802900000000,28,029,Copiah County, MS,Aug-17,11195,10581,614,5.5
CN2802900000000,28,029,Copiah County, MS,Sep-17,11247,10660,587,5.2
CN2802900000000,28,029,Copiah County, MS,Oct-17,11281,10710,571,5.1
CN2802900000000,28,029,Copiah County, MS,Nov-17,11295,10731,564,5.0
CN2802900000000,28,029,Copiah County, MS,Dec-17,11306,10744,562,5.0
CN2802900000000,28,029,Copiah County, MS,Jan-18,11170,10616,554,5.0
CN2802900000000,28,029,Copiah County, MS,Feb-18,11257,10713,544,4.8
CN2802900000000,28,029,Copiah County, MS,Mar-18,11292,10777,515,4.6
CN2802900000000,28,029,Copiah County, MS,Apr-18(p),11300,10774,526,4.7
CN3505700000000,35,057,Torrance County, NM,Mar-17,5352,4902,450,8.4
CN3505700000000,35,057,Torrance County, NM,Apr-17,5354,4948,406,7.6
CN3505700000000,35,057,Torrance County, NM,May-17,5325,4912,413,7.8
CN3505700000000,35,057,Torrance County, NM,Jun-17,5428,4948,480,8.8
CN3505700000000,35,057,Torrance County, NM,Jul-17,5404,4938,466,8.6
CN3505700000000,35,057,Torrance County, NM,Aug-17,5483,5017,466,8.5
CN3505700000000,35,057,Torrance County, NM,Sep-17,5517,5061,456,8.3
CN3505700000000,35,057,Torrance County, NM,Oct-17,5885,5419,466,7.9
CN3505700000000,35,057,Torrance County, NM,Nov-17,5730,5185,545,9.5
CN3505700000000,35,057,Torrance County, NM,Dec-17,5599,5043,556,9.9
CN3505700000000,35,057,Torrance County, NM,Jan-18,5531,4988,543,9.8
CN3505700000000,35,057,Torrance County, NM,Feb-18,5507,4998,509,9.2
CN3505700000000,35,057,Torrance County, NM,Mar-18,5499,5048,451,8.2
CN3505700000000,35,057,Torrance County, NM,Apr-18(p),5502,5111,391,7.1
CN3900900000000,39,009,Athens County, OH,Mar-17,30054,28248,1806,6.0
CN3900900000000,39,009,Athens County, OH,Apr-17,29991,28467,1524,5.1
CN3900900000000,39,009,Athens County, OH,May-17,26310,24823,1487,5.7
CN3900900000000,39,009,Athens County, OH,Jun-17,25660,23783,1877,7.3
CN3900900000000,39,009,Athens County, OH,Jul-17,26179,24260,1919,7.3
CN3900900000000,39,009,Athens County, OH,Aug-17,26284,24510,1774,6.7
CN3900900000000,39,009,Athens County, OH,Sep-17,30035,28418,1617,5.4
CN3900900000000,39,009,Athens County, OH,Oct-17,30442,28979,1463,4.8
CN3900900000000,39,009,Athens County, OH,Nov-17,30441,28954,1487,4.9
CN3900900000000,39,009,Athens County, OH,Dec-17,26615,25109,1506,5.7
CN3900900000000,39,009,Athens County, OH,Jan-18,30564,28807,1757,5.7
CN3900900000000,39,009,Athens County, OH,Feb-18,30581,28884,1697,5.5
CN3900900000000,39,009,Athens County, OH,Mar-18,30484,28945,1539,5.0
CN3900900000000,39,009,Athens County, OH,Apr-18(p),30555,29162,1393,4.6
CN4701700000000,47,017,Carroll County, TN,Mar-17,12134,11464,670,5.5
CN4701700000000,47,017,Carroll County, TN,Apr-17,11994,11429,565,4.7
CN4701700000000,47,017,Carroll County, TN,May-17,11861,11330,531,4.5
CN4701700000000,47,017,Carroll County, TN,Jun-17,11995,11328,667,5.6
CN4701700000000,47,017,Carroll County, TN,Jul-17,11985,11344,641,5.3
CN4701700000000,47,017,Carroll County, TN,Aug-17,11924,11324,600,5.0
CN4701700000000,47,017,Carroll County, TN,Sep-17,12058,11510,548,4.5
CN4701700000000,47,017,Carroll County, TN,Oct-17,11996,11447,549,4.6
CN4701700000000,47,017,Carroll County, TN,Nov-17,11882,11369,513,4.3
CN4701700000000,47,017,Carroll County, TN,Dec-17,11875,11350,525,4.4
CN4701700000000,47,017,Carroll County, TN,Jan-18,11922,11266,656,5.5
CN4701700000000,47,017,Carroll County, TN,Feb-18,12068,11442,626,5.2
CN4701700000000,47,017,Carroll County, TN,Mar-18,11976,11423,553,4.6
CN4701700000000,47,017,Carroll County, TN,Apr-18(p),12061,11568,493,4.1
CN5508900000000,55,089,Ozaukee County, WI,Mar-17,49169,47803,1366,2.8
CN5508900000000,55,089,Ozaukee County, WI,Apr-17,49044,47800,1244,2.5
CN5508900000000,55,089,Ozaukee County, WI,May-17,49317,47957,1360,2.8
CN5508900000000,55,089,Ozaukee County, WI,Jun-17,49960,48332,1628,3.3
CN5508900000000,55,089,Ozaukee County, WI,Jul-17,50324,48774,1550,3.1
CN5508900000000,55,089,Ozaukee County, WI,Aug-17,50000,48558,1442,2.9
CN5508900000000,55,089,Ozaukee County, WI,Sep-17,49709,48415,1294,2.6
CN5508900000000,55,089,Ozaukee County, WI,Oct-17,49626,48413,1213,2.4
CN5508900000000,55,089,Ozaukee County, WI,Nov-17,49501,48339,1162,2.3
CN5508900000000,55,089,Ozaukee County, WI,Dec-17,49054,48022,1032,2.1
CN5508900000000,55,089,Ozaukee County, WI,Jan-18,49153,47964,1189,2.4
CN5508900000000,55,089,Ozaukee County, WI,Feb-18,49720,48470,1250,2.5
CN5508900000000,55,089,Ozaukee County, WI,Mar-18,49932,48704,1228,2.5
CN5508900000000,55,089,Ozaukee County, WI,Apr-18(p),49729,48697,1032,2.1
CN2614900000000,26,149,St. Joseph County, MI,Mar-17,28832,27747,1085,3.8
CN2614900000000,26,149,St. Joseph County, MI,Apr-17,28669,27507,1162,4.1
CN2614900000000,26,149,St. Joseph County, MI,May-17,28894,27616,1278,4.4
CN2614900000000,26,149,St. Joseph County, MI,Jun-17,29219,27946,1273,4.4
CN2614900000000,26,149,St. Joseph County, MI,Jul-17,28936,27339,1597,5.5
CN2614900000000,26,149,St. Joseph County, MI,Aug-17,29355,27950,1405,4.8
CN2614900000000,26,149,St. Joseph County, MI,Sep-17,28774,27564,1210,4.2
CN2614900000000,26,149,St. Joseph County, MI,Oct-17,28838,27648,1190,4.1
CN2614900000000,26,149,St. Joseph County, MI,Nov-17,28717,27651,1066,3.7
CN2614900000000,26,149,St. Joseph County, MI,Dec-17,28680,27622,1058,3.7
CN2614900000000,26,149,St. Joseph County, MI,Jan-18,28628,27396,1232,4.3
CN2614900000000,26,149,St. Joseph County, MI,Feb-18,28985,27794,1191,4.1
CN2614900000000,26,149,St. Joseph County, MI,Mar-18,29068,28000,1068,3.7
CN2614900000000,26,149,St. Joseph County, MI,Apr-18(p),28837,27875,962,3.3
CN0807900000000,08,079,Mineral County, CO,Mar-17,532,523,9,1.7
CN0807900000000,08,079,Mineral County, CO,Apr-17,333,326,7,2.1
CN0807900000000,08,079,Mineral County, CO,May-17,397,387,10,2.5
CN0807900000000,08,079,Mineral County, CO,Jun-17,478,468,10,2.1
CN0807900000000,08,079,Mineral County, CO,Jul-17,511,503,8,1.6
CN0807900000000,08,079,Mineral County, CO,Aug-17,495,487,8,1.6
CN0807900000000,08,079,Mineral County, CO,Sep-17,430,422,8,1.9
CN0807900000000,08,079,Mineral County, CO,Oct-17,369,361,8,2.2
CN0807900000000,08,079,Mineral County, CO,Nov-17,368,360,8,2.2
CN0807900000000,08,079,Mineral County, CO,Dec-17,404,396,8,2.0
CN0807900000000,08,079,Mineral County, CO,Jan-18,413,403,10,2.4
CN0807900000000,08,079,Mineral County, CO,Feb-18,427,416,11,2.6
CN0807900000000,08,079,Mineral County, CO,Mar-18,424,412,12,2.8
CN0807900000000,08,079,Mineral County, CO,Apr-18(p),309,300,9,2.9
CN2616100000000,26,161,Washtenaw County, MI,Mar-17,193668,187630,6038,3.1
CN2616100000000,26,161,Washtenaw County, MI,Apr-17,193714,188595,5119,2.6
CN2616100000000,26,161,Washtenaw County, MI,May-17,191523,185234,6289,3.3
CN2616100000000,26,161,Washtenaw County, MI,Jun-17,192969,185489,7480,3.9
CN2616100000000,26,161,Washtenaw County, MI,Jul-17,192839,183246,9593,5.0
CN2616100000000,26,161,Washtenaw County, MI,Aug-17,192543,184313,8230,4.3
CN2616100000000,26,161,Washtenaw County, MI,Sep-17,195564,187898,7666,3.9
CN2616100000000,26,161,Washtenaw County, MI,Oct-17,194956,188321,6635,3.4
CN2616100000000,26,161,Washtenaw County, MI,Nov-17,196827,190381,6446,3.3
CN2616100000000,26,161,Washtenaw County, MI,Dec-17,194270,188260,6010,3.1
CN2616100000000,26,161,Washtenaw County, MI,Jan-18,191651,184662,6989,3.6
CN2616100000000,26,161,Washtenaw County, MI,Feb-18,195358,188316,7042,3.6
CN2616100000000,26,161,Washtenaw County, MI,Mar-18,196621,190612,6009,3.1
CN2616100000000,26,161,Washtenaw County, MI,Apr-18(p),196791,191191,5600,2.8
CN0605500000000,06,055,Napa County, CA,Mar-17,73748,70785,2963,4.0
CN0605500000000,06,055,Napa County, CA,Apr-17,73685,71063,2622,3.6
CN0605500000000,06,055,Napa County, CA,May-17,74440,72072,2368,3.2
CN0605500000000,06,055,Napa County, CA,Jun-17,75223,72602,2621,3.5
CN0605500000000,06,055,Napa County, CA,Jul-17,75594,72825,2769,3.7
CN0605500000000,06,055,Napa County, CA,Aug-17,74909,72265,2644,3.5
CN0605500000000,06,055,Napa County, CA,Sep-17,75875,73590,2285,3.0
CN0605500000000,06,055,Napa County, CA,Oct-17,74992,72635,2357,3.1
CN0605500000000,06,055,Napa County, CA,Nov-17,72316,69872,2444,3.4
CN0605500000000,06,055,Napa County, CA,Dec-17,70938,68348,2590,3.7
CN0605500000000,06,055,Napa County, CA,Jan-18,71620,68786,2834,4.0
CN0605500000000,06,055,Napa County, CA,Feb-18,72986,70460,2526,3.5
CN0605500000000,06,055,Napa County, CA,Mar-18,72733,70431,2302,3.2
CN0605500000000,06,055,Napa County, CA,Apr-18(p),72566,70511,2055,2.8
CN1308300000000,13,083,Dade County, GA,Mar-17,8227,7863,364,4.4
CN1308300000000,13,083,Dade County, GA,Apr-17,8257,7930,327,4.0
CN1308300000000,13,083,Dade County, GA,May-17,8243,7900,343,4.2
CN1308300000000,13,083,Dade County, GA,Jun-17,8312,7920,392,4.7
CN1308300000000,13,083,Dade County, GA,Jul-17,8365,7938,427,5.1
CN1308300000000,13,083,Dade County, GA,Aug-17,8226,7863,363,4.4
CN1308300000000,13,083,Dade County, GA,Sep-17,8385,8048,337,4.0
CN1308300000000,13,083,Dade County, GA,Oct-17,8344,8010,334,4.0
CN1308300000000,13,083,Dade County, GA,Nov-17,8352,8021,331,4.0
CN1308300000000,13,083,Dade County, GA,Dec-17,8322,8001,321,3.9
CN1308300000000,13,083,Dade County, GA,Jan-18,8376,8032,344,4.1
CN1308300000000,13,083,Dade County, GA,Feb-18,8498,8134,364,4.3
CN1308300000000,13,083,Dade County, GA,Mar-18,8469,8156,313,3.7
CN1308300000000,13,083,Dade County, GA,Apr-18(p),8521,8255,266,3.1
CN1913300000000,19,133,Monona County, IA,Mar-17,4530,4324,206,4.5
CN1913300000000,19,133,Monona County, IA,Apr-17,4544,4383,161,3.5
CN1913300000000,19,133,Monona County, IA,May-17,4561,4413,148,3.2
CN1913300000000,19,133,Monona County, IA,Jun-17,4666,4495,171,3.7
CN1913300000000,19,133,Monona County, IA,Jul-17,4592,4446,146,3.2
CN1913300000000,19,133,Monona County, IA,Aug-17,4536,4378,158,3.5
CN1913300000000,19,133,Monona County, IA,Sep-17,4463,4328,135,3.0
CN1913300000000,19,133,Monona County, IA,Oct-17,4440,4334,106,2.4
CN1913300000000,19,133,Monona County, IA,Nov-17,4411,4283,128,2.9
CN1913300000000,19,133,Monona County, IA,Dec-17,4397,4246,151,3.4
CN1913300000000,19,133,Monona County, IA,Jan-18,4387,4176,211,4.8
CN1913300000000,19,133,Monona County, IA,Feb-18,4418,4220,198,4.5
CN1913300000000,19,133,Monona County, IA,Mar-18,4359,4202,157,3.6
CN1913300000000,19,133,Monona County, IA,Apr-18(p),4351,4226,125,2.9
CN2001100000000,20,011,Bourbon County, KS,Mar-17,7033,6706,327,4.6
CN2001100000000,20,011,Bourbon County, KS,Apr-17,7063,6760,303,4.3
CN2001100000000,20,011,Bourbon County, KS,May-17,6993,6702,291,4.2
CN2001100000000,20,011,Bourbon County, KS,Jun-17,7180,6842,338,4.7
CN2001100000000,20,011,Bourbon County, KS,Jul-17,6819,6472,347,5.1
CN2001100000000,20,011,Bourbon County, KS,Aug-17,6640,6320,320,4.8
CN2001100000000,20,011,Bourbon County, KS,Sep-17,6607,6323,284,4.3
CN2001100000000,20,011,Bourbon County, KS,Oct-17,6685,6425,260,3.9
CN2001100000000,20,011,Bourbon County, KS,Nov-17,6681,6416,265,4.0
CN2001100000000,20,011,Bourbon County, KS,Dec-17,6664,6405,259,3.9
CN2001100000000,20,011,Bourbon County, KS,Jan-18,6746,6414,332,4.9
CN2001100000000,20,011,Bourbon County, KS,Feb-18,6699,6376,323,4.8
CN2001100000000,20,011,Bourbon County, KS,Mar-18,7210,6891,319,4.4
CN2001100000000,20,011,Bourbon County, KS,Apr-18(p),7103,6830,273,3.8
CN0102300000000,01,023,Choctaw County, AL,Mar-17,4344,4038,306,7.0
CN0102300000000,01,023,Choctaw County, AL,Apr-17,4279,4020,259,6.1
CN0102300000000,01,023,Choctaw County, AL,May-17,4347,4094,253,5.8
CN0102300000000,01,023,Choctaw County, AL,Jun-17,4388,4091,297,6.8
CN0102300000000,01,023,Choctaw County, AL,Jul-17,4364,4072,292,6.7
CN0102300000000,01,023,Choctaw County, AL,Aug-17,4333,4057,276,6.4
CN0102300000000,01,023,Choctaw County, AL,Sep-17,4401,4166,235,5.3
CN0102300000000,01,023,Choctaw County, AL,Oct-17,4380,4141,239,5.5
CN0102300000000,01,023,Choctaw County, AL,Nov-17,4311,4082,229,5.3
CN0102300000000,01,023,Choctaw County, AL,Dec-17,4262,4041,221,5.2
CN0102300000000,01,023,Choctaw County, AL,Jan-18,4244,3966,278,6.6
CN0102300000000,01,023,Choctaw County, AL,Feb-18,4311,4031,280,6.5
CN0102300000000,01,023,Choctaw County, AL,Mar-18,4344,4091,253,5.8
CN0102300000000,01,023,Choctaw County, AL,Apr-18(p),4320,4091,229,5.3
CN2203500000000,22,035,East Carroll Parish, LA,Mar-17,2052,1795,257,12.5
CN2203500000000,22,035,East Carroll Parish, LA,Apr-17,2072,1828,244,11.8
CN2203500000000,22,035,East Carroll Parish, LA,May-17,2122,1876,246,11.6
CN2203500000000,22,035,East Carroll Parish, LA,Jun-17,2193,1927,266,12.1
CN2203500000000,22,035,East Carroll Parish, LA,Jul-17,2140,1901,239,11.2
CN2203500000000,22,035,East Carroll Parish, LA,Aug-17,2079,1857,222,10.7
CN2203500000000,22,035,East Carroll Parish, LA,Sep-17,2019,1821,198,9.8
CN2203500000000,22,035,East Carroll Parish, LA,Oct-17,2061,1872,189,9.2
CN2203500000000,22,035,East Carroll Parish, LA,Nov-17,2033,1852,181,8.9
CN2203500000000,22,035,East Carroll Parish, LA,Dec-17,1990,1827,163,8.2
CN2203500000000,22,035,East Carroll Parish, LA,Jan-18,2045,1851,194,9.5
CN2203500000000,22,035,East Carroll Parish, LA,Feb-18,2002,1813,189,9.4
CN2203500000000,22,035,East Carroll Parish, LA,Mar-18,2013,1820,193,9.6
CN2203500000000,22,035,East Carroll Parish, LA,Apr-18(p),1993,1805,188,9.4
CN1907100000000,19,071,Fremont County, IA,Mar-17,3811,3710,101,2.7
CN1907100000000,19,071,Fremont County, IA,Apr-17,3848,3751,97,2.5
CN1907100000000,19,071,Fremont County, IA,May-17,3868,3769,99,2.6
CN1907100000000,19,071,Fremont County, IA,Jun-17,3921,3818,103,2.6
CN1907100000000,19,071,Fremont County, IA,Jul-17,3943,3839,104,2.6
CN1907100000000,19,071,Fremont County, IA,Aug-17,3857,3745,112,2.9
CN1907100000000,19,071,Fremont County, IA,Sep-17,3805,3707,98,2.6
CN1907100000000,19,071,Fremont County, IA,Oct-17,3853,3768,85,2.2
CN1907100000000,19,071,Fremont County, IA,Nov-17,3776,3699,77,2.0
CN1907100000000,19,071,Fremont County, IA,Dec-17,3751,3671,80,2.1
CN1907100000000,19,071,Fremont County, IA,Jan-18,3709,3623,86,2.3
CN1907100000000,19,071,Fremont County, IA,Feb-18,3730,3647,83,2.2
CN1907100000000,19,071,Fremont County, IA,Mar-18,3713,3640,73,2.0
CN1907100000000,19,071,Fremont County, IA,Apr-18(p),3729,3660,69,1.9
CN5500700000000,55,007,Bayfield County, WI,Mar-17,7271,6742,529,7.3
CN5500700000000,55,007,Bayfield County, WI,Apr-17,7386,6932,454,6.1
CN5500700000000,55,007,Bayfield County, WI,May-17,7530,7203,327,4.3
CN5500700000000,55,007,Bayfield County, WI,Jun-17,7860,7496,364,4.6
CN5500700000000,55,007,Bayfield County, WI,Jul-17,7900,7553,347,4.4
CN5500700000000,55,007,Bayfield County, WI,Aug-17,7805,7444,361,4.6
CN5500700000000,55,007,Bayfield County, WI,Sep-17,7612,7338,274,3.6
CN5500700000000,55,007,Bayfield County, WI,Oct-17,7664,7401,263,3.4
CN5500700000000,55,007,Bayfield County, WI,Nov-17,7476,7144,332,4.4
CN5500700000000,55,007,Bayfield County, WI,Dec-17,7430,7037,393,5.3
CN5500700000000,55,007,Bayfield County, WI,Jan-18,7307,6897,410,5.6
CN5500700000000,55,007,Bayfield County, WI,Feb-18,7299,6835,464,6.4
CN5500700000000,55,007,Bayfield County, WI,Mar-18,7334,6860,474,6.5
CN5500700000000,55,007,Bayfield County, WI,Apr-18(p),7470,7029,441,5.9
CN2105500000000,21,055,Crittenden County, KY,Mar-17,4157,3894,263,6.3
CN2105500000000,21,055,Crittenden County, KY,Apr-17,4159,3937,222,5.3
CN2105500000000,21,055,Crittenden County, KY,May-17,4135,3908,227,5.5
CN2105500000000,21,055,Crittenden County, KY,Jun-17,4202,3961,241,5.7
CN2105500000000,21,055,Crittenden County, KY,Jul-17,4115,3876,239,5.8
CN2105500000000,21,055,Crittenden County, KY,Aug-17,4175,3968,207,5.0
CN2105500000000,21,055,Crittenden County, KY,Sep-17,4111,3935,176,4.3
CN2105500000000,21,055,Crittenden County, KY,Oct-17,4150,3972,178,4.3
CN2105500000000,21,055,Crittenden County, KY,Nov-17,4145,3978,167,4.0
CN2105500000000,21,055,Crittenden County, KY,Dec-17,4120,3951,169,4.1
CN2105500000000,21,055,Crittenden County, KY,Jan-18,4106,3889,217,5.3
CN2105500000000,21,055,Crittenden County, KY,Feb-18,4144,3913,231,5.6
CN2105500000000,21,055,Crittenden County, KY,Mar-18,4189,3964,225,5.4
CN2105500000000,21,055,Crittenden County, KY,Apr-18(p),4180,3986,194,4.6
CN4004300000000,40,043,Dewey County, OK,Mar-17,2361,2288,73,3.1
CN4004300000000,40,043,Dewey County, OK,Apr-17,2446,2382,64,2.6
CN4004300000000,40,043,Dewey County, OK,May-17,2431,2353,78,3.2
CN4004300000000,40,043,Dewey County, OK,Jun-17,2413,2322,91,3.8
CN4004300000000,40,043,Dewey County, OK,Jul-17,2395,2311,84,3.5
CN4004300000000,40,043,Dewey County, OK,Aug-17,2593,2517,76,2.9
CN4004300000000,40,043,Dewey County, OK,Sep-17,2537,2466,71,2.8
CN4004300000000,40,043,Dewey County, OK,Oct-17,2589,2527,62,2.4
CN4004300000000,40,043,Dewey County, OK,Nov-17,2594,2529,65,2.5
CN4004300000000,40,043,Dewey County, OK,Dec-17,2533,2473,60,2.4
CN4004300000000,40,043,Dewey County, OK,Jan-18,2500,2440,60,2.4
CN4004300000000,40,043,Dewey County, OK,Feb-18,2492,2427,65,2.6
CN4004300000000,40,043,Dewey County, OK,Mar-18,2459,2396,63,2.6
CN4004300000000,40,043,Dewey County, OK,Apr-18(p),2428,2372,56,2.3
CN1801500000000,18,015,Carroll County, IN,Mar-17,10168,9793,375,3.7
CN1801500000000,18,015,Carroll County, IN,Apr-17,10012,9732,280,2.8
CN1801500000000,18,015,Carroll County, IN,May-17,10017,9716,301,3.0
CN1801500000000,18,015,Carroll County, IN,Jun-17,9888,9547,341,3.4
CN1801500000000,18,015,Carroll County, IN,Jul-17,9851,9500,351,3.6
CN1801500000000,18,015,Carroll County, IN,Aug-17,10133,9765,368,3.6
CN1801500000000,18,015,Carroll County, IN,Sep-17,10014,9721,293,2.9
CN1801500000000,18,015,Carroll County, IN,Oct-17,10130,9833,297,2.9
CN1801500000000,18,015,Carroll County, IN,Nov-17,10229,9928,301,2.9
CN1801500000000,18,015,Carroll County, IN,Dec-17,9877,9594,283,2.9
CN1801500000000,18,015,Carroll County, IN,Jan-18,9887,9530,357,3.6
CN1801500000000,18,015,Carroll County, IN,Feb-18,10239,9850,389,3.8
CN1801500000000,18,015,Carroll County, IN,Mar-18,10243,9908,335,3.3
CN1801500000000,18,015,Carroll County, IN,Apr-18(p),10257,9970,287,2.8
CN2920900000000,29,209,Stone County, MO,Mar-17,12906,12062,844,6.5
CN2920900000000,29,209,Stone County, MO,Apr-17,13186,12547,639,4.8
CN2920900000000,29,209,Stone County, MO,May-17,13315,12712,603,4.5
CN2920900000000,29,209,Stone County, MO,Jun-17,14523,13927,596,4.1
CN2920900000000,29,209,Stone County, MO,Jul-17,14473,13856,617,4.3
CN2920900000000,29,209,Stone County, MO,Aug-17,14051,13411,640,4.6
CN2920900000000,29,209,Stone County, MO,Sep-17,13599,13085,514,3.8
CN2920900000000,29,209,Stone County, MO,Oct-17,13481,13073,408,3.0
CN2920900000000,29,209,Stone County, MO,Nov-17,13506,13012,494,3.7
CN2920900000000,29,209,Stone County, MO,Dec-17,13266,12668,598,4.5
CN2920900000000,29,209,Stone County, MO,Jan-18,12857,11572,1285,10.0
CN2920900000000,29,209,Stone County, MO,Feb-18,12670,11268,1402,11.1
CN2920900000000,29,209,Stone County, MO,Mar-18,13128,12346,782,6.0
CN2920900000000,29,209,Stone County, MO,Apr-18(p),13342,12790,552,4.1
CN3700300000000,37,003,Alexander County, NC,Mar-17,18345,17675,670,3.7
CN3700300000000,37,003,Alexander County, NC,Apr-17,18278,17696,582,3.2
CN3700300000000,37,003,Alexander County, NC,May-17,18205,17580,625,3.4
CN3700300000000,37,003,Alexander County, NC,Jun-17,18157,17481,676,3.7
CN3700300000000,37,003,Alexander County, NC,Jul-17,18233,17520,713,3.9
CN3700300000000,37,003,Alexander County, NC,Aug-17,18001,17294,707,3.9
CN3700300000000,37,003,Alexander County, NC,Sep-17,18247,17613,634,3.5
CN3700300000000,37,003,Alexander County, NC,Oct-17,18150,17528,622,3.4
CN3700300000000,37,003,Alexander County, NC,Nov-17,18117,17452,665,3.7
CN3700300000000,37,003,Alexander County, NC,Dec-17,18023,17383,640,3.6
CN3700300000000,37,003,Alexander County, NC,Jan-18,18170,17505,665,3.7
CN3700300000000,37,003,Alexander County, NC,Feb-18,18355,17707,648,3.5
CN3700300000000,37,003,Alexander County, NC,Mar-18,18362,17728,634,3.5
CN3700300000000,37,003,Alexander County, NC,Apr-18(p),18318,17770,548,3.0
CN4102900000000,41,029,Jackson County, OR,Mar-17,102266,97001,5265,5.1
CN4102900000000,41,029,Jackson County, OR,Apr-17,102655,97882,4773,4.6
CN4102900000000,41,029,Jackson County, OR,May-17,102868,98361,4507,4.4
CN4102900000000,41,029,Jackson County, OR,Jun-17,104093,98950,5143,4.9
CN4102900000000,41,029,Jackson County, OR,Jul-17,103973,98495,5478,5.3
CN4102900000000,41,029,Jackson County, OR,Aug-17,105321,99793,5528,5.2
CN4102900000000,41,029,Jackson County, OR,Sep-17,106149,101489,4660,4.4
CN4102900000000,41,029,Jackson County, OR,Oct-17,106492,101955,4537,4.3
CN4102900000000,41,029,Jackson County, OR,Nov-17,106271,101744,4527,4.3
CN4102900000000,41,029,Jackson County, OR,Dec-17,105089,100686,4403,4.2
CN4102900000000,41,029,Jackson County, OR,Jan-18,104147,98950,5197,5.0
CN4102900000000,41,029,Jackson County, OR,Feb-18,105657,100192,5465,5.2
CN4102900000000,41,029,Jackson County, OR,Mar-18,105536,100100,5436,5.2
CN4102900000000,41,029,Jackson County, OR,Apr-18(p),105039,100301,4738,4.5
CN4715500000000,47,155,Sevier County, TN,Mar-17,51158,48533,2625,5.1
CN4715500000000,47,155,Sevier County, TN,Apr-17,52216,50447,1769,3.4
CN4715500000000,47,155,Sevier County, TN,May-17,52711,51161,1550,2.9
CN4715500000000,47,155,Sevier County, TN,Jun-17,54261,52421,1840,3.4
CN4715500000000,47,155,Sevier County, TN,Jul-17,54522,52826,1696,3.1
CN4715500000000,47,155,Sevier County, TN,Aug-17,53662,52067,1595,3.0
CN4715500000000,47,155,Sevier County, TN,Sep-17,52749,51288,1461,2.8
CN4715500000000,47,155,Sevier County, TN,Oct-17,52173,50797,1376,2.6
CN4715500000000,47,155,Sevier County, TN,Nov-17,51713,50283,1430,2.8
CN4715500000000,47,155,Sevier County, TN,Dec-17,51403,49913,1490,2.9
CN4715500000000,47,155,Sevier County, TN,Jan-18,51207,48054,3153,6.2
CN4715500000000,47,155,Sevier County, TN,Feb-18,50575,47375,3200,6.3
CN4715500000000,47,155,Sevier County, TN,Mar-18,51456,49487,1969,3.8
CN4715500000000,47,155,Sevier County, TN,Apr-18(p),53267,51871,1396,2.6
CN2017300000000,20,173,Sedgwick County, KS,Mar-17,244839,234367,10472,4.3
CN2017300000000,20,173,Sedgwick County, KS,Apr-17,245189,235341,9848,4.0
CN2017300000000,20,173,Sedgwick County, KS,May-17,244145,233975,10170,4.2
CN2017300000000,20,173,Sedgwick County, KS,Jun-17,247213,236043,11170,4.5
CN2017300000000,20,173,Sedgwick County, KS,Jul-17,249035,237141,11894,4.8
CN2017300000000,20,173,Sedgwick County, KS,Aug-17,244531,233190,11341,4.6
CN2017300000000,20,173,Sedgwick County, KS,Sep-17,242274,232669,9605,4.0
CN2017300000000,20,173,Sedgwick County, KS,Oct-17,242175,233508,8667,3.6
CN2017300000000,20,173,Sedgwick County, KS,Nov-17,242557,233613,8944,3.7
CN2017300000000,20,173,Sedgwick County, KS,Dec-17,242012,233370,8642,3.6
CN2017300000000,20,173,Sedgwick County, KS,Jan-18,242539,233102,9437,3.9
CN2017300000000,20,173,Sedgwick County, KS,Feb-18,242630,232559,10071,4.2
CN2017300000000,20,173,Sedgwick County, KS,Mar-18,241815,232299,9516,3.9
CN2017300000000,20,173,Sedgwick County, KS,Apr-18(p),243239,234332,8907,3.7
CN1200900000000,12,009,Brevard County, FL,Mar-17,268680,257117,11563,4.3
CN1200900000000,12,009,Brevard County, FL,Apr-17,267756,256757,10999,4.1
CN1200900000000,12,009,Brevard County, FL,May-17,269419,258216,11203,4.2
CN1200900000000,12,009,Brevard County, FL,Jun-17,271759,259795,11964,4.4
CN1200900000000,12,009,Brevard County, FL,Jul-17,272917,260892,12025,4.4
CN1200900000000,12,009,Brevard County, FL,Aug-17,270875,259052,11823,4.4
CN1200900000000,12,009,Brevard County, FL,Sep-17,271905,260931,10974,4.0
CN1200900000000,12,009,Brevard County, FL,Oct-17,268145,257777,10368,3.9
CN1200900000000,12,009,Brevard County, FL,Nov-17,266055,255712,10343,3.9
CN1200900000000,12,009,Brevard County, FL,Dec-17,263565,253878,9687,3.7
CN1200900000000,12,009,Brevard County, FL,Jan-18,266960,255760,11200,4.2
CN1200900000000,12,009,Brevard County, FL,Feb-18,267550,257327,10223,3.8
CN1200900000000,12,009,Brevard County, FL,Mar-18,269570,259405,10165,3.8
CN1200900000000,12,009,Brevard County, FL,Apr-18(p),268534,259353,9181,3.4
CN2608700000000,26,087,Lapeer County, MI,Mar-17,41289,38697,2592,6.3
CN2608700000000,26,087,Lapeer County, MI,Apr-17,40402,38688,1714,4.2
CN2608700000000,26,087,Lapeer County, MI,May-17,40596,39010,1586,3.9
CN2608700000000,26,087,Lapeer County, MI,Jun-17,40907,39035,1872,4.6
CN2608700000000,26,087,Lapeer County, MI,Jul-17,41589,39297,2292,5.5
CN2608700000000,26,087,Lapeer County, MI,Aug-17,41304,39122,2182,5.3
CN2608700000000,26,087,Lapeer County, MI,Sep-17,41273,39366,1907,4.6
CN2608700000000,26,087,Lapeer County, MI,Oct-17,41083,39181,1902,4.6
CN2608700000000,26,087,Lapeer County, MI,Nov-17,40860,39098,1762,4.3
CN2608700000000,26,087,Lapeer County, MI,Dec-17,41343,39039,2304,5.6
CN2608700000000,26,087,Lapeer County, MI,Jan-18,41105,38186,2919,7.1
CN2608700000000,26,087,Lapeer County, MI,Feb-18,41327,38576,2751,6.7
CN2608700000000,26,087,Lapeer County, MI,Mar-18,41353,38817,2536,6.1
CN2608700000000,26,087,Lapeer County, MI,Apr-18(p),40701,38785,1916,4.7
CN4507500000000,45,075,Orangeburg County, SC,Mar-17,34926,32663,2263,6.5
CN4507500000000,45,075,Orangeburg County, SC,Apr-17,34838,32744,2094,6.0
CN4507500000000,45,075,Orangeburg County, SC,May-17,34845,32738,2107,6.0
CN4507500000000,45,075,Orangeburg County, SC,Jun-17,35151,32713,2438,6.9
CN4507500000000,45,075,Orangeburg County, SC,Jul-17,35161,32708,2453,7.0
CN4507500000000,45,075,Orangeburg County, SC,Aug-17,35848,32382,3466,9.7
CN4507500000000,45,075,Orangeburg County, SC,Sep-17,34955,32542,2413,6.9
CN4507500000000,45,075,Orangeburg County, SC,Oct-17,35336,32681,2655,7.5
CN4507500000000,45,075,Orangeburg County, SC,Nov-17,35026,32769,2257,6.4
CN4507500000000,45,075,Orangeburg County, SC,Dec-17,35372,33021,2351,6.6
CN4507500000000,45,075,Orangeburg County, SC,Jan-18,35529,32723,2806,7.9
CN4507500000000,45,075,Orangeburg County, SC,Feb-18,35614,33131,2483,7.0
CN4507500000000,45,075,Orangeburg County, SC,Mar-18,35076,32880,2196,6.3
CN4507500000000,45,075,Orangeburg County, SC,Apr-18(p),34439,32884,1555,4.5
CN2803300000000,28,033,DeSoto County, MS,Mar-17,87485,84144,3341,3.8
CN2803300000000,28,033,DeSoto County, MS,Apr-17,87502,84446,3056,3.5
CN2803300000000,28,033,DeSoto County, MS,May-17,87966,84229,3737,4.2
CN2803300000000,28,033,DeSoto County, MS,Jun-17,88714,84613,4101,4.6
CN2803300000000,28,033,DeSoto County, MS,Jul-17,89059,85332,3727,4.2
CN2803300000000,28,033,DeSoto County, MS,Aug-17,87519,84354,3165,3.6
CN2803300000000,28,033,DeSoto County, MS,Sep-17,87936,84852,3084,3.5
CN2803300000000,28,033,DeSoto County, MS,Oct-17,88165,85234,2931,3.3
CN2803300000000,28,033,DeSoto County, MS,Nov-17,89654,86774,2880,3.2
CN2803300000000,28,033,DeSoto County, MS,Dec-17,89411,86517,2894,3.2
CN2803300000000,28,033,DeSoto County, MS,Jan-18,87528,84618,2910,3.3
CN2803300000000,28,033,DeSoto County, MS,Feb-18,88223,85244,2979,3.4
CN2803300000000,28,033,DeSoto County, MS,Mar-18,88265,85374,2891,3.3
CN2803300000000,28,033,DeSoto County, MS,Apr-18(p),88481,85509,2972,3.4
CN2107900000000,21,079,Garrard County, KY,Mar-17,7811,7393,418,5.4
CN2107900000000,21,079,Garrard County, KY,Apr-17,7809,7445,364,4.7
CN2107900000000,21,079,Garrard County, KY,May-17,7794,7425,369,4.7
CN2107900000000,21,079,Garrard County, KY,Jun-17,7871,7470,401,5.1
CN2107900000000,21,079,Garrard County, KY,Jul-17,7710,7303,407,5.3
CN2107900000000,21,079,Garrard County, KY,Aug-17,7717,7353,364,4.7
CN2107900000000,21,079,Garrard County, KY,Sep-17,7737,7387,350,4.5
CN2107900000000,21,079,Garrard County, KY,Oct-17,7690,7385,305,4.0
CN2107900000000,21,079,Garrard County, KY,Nov-17,7716,7420,296,3.8
CN2107900000000,21,079,Garrard County, KY,Dec-17,7711,7421,290,3.8
CN2107900000000,21,079,Garrard County, KY,Jan-18,7649,7331,318,4.2
CN2107900000000,21,079,Garrard County, KY,Feb-18,7771,7410,361,4.6
CN2107900000000,21,079,Garrard County, KY,Mar-18,7849,7490,359,4.6
CN2107900000000,21,079,Garrard County, KY,Apr-18(p),7853,7546,307,3.9
CN4006700000000,40,067,Jefferson County, OK,Mar-17,2564,2417,147,5.7
CN4006700000000,40,067,Jefferson County, OK,Apr-17,2480,2343,137,5.5
CN4006700000000,40,067,Jefferson County, OK,May-17,2449,2300,149,6.1
CN4006700000000,40,067,Jefferson County, OK,Jun-17,2420,2275,145,6.0
CN4006700000000,40,067,Jefferson County, OK,Jul-17,2300,2171,129,5.6
CN4006700000000,40,067,Jefferson County, OK,Aug-17,2482,2354,128,5.2
CN4006700000000,40,067,Jefferson County, OK,Sep-17,2565,2438,127,5.0
CN4006700000000,40,067,Jefferson County, OK,Oct-17,2540,2419,121,4.8
CN4006700000000,40,067,Jefferson County, OK,Nov-17,2567,2447,120,4.7
CN4006700000000,40,067,Jefferson County, OK,Dec-17,2531,2408,123,4.9
CN4006700000000,40,067,Jefferson County, OK,Jan-18,2519,2395,124,4.9
CN4006700000000,40,067,Jefferson County, OK,Feb-18,2558,2445,113,4.4
CN4006700000000,40,067,Jefferson County, OK,Mar-18,2536,2425,111,4.4
CN4006700000000,40,067,Jefferson County, OK,Apr-18(p),2488,2380,108,4.3
CN1320700000000,13,207,Monroe County, GA,Mar-17,13263,12652,611,4.6
CN1320700000000,13,207,Monroe County, GA,Apr-17,13170,12610,560,4.3
CN1320700000000,13,207,Monroe County, GA,May-17,13197,12623,574,4.3
CN1320700000000,13,207,Monroe County, GA,Jun-17,13302,12673,629,4.7
CN1320700000000,13,207,Monroe County, GA,Jul-17,13283,12647,636,4.8
CN1320700000000,13,207,Monroe County, GA,Aug-17,13243,12590,653,4.9
CN1320700000000,13,207,Monroe County, GA,Sep-17,13271,12697,574,4.3
CN1320700000000,13,207,Monroe County, GA,Oct-17,13178,12630,548,4.2
CN1320700000000,13,207,Monroe County, GA,Nov-17,13200,12682,518,3.9
CN1320700000000,13,207,Monroe County, GA,Dec-17,13259,12718,541,4.1
CN1320700000000,13,207,Monroe County, GA,Jan-18,13365,12769,596,4.5
CN1320700000000,13,207,Monroe County, GA,Feb-18,13365,12824,541,4.0
CN1320700000000,13,207,Monroe County, GA,Mar-18,13365,12853,512,3.8
CN1320700000000,13,207,Monroe County, GA,Apr-18(p),13261,12819,442,3.3
CN4829700000000,48,297,Live Oak County, TX,Mar-17,5287,5026,261,4.9
CN4829700000000,48,297,Live Oak County, TX,Apr-17,5322,5082,240,4.5
CN4829700000000,48,297,Live Oak County, TX,May-17,5387,5142,245,4.5
CN4829700000000,48,297,Live Oak County, TX,Jun-17,5522,5263,259,4.7
CN4829700000000,48,297,Live Oak County, TX,Jul-17,5482,5235,247,4.5
CN4829700000000,48,297,Live Oak County, TX,Aug-17,5453,5197,256,4.7
CN4829700000000,48,297,Live Oak County, TX,Sep-17,5497,5266,231,4.2
CN4829700000000,48,297,Live Oak County, TX,Oct-17,5424,5201,223,4.1
CN4829700000000,48,297,Live Oak County, TX,Nov-17,5357,5131,226,4.2
CN4829700000000,48,297,Live Oak County, TX,Dec-17,5340,5127,213,4.0
CN4829700000000,48,297,Live Oak County, TX,Jan-18,5316,5072,244,4.6
CN4829700000000,48,297,Live Oak County, TX,Feb-18,5391,5170,221,4.1
CN4829700000000,48,297,Live Oak County, TX,Mar-18,5414,5199,215,4.0
CN4829700000000,48,297,Live Oak County, TX,Apr-18(p),5495,5303,192,3.5
CN0811700000000,08,117,Summit County, CO,Mar-17,24172,23815,357,1.5
CN0811700000000,08,117,Summit County, CO,Apr-17,22365,22022,343,1.5
CN0811700000000,08,117,Summit County, CO,May-17,18631,18133,498,2.7
CN0811700000000,08,117,Summit County, CO,Jun-17,20664,20224,440,2.1
CN0811700000000,08,117,Summit County, CO,Jul-17,21316,20933,383,1.8
CN0811700000000,08,117,Summit County, CO,Aug-17,21206,20833,373,1.8
CN0811700000000,08,117,Summit County, CO,Sep-17,20753,20362,391,1.9
CN0811700000000,08,117,Summit County, CO,Oct-17,20247,19789,458,2.3
CN0811700000000,08,117,Summit County, CO,Nov-17,21828,21379,449,2.1
CN0811700000000,08,117,Summit County, CO,Dec-17,24660,24260,400,1.6
CN0811700000000,08,117,Summit County, CO,Jan-18,25010,24562,448,1.8
CN0811700000000,08,117,Summit County, CO,Feb-18,25419,24972,447,1.8
CN0811700000000,08,117,Summit County, CO,Mar-18,25292,24900,392,1.5
CN0811700000000,08,117,Summit County, CO,Apr-18(p),23381,23034,347,1.5
CN1809100000000,18,091,LaPorte County, IN,Mar-17,47623,45304,2319,4.9
CN1809100000000,18,091,LaPorte County, IN,Apr-17,47721,45850,1871,3.9
CN1809100000000,18,091,LaPorte County, IN,May-17,47898,46019,1879,3.9
CN1809100000000,18,091,LaPorte County, IN,Jun-17,48388,46364,2024,4.2
CN1809100000000,18,091,LaPorte County, IN,Jul-17,48212,46174,2038,4.2
CN1809100000000,18,091,LaPorte County, IN,Aug-17,47716,45516,2200,4.6
CN1809100000000,18,091,LaPorte County, IN,Sep-17,47378,45526,1852,3.9
CN1809100000000,18,091,LaPorte County, IN,Oct-17,47162,45397,1765,3.7
CN1809100000000,18,091,LaPorte County, IN,Nov-17,47076,45255,1821,3.9
CN1809100000000,18,091,LaPorte County, IN,Dec-17,46711,44793,1918,4.1
CN1809100000000,18,091,LaPorte County, IN,Jan-18,45830,43509,2321,5.1
CN1809100000000,18,091,LaPorte County, IN,Feb-18,47350,44885,2465,5.2
CN1809100000000,18,091,LaPorte County, IN,Mar-18,47515,45318,2197,4.6
CN1809100000000,18,091,LaPorte County, IN,Apr-18(p),47776,45890,1886,3.9
CN4100500000000,41,005,Clackamas County, OR,Mar-17,216193,208112,8081,3.7
CN4100500000000,41,005,Clackamas County, OR,Apr-17,217161,209774,7387,3.4
CN4100500000000,41,005,Clackamas County, OR,May-17,217058,209817,7241,3.3
CN4100500000000,41,005,Clackamas County, OR,Jun-17,219167,210472,8695,4.0
CN4100500000000,41,005,Clackamas County, OR,Jul-17,221257,212108,9149,4.1
CN4100500000000,41,005,Clackamas County, OR,Aug-17,221863,212607,9256,4.2
CN4100500000000,41,005,Clackamas County, OR,Sep-17,221861,213579,8282,3.7
CN4100500000000,41,005,Clackamas County, OR,Oct-17,221703,213563,8140,3.7
CN4100500000000,41,005,Clackamas County, OR,Nov-17,222139,214057,8082,3.6
CN4100500000000,41,005,Clackamas County, OR,Dec-17,220807,213177,7630,3.5
CN4100500000000,41,005,Clackamas County, OR,Jan-18,219994,211873,8121,3.7
CN4100500000000,41,005,Clackamas County, OR,Feb-18,221169,212699,8470,3.8
CN4100500000000,41,005,Clackamas County, OR,Mar-18,220535,212081,8454,3.8
CN4100500000000,41,005,Clackamas County, OR,Apr-18(p),218802,211264,7538,3.4
CN4717900000000,47,179,Washington County, TN,Mar-17,59846,57456,2390,4.0
CN4717900000000,47,179,Washington County, TN,Apr-17,60004,58005,1999,3.3
CN4717900000000,47,179,Washington County, TN,May-17,59402,57460,1942,3.3
CN4717900000000,47,179,Washington County, TN,Jun-17,59025,56503,2522,4.3
CN4717900000000,47,179,Washington County, TN,Jul-17,59408,56982,2426,4.1
CN4717900000000,47,179,Washington County, TN,Aug-17,58911,56609,2302,3.9
CN4717900000000,47,179,Washington County, TN,Sep-17,59754,57734,2020,3.4
CN4717900000000,47,179,Washington County, TN,Oct-17,59660,57711,1949,3.3
CN4717900000000,47,179,Washington County, TN,Nov-17,59309,57364,1945,3.3
CN4717900000000,47,179,Washington County, TN,Dec-17,59158,57277,1881,3.2
CN4717900000000,47,179,Washington County, TN,Jan-18,58560,56326,2234,3.8
CN4717900000000,47,179,Washington County, TN,Feb-18,59574,57388,2186,3.7
CN4717900000000,47,179,Washington County, TN,Mar-18,59624,57550,2074,3.5
CN4717900000000,47,179,Washington County, TN,Apr-18(p),59939,58249,1690,2.8
CN0513100000000,05,131,Sebastian County, AR,Mar-17,57224,55278,1946,3.4
CN0513100000000,05,131,Sebastian County, AR,Apr-17,57231,55380,1851,3.2
CN0513100000000,05,131,Sebastian County, AR,May-17,57535,55496,2039,3.5
CN0513100000000,05,131,Sebastian County, AR,Jun-17,58042,55829,2213,3.8
CN0513100000000,05,131,Sebastian County, AR,Jul-17,58220,55890,2330,4.0
CN0513100000000,05,131,Sebastian County, AR,Aug-17,57758,55586,2172,3.8
CN0513100000000,05,131,Sebastian County, AR,Sep-17,57563,55501,2062,3.6
CN0513100000000,05,131,Sebastian County, AR,Oct-17,56864,54991,1873,3.3
CN0513100000000,05,131,Sebastian County, AR,Nov-17,56699,54804,1895,3.3
CN0513100000000,05,131,Sebastian County, AR,Dec-17,56148,54151,1997,3.6
CN0513100000000,05,131,Sebastian County, AR,Jan-18,55541,53176,2365,4.3
CN0513100000000,05,131,Sebastian County, AR,Feb-18,56259,53861,2398,4.3
CN0513100000000,05,131,Sebastian County, AR,Mar-18,56561,54365,2196,3.9
CN0513100000000,05,131,Sebastian County, AR,Apr-18(p),56403,54399,2004,3.6
CN4903500000000,49,035,Salt Lake County, UT,Mar-17,613207,592824,20383,3.3
CN4903500000000,49,035,Salt Lake County, UT,Apr-17,613470,594276,19194,3.1
CN4903500000000,49,035,Salt Lake County, UT,May-17,620216,601081,19135,3.1
CN4903500000000,49,035,Salt Lake County, UT,Jun-17,625223,603482,21741,3.5
CN4903500000000,49,035,Salt Lake County, UT,Jul-17,628133,607959,20174,3.2
CN4903500000000,49,035,Salt Lake County, UT,Aug-17,626302,605830,20472,3.3
CN4903500000000,49,035,Salt Lake County, UT,Sep-17,623970,605956,18014,2.9
CN4903500000000,49,035,Salt Lake County, UT,Oct-17,624585,607000,17585,2.8
CN4903500000000,49,035,Salt Lake County, UT,Nov-17,630287,613754,16533,2.6
CN4903500000000,49,035,Salt Lake County, UT,Dec-17,628956,611984,16972,2.7
CN4903500000000,49,035,Salt Lake County, UT,Jan-18,624326,605944,18382,2.9
CN4903500000000,49,035,Salt Lake County, UT,Feb-18,630853,610877,19976,3.2
CN4903500000000,49,035,Salt Lake County, UT,Mar-18,631180,610840,20340,3.2
CN4903500000000,49,035,Salt Lake County, UT,Apr-18(p),631114,612186,18928,3.0
CN1817700000000,18,177,Wayne County, IN,Mar-17,30836,29594,1242,4.0
CN1817700000000,18,177,Wayne County, IN,Apr-17,31037,30013,1024,3.3
CN1817700000000,18,177,Wayne County, IN,May-17,31340,30273,1067,3.4
CN1817700000000,18,177,Wayne County, IN,Jun-17,31374,30231,1143,3.6
CN1817700000000,18,177,Wayne County, IN,Jul-17,30771,29582,1189,3.9
CN1817700000000,18,177,Wayne County, IN,Aug-17,30665,29389,1276,4.2
CN1817700000000,18,177,Wayne County, IN,Sep-17,30462,29401,1061,3.5
CN1817700000000,18,177,Wayne County, IN,Oct-17,30744,29729,1015,3.3
CN1817700000000,18,177,Wayne County, IN,Nov-17,30639,29630,1009,3.3
CN1817700000000,18,177,Wayne County, IN,Dec-17,30460,29489,971,3.2
CN1817700000000,18,177,Wayne County, IN,Jan-18,30105,28977,1128,3.7
CN1817700000000,18,177,Wayne County, IN,Feb-18,30488,29313,1175,3.9
CN1817700000000,18,177,Wayne County, IN,Mar-18,30557,29475,1082,3.5
CN1817700000000,18,177,Wayne County, IN,Apr-18(p),30836,29862,974,3.2
CN0805500000000,08,055,Huerfano County, CO,Mar-17,2431,2272,159,6.5
CN0805500000000,08,055,Huerfano County, CO,Apr-17,2490,2353,137,5.5
CN0805500000000,08,055,Huerfano County, CO,May-17,2550,2426,124,4.9
CN0805500000000,08,055,Huerfano County, CO,Jun-17,2655,2503,152,5.7
CN0805500000000,08,055,Huerfano County, CO,Jul-17,2672,2526,146,5.5
CN0805500000000,08,055,Huerfano County, CO,Aug-17,2662,2526,136,5.1
CN0805500000000,08,055,Huerfano County, CO,Sep-17,2648,2523,125,4.7
CN0805500000000,08,055,Huerfano County, CO,Oct-17,2681,2556,125,4.7
CN0805500000000,08,055,Huerfano County, CO,Nov-17,2678,2531,147,5.5
CN0805500000000,08,055,Huerfano County, CO,Dec-17,2656,2481,175,6.6
CN0805500000000,08,055,Huerfano County, CO,Jan-18,2580,2387,193,7.5
CN0805500000000,08,055,Huerfano County, CO,Feb-18,2525,2332,193,7.6
CN0805500000000,08,055,Huerfano County, CO,Mar-18,2554,2392,162,6.3
CN0805500000000,08,055,Huerfano County, CO,Apr-18(p),2612,2475,137,5.2
CN4808300000000,48,083,Coleman County, TX,Mar-17,3113,2965,148,4.8
CN4808300000000,48,083,Coleman County, TX,Apr-17,3097,2971,126,4.1
CN4808300000000,48,083,Coleman County, TX,May-17,3125,2990,135,4.3
CN4808300000000,48,083,Coleman County, TX,Jun-17,3112,2970,142,4.6
CN4808300000000,48,083,Coleman County, TX,Jul-17,3053,2906,147,4.8
CN4808300000000,48,083,Coleman County, TX,Aug-17,3085,2942,143,4.6
CN4808300000000,48,083,Coleman County, TX,Sep-17,3050,2928,122,4.0
CN4808300000000,48,083,Coleman County, TX,Oct-17,3033,2921,112,3.7
CN4808300000000,48,083,Coleman County, TX,Nov-17,3014,2893,121,4.0
CN4808300000000,48,083,Coleman County, TX,Dec-17,3044,2929,115,3.8
CN4808300000000,48,083,Coleman County, TX,Jan-18,3057,2934,123,4.0
CN4808300000000,48,083,Coleman County, TX,Feb-18,3109,2982,127,4.1
CN4808300000000,48,083,Coleman County, TX,Mar-18,3165,3040,125,3.9
CN4808300000000,48,083,Coleman County, TX,Apr-18(p),3121,3006,115,3.7
CN2921900000000,29,219,Warren County, MO,Mar-17,17258,16664,594,3.4
CN2921900000000,29,219,Warren County, MO,Apr-17,17383,16833,550,3.2
CN2921900000000,29,219,Warren County, MO,May-17,17392,16824,568,3.3
CN2921900000000,29,219,Warren County, MO,Jun-17,17542,16967,575,3.3
CN2921900000000,29,219,Warren County, MO,Jul-17,17631,17020,611,3.5
CN2921900000000,29,219,Warren County, MO,Aug-17,17381,16780,601,3.5
CN2921900000000,29,219,Warren County, MO,Sep-17,17284,16806,478,2.8
CN2921900000000,29,219,Warren County, MO,Oct-17,17185,16806,379,2.2
CN2921900000000,29,219,Warren County, MO,Nov-17,17235,16764,471,2.7
CN2921900000000,29,219,Warren County, MO,Dec-17,17115,16629,486,2.8
CN2921900000000,29,219,Warren County, MO,Jan-18,17029,16367,662,3.9
CN2921900000000,29,219,Warren County, MO,Feb-18,17305,16637,668,3.9
CN2921900000000,29,219,Warren County, MO,Mar-18,17250,16665,585,3.4
CN2921900000000,29,219,Warren County, MO,Apr-18(p),17314,16815,499,2.9
CN0603100000000,06,031,Kings County, CA,Mar-17,57534,51094,6440,11.2
CN0603100000000,06,031,Kings County, CA,Apr-17,57632,52077,5555,9.6
CN0603100000000,06,031,Kings County, CA,May-17,57735,53124,4611,8.0
CN0603100000000,06,031,Kings County, CA,Jun-17,58205,53136,5069,8.7
CN0603100000000,06,031,Kings County, CA,Jul-17,58688,53820,4868,8.3
CN0603100000000,06,031,Kings County, CA,Aug-17,58349,53883,4466,7.7
CN0603100000000,06,031,Kings County, CA,Sep-17,57805,53885,3920,6.8
CN0603100000000,06,031,Kings County, CA,Oct-17,57099,53120,3979,7.0
CN0603100000000,06,031,Kings County, CA,Nov-17,57062,52667,4395,7.7
CN0603100000000,06,031,Kings County, CA,Dec-17,56850,52076,4774,8.4
CN0603100000000,06,031,Kings County, CA,Jan-18,57284,51909,5375,9.4
CN0603100000000,06,031,Kings County, CA,Feb-18,57987,52327,5660,9.8
CN0603100000000,06,031,Kings County, CA,Mar-18,57526,52230,5296,9.2
CN0603100000000,06,031,Kings County, CA,Apr-18(p),57327,52753,4574,8.0
CN3101500000000,31,015,Boyd County, NE,Mar-17,1085,1039,46,4.2
CN3101500000000,31,015,Boyd County, NE,Apr-17,1116,1072,44,3.9
CN3101500000000,31,015,Boyd County, NE,May-17,1104,1070,34,3.1
CN3101500000000,31,015,Boyd County, NE,Jun-17,1171,1136,35,3.0
CN3101500000000,31,015,Boyd County, NE,Jul-17,1121,1088,33,2.9
CN3101500000000,31,015,Boyd County, NE,Aug-17,1061,1031,30,2.8
CN3101500000000,31,015,Boyd County, NE,Sep-17,1028,1001,27,2.6
CN3101500000000,31,015,Boyd County, NE,Oct-17,1039,1012,27,2.6
CN3101500000000,31,015,Boyd County, NE,Nov-17,1038,1018,20,1.9
CN3101500000000,31,015,Boyd County, NE,Dec-17,1055,1018,37,3.5
CN3101500000000,31,015,Boyd County, NE,Jan-18,1082,1040,42,3.9
CN3101500000000,31,015,Boyd County, NE,Feb-18,1058,1017,41,3.9
CN3101500000000,31,015,Boyd County, NE,Mar-18,1078,1037,41,3.8
CN3101500000000,31,015,Boyd County, NE,Apr-18(p),1082,1045,37,3.4
CN4833500000000,48,335,Mitchell County, TX,Mar-17,2619,2464,155,5.9
CN4833500000000,48,335,Mitchell County, TX,Apr-17,2597,2458,139,5.4
CN4833500000000,48,335,Mitchell County, TX,May-17,2549,2412,137,5.4
CN4833500000000,48,335,Mitchell County, TX,Jun-17,2555,2411,144,5.6
CN4833500000000,48,335,Mitchell County, TX,Jul-17,2509,2366,143,5.7
CN4833500000000,48,335,Mitchell County, TX,Aug-17,2476,2342,134,5.4
CN4833500000000,48,335,Mitchell County, TX,Sep-17,2466,2349,117,4.7
CN4833500000000,48,335,Mitchell County, TX,Oct-17,2458,2348,110,4.5
CN4833500000000,48,335,Mitchell County, TX,Nov-17,2448,2333,115,4.7
CN4833500000000,48,335,Mitchell County, TX,Dec-17,2461,2350,111,4.5
CN4833500000000,48,335,Mitchell County, TX,Jan-18,2458,2325,133,5.4
CN4833500000000,48,335,Mitchell County, TX,Feb-18,2475,2349,126,5.1
CN4833500000000,48,335,Mitchell County, TX,Mar-18,2475,2351,124,5.0
CN4833500000000,48,335,Mitchell County, TX,Apr-18(p),2378,2272,106,4.5
CN1500100000000,15,001,Hawaii County, HI,Mar-17,91811,89111,2700,2.9
CN1500100000000,15,001,Hawaii County, HI,Apr-17,92171,89473,2698,2.9
CN1500100000000,15,001,Hawaii County, HI,May-17,91897,89325,2572,2.8
CN1500100000000,15,001,Hawaii County, HI,Jun-17,92906,89619,3287,3.5
CN1500100000000,15,001,Hawaii County, HI,Jul-17,92330,89509,2821,3.1
CN1500100000000,15,001,Hawaii County, HI,Aug-17,91786,89524,2262,2.5
CN1500100000000,15,001,Hawaii County, HI,Sep-17,90606,88263,2343,2.6
CN1500100000000,15,001,Hawaii County, HI,Oct-17,90702,88461,2241,2.5
CN1500100000000,15,001,Hawaii County, HI,Nov-17,90287,88071,2216,2.5
CN1500100000000,15,001,Hawaii County, HI,Dec-17,89945,88123,1822,2.0
CN1500100000000,15,001,Hawaii County, HI,Jan-18,89568,87474,2094,2.3
CN1500100000000,15,001,Hawaii County, HI,Feb-18,89925,87928,1997,2.2
CN1500100000000,15,001,Hawaii County, HI,Mar-18,90773,88632,2141,2.4
CN1500100000000,15,001,Hawaii County, HI,Apr-18(p),91356,89307,2049,2.2
CN2120100000000,21,201,Robertson County, KY,Mar-17,854,792,62,7.3
CN2120100000000,21,201,Robertson County, KY,Apr-17,868,816,52,6.0
CN2120100000000,21,201,Robertson County, KY,May-17,860,810,50,5.8
CN2120100000000,21,201,Robertson County, KY,Jun-17,860,801,59,6.9
CN2120100000000,21,201,Robertson County, KY,Jul-17,804,750,54,6.7
CN2120100000000,21,201,Robertson County, KY,Aug-17,815,765,50,6.1
CN2120100000000,21,201,Robertson County, KY,Sep-17,824,776,48,5.8
CN2120100000000,21,201,Robertson County, KY,Oct-17,825,786,39,4.7
CN2120100000000,21,201,Robertson County, KY,Nov-17,831,793,38,4.6
CN2120100000000,21,201,Robertson County, KY,Dec-17,824,784,40,4.9
CN2120100000000,21,201,Robertson County, KY,Jan-18,822,778,44,5.4
CN2120100000000,21,201,Robertson County, KY,Feb-18,816,765,51,6.3
CN2120100000000,21,201,Robertson County, KY,Mar-18,818,773,45,5.5
CN2120100000000,21,201,Robertson County, KY,Apr-18(p),822,788,34,4.1
CN3400500000000,34,005,Burlington County, NJ,Mar-17,234376,225208,9168,3.9
CN3400500000000,34,005,Burlington County, NJ,Apr-17,233825,225397,8428,3.6
CN3400500000000,34,005,Burlington County, NJ,May-17,233803,224607,9196,3.9
CN3400500000000,34,005,Burlington County, NJ,Jun-17,235060,225351,9709,4.1
CN3400500000000,34,005,Burlington County, NJ,Jul-17,234720,223670,11050,4.7
CN3400500000000,34,005,Burlington County, NJ,Aug-17,233473,222731,10742,4.6
CN3400500000000,34,005,Burlington County, NJ,Sep-17,234058,224256,9802,4.2
CN3400500000000,34,005,Burlington County, NJ,Oct-17,234260,224977,9283,4.0
CN3400500000000,34,005,Burlington County, NJ,Nov-17,235039,225951,9088,3.9
CN3400500000000,34,005,Burlington County, NJ,Dec-17,233681,225074,8607,3.7
CN3400500000000,34,005,Burlington County, NJ,Jan-18,232173,222371,9802,4.2
CN3400500000000,34,005,Burlington County, NJ,Feb-18,233784,223872,9912,4.2
CN3400500000000,34,005,Burlington County, NJ,Mar-18,233794,224319,9475,4.1
CN3400500000000,34,005,Burlington County, NJ,Apr-18(p),232883,224631,8252,3.5
CN0509300000000,05,093,Mississippi County, AR,Mar-17,17874,16839,1035,5.8
CN0509300000000,05,093,Mississippi County, AR,Apr-17,17688,16775,913,5.2
CN0509300000000,05,093,Mississippi County, AR,May-17,17867,16842,1025,5.7
CN0509300000000,05,093,Mississippi County, AR,Jun-17,18303,16784,1519,8.3
CN0509300000000,05,093,Mississippi County, AR,Jul-17,18166,16876,1290,7.1
CN0509300000000,05,093,Mississippi County, AR,Aug-17,18110,16984,1126,6.2
CN0509300000000,05,093,Mississippi County, AR,Sep-17,18169,17291,878,4.8
CN0509300000000,05,093,Mississippi County, AR,Oct-17,18017,17221,796,4.4
CN0509300000000,05,093,Mississippi County, AR,Nov-17,17750,16922,828,4.7
CN0509300000000,05,093,Mississippi County, AR,Dec-17,17617,16701,916,5.2
CN0509300000000,05,093,Mississippi County, AR,Jan-18,17300,16209,1091,6.3
CN0509300000000,05,093,Mississippi County, AR,Feb-18,17470,16408,1062,6.1
CN0509300000000,05,093,Mississippi County, AR,Mar-18,17610,16593,1017,5.8
CN0509300000000,05,093,Mississippi County, AR,Apr-18(p),17533,16631,902,5.1
CN1702500000000,17,025,Clay County, IL,Mar-17,6586,6207,379,5.8
CN1702500000000,17,025,Clay County, IL,Apr-17,6664,6353,311,4.7
CN1702500000000,17,025,Clay County, IL,May-17,6664,6370,294,4.4
CN1702500000000,17,025,Clay County, IL,Jun-17,6775,6458,317,4.7
CN1702500000000,17,025,Clay County, IL,Jul-17,6642,6297,345,5.2
CN1702500000000,17,025,Clay County, IL,Aug-17,6625,6271,354,5.3
CN1702500000000,17,025,Clay County, IL,Sep-17,6627,6300,327,4.9
CN1702500000000,17,025,Clay County, IL,Oct-17,6577,6292,285,4.3
CN1702500000000,17,025,Clay County, IL,Nov-17,6586,6284,302,4.6
CN1702500000000,17,025,Clay County, IL,Dec-17,6541,6222,319,4.9
CN1702500000000,17,025,Clay County, IL,Jan-18,6593,6233,360,5.5
CN1702500000000,17,025,Clay County, IL,Feb-18,6633,6312,321,4.8
CN1702500000000,17,025,Clay County, IL,Mar-18,6779,6442,337,5.0
CN1702500000000,17,025,Clay County, IL,Apr-18(p),6814,6558,256,3.8
CN0800100000000,08,001,Adams County, CO,Mar-17,257055,249132,7923,3.1
CN0800100000000,08,001,Adams County, CO,Apr-17,257459,250266,7193,2.8
CN0800100000000,08,001,Adams County, CO,May-17,259185,252176,7009,2.7
CN0800100000000,08,001,Adams County, CO,Jun-17,262789,254534,8255,3.1
CN0800100000000,08,001,Adams County, CO,Jul-17,263910,255952,7958,3.0
CN0800100000000,08,001,Adams County, CO,Aug-17,263749,255888,7861,3.0
CN0800100000000,08,001,Adams County, CO,Sep-17,264929,257274,7655,2.9
CN0800100000000,08,001,Adams County, CO,Oct-17,264688,256940,7748,2.9
CN0800100000000,08,001,Adams County, CO,Nov-17,264931,256881,8050,3.0
CN0800100000000,08,001,Adams County, CO,Dec-17,264405,255939,8466,3.2
CN0800100000000,08,001,Adams County, CO,Jan-18,263548,253985,9563,3.6
CN0800100000000,08,001,Adams County, CO,Feb-18,267170,257547,9623,3.6
CN0800100000000,08,001,Adams County, CO,Mar-18,266854,258387,8467,3.2
CN0800100000000,08,001,Adams County, CO,Apr-18(p),266375,258870,7505,2.8
CN2204500000000,22,045,Iberia Parish, LA,Mar-17,29684,27223,2461,8.3
CN2204500000000,22,045,Iberia Parish, LA,Apr-17,29662,27409,2253,7.6
CN2204500000000,22,045,Iberia Parish, LA,May-17,29769,27528,2241,7.5
CN2204500000000,22,045,Iberia Parish, LA,Jun-17,30239,27816,2423,8.0
CN2204500000000,22,045,Iberia Parish, LA,Jul-17,30131,27891,2240,7.4
CN2204500000000,22,045,Iberia Parish, LA,Aug-17,29578,27392,2186,7.4
CN2204500000000,22,045,Iberia Parish, LA,Sep-17,29219,27344,1875,6.4
CN2204500000000,22,045,Iberia Parish, LA,Oct-17,29102,27431,1671,5.7
CN2204500000000,22,045,Iberia Parish, LA,Nov-17,29023,27431,1592,5.5
CN2204500000000,22,045,Iberia Parish, LA,Dec-17,28792,27277,1515,5.3
CN2204500000000,22,045,Iberia Parish, LA,Jan-18,28962,27327,1635,5.6
CN2204500000000,22,045,Iberia Parish, LA,Feb-18,29060,27551,1509,5.2
CN2204500000000,22,045,Iberia Parish, LA,Mar-18,29316,27697,1619,5.5
CN2204500000000,22,045,Iberia Parish, LA,Apr-18(p),29319,27746,1573,5.4
CN1718700000000,17,187,Warren County, IL,Mar-17,8633,8262,371,4.3
CN1718700000000,17,187,Warren County, IL,Apr-17,8680,8375,305,3.5
CN1718700000000,17,187,Warren County, IL,May-17,8708,8393,315,3.6
CN1718700000000,17,187,Warren County, IL,Jun-17,8745,8373,372,4.3
CN1718700000000,17,187,Warren County, IL,Jul-17,8738,8353,385,4.4
CN1718700000000,17,187,Warren County, IL,Aug-17,8544,8192,352,4.1
CN1718700000000,17,187,Warren County, IL,Sep-17,8671,8362,309,3.6
CN1718700000000,17,187,Warren County, IL,Oct-17,8682,8366,316,3.6
CN1718700000000,17,187,Warren County, IL,Nov-17,8635,8322,313,3.6
CN1718700000000,17,187,Warren County, IL,Dec-17,8552,8244,308,3.6
CN1718700000000,17,187,Warren County, IL,Jan-18,8471,8113,358,4.2
CN1718700000000,17,187,Warren County, IL,Feb-18,8537,8213,324,3.8
CN1718700000000,17,187,Warren County, IL,Mar-18,8703,8370,333,3.8
CN1718700000000,17,187,Warren County, IL,Apr-18(p),8823,8552,271,3.1
CN1328900000000,13,289,Twiggs County, GA,Mar-17,2974,2754,220,7.4
CN1328900000000,13,289,Twiggs County, GA,Apr-17,2948,2732,216,7.3
CN1328900000000,13,289,Twiggs County, GA,May-17,2955,2738,217,7.3
CN1328900000000,13,289,Twiggs County, GA,Jun-17,2966,2749,217,7.3
CN1328900000000,13,289,Twiggs County, GA,Jul-17,2978,2744,234,7.9
CN1328900000000,13,289,Twiggs County, GA,Aug-17,2966,2740,226,7.6
CN1328900000000,13,289,Twiggs County, GA,Sep-17,2984,2757,227,7.6
CN1328900000000,13,289,Twiggs County, GA,Oct-17,2951,2746,205,6.9
CN1328900000000,13,289,Twiggs County, GA,Nov-17,2970,2764,206,6.9
CN1328900000000,13,289,Twiggs County, GA,Dec-17,2986,2772,214,7.2
CN1328900000000,13,289,Twiggs County, GA,Jan-18,3013,2773,240,8.0
CN1328900000000,13,289,Twiggs County, GA,Feb-18,3001,2791,210,7.0
CN1328900000000,13,289,Twiggs County, GA,Mar-18,2997,2802,195,6.5
CN1328900000000,13,289,Twiggs County, GA,Apr-18(p),2936,2777,159,5.4
CN3109700000000,31,097,Johnson County, NE,Mar-17,2083,2010,73,3.5
CN3109700000000,31,097,Johnson County, NE,Apr-17,2099,2036,63,3.0
CN3109700000000,31,097,Johnson County, NE,May-17,2099,2039,60,2.9
CN3109700000000,31,097,Johnson County, NE,Jun-17,2150,2078,72,3.3
CN3109700000000,31,097,Johnson County, NE,Jul-17,2112,2042,70,3.3
CN3109700000000,31,097,Johnson County, NE,Aug-17,2060,1992,68,3.3
CN3109700000000,31,097,Johnson County, NE,Sep-17,1994,1921,73,3.7
CN3109700000000,31,097,Johnson County, NE,Oct-17,1987,1929,58,2.9
CN3109700000000,31,097,Johnson County, NE,Nov-17,1999,1940,59,3.0
CN3109700000000,31,097,Johnson County, NE,Dec-17,1998,1929,69,3.5
CN3109700000000,31,097,Johnson County, NE,Jan-18,2041,1952,89,4.4
CN3109700000000,31,097,Johnson County, NE,Feb-18,2044,1958,86,4.2
CN3109700000000,31,097,Johnson County, NE,Mar-18,2046,1973,73,3.6
CN3109700000000,31,097,Johnson County, NE,Apr-18(p),2043,1969,74,3.6
CN3115900000000,31,159,Seward County, NE,Mar-17,8703,8473,230,2.6
CN3115900000000,31,159,Seward County, NE,Apr-17,8778,8554,224,2.6
CN3115900000000,31,159,Seward County, NE,May-17,8799,8565,234,2.7
CN3115900000000,31,159,Seward County, NE,Jun-17,8841,8560,281,3.2
CN3115900000000,31,159,Seward County, NE,Jul-17,8847,8578,269,3.0
CN3115900000000,31,159,Seward County, NE,Aug-17,8779,8547,232,2.6
CN3115900000000,31,159,Seward County, NE,Sep-17,8641,8423,218,2.5
CN3115900000000,31,159,Seward County, NE,Oct-17,8656,8453,203,2.3
CN3115900000000,31,159,Seward County, NE,Nov-17,8681,8507,174,2.0
CN3115900000000,31,159,Seward County, NE,Dec-17,8657,8461,196,2.3
CN3115900000000,31,159,Seward County, NE,Jan-18,8643,8421,222,2.6
CN3115900000000,31,159,Seward County, NE,Feb-18,8670,8451,219,2.5
CN3115900000000,31,159,Seward County, NE,Mar-18,8734,8510,224,2.6
CN3115900000000,31,159,Seward County, NE,Apr-18(p),8804,8579,225,2.6
CN4718300000000,47,183,Weakley County, TN,Mar-17,16201,15479,722,4.5
CN4718300000000,47,183,Weakley County, TN,Apr-17,16054,15455,599,3.7
CN4718300000000,47,183,Weakley County, TN,May-17,15933,15335,598,3.8
CN4718300000000,47,183,Weakley County, TN,Jun-17,15559,14741,818,5.3
CN4718300000000,47,183,Weakley County, TN,Jul-17,15000,13942,1058,7.1
CN4718300000000,47,183,Weakley County, TN,Aug-17,15913,14953,960,6.0
CN4718300000000,47,183,Weakley County, TN,Sep-17,16040,15197,843,5.3
CN4718300000000,47,183,Weakley County, TN,Oct-17,15987,15238,749,4.7
CN4718300000000,47,183,Weakley County, TN,Nov-17,15989,15380,609,3.8
CN4718300000000,47,183,Weakley County, TN,Dec-17,15777,15210,567,3.6
CN4718300000000,47,183,Weakley County, TN,Jan-18,15697,15012,685,4.4
CN4718300000000,47,183,Weakley County, TN,Feb-18,16091,15454,637,4.0
CN4718300000000,47,183,Weakley County, TN,Mar-18,15969,15356,613,3.8
CN4718300000000,47,183,Weakley County, TN,Apr-18(p),16032,15505,527,3.3
CN4807300000000,48,073,Cherokee County, TX,Mar-17,21231,20240,991,4.7
CN4807300000000,48,073,Cherokee County, TX,Apr-17,20842,19946,896,4.3
CN4807300000000,48,073,Cherokee County, TX,May-17,20777,19884,893,4.3
CN4807300000000,48,073,Cherokee County, TX,Jun-17,20667,19698,969,4.7
CN4807300000000,48,073,Cherokee County, TX,Jul-17,20436,19469,967,4.7
CN4807300000000,48,073,Cherokee County, TX,Aug-17,20535,19567,968,4.7
CN4807300000000,48,073,Cherokee County, TX,Sep-17,20414,19559,855,4.2
CN4807300000000,48,073,Cherokee County, TX,Oct-17,20294,19497,797,3.9
CN4807300000000,48,073,Cherokee County, TX,Nov-17,20327,19499,828,4.1
CN4807300000000,48,073,Cherokee County, TX,Dec-17,20347,19526,821,4.0
CN4807300000000,48,073,Cherokee County, TX,Jan-18,20406,19462,944,4.6
CN4807300000000,48,073,Cherokee County, TX,Feb-18,20692,19746,946,4.6
CN4807300000000,48,073,Cherokee County, TX,Mar-18,20871,19957,914,4.4
CN4807300000000,48,073,Cherokee County, TX,Apr-18(p),20734,19901,833,4.0
CN1321100000000,13,211,Morgan County, GA,Mar-17,8958,8537,421,4.7
CN1321100000000,13,211,Morgan County, GA,Apr-17,8970,8576,394,4.4
CN1321100000000,13,211,Morgan County, GA,May-17,8993,8606,387,4.3
CN1321100000000,13,211,Morgan County, GA,Jun-17,9057,8631,426,4.7
CN1321100000000,13,211,Morgan County, GA,Jul-17,9077,8638,439,4.8
CN1321100000000,13,211,Morgan County, GA,Aug-17,9007,8586,421,4.7
CN1321100000000,13,211,Morgan County, GA,Sep-17,9052,8679,373,4.1
CN1321100000000,13,211,Morgan County, GA,Oct-17,9058,8686,372,4.1
CN1321100000000,13,211,Morgan County, GA,Nov-17,9064,8703,361,4.0
CN1321100000000,13,211,Morgan County, GA,Dec-17,9073,8713,360,4.0
CN1321100000000,13,211,Morgan County, GA,Jan-18,9154,8745,409,4.5
CN1321100000000,13,211,Morgan County, GA,Feb-18,9151,8765,386,4.2
CN1321100000000,13,211,Morgan County, GA,Mar-18,9128,8783,345,3.8
CN1321100000000,13,211,Morgan County, GA,Apr-18(p),9108,8797,311,3.4
CN0400900000000,04,009,Graham County, AZ,Mar-17,14790,13944,846,5.7
CN0400900000000,04,009,Graham County, AZ,Apr-17,14586,13823,763,5.2
CN0400900000000,04,009,Graham County, AZ,May-17,14378,13622,756,5.3
CN0400900000000,04,009,Graham County, AZ,Jun-17,13857,13060,797,5.8
CN0400900000000,04,009,Graham County, AZ,Jul-17,13129,12335,794,6.0
CN0400900000000,04,009,Graham County, AZ,Aug-17,13732,12978,754,5.5
CN0400900000000,04,009,Graham County, AZ,Sep-17,14972,14237,735,4.9
CN0400900000000,04,009,Graham County, AZ,Oct-17,14972,14238,734,4.9
CN0400900000000,04,009,Graham County, AZ,Nov-17,14914,14207,707,4.7
CN0400900000000,04,009,Graham County, AZ,Dec-17,14880,14148,732,4.9
CN0400900000000,04,009,Graham County, AZ,Jan-18,14639,13822,817,5.6
CN0400900000000,04,009,Graham County, AZ,Feb-18,15023,14225,798,5.3
CN0400900000000,04,009,Graham County, AZ,Mar-18,15034,14293,741,4.9
CN0400900000000,04,009,Graham County, AZ,Apr-18(p),14925,14238,687,4.6
CN4003900000000,40,039,Custer County, OK,Mar-17,15403,14849,554,3.6
CN4003900000000,40,039,Custer County, OK,Apr-17,15326,14841,485,3.2
CN4003900000000,40,039,Custer County, OK,May-17,15260,14730,530,3.5
CN4003900000000,40,039,Custer County, OK,Jun-17,15454,14866,588,3.8
CN4003900000000,40,039,Custer County, OK,Jul-17,15208,14690,518,3.4
CN4003900000000,40,039,Custer County, OK,Aug-17,15230,14740,490,3.2
CN4003900000000,40,039,Custer County, OK,Sep-17,15693,15215,478,3.0
CN4003900000000,40,039,Custer County, OK,Oct-17,15361,14923,438,2.9
CN4003900000000,40,039,Custer County, OK,Nov-17,15408,14993,415,2.7
CN4003900000000,40,039,Custer County, OK,Dec-17,15254,14849,405,2.7
CN4003900000000,40,039,Custer County, OK,Jan-18,15192,14732,460,3.0
CN4003900000000,40,039,Custer County, OK,Feb-18,15673,15215,458,2.9
CN4003900000000,40,039,Custer County, OK,Mar-18,15682,15242,440,2.8
CN4003900000000,40,039,Custer County, OK,Apr-18(p),15507,15091,416,2.7
CN3002500000000,30,025,Fallon County, MT,Mar-17,1724,1668,56,3.2
CN3002500000000,30,025,Fallon County, MT,Apr-17,1776,1730,46,2.6
CN3002500000000,30,025,Fallon County, MT,May-17,1794,1750,44,2.5
CN3002500000000,30,025,Fallon County, MT,Jun-17,1807,1755,52,2.9
CN3002500000000,30,025,Fallon County, MT,Jul-17,1797,1753,44,2.4
CN3002500000000,30,025,Fallon County, MT,Aug-17,1819,1778,41,2.3
CN3002500000000,30,025,Fallon County, MT,Sep-17,1728,1689,39,2.3
CN3002500000000,30,025,Fallon County, MT,Oct-17,1730,1691,39,2.3
CN3002500000000,30,025,Fallon County, MT,Nov-17,1727,1685,42,2.4
CN3002500000000,30,025,Fallon County, MT,Dec-17,1701,1656,45,2.6
CN3002500000000,30,025,Fallon County, MT,Jan-18,1682,1633,49,2.9
CN3002500000000,30,025,Fallon County, MT,Feb-18,1672,1628,44,2.6
CN3002500000000,30,025,Fallon County, MT,Mar-18,1643,1600,43,2.6
CN3002500000000,30,025,Fallon County, MT,Apr-18(p),1633,1605,28,1.7
CN4814500000000,48,145,Falls County, TX,Mar-17,6760,6463,297,4.4
CN4814500000000,48,145,Falls County, TX,Apr-17,6723,6457,266,4.0
CN4814500000000,48,145,Falls County, TX,May-17,6724,6447,277,4.1
CN4814500000000,48,145,Falls County, TX,Jun-17,6731,6426,305,4.5
CN4814500000000,48,145,Falls County, TX,Jul-17,6648,6344,304,4.6
CN4814500000000,48,145,Falls County, TX,Aug-17,6674,6381,293,4.4
CN4814500000000,48,145,Falls County, TX,Sep-17,6652,6393,259,3.9
CN4814500000000,48,145,Falls County, TX,Oct-17,6628,6376,252,3.8
CN4814500000000,48,145,Falls County, TX,Nov-17,6604,6341,263,4.0
CN4814500000000,48,145,Falls County, TX,Dec-17,6600,6356,244,3.7
CN4814500000000,48,145,Falls County, TX,Jan-18,6589,6305,284,4.3
CN4814500000000,48,145,Falls County, TX,Feb-18,6682,6399,283,4.2
CN4814500000000,48,145,Falls County, TX,Mar-18,6758,6486,272,4.0
CN4814500000000,48,145,Falls County, TX,Apr-18(p),6714,6468,246,3.7
CN4010500000000,40,105,Nowata County, OK,Mar-17,4618,4362,256,5.5
CN4010500000000,40,105,Nowata County, OK,Apr-17,4623,4391,232,5.0
CN4010500000000,40,105,Nowata County, OK,May-17,4603,4352,251,5.5
CN4010500000000,40,105,Nowata County, OK,Jun-17,4639,4379,260,5.6
CN4010500000000,40,105,Nowata County, OK,Jul-17,4444,4203,241,5.4
CN4010500000000,40,105,Nowata County, OK,Aug-17,4621,4385,236,5.1
CN4010500000000,40,105,Nowata County, OK,Sep-17,4632,4403,229,4.9
CN4010500000000,40,105,Nowata County, OK,Oct-17,4657,4407,250,5.4
CN4010500000000,40,105,Nowata County, OK,Nov-17,4668,4426,242,5.2
CN4010500000000,40,105,Nowata County, OK,Dec-17,4625,4370,255,5.5
CN4010500000000,40,105,Nowata County, OK,Jan-18,4588,4312,276,6.0
CN4010500000000,40,105,Nowata County, OK,Feb-18,4629,4376,253,5.5
CN4010500000000,40,105,Nowata County, OK,Mar-18,4629,4384,245,5.3
CN4010500000000,40,105,Nowata County, OK,Apr-18(p),4565,4336,229,5.0
CN5117500000000,51,175,Southampton County, VA,Mar-17,8749,8405,344,3.9
CN5117500000000,51,175,Southampton County, VA,Apr-17,8935,8616,319,3.6
CN5117500000000,51,175,Southampton County, VA,May-17,8871,8542,329,3.7
CN5117500000000,51,175,Southampton County, VA,Jun-17,9091,8748,343,3.8
CN5117500000000,51,175,Southampton County, VA,Jul-17,9111,8775,336,3.7
CN5117500000000,51,175,Southampton County, VA,Aug-17,8941,8585,356,4.0
CN5117500000000,51,175,Southampton County, VA,Sep-17,8901,8585,316,3.6
CN5117500000000,51,175,Southampton County, VA,Oct-17,8737,8439,298,3.4
CN5117500000000,51,175,Southampton County, VA,Nov-17,8686,8392,294,3.4
CN5117500000000,51,175,Southampton County, VA,Dec-17,8767,8468,299,3.4
CN5117500000000,51,175,Southampton County, VA,Jan-18,8525,8210,315,3.7
CN5117500000000,51,175,Southampton County, VA,Feb-18,8679,8380,299,3.4
CN5117500000000,51,175,Southampton County, VA,Mar-18,8631,8333,298,3.5
CN5117500000000,51,175,Southampton County, VA,Apr-18(p),8813,8565,248,2.8
CN3301500000000,33,015,Rockingham County, NH,Mar-17,179903,173934,5969,3.3
CN3301500000000,33,015,Rockingham County, NH,Apr-17,180065,174952,5113,2.8
CN3301500000000,33,015,Rockingham County, NH,May-17,180769,175869,4900,2.7
CN3301500000000,33,015,Rockingham County, NH,Jun-17,184553,179235,5318,2.9
CN3301500000000,33,015,Rockingham County, NH,Jul-17,184988,179846,5142,2.8
CN3301500000000,33,015,Rockingham County, NH,Aug-17,183592,178367,5225,2.8
CN3301500000000,33,015,Rockingham County, NH,Sep-17,180466,175692,4774,2.6
CN3301500000000,33,015,Rockingham County, NH,Oct-17,180995,176365,4630,2.6
CN3301500000000,33,015,Rockingham County, NH,Nov-17,181379,176631,4748,2.6
CN3301500000000,33,015,Rockingham County, NH,Dec-17,180264,175745,4519,2.5
CN3301500000000,33,015,Rockingham County, NH,Jan-18,181037,174959,6078,3.4
CN3301500000000,33,015,Rockingham County, NH,Feb-18,181480,175621,5859,3.2
CN3301500000000,33,015,Rockingham County, NH,Mar-18,182838,177126,5712,3.1
CN3301500000000,33,015,Rockingham County, NH,Apr-18(p),183556,178187,5369,2.9
CN2712300000000,27,123,Ramsey County, MN,Mar-17,284807,274795,10012,3.5
CN2712300000000,27,123,Ramsey County, MN,Apr-17,285581,276660,8921,3.1
CN2712300000000,27,123,Ramsey County, MN,May-17,286841,277913,8928,3.1
CN2712300000000,27,123,Ramsey County, MN,Jun-17,289579,279317,10262,3.5
CN2712300000000,27,123,Ramsey County, MN,Jul-17,292669,282728,9941,3.4
CN2712300000000,27,123,Ramsey County, MN,Aug-17,291824,281778,10046,3.4
CN2712300000000,27,123,Ramsey County, MN,Sep-17,290544,282001,8543,2.9
CN2712300000000,27,123,Ramsey County, MN,Oct-17,287116,280103,7013,2.4
CN2712300000000,27,123,Ramsey County, MN,Nov-17,287206,279877,7329,2.6
CN2712300000000,27,123,Ramsey County, MN,Dec-17,285890,277705,8185,2.9
CN2712300000000,27,123,Ramsey County, MN,Jan-18,288677,279460,9217,3.2
CN2712300000000,27,123,Ramsey County, MN,Feb-18,290674,281329,9345,3.2
CN2712300000000,27,123,Ramsey County, MN,Mar-18,289954,280871,9083,3.1
CN2712300000000,27,123,Ramsey County, MN,Apr-18(p),290117,282427,7690,2.7
CN2914700000000,29,147,Nodaway County, MO,Mar-17,10714,10291,423,3.9
CN2914700000000,29,147,Nodaway County, MO,Apr-17,11005,10647,358,3.3
CN2914700000000,29,147,Nodaway County, MO,May-17,10597,10157,440,4.2
CN2914700000000,29,147,Nodaway County, MO,Jun-17,10593,10125,468,4.4
CN2914700000000,29,147,Nodaway County, MO,Jul-17,10207,9725,482,4.7
CN2914700000000,29,147,Nodaway County, MO,Aug-17,10111,9692,419,4.1
CN2914700000000,29,147,Nodaway County, MO,Sep-17,10479,10155,324,3.1
CN2914700000000,29,147,Nodaway County, MO,Oct-17,10372,10167,205,2.0
CN2914700000000,29,147,Nodaway County, MO,Nov-17,10394,10099,295,2.8
CN2914700000000,29,147,Nodaway County, MO,Dec-17,10228,9935,293,2.9
CN2914700000000,29,147,Nodaway County, MO,Jan-18,10178,9807,371,3.6
CN2914700000000,29,147,Nodaway County, MO,Feb-18,10523,10141,382,3.6
CN2914700000000,29,147,Nodaway County, MO,Mar-18,10456,10125,331,3.2
CN2914700000000,29,147,Nodaway County, MO,Apr-18(p),10696,10390,306,2.9
CN0506500000000,05,065,Izard County, AR,Mar-17,4976,4737,239,4.8
CN0506500000000,05,065,Izard County, AR,Apr-17,4974,4743,231,4.6
CN0506500000000,05,065,Izard County, AR,May-17,4938,4674,264,5.3
CN0506500000000,05,065,Izard County, AR,Jun-17,4911,4630,281,5.7
CN0506500000000,05,065,Izard County, AR,Jul-17,4744,4438,306,6.5
CN0506500000000,05,065,Izard County, AR,Aug-17,4883,4591,292,6.0
CN0506500000000,05,065,Izard County, AR,Sep-17,4925,4668,257,5.2
CN0506500000000,05,065,Izard County, AR,Oct-17,4898,4687,211,4.3
CN0506500000000,05,065,Izard County, AR,Nov-17,4939,4684,255,5.2
CN0506500000000,05,065,Izard County, AR,Dec-17,4930,4642,288,5.8
CN0506500000000,05,065,Izard County, AR,Jan-18,4790,4458,332,6.9
CN0506500000000,05,065,Izard County, AR,Feb-18,4790,4499,291,6.1
CN0506500000000,05,065,Izard County, AR,Mar-18,4830,4567,263,5.4
CN0506500000000,05,065,Izard County, AR,Apr-18(p),4862,4611,251,5.2
CN3602300000000,36,023,Cortland County, NY,Mar-17,23686,22150,1536,6.5
CN3602300000000,36,023,Cortland County, NY,Apr-17,23410,22113,1297,5.5
CN3602300000000,36,023,Cortland County, NY,May-17,23094,21932,1162,5.0
CN3602300000000,36,023,Cortland County, NY,Jun-17,22759,21467,1292,5.7
CN3602300000000,36,023,Cortland County, NY,Jul-17,22661,21394,1267,5.6
CN3602300000000,36,023,Cortland County, NY,Aug-17,22452,21314,1138,5.1
CN3602300000000,36,023,Cortland County, NY,Sep-17,23078,21939,1139,4.9
CN3602300000000,36,023,Cortland County, NY,Oct-17,22859,21753,1106,4.8
CN3602300000000,36,023,Cortland County, NY,Nov-17,23193,21845,1348,5.8
CN3602300000000,36,023,Cortland County, NY,Dec-17,22865,21380,1485,6.5
CN3602300000000,36,023,Cortland County, NY,Jan-18,23144,21287,1857,8.0
CN3602300000000,36,023,Cortland County, NY,Feb-18,23431,21639,1792,7.6
CN3602300000000,36,023,Cortland County, NY,Mar-18,22898,21258,1640,7.2
CN3602300000000,36,023,Cortland County, NY,Apr-18(p),22851,21466,1385,6.1
CN5167800000000,51,678,Lexington city, VA,Mar-17,2344,2212,132,5.6
CN5167800000000,51,678,Lexington city, VA,Apr-17,2331,2220,111,4.8
CN5167800000000,51,678,Lexington city, VA,May-17,2172,2058,114,5.2
CN5167800000000,51,678,Lexington city, VA,Jun-17,2160,2010,150,6.9
CN5167800000000,51,678,Lexington city, VA,Jul-17,2202,2050,152,6.9
CN5167800000000,51,678,Lexington city, VA,Aug-17,2221,2077,144,6.5
CN5167800000000,51,678,Lexington city, VA,Sep-17,2347,2221,126,5.4
CN5167800000000,51,678,Lexington city, VA,Oct-17,2315,2208,107,4.6
CN5167800000000,51,678,Lexington city, VA,Nov-17,2314,2197,117,5.1
CN5167800000000,51,678,Lexington city, VA,Dec-17,2161,2061,100,4.6
CN5167800000000,51,678,Lexington city, VA,Jan-18,2262,2141,121,5.3
CN5167800000000,51,678,Lexington city, VA,Feb-18,2305,2195,110,4.8
CN5167800000000,51,678,Lexington city, VA,Mar-18,2330,2221,109,4.7
CN5167800000000,51,678,Lexington city, VA,Apr-18(p),2310,2226,84,3.6
CN5112100000000,51,121,Montgomery County, VA,Mar-17,50817,48727,2090,4.1
CN5112100000000,51,121,Montgomery County, VA,Apr-17,50858,49127,1731,3.4
CN5112100000000,51,121,Montgomery County, VA,May-17,49962,48110,1852,3.7
CN5112100000000,51,121,Montgomery County, VA,Jun-17,49051,46941,2110,4.3
CN5112100000000,51,121,Montgomery County, VA,Jul-17,49136,47097,2039,4.1
CN5112100000000,51,121,Montgomery County, VA,Aug-17,49771,47764,2007,4.0
CN5112100000000,51,121,Montgomery County, VA,Sep-17,50679,48810,1869,3.7
CN5112100000000,51,121,Montgomery County, VA,Oct-17,49978,48302,1676,3.4
CN5112100000000,51,121,Montgomery County, VA,Nov-17,49818,48049,1769,3.6
CN5112100000000,51,121,Montgomery County, VA,Dec-17,49365,47839,1526,3.1
CN5112100000000,51,121,Montgomery County, VA,Jan-18,47765,46011,1754,3.7
CN5112100000000,51,121,Montgomery County, VA,Feb-18,50186,48599,1587,3.2
CN5112100000000,51,121,Montgomery County, VA,Mar-18,50421,48812,1609,3.2
CN5112100000000,51,121,Montgomery County, VA,Apr-18(p),50631,49272,1359,2.7
CN3804700000000,38,047,Logan County, ND,Mar-17,966,932,34,3.5
CN3804700000000,38,047,Logan County, ND,Apr-17,953,924,29,3.0
CN3804700000000,38,047,Logan County, ND,May-17,943,921,22,2.3
CN3804700000000,38,047,Logan County, ND,Jun-17,1000,976,24,2.4
CN3804700000000,38,047,Logan County, ND,Jul-17,960,943,17,1.8
CN3804700000000,38,047,Logan County, ND,Aug-17,982,964,18,1.8
CN3804700000000,38,047,Logan County, ND,Sep-17,966,949,17,1.8
CN3804700000000,38,047,Logan County, ND,Oct-17,980,966,14,1.4
CN3804700000000,38,047,Logan County, ND,Nov-17,951,929,22,2.3
CN3804700000000,38,047,Logan County, ND,Dec-17,948,927,21,2.2
CN3804700000000,38,047,Logan County, ND,Jan-18,951,926,25,2.6
CN3804700000000,38,047,Logan County, ND,Feb-18,935,903,32,3.4
CN3804700000000,38,047,Logan County, ND,Mar-18,961,931,30,3.1
CN3804700000000,38,047,Logan County, ND,Apr-18(p),934,903,31,3.3
CN1314500000000,13,145,Harris County, GA,Mar-17,16384,15676,708,4.3
CN1314500000000,13,145,Harris County, GA,Apr-17,16281,15630,651,4.0
CN1314500000000,13,145,Harris County, GA,May-17,16306,15641,665,4.1
CN1314500000000,13,145,Harris County, GA,Jun-17,16316,15587,729,4.5
CN1314500000000,13,145,Harris County, GA,Jul-17,16424,15645,779,4.7
CN1314500000000,13,145,Harris County, GA,Aug-17,16229,15516,713,4.4
CN1314500000000,13,145,Harris County, GA,Sep-17,16387,15757,630,3.8
CN1314500000000,13,145,Harris County, GA,Oct-17,16398,15750,648,4.0
CN1314500000000,13,145,Harris County, GA,Nov-17,16423,15801,622,3.8
CN1314500000000,13,145,Harris County, GA,Dec-17,16443,15827,616,3.7
CN1314500000000,13,145,Harris County, GA,Jan-18,16514,15827,687,4.2
CN1314500000000,13,145,Harris County, GA,Feb-18,16587,15924,663,4.0
CN1314500000000,13,145,Harris County, GA,Mar-18,16603,16006,597,3.6
CN1314500000000,13,145,Harris County, GA,Apr-18(p),16446,15923,523,3.2
CN3506100000000,35,061,Valencia County, NM,Mar-17,29691,27724,1967,6.6
CN3506100000000,35,061,Valencia County, NM,Apr-17,29569,27775,1794,6.1
CN3506100000000,35,061,Valencia County, NM,May-17,29431,27597,1834,6.2
CN3506100000000,35,061,Valencia County, NM,Jun-17,30009,27763,2246,7.5
CN3506100000000,35,061,Valencia County, NM,Jul-17,29983,27737,2246,7.5
CN3506100000000,35,061,Valencia County, NM,Aug-17,29880,27761,2119,7.1
CN3506100000000,35,061,Valencia County, NM,Sep-17,29891,27925,1966,6.6
CN3506100000000,35,061,Valencia County, NM,Oct-17,30000,28085,1915,6.4
CN3506100000000,35,061,Valencia County, NM,Nov-17,30230,28348,1882,6.2
CN3506100000000,35,061,Valencia County, NM,Dec-17,30203,28380,1823,6.0
CN3506100000000,35,061,Valencia County, NM,Jan-18,30024,28195,1829,6.1
CN3506100000000,35,061,Valencia County, NM,Feb-18,30195,28434,1761,5.8
CN3506100000000,35,061,Valencia County, NM,Mar-18,30152,28503,1649,5.5
CN3506100000000,35,061,Valencia County, NM,Apr-18(p),30083,28622,1461,4.9
CN1719100000000,17,191,Wayne County, IL,Mar-17,7009,6545,464,6.6
CN1719100000000,17,191,Wayne County, IL,Apr-17,7015,6616,399,5.7
CN1719100000000,17,191,Wayne County, IL,May-17,6982,6590,392,5.6
CN1719100000000,17,191,Wayne County, IL,Jun-17,7000,6579,421,6.0
CN1719100000000,17,191,Wayne County, IL,Jul-17,6858,6450,408,5.9
CN1719100000000,17,191,Wayne County, IL,Aug-17,6740,6326,414,6.1
CN1719100000000,17,191,Wayne County, IL,Sep-17,6835,6467,368,5.4
CN1719100000000,17,191,Wayne County, IL,Oct-17,6776,6437,339,5.0
CN1719100000000,17,191,Wayne County, IL,Nov-17,6722,6387,335,5.0
CN1719100000000,17,191,Wayne County, IL,Dec-17,6689,6337,352,5.3
CN1719100000000,17,191,Wayne County, IL,Jan-18,6636,6274,362,5.5
CN1719100000000,17,191,Wayne County, IL,Feb-18,6598,6254,344,5.2
CN1719100000000,17,191,Wayne County, IL,Mar-18,6816,6452,364,5.3
CN1719100000000,17,191,Wayne County, IL,Apr-18(p),6823,6520,303,4.4
CN4838100000000,48,381,Randall County, TX,Mar-17,70649,68497,2152,3.0
CN4838100000000,48,381,Randall County, TX,Apr-17,70845,68965,1880,2.7
CN4838100000000,48,381,Randall County, TX,May-17,70495,68532,1963,2.8
CN4838100000000,48,381,Randall County, TX,Jun-17,70120,67967,2153,3.1
CN4838100000000,48,381,Randall County, TX,Jul-17,69829,67686,2143,3.1
CN4838100000000,48,381,Randall County, TX,Aug-17,69555,67524,2031,2.9
CN4838100000000,48,381,Randall County, TX,Sep-17,70217,68408,1809,2.6
CN4838100000000,48,381,Randall County, TX,Oct-17,70231,68537,1694,2.4
CN4838100000000,48,381,Randall County, TX,Nov-17,70580,68827,1753,2.5
CN4838100000000,48,381,Randall County, TX,Dec-17,70463,68822,1641,2.3
CN4838100000000,48,381,Randall County, TX,Jan-18,70222,68347,1875,2.7
CN4838100000000,48,381,Randall County, TX,Feb-18,71246,69311,1935,2.7
CN4838100000000,48,381,Randall County, TX,Mar-18,71399,69418,1981,2.8
CN4838100000000,48,381,Randall County, TX,Apr-18(p),71811,70038,1773,2.5
CN1815300000000,18,153,Sullivan County, IN,Mar-17,8539,8139,400,4.7
CN1815300000000,18,153,Sullivan County, IN,Apr-17,8550,8222,328,3.8
CN1815300000000,18,153,Sullivan County, IN,May-17,8666,8339,327,3.8
CN1815300000000,18,153,Sullivan County, IN,Jun-17,8591,8231,360,4.2
CN1815300000000,18,153,Sullivan County, IN,Jul-17,8506,8136,370,4.3
CN1815300000000,18,153,Sullivan County, IN,Aug-17,8442,8047,395,4.7
CN1815300000000,18,153,Sullivan County, IN,Sep-17,8446,8125,321,3.8
CN1815300000000,18,153,Sullivan County, IN,Oct-17,8420,8106,314,3.7
CN1815300000000,18,153,Sullivan County, IN,Nov-17,8471,8139,332,3.9
CN1815300000000,18,153,Sullivan County, IN,Dec-17,8463,8104,359,4.2
CN1815300000000,18,153,Sullivan County, IN,Jan-18,8337,7907,430,5.2
CN1815300000000,18,153,Sullivan County, IN,Feb-18,8497,8052,445,5.2
CN1815300000000,18,153,Sullivan County, IN,Mar-18,8586,8191,395,4.6
CN1815300000000,18,153,Sullivan County, IN,Apr-18(p),8541,8210,331,3.9
CN4504700000000,45,047,Greenwood County, SC,Mar-17,31104,29800,1304,4.2
CN4504700000000,45,047,Greenwood County, SC,Apr-17,30832,29610,1222,4.0
CN4504700000000,45,047,Greenwood County, SC,May-17,30797,29499,1298,4.2
CN4504700000000,45,047,Greenwood County, SC,Jun-17,30773,29279,1494,4.9
CN4504700000000,45,047,Greenwood County, SC,Jul-17,30739,29243,1496,4.9
CN4504700000000,45,047,Greenwood County, SC,Aug-17,30592,29064,1528,5.0
CN4504700000000,45,047,Greenwood County, SC,Sep-17,30669,29289,1380,4.5
CN4504700000000,45,047,Greenwood County, SC,Oct-17,30817,29481,1336,4.3
CN4504700000000,45,047,Greenwood County, SC,Nov-17,30862,29570,1292,4.2
CN4504700000000,45,047,Greenwood County, SC,Dec-17,31023,29691,1332,4.3
CN4504700000000,45,047,Greenwood County, SC,Jan-18,31056,29393,1663,5.4
CN4504700000000,45,047,Greenwood County, SC,Feb-18,31294,29795,1499,4.8
CN4504700000000,45,047,Greenwood County, SC,Mar-18,31030,29686,1344,4.3
CN4504700000000,45,047,Greenwood County, SC,Apr-18(p),30539,29627,912,3.0
CN2912300000000,29,123,Madison County, MO,Mar-17,5432,5155,277,5.1
CN2912300000000,29,123,Madison County, MO,Apr-17,5437,5198,239,4.4
CN2912300000000,29,123,Madison County, MO,May-17,5432,5178,254,4.7
CN2912300000000,29,123,Madison County, MO,Jun-17,5396,5124,272,5.0
CN2912300000000,29,123,Madison County, MO,Jul-17,5363,5067,296,5.5
CN2912300000000,29,123,Madison County, MO,Aug-17,5340,5064,276,5.2
CN2912300000000,29,123,Madison County, MO,Sep-17,5363,5157,206,3.8
CN2912300000000,29,123,Madison County, MO,Oct-17,5255,5097,158,3.0
CN2912300000000,29,123,Madison County, MO,Nov-17,5265,5065,200,3.8
CN2912300000000,29,123,Madison County, MO,Dec-17,5255,5042,213,4.1
CN2912300000000,29,123,Madison County, MO,Jan-18,5267,4994,273,5.2
CN2912300000000,29,123,Madison County, MO,Feb-18,5343,5099,244,4.6
CN2912300000000,29,123,Madison County, MO,Mar-18,5357,5124,233,4.3
CN2912300000000,29,123,Madison County, MO,Apr-18(p),5396,5189,207,3.8
CN4206100000000,42,061,Huntingdon County, PA,Mar-17,19822,18371,1451,7.3
CN4206100000000,42,061,Huntingdon County, PA,Apr-17,19935,18883,1052,5.3
CN4206100000000,42,061,Huntingdon County, PA,May-17,19678,18638,1040,5.3
CN4206100000000,42,061,Huntingdon County, PA,Jun-17,19987,18886,1101,5.5
CN4206100000000,42,061,Huntingdon County, PA,Jul-17,20155,19008,1147,5.7
CN4206100000000,42,061,Huntingdon County, PA,Aug-17,19935,18784,1151,5.8
CN4206100000000,42,061,Huntingdon County, PA,Sep-17,19797,18920,877,4.4
CN4206100000000,42,061,Huntingdon County, PA,Oct-17,19541,18667,874,4.5
CN4206100000000,42,061,Huntingdon County, PA,Nov-17,19516,18467,1049,5.4
CN4206100000000,42,061,Huntingdon County, PA,Dec-17,19519,18293,1226,6.3
CN4206100000000,42,061,Huntingdon County, PA,Jan-18,19363,17840,1523,7.9
CN4206100000000,42,061,Huntingdon County, PA,Feb-18,19889,18365,1524,7.7
CN4206100000000,42,061,Huntingdon County, PA,Mar-18,19604,18339,1265,6.5
CN4206100000000,42,061,Huntingdon County, PA,Apr-18(p),19504,18577,927,4.8
CN3005300000000,30,053,Lincoln County, MT,Mar-17,7779,6915,864,11.1
CN3005300000000,30,053,Lincoln County, MT,Apr-17,7830,7068,762,9.7
CN3005300000000,30,053,Lincoln County, MT,May-17,7906,7274,632,8.0
CN3005300000000,30,053,Lincoln County, MT,Jun-17,8118,7477,641,7.9
CN3005300000000,30,053,Lincoln County, MT,Jul-17,8051,7474,577,7.2
CN3005300000000,30,053,Lincoln County, MT,Aug-17,8162,7594,568,7.0
CN3005300000000,30,053,Lincoln County, MT,Sep-17,7883,7383,500,6.3
CN3005300000000,30,053,Lincoln County, MT,Oct-17,7904,7391,513,6.5
CN3005300000000,30,053,Lincoln County, MT,Nov-17,7793,7168,625,8.0
CN3005300000000,30,053,Lincoln County, MT,Dec-17,7652,6984,668,8.7
CN3005300000000,30,053,Lincoln County, MT,Jan-18,7760,6904,856,11.0
CN3005300000000,30,053,Lincoln County, MT,Feb-18,7740,6889,851,11.0
CN3005300000000,30,053,Lincoln County, MT,Mar-18,7744,6936,808,10.4
CN3005300000000,30,053,Lincoln County, MT,Apr-18(p),7742,7052,690,8.9
CN5119900000000,51,199,York County, VA,Mar-17,32562,31378,1184,3.6
CN5119900000000,51,199,York County, VA,Apr-17,32684,31599,1085,3.3
CN5119900000000,51,199,York County, VA,May-17,32750,31589,1161,3.5
CN5119900000000,51,199,York County, VA,Jun-17,33011,31801,1210,3.7
CN5119900000000,51,199,York County, VA,Jul-17,33285,32058,1227,3.7
CN5119900000000,51,199,York County, VA,Aug-17,32972,31737,1235,3.7
CN5119900000000,51,199,York County, VA,Sep-17,32750,31657,1093,3.3
CN5119900000000,51,199,York County, VA,Oct-17,32464,31426,1038,3.2
CN5119900000000,51,199,York County, VA,Nov-17,32268,31210,1058,3.3
CN5119900000000,51,199,York County, VA,Dec-17,32033,31028,1005,3.1
CN5119900000000,51,199,York County, VA,Jan-18,32017,30905,1112,3.5
CN5119900000000,51,199,York County, VA,Feb-18,32385,31399,986,3.0
CN5119900000000,51,199,York County, VA,Mar-18,32647,31643,1004,3.1
CN5119900000000,51,199,York County, VA,Apr-18(p),32647,31809,838,2.6
CN4709300000000,47,093,Knox County, TN,Mar-17,236342,228282,8060,3.4
CN4709300000000,47,093,Knox County, TN,Apr-17,236899,230127,6772,2.9
CN4709300000000,47,093,Knox County, TN,May-17,237442,230959,6483,2.7
CN4709300000000,47,093,Knox County, TN,Jun-17,239658,231050,8608,3.6
CN4709300000000,47,093,Knox County, TN,Jul-17,240532,232234,8298,3.4
CN4709300000000,47,093,Knox County, TN,Aug-17,237280,229529,7751,3.3
CN4709300000000,47,093,Knox County, TN,Sep-17,239474,232775,6699,2.8
CN4709300000000,47,093,Knox County, TN,Oct-17,238148,231762,6386,2.7
CN4709300000000,47,093,Knox County, TN,Nov-17,238558,232115,6443,2.7
CN4709300000000,47,093,Knox County, TN,Dec-17,236414,230340,6074,2.6
CN4709300000000,47,093,Knox County, TN,Jan-18,235476,228257,7219,3.1
CN4709300000000,47,093,Knox County, TN,Feb-18,239420,232389,7031,2.9
CN4709300000000,47,093,Knox County, TN,Mar-18,239391,232475,6916,2.9
CN4709300000000,47,093,Knox County, TN,Apr-18(p),239393,233665,5728,2.4
CN1312100000000,13,121,Fulton County, GA,Mar-17,545579,518544,27035,5.0
CN1312100000000,13,121,Fulton County, GA,Apr-17,545275,519780,25495,4.7
CN1312100000000,13,121,Fulton County, GA,May-17,546633,520717,25916,4.7
CN1312100000000,13,121,Fulton County, GA,Jun-17,548009,520217,27792,5.1
CN1312100000000,13,121,Fulton County, GA,Jul-17,551878,523858,28020,5.1
CN1312100000000,13,121,Fulton County, GA,Aug-17,548932,521268,27664,5.0
CN1312100000000,13,121,Fulton County, GA,Sep-17,553272,528356,24916,4.5
CN1312100000000,13,121,Fulton County, GA,Oct-17,550611,526225,24386,4.4
CN1312100000000,13,121,Fulton County, GA,Nov-17,551931,528006,23925,4.3
CN1312100000000,13,121,Fulton County, GA,Dec-17,552028,527774,24254,4.4
CN1312100000000,13,121,Fulton County, GA,Jan-18,552333,526840,25493,4.6
CN1312100000000,13,121,Fulton County, GA,Feb-18,561078,535558,25520,4.5
CN1312100000000,13,121,Fulton County, GA,Mar-18,561139,537403,23736,4.2
CN1312100000000,13,121,Fulton County, GA,Apr-18(p),557100,535983,21117,3.8
CN3106900000000,31,069,Garden County, NE,Mar-17,1185,1150,35,3.0
CN3106900000000,31,069,Garden County, NE,Apr-17,1214,1177,37,3.0
CN3106900000000,31,069,Garden County, NE,May-17,1237,1202,35,2.8
CN3106900000000,31,069,Garden County, NE,Jun-17,1268,1236,32,2.5
CN3106900000000,31,069,Garden County, NE,Jul-17,1241,1204,37,3.0
CN3106900000000,31,069,Garden County, NE,Aug-17,1217,1184,33,2.7
CN3106900000000,31,069,Garden County, NE,Sep-17,1151,1116,35,3.0
CN3106900000000,31,069,Garden County, NE,Oct-17,1149,1124,25,2.2
CN3106900000000,31,069,Garden County, NE,Nov-17,1158,1134,24,2.1
CN3106900000000,31,069,Garden County, NE,Dec-17,1156,1126,30,2.6
CN3106900000000,31,069,Garden County, NE,Jan-18,1178,1148,30,2.5
CN3106900000000,31,069,Garden County, NE,Feb-18,1156,1129,27,2.3
CN3106900000000,31,069,Garden County, NE,Mar-18,1163,1136,27,2.3
CN3106900000000,31,069,Garden County, NE,Apr-18(p),1156,1125,31,2.7
CN7207700000000,72,077,Juncos Municipio, PR,Mar-17,12421,10992,1429,11.5
CN7207700000000,72,077,Juncos Municipio, PR,Apr-17,12365,10860,1505,12.2
CN7207700000000,72,077,Juncos Municipio, PR,May-17,12152,10828,1324,10.9
CN7207700000000,72,077,Juncos Municipio, PR,Jun-17,11980,10768,1212,10.1
CN7207700000000,72,077,Juncos Municipio, PR,Jul-17,12078,10751,1327,11.0
CN7207700000000,72,077,Juncos Municipio, PR,Aug-17,12093,10604,1489,12.3
CN7207700000000,72,077,Juncos Municipio, PR,Sep-17(y),12114,10700,1414,11.7
CN7207700000000,72,077,Juncos Municipio, PR,Oct-17,11737,10281,1456,12.4
CN7207700000000,72,077,Juncos Municipio, PR,Nov-17,12250,10851,1399,11.4
CN7207700000000,72,077,Juncos Municipio, PR,Dec-17,12184,10922,1262,10.4
CN7207700000000,72,077,Juncos Municipio, PR,Jan-18,12067,10708,1359,11.3
CN7207700000000,72,077,Juncos Municipio, PR,Feb-18,11992,10748,1244,10.4
CN7207700000000,72,077,Juncos Municipio, PR,Mar-18,12005,10771,1234,10.3
CN7207700000000,72,077,Juncos Municipio, PR,Apr-18(p),12014,10820,1194,9.9
CN0111300000000,01,113,Russell County, AL,Mar-17,23602,22507,1095,4.6
CN0111300000000,01,113,Russell County, AL,Apr-17,23447,22524,923,3.9
CN0111300000000,01,113,Russell County, AL,May-17,23363,22451,912,3.9
CN0111300000000,01,113,Russell County, AL,Jun-17,23427,22312,1115,4.8
CN0111300000000,01,113,Russell County, AL,Jul-17,23386,22355,1031,4.4
CN0111300000000,01,113,Russell County, AL,Aug-17,23256,22256,1000,4.3
CN0111300000000,01,113,Russell County, AL,Sep-17,23295,22430,865,3.7
CN0111300000000,01,113,Russell County, AL,Oct-17,23519,22632,887,3.8
CN0111300000000,01,113,Russell County, AL,Nov-17,23541,22721,820,3.5
CN0111300000000,01,113,Russell County, AL,Dec-17,23501,22682,819,3.5
CN0111300000000,01,113,Russell County, AL,Jan-18,23282,22272,1010,4.3
CN0111300000000,01,113,Russell County, AL,Feb-18,23462,22442,1020,4.3
CN0111300000000,01,113,Russell County, AL,Mar-18,23530,22607,923,3.9
CN0111300000000,01,113,Russell County, AL,Apr-18(p),23578,22740,838,3.6
CN1319900000000,13,199,Meriwether County, GA,Mar-17,8954,8423,531,5.9
CN1319900000000,13,199,Meriwether County, GA,Apr-17,8949,8453,496,5.5
CN1319900000000,13,199,Meriwether County, GA,May-17,8966,8476,490,5.5
CN1319900000000,13,199,Meriwether County, GA,Jun-17,9035,8486,549,6.1
CN1319900000000,13,199,Meriwether County, GA,Jul-17,9184,8516,668,7.3
CN1319900000000,13,199,Meriwether County, GA,Aug-17,8989,8470,519,5.8
CN1319900000000,13,199,Meriwether County, GA,Sep-17,9046,8571,475,5.3
CN1319900000000,13,199,Meriwether County, GA,Oct-17,9016,8559,457,5.1
CN1319900000000,13,199,Meriwether County, GA,Nov-17,9023,8583,440,4.9
CN1319900000000,13,199,Meriwether County, GA,Dec-17,9036,8585,451,5.0
CN1319900000000,13,199,Meriwether County, GA,Jan-18,9126,8596,530,5.8
CN1319900000000,13,199,Meriwether County, GA,Feb-18,9157,8671,486,5.3
CN1319900000000,13,199,Meriwether County, GA,Mar-18,9142,8695,447,4.9
CN1319900000000,13,199,Meriwether County, GA,Apr-18(p),9120,8693,427,4.7
CN3604700000000,36,047,Kings County, NY,Mar-17,1250433,1194324,56109,4.5
CN3604700000000,36,047,Kings County, NY,Apr-17,1243987,1190813,53174,4.3
CN3604700000000,36,047,Kings County, NY,May-17,1242373,1187198,55175,4.4
CN3604700000000,36,047,Kings County, NY,Jun-17,1245176,1187261,57915,4.7
CN3604700000000,36,047,Kings County, NY,Jul-17,1258244,1192812,65432,5.2
CN3604700000000,36,047,Kings County, NY,Aug-17,1249938,1184418,65520,5.2
CN3604700000000,36,047,Kings County, NY,Sep-17,1251762,1193852,57910,4.6
CN3604700000000,36,047,Kings County, NY,Oct-17,1246737,1190894,55843,4.5
CN3604700000000,36,047,Kings County, NY,Nov-17,1240008,1188686,51322,4.1
CN3604700000000,36,047,Kings County, NY,Dec-17,1235036,1185408,49628,4.0
CN3604700000000,36,047,Kings County, NY,Jan-18,1246197,1188716,57481,4.6
CN3604700000000,36,047,Kings County, NY,Feb-18,1259891,1204532,55359,4.4
CN3604700000000,36,047,Kings County, NY,Mar-18,1251592,1198366,53226,4.3
CN3604700000000,36,047,Kings County, NY,Apr-18(p),1243031,1190970,52061,4.2
CN4012900000000,40,129,Roger Mills County, OK,Mar-17,1830,1766,64,3.5
CN4012900000000,40,129,Roger Mills County, OK,Apr-17,1859,1802,57,3.1
CN4012900000000,40,129,Roger Mills County, OK,May-17,1854,1787,67,3.6
CN4012900000000,40,129,Roger Mills County, OK,Jun-17,1803,1736,67,3.7
CN4012900000000,40,129,Roger Mills County, OK,Jul-17,1742,1680,62,3.6
CN4012900000000,40,129,Roger Mills County, OK,Aug-17,1888,1826,62,3.3
CN4012900000000,40,129,Roger Mills County, OK,Sep-17,1915,1859,56,2.9
CN4012900000000,40,129,Roger Mills County, OK,Oct-17,1950,1899,51,2.6
CN4012900000000,40,129,Roger Mills County, OK,Nov-17,1978,1928,50,2.5
CN4012900000000,40,129,Roger Mills County, OK,Dec-17,1920,1872,48,2.5
CN4012900000000,40,129,Roger Mills County, OK,Jan-18,1875,1824,51,2.7
CN4012900000000,40,129,Roger Mills County, OK,Feb-18,1882,1830,52,2.8
CN4012900000000,40,129,Roger Mills County, OK,Mar-18,1857,1802,55,3.0
CN4012900000000,40,129,Roger Mills County, OK,Apr-18(p),1816,1768,48,2.6
CN4015100000000,40,151,Woods County, OK,Mar-17,5036,4903,133,2.6
CN4015100000000,40,151,Woods County, OK,Apr-17,4965,4847,118,2.4
CN4015100000000,40,151,Woods County, OK,May-17,4922,4779,143,2.9
CN4015100000000,40,151,Woods County, OK,Jun-17,4839,4682,157,3.2
CN4015100000000,40,151,Woods County, OK,Jul-17,4786,4647,139,2.9
CN4015100000000,40,151,Woods County, OK,Aug-17,4894,4762,132,2.7
CN4015100000000,40,151,Woods County, OK,Sep-17,4913,4787,126,2.6
CN4015100000000,40,151,Woods County, OK,Oct-17,4928,4825,103,2.1
CN4015100000000,40,151,Woods County, OK,Nov-17,4972,4862,110,2.2
CN4015100000000,40,151,Woods County, OK,Dec-17,4865,4762,103,2.1
CN4015100000000,40,151,Woods County, OK,Jan-18,4772,4662,110,2.3
CN4015100000000,40,151,Woods County, OK,Feb-18,4924,4814,110,2.2
CN4015100000000,40,151,Woods County, OK,Mar-18,4926,4815,111,2.3
CN4015100000000,40,151,Woods County, OK,Apr-18(p),4815,4705,110,2.3
CN2707700000000,27,077,Lake of the Woods County, MN,Mar-17,2457,2350,107,4.4
CN2707700000000,27,077,Lake of the Woods County, MN,Apr-17,2309,2176,133,5.8
CN2707700000000,27,077,Lake of the Woods County, MN,May-17,2380,2275,105,4.4
CN2707700000000,27,077,Lake of the Woods County, MN,Jun-17,2421,2312,109,4.5
CN2707700000000,27,077,Lake of the Woods County, MN,Jul-17,2405,2297,108,4.5
CN2707700000000,27,077,Lake of the Woods County, MN,Aug-17,2367,2244,123,5.2
CN2707700000000,27,077,Lake of the Woods County, MN,Sep-17,2288,2197,91,4.0
CN2707700000000,27,077,Lake of the Woods County, MN,Oct-17,2320,2242,78,3.4
CN2707700000000,27,077,Lake of the Woods County, MN,Nov-17,2356,2227,129,5.5
CN2707700000000,27,077,Lake of the Woods County, MN,Dec-17,2327,2218,109,4.7
CN2707700000000,27,077,Lake of the Woods County, MN,Jan-18,2437,2320,117,4.8
CN2707700000000,27,077,Lake of the Woods County, MN,Feb-18,2427,2326,101,4.2
CN2707700000000,27,077,Lake of the Woods County, MN,Mar-18,2401,2304,97,4.0
CN2707700000000,27,077,Lake of the Woods County, MN,Apr-18(p),2253,2137,116,5.1
CN3903700000000,39,037,Darke County, OH,Mar-17,26929,25748,1181,4.4
CN3903700000000,39,037,Darke County, OH,Apr-17,26771,25779,992,3.7
CN3903700000000,39,037,Darke County, OH,May-17,26536,25529,1007,3.8
CN3903700000000,39,037,Darke County, OH,Jun-17,26646,25512,1134,4.3
CN3903700000000,39,037,Darke County, OH,Jul-17,26345,25209,1136,4.3
CN3903700000000,39,037,Darke County, OH,Aug-17,26723,25595,1128,4.2
CN3903700000000,39,037,Darke County, OH,Sep-17,26373,25365,1008,3.8
CN3903700000000,39,037,Darke County, OH,Oct-17,26458,25499,959,3.6
CN3903700000000,39,037,Darke County, OH,Nov-17,26347,25347,1000,3.8
CN3903700000000,39,037,Darke County, OH,Dec-17,25864,24809,1055,4.1
CN3903700000000,39,037,Darke County, OH,Jan-18,25513,24352,1161,4.6
CN3903700000000,39,037,Darke County, OH,Feb-18,26123,25016,1107,4.2
CN3903700000000,39,037,Darke County, OH,Mar-18,26559,25552,1007,3.8
CN3903700000000,39,037,Darke County, OH,Apr-18(p),26387,25471,916,3.5
CN4606500000000,46,065,Hughes County, SD,Mar-17,9847,9538,309,3.1
CN4606500000000,46,065,Hughes County, SD,Apr-17,9806,9544,262,2.7
CN4606500000000,46,065,Hughes County, SD,May-17,10077,9825,252,2.5
CN4606500000000,46,065,Hughes County, SD,Jun-17,10212,9957,255,2.5
CN4606500000000,46,065,Hughes County, SD,Jul-17,10227,9983,244,2.4
CN4606500000000,46,065,Hughes County, SD,Aug-17,10184,9912,272,2.7
CN4606500000000,46,065,Hughes County, SD,Sep-17,10049,9793,256,2.5
CN4606500000000,46,065,Hughes County, SD,Oct-17,10149,9904,245,2.4
CN4606500000000,46,065,Hughes County, SD,Nov-17,10170,9891,279,2.7
CN4606500000000,46,065,Hughes County, SD,Dec-17,10013,9719,294,2.9
CN4606500000000,46,065,Hughes County, SD,Jan-18,10021,9667,354,3.5
CN4606500000000,46,065,Hughes County, SD,Feb-18,9898,9551,347,3.5
CN4606500000000,46,065,Hughes County, SD,Mar-18,9864,9552,312,3.2
CN4606500000000,46,065,Hughes County, SD,Apr-18(p),9894,9605,289,2.9
CN5600100000000,56,001,Albany County, WY,Mar-17,21289,20635,654,3.1
CN5600100000000,56,001,Albany County, WY,Apr-17,21228,20690,538,2.5
CN5600100000000,56,001,Albany County, WY,May-17,20803,20253,550,2.6
CN5600100000000,56,001,Albany County, WY,Jun-17,19599,18974,625,3.2
CN5600100000000,56,001,Albany County, WY,Jul-17,19008,18448,560,2.9
CN5600100000000,56,001,Albany County, WY,Aug-17,18920,18394,526,2.8
CN5600100000000,56,001,Albany County, WY,Sep-17,20556,20028,528,2.6
CN5600100000000,56,001,Albany County, WY,Oct-17,20785,20228,557,2.7
CN5600100000000,56,001,Albany County, WY,Nov-17,21123,20546,577,2.7
CN5600100000000,56,001,Albany County, WY,Dec-17,20808,20249,559,2.7
CN5600100000000,56,001,Albany County, WY,Jan-18,20108,19457,651,3.2
CN5600100000000,56,001,Albany County, WY,Feb-18,20769,20188,581,2.8
CN5600100000000,56,001,Albany County, WY,Mar-18,20942,20312,630,3.0
CN5600100000000,56,001,Albany County, WY,Apr-18(p),20651,20069,582,2.8
CN4612700000000,46,127,Union County, SD,Mar-17,7923,7631,292,3.7
CN4612700000000,46,127,Union County, SD,Apr-17,7883,7623,260,3.3
CN4612700000000,46,127,Union County, SD,May-17,7890,7618,272,3.4
CN4612700000000,46,127,Union County, SD,Jun-17,7929,7637,292,3.7
CN4612700000000,46,127,Union County, SD,Jul-17,7894,7612,282,3.6
CN4612700000000,46,127,Union County, SD,Aug-17,7855,7555,300,3.8
CN4612700000000,46,127,Union County, SD,Sep-17,7946,7643,303,3.8
CN4612700000000,46,127,Union County, SD,Oct-17,8020,7733,287,3.6
CN4612700000000,46,127,Union County, SD,Nov-17,8059,7762,297,3.7
CN4612700000000,46,127,Union County, SD,Dec-17,7951,7649,302,3.8
CN4612700000000,46,127,Union County, SD,Jan-18,7976,7649,327,4.1
CN4612700000000,46,127,Union County, SD,Feb-18,8031,7702,329,4.1
CN4612700000000,46,127,Union County, SD,Mar-18,8047,7740,307,3.8
CN4612700000000,46,127,Union County, SD,Apr-18(p),8039,7749,290,3.6
CN7208100000000,72,081,Lares Municipio, PR,Mar-17,7449,5902,1547,20.8
CN7208100000000,72,081,Lares Municipio, PR,Apr-17,7313,5672,1641,22.4
CN7208100000000,72,081,Lares Municipio, PR,May-17,7448,5983,1465,19.7
CN7208100000000,72,081,Lares Municipio, PR,Jun-17,7205,6075,1130,15.7
CN7208100000000,72,081,Lares Municipio, PR,Jul-17,7508,6358,1150,15.3
CN7208100000000,72,081,Lares Municipio, PR,Aug-17,7598,6322,1276,16.8
CN7208100000000,72,081,Lares Municipio, PR,Sep-17(y),7178,6048,1130,15.7
CN7208100000000,72,081,Lares Municipio, PR,Oct-17,6816,5688,1128,16.5
CN7208100000000,72,081,Lares Municipio, PR,Nov-17,7339,6157,1182,16.1
CN7208100000000,72,081,Lares Municipio, PR,Dec-17,7349,6123,1226,16.7
CN7208100000000,72,081,Lares Municipio, PR,Jan-18,7334,5958,1376,18.8
CN7208100000000,72,081,Lares Municipio, PR,Feb-18,7018,5722,1296,18.5
CN7208100000000,72,081,Lares Municipio, PR,Mar-18,7036,5787,1249,17.8
CN7208100000000,72,081,Lares Municipio, PR,Apr-18(p),7044,5875,1169,16.6
CN2713900000000,27,139,Scott County, MN,Mar-17,81575,78890,2685,3.3
CN2713900000000,27,139,Scott County, MN,Apr-17,81725,79433,2292,2.8
CN2713900000000,27,139,Scott County, MN,May-17,81970,79762,2208,2.7
CN2713900000000,27,139,Scott County, MN,Jun-17,82671,80134,2537,3.1
CN2713900000000,27,139,Scott County, MN,Jul-17,83462,81072,2390,2.9
CN2713900000000,27,139,Scott County, MN,Aug-17,83208,80795,2413,2.9
CN2713900000000,27,139,Scott County, MN,Sep-17,82900,80861,2039,2.5
CN2713900000000,27,139,Scott County, MN,Oct-17,82101,80383,1718,2.1
CN2713900000000,27,139,Scott County, MN,Nov-17,82106,80308,1798,2.2
CN2713900000000,27,139,Scott County, MN,Dec-17,81968,79662,2306,2.8
CN2713900000000,27,139,Scott County, MN,Jan-18,82847,80171,2676,3.2
CN2713900000000,27,139,Scott County, MN,Feb-18,83431,80729,2702,3.2
CN2713900000000,27,139,Scott County, MN,Mar-18,83267,80638,2629,3.2
CN2713900000000,27,139,Scott County, MN,Apr-18(p),83244,81063,2181,2.6
CN1303700000000,13,037,Calhoun County, GA,Mar-17,2220,2097,123,5.5
CN1303700000000,13,037,Calhoun County, GA,Apr-17,2189,2074,115,5.3
CN1303700000000,13,037,Calhoun County, GA,May-17,2243,2134,109,4.9
CN1303700000000,13,037,Calhoun County, GA,Jun-17,2282,2159,123,5.4
CN1303700000000,13,037,Calhoun County, GA,Jul-17,2182,2067,115,5.3
CN1303700000000,13,037,Calhoun County, GA,Aug-17,2216,2101,115,5.2
CN1303700000000,13,037,Calhoun County, GA,Sep-17,2197,2090,107,4.9
CN1303700000000,13,037,Calhoun County, GA,Oct-17,2256,2147,109,4.8
CN1303700000000,13,037,Calhoun County, GA,Nov-17,2264,2153,111,4.9
CN1303700000000,13,037,Calhoun County, GA,Dec-17,2265,2162,103,4.5
CN1303700000000,13,037,Calhoun County, GA,Jan-18,2290,2182,108,4.7
CN1303700000000,13,037,Calhoun County, GA,Feb-18,2134,2025,109,5.1
CN1303700000000,13,037,Calhoun County, GA,Mar-18,2115,2024,91,4.3
CN1303700000000,13,037,Calhoun County, GA,Apr-18(p),2112,2028,84,4.0
CN1716300000000,17,163,St. Clair County, IL,Mar-17,125578,119397,6181,4.9
CN1716300000000,17,163,St. Clair County, IL,Apr-17,125542,120205,5337,4.3
CN1716300000000,17,163,St. Clair County, IL,May-17,124569,119081,5488,4.4
CN1716300000000,17,163,St. Clair County, IL,Jun-17,126118,119778,6340,5.0
CN1716300000000,17,163,St. Clair County, IL,Jul-17,126660,119921,6739,5.3
CN1716300000000,17,163,St. Clair County, IL,Aug-17,125678,118968,6710,5.3
CN1716300000000,17,163,St. Clair County, IL,Sep-17,125630,119734,5896,4.7
CN1716300000000,17,163,St. Clair County, IL,Oct-17,125626,119942,5684,4.5
CN1716300000000,17,163,St. Clair County, IL,Nov-17,125983,120203,5780,4.6
CN1716300000000,17,163,St. Clair County, IL,Dec-17,125208,119588,5620,4.5
CN1716300000000,17,163,St. Clair County, IL,Jan-18,124734,118767,5967,4.8
CN1716300000000,17,163,St. Clair County, IL,Feb-18,125902,120442,5460,4.3
CN1716300000000,17,163,St. Clair County, IL,Mar-18,127902,122192,5710,4.5
CN1716300000000,17,163,St. Clair County, IL,Apr-18(p),127944,123167,4777,3.7
CN2006500000000,20,065,Graham County, KS,Mar-17,1121,1075,46,4.1
CN2006500000000,20,065,Graham County, KS,Apr-17,1099,1060,39,3.5
CN2006500000000,20,065,Graham County, KS,May-17,1100,1060,40,3.6
CN2006500000000,20,065,Graham County, KS,Jun-17,1150,1107,43,3.7
CN2006500000000,20,065,Graham County, KS,Jul-17,1136,1093,43,3.8
CN2006500000000,20,065,Graham County, KS,Aug-17,1118,1076,42,3.8
CN2006500000000,20,065,Graham County, KS,Sep-17,1147,1113,34,3.0
CN2006500000000,20,065,Graham County, KS,Oct-17,1157,1124,33,2.9
CN2006500000000,20,065,Graham County, KS,Nov-17,1141,1107,34,3.0
CN2006500000000,20,065,Graham County, KS,Dec-17,1127,1094,33,2.9
CN2006500000000,20,065,Graham County, KS,Jan-18,1106,1073,33,3.0
CN2006500000000,20,065,Graham County, KS,Feb-18,1104,1071,33,3.0
CN2006500000000,20,065,Graham County, KS,Mar-18,1099,1065,34,3.1
CN2006500000000,20,065,Graham County, KS,Apr-18(p),1051,1020,31,2.9
CN2012700000000,20,127,Morris County, KS,Mar-17,2997,2894,103,3.4
CN2012700000000,20,127,Morris County, KS,Apr-17,2932,2841,91,3.1
CN2012700000000,20,127,Morris County, KS,May-17,3006,2910,96,3.2
CN2012700000000,20,127,Morris County, KS,Jun-17,3036,2942,94,3.1
CN2012700000000,20,127,Morris County, KS,Jul-17,2988,2890,98,3.3
CN2012700000000,20,127,Morris County, KS,Aug-17,2982,2888,94,3.2
CN2012700000000,20,127,Morris County, KS,Sep-17,3056,2974,82,2.7
CN2012700000000,20,127,Morris County, KS,Oct-17,3077,3006,71,2.3
CN2012700000000,20,127,Morris County, KS,Nov-17,3052,2970,82,2.7
CN2012700000000,20,127,Morris County, KS,Dec-17,3015,2938,77,2.6
CN2012700000000,20,127,Morris County, KS,Jan-18,3033,2942,91,3.0
CN2012700000000,20,127,Morris County, KS,Feb-18,3025,2939,86,2.8
CN2012700000000,20,127,Morris County, KS,Mar-18,3012,2931,81,2.7
CN2012700000000,20,127,Morris County, KS,Apr-18(p),2907,2832,75,2.6
CN3000100000000,30,001,Beaverhead County, MT,Mar-17,4999,4810,189,3.8
CN3000100000000,30,001,Beaverhead County, MT,Apr-17,5014,4851,163,3.3
CN3000100000000,30,001,Beaverhead County, MT,May-17,5077,4942,135,2.7
CN3000100000000,30,001,Beaverhead County, MT,Jun-17,5178,5030,148,2.9
CN3000100000000,30,001,Beaverhead County, MT,Jul-17,5204,5069,135,2.6
CN3000100000000,30,001,Beaverhead County, MT,Aug-17,5206,5077,129,2.5
CN3000100000000,30,001,Beaverhead County, MT,Sep-17,5052,4922,130,2.6
CN3000100000000,30,001,Beaverhead County, MT,Oct-17,5058,4922,136,2.7
CN3000100000000,30,001,Beaverhead County, MT,Nov-17,5037,4882,155,3.1
CN3000100000000,30,001,Beaverhead County, MT,Dec-17,4937,4755,182,3.7
CN3000100000000,30,001,Beaverhead County, MT,Jan-18,5029,4817,212,4.2
CN3000100000000,30,001,Beaverhead County, MT,Feb-18,4993,4786,207,4.1
CN3000100000000,30,001,Beaverhead County, MT,Mar-18,4960,4770,190,3.8
CN3000100000000,30,001,Beaverhead County, MT,Apr-18(p),4936,4781,155,3.1
CN4901100000000,49,011,Davis County, UT,Mar-17,167780,162405,5375,3.2
CN4901100000000,49,011,Davis County, UT,Apr-17,168644,163612,5032,3.0
CN4901100000000,49,011,Davis County, UT,May-17,170909,165854,5055,3.0
CN4901100000000,49,011,Davis County, UT,Jun-17,171920,165963,5957,3.5
CN4901100000000,49,011,Davis County, UT,Jul-17,173323,167754,5569,3.2
CN4901100000000,49,011,Davis County, UT,Aug-17,172374,166754,5620,3.3
CN4901100000000,49,011,Davis County, UT,Sep-17,171586,166619,4967,2.9
CN4901100000000,49,011,Davis County, UT,Oct-17,171810,166779,5031,2.9
CN4901100000000,49,011,Davis County, UT,Nov-17,171874,167205,4669,2.7
CN4901100000000,49,011,Davis County, UT,Dec-17,170744,166116,4628,2.7
CN4901100000000,49,011,Davis County, UT,Jan-18,169652,164820,4832,2.8
CN4901100000000,49,011,Davis County, UT,Feb-18,171599,166281,5318,3.1
CN4901100000000,49,011,Davis County, UT,Mar-18,171503,166174,5329,3.1
CN4901100000000,49,011,Davis County, UT,Apr-18(p),171886,166866,5020,2.9
CN0600900000000,06,009,Calaveras County, CA,Mar-17,21027,19896,1131,5.4
CN0600900000000,06,009,Calaveras County, CA,Apr-17,21008,20002,1006,4.8
CN0600900000000,06,009,Calaveras County, CA,May-17,20894,19954,940,4.5
CN0600900000000,06,009,Calaveras County, CA,Jun-17,21365,20353,1012,4.7
CN0600900000000,06,009,Calaveras County, CA,Jul-17,21445,20383,1062,5.0
CN0600900000000,06,009,Calaveras County, CA,Aug-17,21541,20540,1001,4.6
CN0600900000000,06,009,Calaveras County, CA,Sep-17,21457,20604,853,4.0
CN0600900000000,06,009,Calaveras County, CA,Oct-17,21370,20526,844,3.9
CN0600900000000,06,009,Calaveras County, CA,Nov-17,21139,20307,832,3.9
CN0600900000000,06,009,Calaveras County, CA,Dec-17,21261,20419,842,4.0
CN0600900000000,06,009,Calaveras County, CA,Jan-18,21220,20253,967,4.6
CN0600900000000,06,009,Calaveras County, CA,Feb-18,21352,20379,973,4.6
CN0600900000000,06,009,Calaveras County, CA,Mar-18,21255,20334,921,4.3
CN0600900000000,06,009,Calaveras County, CA,Apr-18(p),21193,20382,811,3.8
CN1910500000000,19,105,Jones County, IA,Mar-17,10534,10020,514,4.9
CN1910500000000,19,105,Jones County, IA,Apr-17,10517,10121,396,3.8
CN1910500000000,19,105,Jones County, IA,May-17,10451,10117,334,3.2
CN1910500000000,19,105,Jones County, IA,Jun-17,10616,10296,320,3.0
CN1910500000000,19,105,Jones County, IA,Jul-17,10715,10398,317,3.0
CN1910500000000,19,105,Jones County, IA,Aug-17,10574,10237,337,3.2
CN1910500000000,19,105,Jones County, IA,Sep-17,10447,10148,299,2.9
CN1910500000000,19,105,Jones County, IA,Oct-17,10482,10221,261,2.5
CN1910500000000,19,105,Jones County, IA,Nov-17,10425,10141,284,2.7
CN1910500000000,19,105,Jones County, IA,Dec-17,10443,10092,351,3.4
CN1910500000000,19,105,Jones County, IA,Jan-18,10488,9938,550,5.2
CN1910500000000,19,105,Jones County, IA,Feb-18,10590,10061,529,5.0
CN1910500000000,19,105,Jones County, IA,Mar-18,10450,9995,455,4.4
CN1910500000000,19,105,Jones County, IA,Apr-18(p),10415,10068,347,3.3
CN2906100000000,29,061,Daviess County, MO,Mar-17,4060,3905,155,3.8
CN2906100000000,29,061,Daviess County, MO,Apr-17,4298,4161,137,3.2
CN2906100000000,29,061,Daviess County, MO,May-17,4161,4033,128,3.1
CN2906100000000,29,061,Daviess County, MO,Jun-17,4202,4071,131,3.1
CN2906100000000,29,061,Daviess County, MO,Jul-17,3891,3731,160,4.1
CN2906100000000,29,061,Daviess County, MO,Aug-17,3854,3705,149,3.9
CN2906100000000,29,061,Daviess County, MO,Sep-17,3944,3842,102,2.6
CN2906100000000,29,061,Daviess County, MO,Oct-17,4063,3973,90,2.2
CN2906100000000,29,061,Daviess County, MO,Nov-17,4014,3922,92,2.3
CN2906100000000,29,061,Daviess County, MO,Dec-17,3922,3814,108,2.8
CN2906100000000,29,061,Daviess County, MO,Jan-18,3969,3801,168,4.2
CN2906100000000,29,061,Daviess County, MO,Feb-18,4024,3858,166,4.1
CN2906100000000,29,061,Daviess County, MO,Mar-18,4008,3872,136,3.4
CN2906100000000,29,061,Daviess County, MO,Apr-18(p),4132,4007,125,3.0
CN2613300000000,26,133,Osceola County, MI,Mar-17,10564,9892,672,6.4
CN2613300000000,26,133,Osceola County, MI,Apr-17,10512,9981,531,5.1
CN2613300000000,26,133,Osceola County, MI,May-17,10642,10096,546,5.1
CN2613300000000,26,133,Osceola County, MI,Jun-17,10699,10070,629,5.9
CN2613300000000,26,133,Osceola County, MI,Jul-17,10912,9969,943,8.6
CN2613300000000,26,133,Osceola County, MI,Aug-17,10561,9941,620,5.9
CN2613300000000,26,133,Osceola County, MI,Sep-17,10696,10130,566,5.3
CN2613300000000,26,133,Osceola County, MI,Oct-17,10632,10109,523,4.9
CN2613300000000,26,133,Osceola County, MI,Nov-17,10569,10052,517,4.9
CN2613300000000,26,133,Osceola County, MI,Dec-17,10569,9954,615,5.8
CN2613300000000,26,133,Osceola County, MI,Jan-18,10619,9886,733,6.9
CN2613300000000,26,133,Osceola County, MI,Feb-18,10757,10042,715,6.6
CN2613300000000,26,133,Osceola County, MI,Mar-18,10714,10103,611,5.7
CN2613300000000,26,133,Osceola County, MI,Apr-18(p),10703,10177,526,4.9
CN4816900000000,48,169,Garza County, TX,Mar-17,2149,2071,78,3.6
CN4816900000000,48,169,Garza County, TX,Apr-17,2134,2069,65,3.0
CN4816900000000,48,169,Garza County, TX,May-17,2107,2041,66,3.1
CN4816900000000,48,169,Garza County, TX,Jun-17,2099,2025,74,3.5
CN4816900000000,48,169,Garza County, TX,Jul-17,2124,2050,74,3.5
CN4816900000000,48,169,Garza County, TX,Aug-17,2131,2057,74,3.5
CN4816900000000,48,169,Garza County, TX,Sep-17,2114,2052,62,2.9
CN4816900000000,48,169,Garza County, TX,Oct-17,2100,2045,55,2.6
CN4816900000000,48,169,Garza County, TX,Nov-17,2091,2031,60,2.9
CN4816900000000,48,169,Garza County, TX,Dec-17,2106,2050,56,2.7
CN4816900000000,48,169,Garza County, TX,Jan-18,2102,2040,62,2.9
CN4816900000000,48,169,Garza County, TX,Feb-18,2132,2063,69,3.2
CN4816900000000,48,169,Garza County, TX,Mar-18,2158,2086,72,3.3
CN4816900000000,48,169,Garza County, TX,Apr-18(p),2135,2068,67,3.1
CN1203100000000,12,031,Duval County, FL,Mar-17,477012,457248,19764,4.1
CN1203100000000,12,031,Duval County, FL,Apr-17,478991,459973,19018,4.0
CN1203100000000,12,031,Duval County, FL,May-17,483320,463807,19513,4.0
CN1203100000000,12,031,Duval County, FL,Jun-17,487035,465565,21470,4.4
CN1203100000000,12,031,Duval County, FL,Jul-17,491051,469049,22002,4.5
CN1203100000000,12,031,Duval County, FL,Aug-17,488247,466578,21669,4.4
CN1203100000000,12,031,Duval County, FL,Sep-17,494690,475458,19232,3.9
CN1203100000000,12,031,Duval County, FL,Oct-17,488649,470520,18129,3.7
CN1203100000000,12,031,Duval County, FL,Nov-17,486928,468853,18075,3.7
CN1203100000000,12,031,Duval County, FL,Dec-17,485056,467977,17079,3.5
CN1203100000000,12,031,Duval County, FL,Jan-18,484273,464801,19472,4.0
CN1203100000000,12,031,Duval County, FL,Feb-18,488130,470184,17946,3.7
CN1203100000000,12,031,Duval County, FL,Mar-18,489704,471849,17855,3.6
CN1203100000000,12,031,Duval County, FL,Apr-18(p),487406,471243,16163,3.3
CN0500300000000,05,003,Ashley County, AR,Mar-17,7789,7344,445,5.7
CN0500300000000,05,003,Ashley County, AR,Apr-17,7854,7452,402,5.1
CN0500300000000,05,003,Ashley County, AR,May-17,7683,7257,426,5.5
CN0500300000000,05,003,Ashley County, AR,Jun-17,7769,7295,474,6.1
CN0500300000000,05,003,Ashley County, AR,Jul-17,7585,7098,487,6.4
CN0500300000000,05,003,Ashley County, AR,Aug-17,7598,7158,440,5.8
CN0500300000000,05,003,Ashley County, AR,Sep-17,7694,7285,409,5.3
CN0500300000000,05,003,Ashley County, AR,Oct-17,7742,7378,364,4.7
CN0500300000000,05,003,Ashley County, AR,Nov-17,7643,7281,362,4.7
CN0500300000000,05,003,Ashley County, AR,Dec-17,7618,7197,421,5.5
CN0500300000000,05,003,Ashley County, AR,Jan-18,7617,7093,524,6.9
CN0500300000000,05,003,Ashley County, AR,Feb-18,7706,7201,505,6.6
CN0500300000000,05,003,Ashley County, AR,Mar-18,7752,7294,458,5.9
CN0500300000000,05,003,Ashley County, AR,Apr-18(p),7724,7326,398,5.2
CN4400300000000,44,003,Kent County, RI,Mar-17,90021,86155,3866,4.3
CN4400300000000,44,003,Kent County, RI,Apr-17,89988,86696,3292,3.7
CN4400300000000,44,003,Kent County, RI,May-17,90139,86840,3299,3.7
CN4400300000000,44,003,Kent County, RI,Jun-17,91500,88005,3495,3.8
CN4400300000000,44,003,Kent County, RI,Jul-17,92056,88142,3914,4.3
CN4400300000000,44,003,Kent County, RI,Aug-17,91851,88035,3816,4.2
CN4400300000000,44,003,Kent County, RI,Sep-17,91333,87843,3490,3.8
CN4400300000000,44,003,Kent County, RI,Oct-17,91545,87969,3576,3.9
CN4400300000000,44,003,Kent County, RI,Nov-17,91899,88260,3639,4.0
CN4400300000000,44,003,Kent County, RI,Dec-17,91580,87944,3636,4.0
CN4400300000000,44,003,Kent County, RI,Jan-18,90933,86464,4469,4.9
CN4400300000000,44,003,Kent County, RI,Feb-18,91285,86864,4421,4.8
CN4400300000000,44,003,Kent County, RI,Mar-18,91096,87205,3891,4.3
CN4400300000000,44,003,Kent County, RI,Apr-18(p),91288,87953,3335,3.7
CN5305500000000,53,055,San Juan County, WA,Mar-17,7569,7241,328,4.3
CN5305500000000,53,055,San Juan County, WA,Apr-17,7834,7531,303,3.9
CN5305500000000,53,055,San Juan County, WA,May-17,8168,7874,294,3.6
CN5305500000000,53,055,San Juan County, WA,Jun-17,8787,8498,289,3.3
CN5305500000000,53,055,San Juan County, WA,Jul-17,9272,8978,294,3.2
CN5305500000000,53,055,San Juan County, WA,Aug-17,9227,8951,276,3.0
CN5305500000000,53,055,San Juan County, WA,Sep-17,8756,8447,309,3.5
CN5305500000000,53,055,San Juan County, WA,Oct-17,8175,7885,290,3.5
CN5305500000000,53,055,San Juan County, WA,Nov-17,8092,7779,313,3.9
CN5305500000000,53,055,San Juan County, WA,Dec-17,7940,7589,351,4.4
CN5305500000000,53,055,San Juan County, WA,Jan-18,7795,7392,403,5.2
CN5305500000000,53,055,San Juan County, WA,Feb-18,7742,7356,386,5.0
CN5305500000000,53,055,San Juan County, WA,Mar-18,7719,7372,347,4.5
CN5305500000000,53,055,San Juan County, WA,Apr-18(p),7853,7525,328,4.2
CN2703900000000,27,039,Dodge County, MN,Mar-17,11636,11114,522,4.5
CN2703900000000,27,039,Dodge County, MN,Apr-17,11590,11212,378,3.3
CN2703900000000,27,039,Dodge County, MN,May-17,11587,11259,328,2.8
CN2703900000000,27,039,Dodge County, MN,Jun-17,11773,11385,388,3.3
CN2703900000000,27,039,Dodge County, MN,Jul-17,11871,11490,381,3.2
CN2703900000000,27,039,Dodge County, MN,Aug-17,11766,11384,382,3.2
CN2703900000000,27,039,Dodge County, MN,Sep-17,11509,11209,300,2.6
CN2703900000000,27,039,Dodge County, MN,Oct-17,11643,11393,250,2.1
CN2703900000000,27,039,Dodge County, MN,Nov-17,11564,11312,252,2.2
CN2703900000000,27,039,Dodge County, MN,Dec-17,11630,11247,383,3.3
CN2703900000000,27,039,Dodge County, MN,Jan-18,11708,11173,535,4.6
CN2703900000000,27,039,Dodge County, MN,Feb-18,11765,11224,541,4.6
CN2703900000000,27,039,Dodge County, MN,Mar-18,11759,11251,508,4.3
CN2703900000000,27,039,Dodge County, MN,Apr-18(p),11662,11263,399,3.4
CN0103900000000,01,039,Covington County, AL,Mar-17,15755,14851,904,5.7
CN0103900000000,01,039,Covington County, AL,Apr-17,15678,14878,800,5.1
CN0103900000000,01,039,Covington County, AL,May-17,15628,14856,772,4.9
CN0103900000000,01,039,Covington County, AL,Jun-17,15800,14904,896,5.7
CN0103900000000,01,039,Covington County, AL,Jul-17,15728,14881,847,5.4
CN0103900000000,01,039,Covington County, AL,Aug-17,15656,14866,790,5.0
CN0103900000000,01,039,Covington County, AL,Sep-17,15914,15208,706,4.4
CN0103900000000,01,039,Covington County, AL,Oct-17,15726,15059,667,4.2
CN0103900000000,01,039,Covington County, AL,Nov-17,15470,14856,614,4.0
CN0103900000000,01,039,Covington County, AL,Dec-17,15204,14569,635,4.2
CN0103900000000,01,039,Covington County, AL,Jan-18,15080,14325,755,5.0
CN0103900000000,01,039,Covington County, AL,Feb-18,15262,14492,770,5.0
CN0103900000000,01,039,Covington County, AL,Mar-18,15298,14616,682,4.5
CN0103900000000,01,039,Covington County, AL,Apr-18(p),15421,14781,640,4.2
CN1327300000000,13,273,Terrell County, GA,Mar-17,3802,3567,235,6.2
CN1327300000000,13,273,Terrell County, GA,Apr-17,3738,3509,229,6.1
CN1327300000000,13,273,Terrell County, GA,May-17,3742,3515,227,6.1
CN1327300000000,13,273,Terrell County, GA,Jun-17,3719,3504,215,5.8
CN1327300000000,13,273,Terrell County, GA,Jul-17,3709,3487,222,6.0
CN1327300000000,13,273,Terrell County, GA,Aug-17,3709,3485,224,6.0
CN1327300000000,13,273,Terrell County, GA,Sep-17,3753,3531,222,5.9
CN1327300000000,13,273,Terrell County, GA,Oct-17,3769,3568,201,5.3
CN1327300000000,13,273,Terrell County, GA,Nov-17,3765,3575,190,5.0
CN1327300000000,13,273,Terrell County, GA,Dec-17,3787,3587,200,5.3
CN1327300000000,13,273,Terrell County, GA,Jan-18,3804,3596,208,5.5
CN1327300000000,13,273,Terrell County, GA,Feb-18,3804,3601,203,5.3
CN1327300000000,13,273,Terrell County, GA,Mar-18,3770,3587,183,4.9
CN1327300000000,13,273,Terrell County, GA,Apr-18(p),3742,3580,162,4.3
CN5170000000000,51,700,Newport News city, VA,Mar-17,89995,85737,4258,4.7
CN5170000000000,51,700,Newport News city, VA,Apr-17,90235,86364,3871,4.3
CN5170000000000,51,700,Newport News city, VA,May-17,90263,86331,3932,4.4
CN5170000000000,51,700,Newport News city, VA,Jun-17,91090,86833,4257,4.7
CN5170000000000,51,700,Newport News city, VA,Jul-17,91993,87609,4384,4.8
CN5170000000000,51,700,Newport News city, VA,Aug-17,91227,86767,4460,4.9
CN5170000000000,51,700,Newport News city, VA,Sep-17,90537,86537,4000,4.4
CN5170000000000,51,700,Newport News city, VA,Oct-17,89755,85945,3810,4.2
CN5170000000000,51,700,Newport News city, VA,Nov-17,89092,85274,3818,4.3
CN5170000000000,51,700,Newport News city, VA,Dec-17,88538,84707,3831,4.3
CN5170000000000,51,700,Newport News city, VA,Jan-18,88484,84445,4039,4.6
CN5170000000000,51,700,Newport News city, VA,Feb-18,89504,85763,3741,4.2
CN5170000000000,51,700,Newport News city, VA,Mar-18,90002,86420,3582,4.0
CN5170000000000,51,700,Newport News city, VA,Apr-18(p),89937,86859,3078,3.4
CN2002700000000,20,027,Clay County, KS,Mar-17,3850,3700,150,3.9
CN2002700000000,20,027,Clay County, KS,Apr-17,3749,3616,133,3.5
CN2002700000000,20,027,Clay County, KS,May-17,3775,3636,139,3.7
CN2002700000000,20,027,Clay County, KS,Jun-17,3883,3730,153,3.9
CN2002700000000,20,027,Clay County, KS,Jul-17,3644,3483,161,4.4
CN2002700000000,20,027,Clay County, KS,Aug-17,3777,3629,148,3.9
CN2002700000000,20,027,Clay County, KS,Sep-17,3873,3748,125,3.2
CN2002700000000,20,027,Clay County, KS,Oct-17,3891,3778,113,2.9
CN2002700000000,20,027,Clay County, KS,Nov-17,3850,3726,124,3.2
CN2002700000000,20,027,Clay County, KS,Dec-17,3819,3703,116,3.0
CN2002700000000,20,027,Clay County, KS,Jan-18,3801,3659,142,3.7
CN2002700000000,20,027,Clay County, KS,Feb-18,3790,3655,135,3.6
CN2002700000000,20,027,Clay County, KS,Mar-18,3760,3635,125,3.3
CN2002700000000,20,027,Clay County, KS,Apr-18(p),3637,3521,116,3.2
CN3605100000000,36,051,Livingston County, NY,Mar-17,31224,29503,1721,5.5
CN3605100000000,36,051,Livingston County, NY,Apr-17,31270,29767,1503,4.8
CN3605100000000,36,051,Livingston County, NY,May-17,30877,29417,1460,4.7
CN3605100000000,36,051,Livingston County, NY,Jun-17,31356,29790,1566,5.0
CN3605100000000,36,051,Livingston County, NY,Jul-17,31123,29596,1527,4.9
CN3605100000000,36,051,Livingston County, NY,Aug-17,30776,29342,1434,4.7
CN3605100000000,36,051,Livingston County, NY,Sep-17,30955,29522,1433,4.6
CN3605100000000,36,051,Livingston County, NY,Oct-17,30928,29524,1404,4.5
CN3605100000000,36,051,Livingston County, NY,Nov-17,31067,29571,1496,4.8
CN3605100000000,36,051,Livingston County, NY,Dec-17,30879,29306,1573,5.1
CN3605100000000,36,051,Livingston County, NY,Jan-18,31358,29422,1936,6.2
CN3605100000000,36,051,Livingston County, NY,Feb-18,31251,29261,1990,6.4
CN3605100000000,36,051,Livingston County, NY,Mar-18,30808,28998,1810,5.9
CN3605100000000,36,051,Livingston County, NY,Apr-18(p),30935,29377,1558,5.0
CN1706300000000,17,063,Grundy County, IL,Mar-17,25699,24130,1569,6.1
CN1706300000000,17,063,Grundy County, IL,Apr-17,25401,24055,1346,5.3
CN1706300000000,17,063,Grundy County, IL,May-17,25463,24224,1239,4.9
CN1706300000000,17,063,Grundy County, IL,Jun-17,26118,24498,1620,6.2
CN1706300000000,17,063,Grundy County, IL,Jul-17,26007,24435,1572,6.0
CN1706300000000,17,063,Grundy County, IL,Aug-17,25707,24103,1604,6.2
CN1706300000000,17,063,Grundy County, IL,Sep-17,25534,24210,1324,5.2
CN1706300000000,17,063,Grundy County, IL,Oct-17,25430,24160,1270,5.0
CN1706300000000,17,063,Grundy County, IL,Nov-17,25507,24199,1308,5.1
CN1706300000000,17,063,Grundy County, IL,Dec-17,25578,24039,1539,6.0
CN1706300000000,17,063,Grundy County, IL,Jan-18,25682,23623,2059,8.0
CN1706300000000,17,063,Grundy County, IL,Feb-18,25981,24018,1963,7.6
CN1706300000000,17,063,Grundy County, IL,Mar-18,25535,24094,1441,5.6
CN1706300000000,17,063,Grundy County, IL,Apr-18(p),25028,23960,1068,4.3
CN1818100000000,18,181,White County, IN,Mar-17,13187,12705,482,3.7
CN1818100000000,18,181,White County, IN,Apr-17,13202,12821,381,2.9
CN1818100000000,18,181,White County, IN,May-17,13686,13311,375,2.7
CN1818100000000,18,181,White County, IN,Jun-17,13826,13422,404,2.9
CN1818100000000,18,181,White County, IN,Jul-17,13515,13100,415,3.1
CN1818100000000,18,181,White County, IN,Aug-17,13525,13073,452,3.3
CN1818100000000,18,181,White County, IN,Sep-17,13121,12738,383,2.9
CN1818100000000,18,181,White County, IN,Oct-17,12793,12418,375,2.9
CN1818100000000,18,181,White County, IN,Nov-17,12804,12413,391,3.1
CN1818100000000,18,181,White County, IN,Dec-17,12469,12083,386,3.1
CN1818100000000,18,181,White County, IN,Jan-18,12403,11917,486,3.9
CN1818100000000,18,181,White County, IN,Feb-18,12779,12282,497,3.9
CN1818100000000,18,181,White County, IN,Mar-18,12964,12522,442,3.4
CN1818100000000,18,181,White County, IN,Apr-18(p),13136,12775,361,2.7
CN2715100000000,27,151,Swift County, MN,Mar-17,5042,4759,283,5.6
CN2715100000000,27,151,Swift County, MN,Apr-17,5094,4865,229,4.5
CN2715100000000,27,151,Swift County, MN,May-17,5060,4901,159,3.1
CN2715100000000,27,151,Swift County, MN,Jun-17,5139,4961,178,3.5
CN2715100000000,27,151,Swift County, MN,Jul-17,5055,4878,177,3.5
CN2715100000000,27,151,Swift County, MN,Aug-17,4954,4771,183,3.7
CN2715100000000,27,151,Swift County, MN,Sep-17,4859,4728,131,2.7
CN2715100000000,27,151,Swift County, MN,Oct-17,5040,4934,106,2.1
CN2715100000000,27,151,Swift County, MN,Nov-17,5022,4869,153,3.0
CN2715100000000,27,151,Swift County, MN,Dec-17,5094,4844,250,4.9
CN2715100000000,27,151,Swift County, MN,Jan-18,5100,4786,314,6.2
CN2715100000000,27,151,Swift County, MN,Feb-18,5072,4785,287,5.7
CN2715100000000,27,151,Swift County, MN,Mar-18,5066,4788,278,5.5
CN2715100000000,27,151,Swift County, MN,Apr-18(p),5121,4890,231,4.5
CN3402900000000,34,029,Ocean County, NJ,Mar-17,270118,256912,13206,4.9
CN3402900000000,34,029,Ocean County, NJ,Apr-17,269538,257537,12001,4.5
CN3402900000000,34,029,Ocean County, NJ,May-17,270571,258311,12260,4.5
CN3402900000000,34,029,Ocean County, NJ,Jun-17,275074,262237,12837,4.7
CN3402900000000,34,029,Ocean County, NJ,Jul-17,276856,262958,13898,5.0
CN3402900000000,34,029,Ocean County, NJ,Aug-17,274382,260975,13407,4.9
CN3402900000000,34,029,Ocean County, NJ,Sep-17,269946,257109,12837,4.8
CN3402900000000,34,029,Ocean County, NJ,Oct-17,269691,257378,12313,4.6
CN3402900000000,34,029,Ocean County, NJ,Nov-17,268949,256616,12333,4.6
CN3402900000000,34,029,Ocean County, NJ,Dec-17,268871,256789,12082,4.5
CN3402900000000,34,029,Ocean County, NJ,Jan-18,268222,253750,14472,5.4
CN3402900000000,34,029,Ocean County, NJ,Feb-18,270410,255849,14561,5.4
CN3402900000000,34,029,Ocean County, NJ,Mar-18,268625,255065,13560,5.0
CN3402900000000,34,029,Ocean County, NJ,Apr-18(p),265974,254713,11261,4.2
CN1712500000000,17,125,Mason County, IL,Mar-17,6334,5931,403,6.4
CN1712500000000,17,125,Mason County, IL,Apr-17,6445,6108,337,5.2
CN1712500000000,17,125,Mason County, IL,May-17,6437,6118,319,5.0
CN1712500000000,17,125,Mason County, IL,Jun-17,6538,6146,392,6.0
CN1712500000000,17,125,Mason County, IL,Jul-17,6445,6044,401,6.2
CN1712500000000,17,125,Mason County, IL,Aug-17,6428,6021,407,6.3
CN1712500000000,17,125,Mason County, IL,Sep-17,6400,6050,350,5.5
CN1712500000000,17,125,Mason County, IL,Oct-17,6322,6016,306,4.8
CN1712500000000,17,125,Mason County, IL,Nov-17,6320,6002,318,5.0
CN1712500000000,17,125,Mason County, IL,Dec-17,6228,5891,337,5.4
CN1712500000000,17,125,Mason County, IL,Jan-18,6298,5915,383,6.1
CN1712500000000,17,125,Mason County, IL,Feb-18,6295,5950,345,5.5
CN1712500000000,17,125,Mason County, IL,Mar-18,6457,6098,359,5.6
CN1712500000000,17,125,Mason County, IL,Apr-18(p),6521,6238,283,4.3
CN1213100000000,12,131,Walton County, FL,Mar-17,29263,28179,1084,3.7
CN1213100000000,12,131,Walton County, FL,Apr-17,29419,28405,1014,3.4
CN1213100000000,12,131,Walton County, FL,May-17,29774,28742,1032,3.5
CN1213100000000,12,131,Walton County, FL,Jun-17,30618,29539,1079,3.5
CN1213100000000,12,131,Walton County, FL,Jul-17,30672,29600,1072,3.5
CN1213100000000,12,131,Walton County, FL,Aug-17,30243,29189,1054,3.5
CN1213100000000,12,131,Walton County, FL,Sep-17,30399,29400,999,3.3
CN1213100000000,12,131,Walton County, FL,Oct-17,29951,28997,954,3.2
CN1213100000000,12,131,Walton County, FL,Nov-17,29810,28831,979,3.3
CN1213100000000,12,131,Walton County, FL,Dec-17,29480,28540,940,3.2
CN1213100000000,12,131,Walton County, FL,Jan-18,29659,28551,1108,3.7
CN1213100000000,12,131,Walton County, FL,Feb-18,29975,28963,1012,3.4
CN1213100000000,12,131,Walton County, FL,Mar-18,30651,29681,970,3.2
CN1213100000000,12,131,Walton County, FL,Apr-18(p),30665,29821,844,2.8
CN3610900000000,36,109,Tompkins County, NY,Mar-17,51129,49064,2065,4.0
CN3610900000000,36,109,Tompkins County, NY,Apr-17,51945,49950,1995,3.8
CN3610900000000,36,109,Tompkins County, NY,May-17,50837,48808,2029,4.0
CN3610900000000,36,109,Tompkins County, NY,Jun-17,49828,47334,2494,5.0
CN3610900000000,36,109,Tompkins County, NY,Jul-17,49361,46914,2447,5.0
CN3610900000000,36,109,Tompkins County, NY,Aug-17,48540,46291,2249,4.6
CN3610900000000,36,109,Tompkins County, NY,Sep-17,51224,48922,2302,4.5
CN3610900000000,36,109,Tompkins County, NY,Oct-17,51183,49062,2121,4.1
CN3610900000000,36,109,Tompkins County, NY,Nov-17,50934,48733,2201,4.3
CN3610900000000,36,109,Tompkins County, NY,Dec-17,50099,48113,1986,4.0
CN3610900000000,36,109,Tompkins County, NY,Jan-18,49624,47309,2315,4.7
CN3610900000000,36,109,Tompkins County, NY,Feb-18,51682,49260,2422,4.7
CN3610900000000,36,109,Tompkins County, NY,Mar-18,51222,49081,2141,4.2
CN3610900000000,36,109,Tompkins County, NY,Apr-18(p),52056,50045,2011,3.9
CN1317300000000,13,173,Lanier County, GA,Mar-17,3873,3693,180,4.6
CN1317300000000,13,173,Lanier County, GA,Apr-17,3863,3695,168,4.3
CN1317300000000,13,173,Lanier County, GA,May-17,3872,3692,180,4.6
CN1317300000000,13,173,Lanier County, GA,Jun-17,3898,3676,222,5.7
CN1317300000000,13,173,Lanier County, GA,Jul-17,3881,3650,231,6.0
CN1317300000000,13,173,Lanier County, GA,Aug-17,3849,3638,211,5.5
CN1317300000000,13,173,Lanier County, GA,Sep-17,3867,3678,189,4.9
CN1317300000000,13,173,Lanier County, GA,Oct-17,3892,3691,201,5.2
CN1317300000000,13,173,Lanier County, GA,Nov-17,3896,3716,180,4.6
CN1317300000000,13,173,Lanier County, GA,Dec-17,3880,3696,184,4.7
CN1317300000000,13,173,Lanier County, GA,Jan-18,3935,3731,204,5.2
CN1317300000000,13,173,Lanier County, GA,Feb-18,3948,3758,190,4.8
CN1317300000000,13,173,Lanier County, GA,Mar-18,3949,3774,175,4.4
CN1317300000000,13,173,Lanier County, GA,Apr-18(p),3947,3790,157,4.0
CN3118100000000,31,181,Webster County, NE,Mar-17,1653,1599,54,3.3
CN3118100000000,31,181,Webster County, NE,Apr-17,1693,1649,44,2.6
CN3118100000000,31,181,Webster County, NE,May-17,1730,1682,48,2.8
CN3118100000000,31,181,Webster County, NE,Jun-17,1784,1730,54,3.0
CN3118100000000,31,181,Webster County, NE,Jul-17,1724,1665,59,3.4
CN3118100000000,31,181,Webster County, NE,Aug-17,1689,1635,54,3.2
CN3118100000000,31,181,Webster County, NE,Sep-17,1608,1569,39,2.4
CN3118100000000,31,181,Webster County, NE,Oct-17,1630,1591,39,2.4
CN3118100000000,31,181,Webster County, NE,Nov-17,1639,1599,40,2.4
CN3118100000000,31,181,Webster County, NE,Dec-17,1632,1586,46,2.8
CN3118100000000,31,181,Webster County, NE,Jan-18,1666,1621,45,2.7
CN3118100000000,31,181,Webster County, NE,Feb-18,1630,1587,43,2.6
CN3118100000000,31,181,Webster County, NE,Mar-18,1660,1615,45,2.7
CN3118100000000,31,181,Webster County, NE,Apr-18(p),1674,1624,50,3.0
CN2100100000000,21,001,Adair County, KY,Mar-17,7074,6561,513,7.3
CN2100100000000,21,001,Adair County, KY,Apr-17,7107,6673,434,6.1
CN2100100000000,21,001,Adair County, KY,May-17,7136,6691,445,6.2
CN2100100000000,21,001,Adair County, KY,Jun-17,6973,6484,489,7.0
CN2100100000000,21,001,Adair County, KY,Jul-17,6654,6195,459,6.9
CN2100100000000,21,001,Adair County, KY,Aug-17,6506,6101,405,6.2
CN2100100000000,21,001,Adair County, KY,Sep-17,6781,6441,340,5.0
CN2100100000000,21,001,Adair County, KY,Oct-17,6745,6424,321,4.8
CN2100100000000,21,001,Adair County, KY,Nov-17,6738,6405,333,4.9
CN2100100000000,21,001,Adair County, KY,Dec-17,6731,6407,324,4.8
CN2100100000000,21,001,Adair County, KY,Jan-18,6652,6273,379,5.7
CN2100100000000,21,001,Adair County, KY,Feb-18,6878,6447,431,6.3
CN2100100000000,21,001,Adair County, KY,Mar-18,6972,6576,396,5.7
CN2100100000000,21,001,Adair County, KY,Apr-18(p),6998,6662,336,4.8
CN5180000000000,51,800,Suffolk city, VA,Mar-17,43422,41573,1849,4.3
CN5180000000000,51,800,Suffolk city, VA,Apr-17,43668,41945,1723,3.9
CN5180000000000,51,800,Suffolk city, VA,May-17,43708,41905,1803,4.1
CN5180000000000,51,800,Suffolk city, VA,Jun-17,44086,42183,1903,4.3
CN5180000000000,51,800,Suffolk city, VA,Jul-17,44494,42563,1931,4.3
CN5180000000000,51,800,Suffolk city, VA,Aug-17,44041,42117,1924,4.4
CN5180000000000,51,800,Suffolk city, VA,Sep-17,43780,42029,1751,4.0
CN5180000000000,51,800,Suffolk city, VA,Oct-17,43334,41714,1620,3.7
CN5180000000000,51,800,Suffolk city, VA,Nov-17,42962,41366,1596,3.7
CN5180000000000,51,800,Suffolk city, VA,Dec-17,42683,41126,1557,3.6
CN5180000000000,51,800,Suffolk city, VA,Jan-18,42615,40933,1682,3.9
CN5180000000000,51,800,Suffolk city, VA,Feb-18,43125,41585,1540,3.6
CN5180000000000,51,800,Suffolk city, VA,Mar-18,43424,41866,1558,3.6
CN5180000000000,51,800,Suffolk city, VA,Apr-18(p),43475,42139,1336,3.1
CN2809500000000,28,095,Monroe County, MS,Mar-17,15452,14662,790,5.1
CN2809500000000,28,095,Monroe County, MS,Apr-17,15240,14539,701,4.6
CN2809500000000,28,095,Monroe County, MS,May-17,15432,14604,828,5.4
CN2809500000000,28,095,Monroe County, MS,Jun-17,15707,14768,939,6.0
CN2809500000000,28,095,Monroe County, MS,Jul-17,15682,14650,1032,6.6
CN2809500000000,28,095,Monroe County, MS,Aug-17,15300,14503,797,5.2
CN2809500000000,28,095,Monroe County, MS,Sep-17,15375,14622,753,4.9
CN2809500000000,28,095,Monroe County, MS,Oct-17,15322,14606,716,4.7
CN2809500000000,28,095,Monroe County, MS,Nov-17,15359,14676,683,4.4
CN2809500000000,28,095,Monroe County, MS,Dec-17,15277,14613,664,4.3
CN2809500000000,28,095,Monroe County, MS,Jan-18,15151,14464,687,4.5
CN2809500000000,28,095,Monroe County, MS,Feb-18,15193,14522,671,4.4
CN2809500000000,28,095,Monroe County, MS,Mar-18,15206,14554,652,4.3
CN2809500000000,28,095,Monroe County, MS,Apr-18(p),15222,14571,651,4.3
CN4804500000000,48,045,Briscoe County, TX,Mar-17,579,552,27,4.7
CN4804500000000,48,045,Briscoe County, TX,Apr-17,551,525,26,4.7
CN4804500000000,48,045,Briscoe County, TX,May-17,578,550,28,4.8
CN4804500000000,48,045,Briscoe County, TX,Jun-17,585,558,27,4.6
CN4804500000000,48,045,Briscoe County, TX,Jul-17,546,520,26,4.8
CN4804500000000,48,045,Briscoe County, TX,Aug-17,554,528,26,4.7
CN4804500000000,48,045,Briscoe County, TX,Sep-17,538,515,23,4.3
CN4804500000000,48,045,Briscoe County, TX,Oct-17,557,539,18,3.2
CN4804500000000,48,045,Briscoe County, TX,Nov-17,556,537,19,3.4
CN4804500000000,48,045,Briscoe County, TX,Dec-17,573,555,18,3.1
CN4804500000000,48,045,Briscoe County, TX,Jan-18,536,516,20,3.7
CN4804500000000,48,045,Briscoe County, TX,Feb-18,542,519,23,4.2
CN4804500000000,48,045,Briscoe County, TX,Mar-18,578,554,24,4.2
CN4804500000000,48,045,Briscoe County, TX,Apr-18(p),550,528,22,4.0
CN3007900000000,30,079,Prairie County, MT,Mar-17,500,480,20,4.0
CN3007900000000,30,079,Prairie County, MT,Apr-17,495,476,19,3.8
CN3007900000000,30,079,Prairie County, MT,May-17,535,514,21,3.9
CN3007900000000,30,079,Prairie County, MT,Jun-17,503,483,20,4.0
CN3007900000000,30,079,Prairie County, MT,Jul-17,518,502,16,3.1
CN3007900000000,30,079,Prairie County, MT,Aug-17,514,498,16,3.1
CN3007900000000,30,079,Prairie County, MT,Sep-17,474,461,13,2.7
CN3007900000000,30,079,Prairie County, MT,Oct-17,477,464,13,2.7
CN3007900000000,30,079,Prairie County, MT,Nov-17,490,474,16,3.3
CN3007900000000,30,079,Prairie County, MT,Dec-17,474,455,19,4.0
CN3007900000000,30,079,Prairie County, MT,Jan-18,483,459,24,5.0
CN3007900000000,30,079,Prairie County, MT,Feb-18,480,453,27,5.6
CN3007900000000,30,079,Prairie County, MT,Mar-18,481,456,25,5.2
CN3007900000000,30,079,Prairie County, MT,Apr-18(p),465,445,20,4.3
CN0206000000000,02,060,Bristol Bay Borough, AK,Mar-17,231,198,33,14.3
CN0206000000000,02,060,Bristol Bay Borough, AK,Apr-17,313,286,27,8.6
CN0206000000000,02,060,Bristol Bay Borough, AK,May-17,561,534,27,4.8
CN0206000000000,02,060,Bristol Bay Borough, AK,Jun-17,767,741,26,3.4
CN0206000000000,02,060,Bristol Bay Borough, AK,Jul-17,1266,1246,20,1.6
CN0206000000000,02,060,Bristol Bay Borough, AK,Aug-17,443,425,18,4.1
CN0206000000000,02,060,Bristol Bay Borough, AK,Sep-17,343,322,21,6.1
CN0206000000000,02,060,Bristol Bay Borough, AK,Oct-17,254,227,27,10.6
CN0206000000000,02,060,Bristol Bay Borough, AK,Nov-17,229,204,25,10.9
CN0206000000000,02,060,Bristol Bay Borough, AK,Dec-17,247,213,34,13.8
CN0206000000000,02,060,Bristol Bay Borough, AK,Jan-18,253,210,43,17.0
CN0206000000000,02,060,Bristol Bay Borough, AK,Feb-18,237,194,43,18.1
CN0206000000000,02,060,Bristol Bay Borough, AK,Mar-18,240,201,39,16.3
CN0206000000000,02,060,Bristol Bay Borough, AK,Apr-18(p),329,296,33,10.0
CN3801900000000,38,019,Cavalier County, ND,Mar-17,2088,2013,75,3.6
CN3801900000000,38,019,Cavalier County, ND,Apr-17,2090,2030,60,2.9
CN3801900000000,38,019,Cavalier County, ND,May-17,2086,2041,45,2.2
CN3801900000000,38,019,Cavalier County, ND,Jun-17,2176,2121,55,2.5
CN3801900000000,38,019,Cavalier County, ND,Jul-17,2142,2095,47,2.2
CN3801900000000,38,019,Cavalier County, ND,Aug-17,2135,2089,46,2.2
CN3801900000000,38,019,Cavalier County, ND,Sep-17,2168,2125,43,2.0
CN3801900000000,38,019,Cavalier County, ND,Oct-17,2167,2131,36,1.7
CN3801900000000,38,019,Cavalier County, ND,Nov-17,2084,2042,42,2.0
CN3801900000000,38,019,Cavalier County, ND,Dec-17,2050,1996,54,2.6
CN3801900000000,38,019,Cavalier County, ND,Jan-18,1981,1914,67,3.4
CN3801900000000,38,019,Cavalier County, ND,Feb-18,1945,1878,67,3.4
CN3801900000000,38,019,Cavalier County, ND,Mar-18,1987,1919,68,3.4
CN3801900000000,38,019,Cavalier County, ND,Apr-18(p),1997,1932,65,3.3
CN0105100000000,01,051,Elmore County, AL,Mar-17,37486,35973,1513,4.0
CN0105100000000,01,051,Elmore County, AL,Apr-17,37396,36157,1239,3.3
CN0105100000000,01,051,Elmore County, AL,May-17,37311,36116,1195,3.2
CN0105100000000,01,051,Elmore County, AL,Jun-17,37529,36062,1467,3.9
CN0105100000000,01,051,Elmore County, AL,Jul-17,37129,35701,1428,3.8
CN0105100000000,01,051,Elmore County, AL,Aug-17,36976,35634,1342,3.6
CN0105100000000,01,051,Elmore County, AL,Sep-17,36993,35841,1152,3.1
CN0105100000000,01,051,Elmore County, AL,Oct-17,37258,36079,1179,3.2
CN0105100000000,01,051,Elmore County, AL,Nov-17,37209,36108,1101,3.0
CN0105100000000,01,051,Elmore County, AL,Dec-17,37096,35994,1102,3.0
CN0105100000000,01,051,Elmore County, AL,Jan-18,36819,35482,1337,3.6
CN0105100000000,01,051,Elmore County, AL,Feb-18,37217,35831,1386,3.7
CN0105100000000,01,051,Elmore County, AL,Mar-18,37248,35995,1253,3.4
CN0105100000000,01,051,Elmore County, AL,Apr-18(p),37329,36196,1133,3.0
CN2018900000000,20,189,Stevens County, KS,Mar-17,2639,2549,90,3.4
CN2018900000000,20,189,Stevens County, KS,Apr-17,2568,2481,87,3.4
CN2018900000000,20,189,Stevens County, KS,May-17,2610,2524,86,3.3
CN2018900000000,20,189,Stevens County, KS,Jun-17,2716,2625,91,3.4
CN2018900000000,20,189,Stevens County, KS,Jul-17,2715,2617,98,3.6
CN2018900000000,20,189,Stevens County, KS,Aug-17,2698,2611,87,3.2
CN2018900000000,20,189,Stevens County, KS,Sep-17,2674,2592,82,3.1
CN2018900000000,20,189,Stevens County, KS,Oct-17,2703,2632,71,2.6
CN2018900000000,20,189,Stevens County, KS,Nov-17,2668,2590,78,2.9
CN2018900000000,20,189,Stevens County, KS,Dec-17,2620,2555,65,2.5
CN2018900000000,20,189,Stevens County, KS,Jan-18,2548,2482,66,2.6
CN2018900000000,20,189,Stevens County, KS,Feb-18,2536,2468,68,2.7
CN2018900000000,20,189,Stevens County, KS,Mar-18,2525,2454,71,2.8
CN2018900000000,20,189,Stevens County, KS,Apr-18(p),2399,2327,72,3.0
CN4827300000000,48,273,Kleberg County, TX,Mar-17,13941,13073,868,6.2
CN4827300000000,48,273,Kleberg County, TX,Apr-17,13895,13098,797,5.7
CN4827300000000,48,273,Kleberg County, TX,May-17,13697,12932,765,5.6
CN4827300000000,48,273,Kleberg County, TX,Jun-17,13256,12398,858,6.5
CN4827300000000,48,273,Kleberg County, TX,Jul-17,12947,12078,869,6.7
CN4827300000000,48,273,Kleberg County, TX,Aug-17,12922,12078,844,6.5
CN4827300000000,48,273,Kleberg County, TX,Sep-17,13144,12446,698,5.3
CN4827300000000,48,273,Kleberg County, TX,Oct-17,13314,12674,640,4.8
CN4827300000000,48,273,Kleberg County, TX,Nov-17,13269,12611,658,5.0
CN4827300000000,48,273,Kleberg County, TX,Dec-17,13132,12487,645,4.9
CN4827300000000,48,273,Kleberg County, TX,Jan-18,12629,11911,718,5.7
CN4827300000000,48,273,Kleberg County, TX,Feb-18,13124,12420,704,5.4
CN4827300000000,48,273,Kleberg County, TX,Mar-18,13350,12642,708,5.3
CN4827300000000,48,273,Kleberg County, TX,Apr-18(p),13415,12734,681,5.1
CN3503300000000,35,033,Mora County, NM,Mar-17,2172,1990,182,8.4
CN3503300000000,35,033,Mora County, NM,Apr-17,2131,1960,171,8.0
CN3503300000000,35,033,Mora County, NM,May-17,2134,1984,150,7.0
CN3503300000000,35,033,Mora County, NM,Jun-17,2182,2016,166,7.6
CN3503300000000,35,033,Mora County, NM,Jul-17,2198,2035,163,7.4
CN3503300000000,35,033,Mora County, NM,Aug-17,2227,2064,163,7.3
CN3503300000000,35,033,Mora County, NM,Sep-17,2221,2060,161,7.2
CN3503300000000,35,033,Mora County, NM,Oct-17,2235,2081,154,6.9
CN3503300000000,35,033,Mora County, NM,Nov-17,2170,2007,163,7.5
CN3503300000000,35,033,Mora County, NM,Dec-17,2165,1985,180,8.3
CN3503300000000,35,033,Mora County, NM,Jan-18,2180,2001,179,8.2
CN3503300000000,35,033,Mora County, NM,Feb-18,2170,1994,176,8.1
CN3503300000000,35,033,Mora County, NM,Mar-18,2155,1998,157,7.3
CN3503300000000,35,033,Mora County, NM,Apr-18(p),2124,1997,127,6.0
CN3913700000000,39,137,Putnam County, OH,Mar-17,19221,18506,715,3.7
CN3913700000000,39,137,Putnam County, OH,Apr-17,19002,18399,603,3.2
CN3913700000000,39,137,Putnam County, OH,May-17,19133,18531,602,3.1
CN3913700000000,39,137,Putnam County, OH,Jun-17,19322,18645,677,3.5
CN3913700000000,39,137,Putnam County, OH,Jul-17,19093,18358,735,3.8
CN3913700000000,39,137,Putnam County, OH,Aug-17,19441,18774,667,3.4
CN3913700000000,39,137,Putnam County, OH,Sep-17,19074,18470,604,3.2
CN3913700000000,39,137,Putnam County, OH,Oct-17,19078,18517,561,2.9
CN3913700000000,39,137,Putnam County, OH,Nov-17,18984,18391,593,3.1
CN3913700000000,39,137,Putnam County, OH,Dec-17,18702,18049,653,3.5
CN3913700000000,39,137,Putnam County, OH,Jan-18,18257,17524,733,4.0
CN3913700000000,39,137,Putnam County, OH,Feb-18,18683,17990,693,3.7
CN3913700000000,39,137,Putnam County, OH,Mar-18,19095,18493,602,3.2
CN3913700000000,39,137,Putnam County, OH,Apr-18(p),18918,18352,566,3.0
CN1806900000000,18,069,Huntington County, IN,Mar-17,18369,17735,634,3.5
CN1806900000000,18,069,Huntington County, IN,Apr-17,18461,17972,489,2.6
CN1806900000000,18,069,Huntington County, IN,May-17,18613,18087,526,2.8
CN1806900000000,18,069,Huntington County, IN,Jun-17,18570,17956,614,3.3
CN1806900000000,18,069,Huntington County, IN,Jul-17,18633,18005,628,3.4
CN1806900000000,18,069,Huntington County, IN,Aug-17,18374,17584,790,4.3
CN1806900000000,18,069,Huntington County, IN,Sep-17,18275,17518,757,4.1
CN1806900000000,18,069,Huntington County, IN,Oct-17,18332,17660,672,3.7
CN1806900000000,18,069,Huntington County, IN,Nov-17,18217,17576,641,3.5
CN1806900000000,18,069,Huntington County, IN,Dec-17,18014,17405,609,3.4
CN1806900000000,18,069,Huntington County, IN,Jan-18,17905,17213,692,3.9
CN1806900000000,18,069,Huntington County, IN,Feb-18,18057,17329,728,4.0
CN1806900000000,18,069,Huntington County, IN,Mar-18,18126,17496,630,3.5
CN1806900000000,18,069,Huntington County, IN,Apr-18(p),18290,17729,561,3.1
CN4800700000000,48,007,Aransas County, TX,Mar-17,10441,9824,617,5.9
CN4800700000000,48,007,Aransas County, TX,Apr-17,10358,9798,560,5.4
CN4800700000000,48,007,Aransas County, TX,May-17,10332,9788,544,5.3
CN4800700000000,48,007,Aransas County, TX,Jun-17,10315,9758,557,5.4
CN4800700000000,48,007,Aransas County, TX,Jul-17,10193,9644,549,5.4
CN4800700000000,48,007,Aransas County, TX,Aug-17,10132,9582,550,5.4
CN4800700000000,48,007,Aransas County, TX,Sep-17,10668,9564,1104,10.3
CN4800700000000,48,007,Aransas County, TX,Oct-17,10468,9561,907,8.7
CN4800700000000,48,007,Aransas County, TX,Nov-17,10478,9607,871,8.3
CN4800700000000,48,007,Aransas County, TX,Dec-17,10411,9628,783,7.5
CN4800700000000,48,007,Aransas County, TX,Jan-18,10379,9545,834,8.0
CN4800700000000,48,007,Aransas County, TX,Feb-18,10456,9716,740,7.1
CN4800700000000,48,007,Aransas County, TX,Mar-18,10527,9817,710,6.7
CN4800700000000,48,007,Aransas County, TX,Apr-18(p),10416,9780,636,6.1
CN5409900000000,54,099,Wayne County, WV,Mar-17,15394,14465,929,6.0
CN5409900000000,54,099,Wayne County, WV,Apr-17,15555,14666,889,5.7
CN5409900000000,54,099,Wayne County, WV,May-17,15507,14705,802,5.2
CN5409900000000,54,099,Wayne County, WV,Jun-17,15694,14761,933,5.9
CN5409900000000,54,099,Wayne County, WV,Jul-17,15628,14739,889,5.7
CN5409900000000,54,099,Wayne County, WV,Aug-17,15628,14685,943,6.0
CN5409900000000,54,099,Wayne County, WV,Sep-17,15702,14894,808,5.1
CN5409900000000,54,099,Wayne County, WV,Oct-17,15656,14842,814,5.2
CN5409900000000,54,099,Wayne County, WV,Nov-17,15602,14725,877,5.6
CN5409900000000,54,099,Wayne County, WV,Dec-17,15530,14626,904,5.8
CN5409900000000,54,099,Wayne County, WV,Jan-18,15444,14409,1035,6.7
CN5409900000000,54,099,Wayne County, WV,Feb-18,15619,14503,1116,7.1
CN5409900000000,54,099,Wayne County, WV,Mar-18,15414,14398,1016,6.6
CN5409900000000,54,099,Wayne County, WV,Apr-18(p),15504,14566,938,6.1
CN5402100000000,54,021,Gilmer County, WV,Mar-17,2505,2312,193,7.7
CN5402100000000,54,021,Gilmer County, WV,Apr-17,2440,2267,173,7.1
CN5402100000000,54,021,Gilmer County, WV,May-17,2434,2275,159,6.5
CN5402100000000,54,021,Gilmer County, WV,Jun-17,2366,2189,177,7.5
CN5402100000000,54,021,Gilmer County, WV,Jul-17,2339,2180,159,6.8
CN5402100000000,54,021,Gilmer County, WV,Aug-17,2322,2167,155,6.7
CN5402100000000,54,021,Gilmer County, WV,Sep-17,2416,2280,136,5.6
CN5402100000000,54,021,Gilmer County, WV,Oct-17,2500,2353,147,5.9
CN5402100000000,54,021,Gilmer County, WV,Nov-17,2500,2334,166,6.6
CN5402100000000,54,021,Gilmer County, WV,Dec-17,2441,2273,168,6.9
CN5402100000000,54,021,Gilmer County, WV,Jan-18,2441,2243,198,8.1
CN5402100000000,54,021,Gilmer County, WV,Feb-18,2502,2286,216,8.6
CN5402100000000,54,021,Gilmer County, WV,Mar-18,2464,2272,192,7.8
CN5402100000000,54,021,Gilmer County, WV,Apr-18(p),2481,2327,154,6.2
CN4710100000000,47,101,Lewis County, TN,Mar-17,4897,4640,257,5.2
CN4710100000000,47,101,Lewis County, TN,Apr-17,4926,4716,210,4.3
CN4710100000000,47,101,Lewis County, TN,May-17,4924,4735,189,3.8
CN4710100000000,47,101,Lewis County, TN,Jun-17,4895,4659,236,4.8
CN4710100000000,47,101,Lewis County, TN,Jul-17,4933,4700,233,4.7
CN4710100000000,47,101,Lewis County, TN,Aug-17,5039,4823,216,4.3
CN4710100000000,47,101,Lewis County, TN,Sep-17,5030,4853,177,3.5
CN4710100000000,47,101,Lewis County, TN,Oct-17,4999,4816,183,3.7
CN4710100000000,47,101,Lewis County, TN,Nov-17,4935,4756,179,3.6
CN4710100000000,47,101,Lewis County, TN,Dec-17,4962,4752,210,4.2
CN4710100000000,47,101,Lewis County, TN,Jan-18,4945,4694,251,5.1
CN4710100000000,47,101,Lewis County, TN,Feb-18,5024,4758,266,5.3
CN4710100000000,47,101,Lewis County, TN,Mar-18,4972,4748,224,4.5
CN4710100000000,47,101,Lewis County, TN,Apr-18(p),5052,4868,184,3.6
CN2603300000000,26,033,Chippewa County, MI,Mar-17,16347,14759,1588,9.7
CN2603300000000,26,033,Chippewa County, MI,Apr-17,16398,15097,1301,7.9
CN2603300000000,26,033,Chippewa County, MI,May-17,16130,15021,1109,6.9
CN2603300000000,26,033,Chippewa County, MI,Jun-17,16512,15326,1186,7.2
CN2603300000000,26,033,Chippewa County, MI,Jul-17,16718,15452,1266,7.6
CN2603300000000,26,033,Chippewa County, MI,Aug-17,16567,15389,1178,7.1
CN2603300000000,26,033,Chippewa County, MI,Sep-17,16576,15643,933,5.6
CN2603300000000,26,033,Chippewa County, MI,Oct-17,16365,15487,878,5.4
CN2603300000000,26,033,Chippewa County, MI,Nov-17,16232,15185,1047,6.5
CN2603300000000,26,033,Chippewa County, MI,Dec-17,16446,15021,1425,8.7
CN2603300000000,26,033,Chippewa County, MI,Jan-18,16462,14862,1600,9.7
CN2603300000000,26,033,Chippewa County, MI,Feb-18,16715,14967,1748,10.5
CN2603300000000,26,033,Chippewa County, MI,Mar-18,16498,14932,1566,9.5
CN2603300000000,26,033,Chippewa County, MI,Apr-18(p),16543,15260,1283,7.8
CN4502100000000,45,021,Cherokee County, SC,Mar-17,23798,22714,1084,4.6
CN4502100000000,45,021,Cherokee County, SC,Apr-17,23975,22983,992,4.1
CN4502100000000,45,021,Cherokee County, SC,May-17,23852,22805,1047,4.4
CN4502100000000,45,021,Cherokee County, SC,Jun-17,24198,22981,1217,5.0
CN4502100000000,45,021,Cherokee County, SC,Jul-17,24399,22939,1460,6.0
CN4502100000000,45,021,Cherokee County, SC,Aug-17,24124,22853,1271,5.3
CN4502100000000,45,021,Cherokee County, SC,Sep-17,24234,23086,1148,4.7
CN4502100000000,45,021,Cherokee County, SC,Oct-17,24347,23199,1148,4.7
CN4502100000000,45,021,Cherokee County, SC,Nov-17,24347,23252,1095,4.5
CN4502100000000,45,021,Cherokee County, SC,Dec-17,24423,23292,1131,4.6
CN4502100000000,45,021,Cherokee County, SC,Jan-18,24383,23059,1324,5.4
CN4502100000000,45,021,Cherokee County, SC,Feb-18,24589,23407,1182,4.8
CN4502100000000,45,021,Cherokee County, SC,Mar-18,24398,23344,1054,4.3
CN4502100000000,45,021,Cherokee County, SC,Apr-18(p),24044,23319,725,3.0
CN4212300000000,42,123,Warren County, PA,Mar-17,19379,18264,1115,5.8
CN4212300000000,42,123,Warren County, PA,Apr-17,19330,18342,988,5.1
CN4212300000000,42,123,Warren County, PA,May-17,19539,18519,1020,5.2
CN4212300000000,42,123,Warren County, PA,Jun-17,19828,18856,972,4.9
CN4212300000000,42,123,Warren County, PA,Jul-17,19757,18670,1087,5.5
CN4212300000000,42,123,Warren County, PA,Aug-17,19350,18248,1102,5.7
CN4212300000000,42,123,Warren County, PA,Sep-17,19177,18272,905,4.7
CN4212300000000,42,123,Warren County, PA,Oct-17,19030,18147,883,4.6
CN4212300000000,42,123,Warren County, PA,Nov-17,18956,18014,942,5.0
CN4212300000000,42,123,Warren County, PA,Dec-17,18855,17904,951,5.0
CN4212300000000,42,123,Warren County, PA,Jan-18,18875,17816,1059,5.6
CN4212300000000,42,123,Warren County, PA,Feb-18,18878,17791,1087,5.8
CN4212300000000,42,123,Warren County, PA,Mar-18,18712,17765,947,5.1
CN4212300000000,42,123,Warren County, PA,Apr-18(p),18636,17843,793,4.3
CN0608300000000,06,083,Santa Barbara County, CA,Mar-17,215895,204295,11600,5.4
CN0608300000000,06,083,Santa Barbara County, CA,Apr-17,218337,209090,9247,4.2
CN0608300000000,06,083,Santa Barbara County, CA,May-17,217504,209368,8136,3.7
CN0608300000000,06,083,Santa Barbara County, CA,Jun-17,218784,209533,9251,4.2
CN0608300000000,06,083,Santa Barbara County, CA,Jul-17,219051,209294,9757,4.5
CN0608300000000,06,083,Santa Barbara County, CA,Aug-17,217573,208273,9300,4.3
CN0608300000000,06,083,Santa Barbara County, CA,Sep-17,218556,210417,8139,3.7
CN0608300000000,06,083,Santa Barbara County, CA,Oct-17,219620,211463,8157,3.7
CN0608300000000,06,083,Santa Barbara County, CA,Nov-17,217985,209491,8494,3.9
CN0608300000000,06,083,Santa Barbara County, CA,Dec-17,213790,204700,9090,4.3
CN0608300000000,06,083,Santa Barbara County, CA,Jan-18,212758,201778,10980,5.2
CN0608300000000,06,083,Santa Barbara County, CA,Feb-18,215825,205281,10544,4.9
CN0608300000000,06,083,Santa Barbara County, CA,Mar-18,216720,207175,9545,4.4
CN0608300000000,06,083,Santa Barbara County, CA,Apr-18(p),217345,209688,7657,3.5
CN2901900000000,29,019,Boone County, MO,Mar-17,98372,95692,2680,2.7
CN2901900000000,29,019,Boone County, MO,Apr-17,98578,96216,2362,2.4
CN2901900000000,29,019,Boone County, MO,May-17,98544,95995,2549,2.6
CN2901900000000,29,019,Boone County, MO,Jun-17,95460,92702,2758,2.9
CN2901900000000,29,019,Boone County, MO,Jul-17,96947,93992,2955,3.0
CN2901900000000,29,019,Boone County, MO,Aug-17,95956,93051,2905,3.0
CN2901900000000,29,019,Boone County, MO,Sep-17,98483,96169,2314,2.3
CN2901900000000,29,019,Boone County, MO,Oct-17,97929,96312,1617,1.7
CN2901900000000,29,019,Boone County, MO,Nov-17,98465,96245,2220,2.3
CN2901900000000,29,019,Boone County, MO,Dec-17,97854,95671,2183,2.2
CN2901900000000,29,019,Boone County, MO,Jan-18,94336,91626,2710,2.9
CN2901900000000,29,019,Boone County, MO,Feb-18,97336,94769,2567,2.6
CN2901900000000,29,019,Boone County, MO,Mar-18,97518,95024,2494,2.6
CN2901900000000,29,019,Boone County, MO,Apr-18(p),98091,95852,2239,2.3
CN2701500000000,27,015,Brown County, MN,Mar-17,14566,13797,769,5.3
CN2701500000000,27,015,Brown County, MN,Apr-17,14571,13988,583,4.0
CN2701500000000,27,015,Brown County, MN,May-17,14482,14008,474,3.3
CN2701500000000,27,015,Brown County, MN,Jun-17,14646,14150,496,3.4
CN2701500000000,27,015,Brown County, MN,Jul-17,14389,13938,451,3.1
CN2701500000000,27,015,Brown County, MN,Aug-17,14267,13830,437,3.1
CN2701500000000,27,015,Brown County, MN,Sep-17,14209,13848,361,2.5
CN2701500000000,27,015,Brown County, MN,Oct-17,14462,14161,301,2.1
CN2701500000000,27,015,Brown County, MN,Nov-17,14430,14059,371,2.6
CN2701500000000,27,015,Brown County, MN,Dec-17,14500,13982,518,3.6
CN2701500000000,27,015,Brown County, MN,Jan-18,14723,13925,798,5.4
CN2701500000000,27,015,Brown County, MN,Feb-18,14722,13979,743,5.0
CN2701500000000,27,015,Brown County, MN,Mar-18,14750,14003,747,5.1
CN2701500000000,27,015,Brown County, MN,Apr-18(p),14804,14223,581,3.9
CN3009100000000,30,091,Sheridan County, MT,Mar-17,1916,1849,67,3.5
CN3009100000000,30,091,Sheridan County, MT,Apr-17,1944,1894,50,2.6
CN3009100000000,30,091,Sheridan County, MT,May-17,1958,1915,43,2.2
CN3009100000000,30,091,Sheridan County, MT,Jun-17,1910,1861,49,2.6
CN3009100000000,30,091,Sheridan County, MT,Jul-17,1855,1811,44,2.4
CN3009100000000,30,091,Sheridan County, MT,Aug-17,1924,1883,41,2.1
CN3009100000000,30,091,Sheridan County, MT,Sep-17,1849,1809,40,2.2
CN3009100000000,30,091,Sheridan County, MT,Oct-17,1889,1846,43,2.3
CN3009100000000,30,091,Sheridan County, MT,Nov-17,1874,1826,48,2.6
CN3009100000000,30,091,Sheridan County, MT,Dec-17,1844,1790,54,2.9
CN3009100000000,30,091,Sheridan County, MT,Jan-18,1819,1758,61,3.4
CN3009100000000,30,091,Sheridan County, MT,Feb-18,1828,1767,61,3.3
CN3009100000000,30,091,Sheridan County, MT,Mar-18,1805,1757,48,2.7
CN3009100000000,30,091,Sheridan County, MT,Apr-18(p),1796,1764,32,1.8
CN0502700000000,05,027,Columbia County, AR,Mar-17,9176,8724,452,4.9
CN0502700000000,05,027,Columbia County, AR,Apr-17,9142,8750,392,4.3
CN0502700000000,05,027,Columbia County, AR,May-17,9171,8723,448,4.9
CN0502700000000,05,027,Columbia County, AR,Jun-17,9142,8621,521,5.7
CN0502700000000,05,027,Columbia County, AR,Jul-17,8842,8305,537,6.1
CN0502700000000,05,027,Columbia County, AR,Aug-17,9020,8526,494,5.5
CN0502700000000,05,027,Columbia County, AR,Sep-17,9266,8827,439,4.7
CN0502700000000,05,027,Columbia County, AR,Oct-17,9139,8762,377,4.1
CN0502700000000,05,027,Columbia County, AR,Nov-17,9102,8711,391,4.3
CN0502700000000,05,027,Columbia County, AR,Dec-17,9005,8598,407,4.5
CN0502700000000,05,027,Columbia County, AR,Jan-18,8873,8375,498,5.6
CN0502700000000,05,027,Columbia County, AR,Feb-18,9038,8558,480,5.3
CN0502700000000,05,027,Columbia County, AR,Mar-18,9077,8627,450,5.0
CN0502700000000,05,027,Columbia County, AR,Apr-18(p),9037,8644,393,4.3
CN1205500000000,12,055,Highlands County, FL,Mar-17,36749,34805,1944,5.3
CN1205500000000,12,055,Highlands County, FL,Apr-17,36575,34745,1830,5.0
CN1205500000000,12,055,Highlands County, FL,May-17,36718,34800,1918,5.2
CN1205500000000,12,055,Highlands County, FL,Jun-17,35595,33516,2079,5.8
CN1205500000000,12,055,Highlands County, FL,Jul-17,35236,33043,2193,6.2
CN1205500000000,12,055,Highlands County, FL,Aug-17,35995,33831,2164,6.0
CN1205500000000,12,055,Highlands County, FL,Sep-17,35827,33788,2039,5.7
CN1205500000000,12,055,Highlands County, FL,Oct-17,34975,33056,1919,5.5
CN1205500000000,12,055,Highlands County, FL,Nov-17,35410,33511,1899,5.4
CN1205500000000,12,055,Highlands County, FL,Dec-17,35286,33504,1782,5.1
CN1205500000000,12,055,Highlands County, FL,Jan-18,35561,33577,1984,5.6
CN1205500000000,12,055,Highlands County, FL,Feb-18,35934,34114,1820,5.1
CN1205500000000,12,055,Highlands County, FL,Mar-18,36061,34289,1772,4.9
CN1205500000000,12,055,Highlands County, FL,Apr-18(p),36191,34621,1570,4.3
CN4820700000000,48,207,Haskell County, TX,Mar-17,2549,2437,112,4.4
CN4820700000000,48,207,Haskell County, TX,Apr-17,2509,2389,120,4.8
CN4820700000000,48,207,Haskell County, TX,May-17,2505,2383,122,4.9
CN4820700000000,48,207,Haskell County, TX,Jun-17,2452,2327,125,5.1
CN4820700000000,48,207,Haskell County, TX,Jul-17,2375,2251,124,5.2
CN4820700000000,48,207,Haskell County, TX,Aug-17,2403,2282,121,5.0
CN4820700000000,48,207,Haskell County, TX,Sep-17,2370,2261,109,4.6
CN4820700000000,48,207,Haskell County, TX,Oct-17,2406,2308,98,4.1
CN4820700000000,48,207,Haskell County, TX,Nov-17,2365,2264,101,4.3
CN4820700000000,48,207,Haskell County, TX,Dec-17,2368,2275,93,3.9
CN4820700000000,48,207,Haskell County, TX,Jan-18,2328,2227,101,4.3
CN4820700000000,48,207,Haskell County, TX,Feb-18,2368,2270,98,4.1
CN4820700000000,48,207,Haskell County, TX,Mar-18,2471,2368,103,4.2
CN4820700000000,48,207,Haskell County, TX,Apr-18(p),2378,2282,96,4.0
CN2918500000000,29,185,St. Clair County, MO,Mar-17,3876,3656,220,5.7
CN2918500000000,29,185,St. Clair County, MO,Apr-17,3924,3741,183,4.7
CN2918500000000,29,185,St. Clair County, MO,May-17,3861,3669,192,5.0
CN2918500000000,29,185,St. Clair County, MO,Jun-17,3913,3702,211,5.4
CN2918500000000,29,185,St. Clair County, MO,Jul-17,3698,3465,233,6.3
CN2918500000000,29,185,St. Clair County, MO,Aug-17,3653,3429,224,6.1
CN2918500000000,29,185,St. Clair County, MO,Sep-17,3689,3531,158,4.3
CN2918500000000,29,185,St. Clair County, MO,Oct-17,3711,3586,125,3.4
CN2918500000000,29,185,St. Clair County, MO,Nov-17,3703,3556,147,4.0
CN2918500000000,29,185,St. Clair County, MO,Dec-17,3690,3521,169,4.6
CN2918500000000,29,185,St. Clair County, MO,Jan-18,3733,3534,199,5.3
CN2918500000000,29,185,St. Clair County, MO,Feb-18,3799,3594,205,5.4
CN2918500000000,29,185,St. Clair County, MO,Mar-18,3783,3597,186,4.9
CN2918500000000,29,185,St. Clair County, MO,Apr-18(p),3795,3629,166,4.4
CN5000300000000,50,003,Bennington County, VT,Mar-17,18489,17791,698,3.8
CN5000300000000,50,003,Bennington County, VT,Apr-17,17937,17273,664,3.7
CN5000300000000,50,003,Bennington County, VT,May-17,18200,17589,611,3.4
CN5000300000000,50,003,Bennington County, VT,Jun-17,18742,18034,708,3.8
CN5000300000000,50,003,Bennington County, VT,Jul-17,18958,18218,740,3.9
CN5000300000000,50,003,Bennington County, VT,Aug-17,18741,18031,710,3.8
CN5000300000000,50,003,Bennington County, VT,Sep-17,18277,17580,697,3.8
CN5000300000000,50,003,Bennington County, VT,Oct-17,18334,17803,531,2.9
CN5000300000000,50,003,Bennington County, VT,Nov-17,18381,17742,639,3.5
CN5000300000000,50,003,Bennington County, VT,Dec-17,18431,17857,574,3.1
CN5000300000000,50,003,Bennington County, VT,Jan-18,18439,17786,653,3.5
CN5000300000000,50,003,Bennington County, VT,Feb-18,18518,17853,665,3.6
CN5000300000000,50,003,Bennington County, VT,Mar-18,18672,18002,670,3.6
CN5000300000000,50,003,Bennington County, VT,Apr-18(p),18169,17528,641,3.5
CN7213900000000,72,139,Trujillo Alto Municipio, PR,Mar-17,27328,25611,1717,6.3
CN7213900000000,72,139,Trujillo Alto Municipio, PR,Apr-17,27146,25405,1741,6.4
CN7213900000000,72,139,Trujillo Alto Municipio, PR,May-17,26719,25224,1495,5.6
CN7213900000000,72,139,Trujillo Alto Municipio, PR,Jun-17,26411,25069,1342,5.1
CN7213900000000,72,139,Trujillo Alto Municipio, PR,Jul-17,26490,24952,1538,5.8
CN7213900000000,72,139,Trujillo Alto Municipio, PR,Aug-17,26331,24617,1714,6.5
CN7213900000000,72,139,Trujillo Alto Municipio, PR,Sep-17(y),26578,24934,1644,6.2
CN7213900000000,72,139,Trujillo Alto Municipio, PR,Oct-17,25320,23922,1398,5.5
CN7213900000000,72,139,Trujillo Alto Municipio, PR,Nov-17,26751,25354,1397,5.2
CN7213900000000,72,139,Trujillo Alto Municipio, PR,Dec-17,26889,25572,1317,4.9
CN7213900000000,72,139,Trujillo Alto Municipio, PR,Jan-18,26566,25071,1495,5.6
CN7213900000000,72,139,Trujillo Alto Municipio, PR,Feb-18,26624,25148,1476,5.5
CN7213900000000,72,139,Trujillo Alto Municipio, PR,Mar-18,26577,25170,1407,5.3
CN7213900000000,72,139,Trujillo Alto Municipio, PR,Apr-18(p),26749,25366,1383,5.2
CN2814100000000,28,141,Tishomingo County, MS,Mar-17,8330,7915,415,5.0
CN2814100000000,28,141,Tishomingo County, MS,Apr-17,8336,7967,369,4.4
CN2814100000000,28,141,Tishomingo County, MS,May-17,8422,7981,441,5.2
CN2814100000000,28,141,Tishomingo County, MS,Jun-17,8466,7967,499,5.9
CN2814100000000,28,141,Tishomingo County, MS,Jul-17,8383,7902,481,5.7
CN2814100000000,28,141,Tishomingo County, MS,Aug-17,8290,7869,421,5.1
CN2814100000000,28,141,Tishomingo County, MS,Sep-17,8285,7930,355,4.3
CN2814100000000,28,141,Tishomingo County, MS,Oct-17,8194,7843,351,4.3
CN2814100000000,28,141,Tishomingo County, MS,Nov-17,8174,7839,335,4.1
CN2814100000000,28,141,Tishomingo County, MS,Dec-17,8283,7924,359,4.3
CN2814100000000,28,141,Tishomingo County, MS,Jan-18,8216,7841,375,4.6
CN2814100000000,28,141,Tishomingo County, MS,Feb-18,8256,7900,356,4.3
CN2814100000000,28,141,Tishomingo County, MS,Mar-18,8292,7954,338,4.1
CN2814100000000,28,141,Tishomingo County, MS,Apr-18(p),8419,8078,341,4.1
CN4202300000000,42,023,Cameron County, PA,Mar-17,2213,2045,168,7.6
CN4202300000000,42,023,Cameron County, PA,Apr-17,2220,2065,155,7.0
CN4202300000000,42,023,Cameron County, PA,May-17,2220,2076,144,6.5
CN4202300000000,42,023,Cameron County, PA,Jun-17,2277,2115,162,7.1
CN4202300000000,42,023,Cameron County, PA,Jul-17,2263,2115,148,6.5
CN4202300000000,42,023,Cameron County, PA,Aug-17,2239,2081,158,7.1
CN4202300000000,42,023,Cameron County, PA,Sep-17,2186,2053,133,6.1
CN4202300000000,42,023,Cameron County, PA,Oct-17,2142,2011,131,6.1
CN4202300000000,42,023,Cameron County, PA,Nov-17,2119,1987,132,6.2
CN4202300000000,42,023,Cameron County, PA,Dec-17,2122,1988,134,6.3
CN4202300000000,42,023,Cameron County, PA,Jan-18,2113,1964,149,7.1
CN4202300000000,42,023,Cameron County, PA,Feb-18,2119,1970,149,7.0
CN4202300000000,42,023,Cameron County, PA,Mar-18,2065,1946,119,5.8
CN4202300000000,42,023,Cameron County, PA,Apr-18(p),2045,1953,92,4.5
CN1211700000000,12,117,Seminole County, FL,Mar-17,248734,239652,9082,3.7
CN1211700000000,12,117,Seminole County, FL,Apr-17,248231,239649,8582,3.5
CN1211700000000,12,117,Seminole County, FL,May-17,249859,241035,8824,3.5
CN1211700000000,12,117,Seminole County, FL,Jun-17,251756,242153,9603,3.8
CN1211700000000,12,117,Seminole County, FL,Jul-17,252822,243075,9747,3.9
CN1211700000000,12,117,Seminole County, FL,Aug-17,251632,242183,9449,3.8
CN1211700000000,12,117,Seminole County, FL,Sep-17,255569,246853,8716,3.4
CN1211700000000,12,117,Seminole County, FL,Oct-17,252594,244281,8313,3.3
CN1211700000000,12,117,Seminole County, FL,Nov-17,251934,243630,8304,3.3
CN1211700000000,12,117,Seminole County, FL,Dec-17,252314,244454,7860,3.1
CN1211700000000,12,117,Seminole County, FL,Jan-18,253921,244851,9070,3.6
CN1211700000000,12,117,Seminole County, FL,Feb-18,256637,248217,8420,3.3
CN1211700000000,12,117,Seminole County, FL,Mar-18,256535,248222,8313,3.2
CN1211700000000,12,117,Seminole County, FL,Apr-18(p),254794,247262,7532,3.0
CN4850500000000,48,505,Zapata County, TX,Mar-17,5376,4896,480,8.9
CN4850500000000,48,505,Zapata County, TX,Apr-17,5503,5079,424,7.7
CN4850500000000,48,505,Zapata County, TX,May-17,5436,5059,377,6.9
CN4850500000000,48,505,Zapata County, TX,Jun-17,5487,5064,423,7.7
CN4850500000000,48,505,Zapata County, TX,Jul-17,5433,5031,402,7.4
CN4850500000000,48,505,Zapata County, TX,Aug-17,5406,5026,380,7.0
CN4850500000000,48,505,Zapata County, TX,Sep-17,5370,5040,330,6.1
CN4850500000000,48,505,Zapata County, TX,Oct-17,5547,5242,305,5.5
CN4850500000000,48,505,Zapata County, TX,Nov-17,5534,5205,329,5.9
CN4850500000000,48,505,Zapata County, TX,Dec-17,5529,5203,326,5.9
CN4850500000000,48,505,Zapata County, TX,Jan-18,5618,5246,372,6.6
CN4850500000000,48,505,Zapata County, TX,Feb-18,5612,5258,354,6.3
CN4850500000000,48,505,Zapata County, TX,Mar-18,5624,5275,349,6.2
CN4850500000000,48,505,Zapata County, TX,Apr-18(p),5905,5611,294,5.0
CN0212200000000,02,122,Kenai Peninsula Borough, AK,Mar-17,26092,23529,2563,9.8
CN0212200000000,02,122,Kenai Peninsula Borough, AK,Apr-17,26336,23961,2375,9.0
CN0212200000000,02,122,Kenai Peninsula Borough, AK,May-17,27511,25295,2216,8.1
CN0212200000000,02,122,Kenai Peninsula Borough, AK,Jun-17,28904,26674,2230,7.7
CN0212200000000,02,122,Kenai Peninsula Borough, AK,Jul-17,28280,26217,2063,7.3
CN0212200000000,02,122,Kenai Peninsula Borough, AK,Aug-17,28076,26119,1957,7.0
CN0212200000000,02,122,Kenai Peninsula Borough, AK,Sep-17,27143,25100,2043,7.5
CN0212200000000,02,122,Kenai Peninsula Borough, AK,Oct-17,26798,24637,2161,8.1
CN0212200000000,02,122,Kenai Peninsula Borough, AK,Nov-17,26981,24615,2366,8.8
CN0212200000000,02,122,Kenai Peninsula Borough, AK,Dec-17,26833,24458,2375,8.9
CN0212200000000,02,122,Kenai Peninsula Borough, AK,Jan-18,26631,23947,2684,10.1
CN0212200000000,02,122,Kenai Peninsula Borough, AK,Feb-18,26495,23764,2731,10.3
CN0212200000000,02,122,Kenai Peninsula Borough, AK,Mar-18,26569,23944,2625,9.9
CN0212200000000,02,122,Kenai Peninsula Borough, AK,Apr-18(p),26607,24251,2356,8.9
CN4103300000000,41,033,Josephine County, OR,Mar-17,34859,32901,1958,5.6
CN4103300000000,41,033,Josephine County, OR,Apr-17,35122,33346,1776,5.1
CN4103300000000,41,033,Josephine County, OR,May-17,35216,33522,1694,4.8
CN4103300000000,41,033,Josephine County, OR,Jun-17,35683,33770,1913,5.4
CN4103300000000,41,033,Josephine County, OR,Jul-17,35500,33463,2037,5.7
CN4103300000000,41,033,Josephine County, OR,Aug-17,35952,33882,2070,5.8
CN4103300000000,41,033,Josephine County, OR,Sep-17,36332,34519,1813,5.0
CN4103300000000,41,033,Josephine County, OR,Oct-17,36008,34204,1804,5.0
CN4103300000000,41,033,Josephine County, OR,Nov-17,35658,33865,1793,5.0
CN4103300000000,41,033,Josephine County, OR,Dec-17,35426,33584,1842,5.2
CN4103300000000,41,033,Josephine County, OR,Jan-18,35370,33263,2107,6.0
CN4103300000000,41,033,Josephine County, OR,Feb-18,35736,33592,2144,6.0
CN4103300000000,41,033,Josephine County, OR,Mar-18,35854,33695,2159,6.0
CN4103300000000,41,033,Josephine County, OR,Apr-18(p),35593,33744,1849,5.2
CN5602500000000,56,025,Natrona County, WY,Mar-17,40234,37813,2421,6.0
CN5602500000000,56,025,Natrona County, WY,Apr-17,39730,37641,2089,5.3
CN5602500000000,56,025,Natrona County, WY,May-17,39150,37200,1950,5.0
CN5602500000000,56,025,Natrona County, WY,Jun-17,39307,37294,2013,5.1
CN5602500000000,56,025,Natrona County, WY,Jul-17,39364,37490,1874,4.8
CN5602500000000,56,025,Natrona County, WY,Aug-17,39289,37504,1785,4.5
CN5602500000000,56,025,Natrona County, WY,Sep-17,38992,37241,1751,4.5
CN5602500000000,56,025,Natrona County, WY,Oct-17,39376,37587,1789,4.5
CN5602500000000,56,025,Natrona County, WY,Nov-17,39617,37739,1878,4.7
CN5602500000000,56,025,Natrona County, WY,Dec-17,39476,37495,1981,5.0
CN5602500000000,56,025,Natrona County, WY,Jan-18,39183,37075,2108,5.4
CN5602500000000,56,025,Natrona County, WY,Feb-18,39263,37282,1981,5.0
CN5602500000000,56,025,Natrona County, WY,Mar-18,39507,37645,1862,4.7
CN5602500000000,56,025,Natrona County, WY,Apr-18(p),39100,37411,1689,4.3
CN5110900000000,51,109,Louisa County, VA,Mar-17,18953,18258,695,3.7
CN5110900000000,51,109,Louisa County, VA,Apr-17,19026,18408,618,3.2
CN5110900000000,51,109,Louisa County, VA,May-17,19154,18505,649,3.4
CN5110900000000,51,109,Louisa County, VA,Jun-17,19218,18542,676,3.5
CN5110900000000,51,109,Louisa County, VA,Jul-17,19261,18565,696,3.6
CN5110900000000,51,109,Louisa County, VA,Aug-17,19421,18724,697,3.6
CN5110900000000,51,109,Louisa County, VA,Sep-17,19562,18942,620,3.2
CN5110900000000,51,109,Louisa County, VA,Oct-17,19056,18459,597,3.1
CN5110900000000,51,109,Louisa County, VA,Nov-17,19013,18413,600,3.2
CN5110900000000,51,109,Louisa County, VA,Dec-17,19010,18401,609,3.2
CN5110900000000,51,109,Louisa County, VA,Jan-18,18925,18269,656,3.5
CN5110900000000,51,109,Louisa County, VA,Feb-18,19451,18867,584,3.0
CN5110900000000,51,109,Louisa County, VA,Mar-18,19760,19166,594,3.0
CN5110900000000,51,109,Louisa County, VA,Apr-18(p),19751,19263,488,2.5
CN5104700000000,51,047,Culpeper County, VA,Mar-17,23723,22799,924,3.9
CN5104700000000,51,047,Culpeper County, VA,Apr-17,23704,22943,761,3.2
CN5104700000000,51,047,Culpeper County, VA,May-17,23832,22992,840,3.5
CN5104700000000,51,047,Culpeper County, VA,Jun-17,24105,23235,870,3.6
CN5104700000000,51,047,Culpeper County, VA,Jul-17,24166,23297,869,3.6
CN5104700000000,51,047,Culpeper County, VA,Aug-17,23748,22864,884,3.7
CN5104700000000,51,047,Culpeper County, VA,Sep-17,23847,22981,866,3.6
CN5104700000000,51,047,Culpeper County, VA,Oct-17,23689,22890,799,3.4
CN5104700000000,51,047,Culpeper County, VA,Nov-17,23759,22959,800,3.4
CN5104700000000,51,047,Culpeper County, VA,Dec-17,23815,23035,780,3.3
CN5104700000000,51,047,Culpeper County, VA,Jan-18,23832,22963,869,3.6
CN5104700000000,51,047,Culpeper County, VA,Feb-18,24088,23288,800,3.3
CN5104700000000,51,047,Culpeper County, VA,Mar-18,24102,23312,790,3.3
CN5104700000000,51,047,Culpeper County, VA,Apr-18(p),24114,23466,648,2.7
CN4844300000000,48,443,Terrell County, TX,Mar-17,404,380,24,5.9
CN4844300000000,48,443,Terrell County, TX,Apr-17,406,384,22,5.4
CN4844300000000,48,443,Terrell County, TX,May-17,405,385,20,4.9
CN4844300000000,48,443,Terrell County, TX,Jun-17,398,379,19,4.8
CN4844300000000,48,443,Terrell County, TX,Jul-17,392,375,17,4.3
CN4844300000000,48,443,Terrell County, TX,Aug-17,377,363,14,3.7
CN4844300000000,48,443,Terrell County, TX,Sep-17,384,371,13,3.4
CN4844300000000,48,443,Terrell County, TX,Oct-17,389,376,13,3.3
CN4844300000000,48,443,Terrell County, TX,Nov-17,386,371,15,3.9
CN4844300000000,48,443,Terrell County, TX,Dec-17,380,367,13,3.4
CN4844300000000,48,443,Terrell County, TX,Jan-18,343,330,13,3.8
CN4844300000000,48,443,Terrell County, TX,Feb-18,360,346,14,3.9
CN4844300000000,48,443,Terrell County, TX,Mar-18,375,360,15,4.0
CN4844300000000,48,443,Terrell County, TX,Apr-18(p),382,366,16,4.2
CN4608900000000,46,089,McPherson County, SD,Mar-17,1046,1005,41,3.9
CN4608900000000,46,089,McPherson County, SD,Apr-17,1041,1006,35,3.4
CN4608900000000,46,089,McPherson County, SD,May-17,1096,1060,36,3.3
CN4608900000000,46,089,McPherson County, SD,Jun-17,1119,1085,34,3.0
CN4608900000000,46,089,McPherson County, SD,Jul-17,1064,1031,33,3.1
CN4608900000000,46,089,McPherson County, SD,Aug-17,1026,988,38,3.7
CN4608900000000,46,089,McPherson County, SD,Sep-17,1022,988,34,3.3
CN4608900000000,46,089,McPherson County, SD,Oct-17,1005,970,35,3.5
CN4608900000000,46,089,McPherson County, SD,Nov-17,1000,962,38,3.8
CN4608900000000,46,089,McPherson County, SD,Dec-17,1037,1000,37,3.6
CN4608900000000,46,089,McPherson County, SD,Jan-18,1042,989,53,5.1
CN4608900000000,46,089,McPherson County, SD,Feb-18,1051,1001,50,4.8
CN4608900000000,46,089,McPherson County, SD,Mar-18,1065,1024,41,3.8
CN4608900000000,46,089,McPherson County, SD,Apr-18(p),1023,976,47,4.6
CN4810700000000,48,107,Crosby County, TX,Mar-17,2709,2583,126,4.7
CN4810700000000,48,107,Crosby County, TX,Apr-17,2685,2579,106,3.9
CN4810700000000,48,107,Crosby County, TX,May-17,2690,2584,106,3.9
CN4810700000000,48,107,Crosby County, TX,Jun-17,2654,2525,129,4.9
CN4810700000000,48,107,Crosby County, TX,Jul-17,2557,2428,129,5.0
CN4810700000000,48,107,Crosby County, TX,Aug-17,2602,2481,121,4.7
CN4810700000000,48,107,Crosby County, TX,Sep-17,2538,2447,91,3.6
CN4810700000000,48,107,Crosby County, TX,Oct-17,2595,2513,82,3.2
CN4810700000000,48,107,Crosby County, TX,Nov-17,2540,2454,86,3.4
CN4810700000000,48,107,Crosby County, TX,Dec-17,2550,2464,86,3.4
CN4810700000000,48,107,Crosby County, TX,Jan-18,2518,2417,101,4.0
CN4810700000000,48,107,Crosby County, TX,Feb-18,2619,2496,123,4.7
CN4810700000000,48,107,Crosby County, TX,Mar-18,2734,2604,130,4.8
CN4810700000000,48,107,Crosby County, TX,Apr-18(p),2663,2551,112,4.2
CN5513500000000,55,135,Waupaca County, WI,Mar-17,26398,25416,982,3.7
CN5513500000000,55,135,Waupaca County, WI,Apr-17,26593,25750,843,3.2
CN5513500000000,55,135,Waupaca County, WI,May-17,26691,25915,776,2.9
CN5513500000000,55,135,Waupaca County, WI,Jun-17,27797,26857,940,3.4
CN5513500000000,55,135,Waupaca County, WI,Jul-17,27215,26365,850,3.1
CN5513500000000,55,135,Waupaca County, WI,Aug-17,26942,26118,824,3.1
CN5513500000000,55,135,Waupaca County, WI,Sep-17,26673,25936,737,2.8
CN5513500000000,55,135,Waupaca County, WI,Oct-17,26417,25715,702,2.7
CN5513500000000,55,135,Waupaca County, WI,Nov-17,26473,25775,698,2.6
CN5513500000000,55,135,Waupaca County, WI,Dec-17,26383,25683,700,2.7
CN5513500000000,55,135,Waupaca County, WI,Jan-18,26490,25653,837,3.2
CN5513500000000,55,135,Waupaca County, WI,Feb-18,26499,25587,912,3.4
CN5513500000000,55,135,Waupaca County, WI,Mar-18,26657,25778,879,3.3
CN5513500000000,55,135,Waupaca County, WI,Apr-18(p),26778,26040,738,2.8
CN3108100000000,31,081,Hamilton County, NE,Mar-17,4595,4489,106,2.3
CN3108100000000,31,081,Hamilton County, NE,Apr-17,4666,4561,105,2.3
CN3108100000000,31,081,Hamilton County, NE,May-17,4678,4572,106,2.3
CN3108100000000,31,081,Hamilton County, NE,Jun-17,4804,4682,122,2.5
CN3108100000000,31,081,Hamilton County, NE,Jul-17,4766,4644,122,2.6
CN3108100000000,31,081,Hamilton County, NE,Aug-17,4665,4547,118,2.5
CN3108100000000,31,081,Hamilton County, NE,Sep-17,4608,4509,99,2.1
CN3108100000000,31,081,Hamilton County, NE,Oct-17,4586,4484,102,2.2
CN3108100000000,31,081,Hamilton County, NE,Nov-17,4578,4484,94,2.1
CN3108100000000,31,081,Hamilton County, NE,Dec-17,4565,4457,108,2.4
CN3108100000000,31,081,Hamilton County, NE,Jan-18,4632,4483,149,3.2
CN3108100000000,31,081,Hamilton County, NE,Feb-18,4578,4468,110,2.4
CN3108100000000,31,081,Hamilton County, NE,Mar-18,4652,4535,117,2.5
CN3108100000000,31,081,Hamilton County, NE,Apr-18(p),4669,4553,116,2.5
CN2908500000000,29,085,Hickory County, MO,Mar-17,3590,3421,169,4.7
CN2908500000000,29,085,Hickory County, MO,Apr-17,3893,3737,156,4.0
CN2908500000000,29,085,Hickory County, MO,May-17,3820,3662,158,4.1
CN2908500000000,29,085,Hickory County, MO,Jun-17,3862,3709,153,4.0
CN2908500000000,29,085,Hickory County, MO,Jul-17,3763,3583,180,4.8
CN2908500000000,29,085,Hickory County, MO,Aug-17,3635,3434,201,5.5
CN2908500000000,29,085,Hickory County, MO,Sep-17,3792,3644,148,3.9
CN2908500000000,29,085,Hickory County, MO,Oct-17,3627,3517,110,3.0
CN2908500000000,29,085,Hickory County, MO,Nov-17,3593,3445,148,4.1
CN2908500000000,29,085,Hickory County, MO,Dec-17,3562,3418,144,4.0
CN2908500000000,29,085,Hickory County, MO,Jan-18,3577,3385,192,5.4
CN2908500000000,29,085,Hickory County, MO,Feb-18,3661,3463,198,5.4
CN2908500000000,29,085,Hickory County, MO,Mar-18,3668,3479,189,5.2
CN2908500000000,29,085,Hickory County, MO,Apr-18(p),3884,3721,163,4.2
CN3114300000000,31,143,Polk County, NE,Mar-17,2837,2771,66,2.3
CN3114300000000,31,143,Polk County, NE,Apr-17,2925,2864,61,2.1
CN3114300000000,31,143,Polk County, NE,May-17,2934,2868,66,2.2
CN3114300000000,31,143,Polk County, NE,Jun-17,3047,2971,76,2.5
CN3114300000000,31,143,Polk County, NE,Jul-17,2937,2867,70,2.4
CN3114300000000,31,143,Polk County, NE,Aug-17,2858,2790,68,2.4
CN3114300000000,31,143,Polk County, NE,Sep-17,2772,2713,59,2.1
CN3114300000000,31,143,Polk County, NE,Oct-17,2807,2743,64,2.3
CN3114300000000,31,143,Polk County, NE,Nov-17,2825,2764,61,2.2
CN3114300000000,31,143,Polk County, NE,Dec-17,2826,2754,72,2.5
CN3114300000000,31,143,Polk County, NE,Jan-18,2884,2808,76,2.6
CN3114300000000,31,143,Polk County, NE,Feb-18,2823,2749,74,2.6
CN3114300000000,31,143,Polk County, NE,Mar-18,2864,2791,73,2.5
CN3114300000000,31,143,Polk County, NE,Apr-18(p),2872,2804,68,2.4
CN2008900000000,20,089,Jewell County, KS,Mar-17,1303,1243,60,4.6
CN2008900000000,20,089,Jewell County, KS,Apr-17,1291,1245,46,3.6
CN2008900000000,20,089,Jewell County, KS,May-17,1292,1246,46,3.6
CN2008900000000,20,089,Jewell County, KS,Jun-17,1337,1289,48,3.6
CN2008900000000,20,089,Jewell County, KS,Jul-17,1303,1253,50,3.8
CN2008900000000,20,089,Jewell County, KS,Aug-17,1291,1242,49,3.8
CN2008900000000,20,089,Jewell County, KS,Sep-17,1350,1311,39,2.9
CN2008900000000,20,089,Jewell County, KS,Oct-17,1361,1327,34,2.5
CN2008900000000,20,089,Jewell County, KS,Nov-17,1324,1288,36,2.7
CN2008900000000,20,089,Jewell County, KS,Dec-17,1318,1286,32,2.4
CN2008900000000,20,089,Jewell County, KS,Jan-18,1290,1259,31,2.4
CN2008900000000,20,089,Jewell County, KS,Feb-18,1277,1244,33,2.6
CN2008900000000,20,089,Jewell County, KS,Mar-18,1265,1231,34,2.7
CN2008900000000,20,089,Jewell County, KS,Apr-18(p),1232,1194,38,3.1
CN0512700000000,05,127,Scott County, AR,Mar-17,4417,4285,132,3.0
CN0512700000000,05,127,Scott County, AR,Apr-17,4443,4318,125,2.8
CN0512700000000,05,127,Scott County, AR,May-17,4485,4347,138,3.1
CN0512700000000,05,127,Scott County, AR,Jun-17,4577,4421,156,3.4
CN0512700000000,05,127,Scott County, AR,Jul-17,4357,4177,180,4.1
CN0512700000000,05,127,Scott County, AR,Aug-17,4299,4140,159,3.7
CN0512700000000,05,127,Scott County, AR,Sep-17,4385,4216,169,3.9
CN0512700000000,05,127,Scott County, AR,Oct-17,4485,4332,153,3.4
CN0512700000000,05,127,Scott County, AR,Nov-17,4453,4303,150,3.4
CN0512700000000,05,127,Scott County, AR,Dec-17,4434,4281,153,3.5
CN0512700000000,05,127,Scott County, AR,Jan-18,4367,4184,183,4.2
CN0512700000000,05,127,Scott County, AR,Feb-18,4344,4158,186,4.3
CN0512700000000,05,127,Scott County, AR,Mar-18,4353,4181,172,4.0
CN0512700000000,05,127,Scott County, AR,Apr-18(p),4349,4204,145,3.3
CN3909900000000,39,099,Mahoning County, OH,Mar-17,107136,97578,9558,8.9
CN3909900000000,39,099,Mahoning County, OH,Apr-17,104808,98131,6677,6.4
CN3909900000000,39,099,Mahoning County, OH,May-17,104959,98762,6197,5.9
CN3909900000000,39,099,Mahoning County, OH,Jun-17,105809,99018,6791,6.4
CN3909900000000,39,099,Mahoning County, OH,Jul-17,106745,98319,8426,7.9
CN3909900000000,39,099,Mahoning County, OH,Aug-17,105071,98220,6851,6.5
CN3909900000000,39,099,Mahoning County, OH,Sep-17,106206,98100,8106,7.6
CN3909900000000,39,099,Mahoning County, OH,Oct-17,104827,98818,6009,5.7
CN3909900000000,39,099,Mahoning County, OH,Nov-17,104310,98302,6008,5.8
CN3909900000000,39,099,Mahoning County, OH,Dec-17,103397,97285,6112,5.9
CN3909900000000,39,099,Mahoning County, OH,Jan-18,103360,95059,8301,8.0
CN3909900000000,39,099,Mahoning County, OH,Feb-18,103055,96811,6244,6.1
CN3909900000000,39,099,Mahoning County, OH,Mar-18,103465,97533,5932,5.7
CN3909900000000,39,099,Mahoning County, OH,Apr-18(p),103071,97683,5388,5.2
CN3902100000000,39,021,Champaign County, OH,Mar-17,19983,19170,813,4.1
CN3902100000000,39,021,Champaign County, OH,Apr-17,19970,19227,743,3.7
CN3902100000000,39,021,Champaign County, OH,May-17,20021,19268,753,3.8
CN3902100000000,39,021,Champaign County, OH,Jun-17,20030,19173,857,4.3
CN3902100000000,39,021,Champaign County, OH,Jul-17,19860,18885,975,4.9
CN3902100000000,39,021,Champaign County, OH,Aug-17,20098,19237,861,4.3
CN3902100000000,39,021,Champaign County, OH,Sep-17,19848,19083,765,3.9
CN3902100000000,39,021,Champaign County, OH,Oct-17,19784,19052,732,3.7
CN3902100000000,39,021,Champaign County, OH,Nov-17,19765,18980,785,4.0
CN3902100000000,39,021,Champaign County, OH,Dec-17,19562,18799,763,3.9
CN3902100000000,39,021,Champaign County, OH,Jan-18,19255,18473,782,4.1
CN3902100000000,39,021,Champaign County, OH,Feb-18,19868,19131,737,3.7
CN3902100000000,39,021,Champaign County, OH,Mar-18,20115,19441,674,3.4
CN3902100000000,39,021,Champaign County, OH,Apr-18(p),20028,19393,635,3.2
CN2210700000000,22,107,Tensas Parish, LA,Mar-17,1559,1419,140,9.0
CN2210700000000,22,107,Tensas Parish, LA,Apr-17,1573,1445,128,8.1
CN2210700000000,22,107,Tensas Parish, LA,May-17,1665,1522,143,8.6
CN2210700000000,22,107,Tensas Parish, LA,Jun-17,1719,1563,156,9.1
CN2210700000000,22,107,Tensas Parish, LA,Jul-17,1650,1494,156,9.5
CN2210700000000,22,107,Tensas Parish, LA,Aug-17,1555,1416,139,8.9
CN2210700000000,22,107,Tensas Parish, LA,Sep-17,1491,1371,120,8.0
CN2210700000000,22,107,Tensas Parish, LA,Oct-17,1507,1414,93,6.2
CN2210700000000,22,107,Tensas Parish, LA,Nov-17,1470,1373,97,6.6
CN2210700000000,22,107,Tensas Parish, LA,Dec-17,1432,1339,93,6.5
CN2210700000000,22,107,Tensas Parish, LA,Jan-18,1488,1382,106,7.1
CN2210700000000,22,107,Tensas Parish, LA,Feb-18,1432,1335,97,6.8
CN2210700000000,22,107,Tensas Parish, LA,Mar-18,1467,1364,103,7.0
CN2210700000000,22,107,Tensas Parish, LA,Apr-18(p),1451,1339,112,7.7
CN4849700000000,48,497,Wise County, TX,Mar-17,29866,28505,1361,4.6
CN4849700000000,48,497,Wise County, TX,Apr-17,29757,28635,1122,3.8
CN4849700000000,48,497,Wise County, TX,May-17,29739,28597,1142,3.8
CN4849700000000,48,497,Wise County, TX,Jun-17,29954,28628,1326,4.4
CN4849700000000,48,497,Wise County, TX,Jul-17,30024,28679,1345,4.5
CN4849700000000,48,497,Wise County, TX,Aug-17,29954,28683,1271,4.2
CN4849700000000,48,497,Wise County, TX,Sep-17,30029,28979,1050,3.5
CN4849700000000,48,497,Wise County, TX,Oct-17,29874,28905,969,3.2
CN4849700000000,48,497,Wise County, TX,Nov-17,29958,28955,1003,3.3
CN4849700000000,48,497,Wise County, TX,Dec-17,29942,28980,962,3.2
CN4849700000000,48,497,Wise County, TX,Jan-18,29867,28786,1081,3.6
CN4849700000000,48,497,Wise County, TX,Feb-18,30252,29174,1078,3.6
CN4849700000000,48,497,Wise County, TX,Mar-18,30536,29332,1204,3.9
CN4849700000000,48,497,Wise County, TX,Apr-18(p),30505,29515,990,3.2
CN4500900000000,45,009,Bamberg County, SC,Mar-17,5236,4888,348,6.6
CN4500900000000,45,009,Bamberg County, SC,Apr-17,5190,4844,346,6.7
CN4500900000000,45,009,Bamberg County, SC,May-17,5179,4826,353,6.8
CN4500900000000,45,009,Bamberg County, SC,Jun-17,5229,4822,407,7.8
CN4500900000000,45,009,Bamberg County, SC,Jul-17,5248,4832,416,7.9
CN4500900000000,45,009,Bamberg County, SC,Aug-17,5269,4775,494,9.4
CN4500900000000,45,009,Bamberg County, SC,Sep-17,5136,4780,356,6.9
CN4500900000000,45,009,Bamberg County, SC,Oct-17,5185,4797,388,7.5
CN4500900000000,45,009,Bamberg County, SC,Nov-17,5171,4822,349,6.7
CN4500900000000,45,009,Bamberg County, SC,Dec-17,5255,4891,364,6.9
CN4500900000000,45,009,Bamberg County, SC,Jan-18,5287,4853,434,8.2
CN4500900000000,45,009,Bamberg County, SC,Feb-18,5275,4892,383,7.3
CN4500900000000,45,009,Bamberg County, SC,Mar-18,5187,4829,358,6.9
CN4500900000000,45,009,Bamberg County, SC,Apr-18(p),5104,4842,262,5.1
CN4105700000000,41,057,Tillamook County, OR,Mar-17,11533,11032,501,4.3
CN4105700000000,41,057,Tillamook County, OR,Apr-17,11744,11276,468,4.0
CN4105700000000,41,057,Tillamook County, OR,May-17,11791,11349,442,3.7
CN4105700000000,41,057,Tillamook County, OR,Jun-17,12187,11672,515,4.2
CN4105700000000,41,057,Tillamook County, OR,Jul-17,12240,11705,535,4.4
CN4105700000000,41,057,Tillamook County, OR,Aug-17,12314,11803,511,4.1
CN4105700000000,41,057,Tillamook County, OR,Sep-17,11977,11497,480,4.0
CN4105700000000,41,057,Tillamook County, OR,Oct-17,11778,11282,496,4.2
CN4105700000000,41,057,Tillamook County, OR,Nov-17,11541,11046,495,4.3
CN4105700000000,41,057,Tillamook County, OR,Dec-17,11293,10806,487,4.3
CN4105700000000,41,057,Tillamook County, OR,Jan-18,11563,11017,546,4.7
CN4105700000000,41,057,Tillamook County, OR,Feb-18,11683,11120,563,4.8
CN4105700000000,41,057,Tillamook County, OR,Mar-18,11729,11178,551,4.7
CN4105700000000,41,057,Tillamook County, OR,Apr-18(p),11807,11310,497,4.2
CN2200700000000,22,007,Assumption Parish, LA,Mar-17,9024,8336,688,7.6
CN2200700000000,22,007,Assumption Parish, LA,Apr-17,8997,8320,677,7.5
CN2200700000000,22,007,Assumption Parish, LA,May-17,9017,8360,657,7.3
CN2200700000000,22,007,Assumption Parish, LA,Jun-17,9170,8440,730,8.0
CN2200700000000,22,007,Assumption Parish, LA,Jul-17,9067,8377,690,7.6
CN2200700000000,22,007,Assumption Parish, LA,Aug-17,8886,8189,697,7.8
CN2200700000000,22,007,Assumption Parish, LA,Sep-17,8908,8268,640,7.2
CN2200700000000,22,007,Assumption Parish, LA,Oct-17,8874,8323,551,6.2
CN2200700000000,22,007,Assumption Parish, LA,Nov-17,8857,8317,540,6.1
CN2200700000000,22,007,Assumption Parish, LA,Dec-17,8821,8278,543,6.2
CN2200700000000,22,007,Assumption Parish, LA,Jan-18,8815,8219,596,6.8
CN2200700000000,22,007,Assumption Parish, LA,Feb-18,8823,8285,538,6.1
CN2200700000000,22,007,Assumption Parish, LA,Mar-18,8890,8325,565,6.4
CN2200700000000,22,007,Assumption Parish, LA,Apr-18(p),8834,8286,548,6.2
CN0510300000000,05,103,Ouachita County, AR,Mar-17,9729,9302,427,4.4
CN0510300000000,05,103,Ouachita County, AR,Apr-17,9742,9327,415,4.3
CN0510300000000,05,103,Ouachita County, AR,May-17,9789,9343,446,4.6
CN0510300000000,05,103,Ouachita County, AR,Jun-17,9980,9515,465,4.7
CN0510300000000,05,103,Ouachita County, AR,Jul-17,9890,9395,495,5.0
CN0510300000000,05,103,Ouachita County, AR,Aug-17,9830,9346,484,4.9
CN0510300000000,05,103,Ouachita County, AR,Sep-17,9951,9511,440,4.4
CN0510300000000,05,103,Ouachita County, AR,Oct-17,9817,9414,403,4.1
CN0510300000000,05,103,Ouachita County, AR,Nov-17,9746,9345,401,4.1
CN0510300000000,05,103,Ouachita County, AR,Dec-17,9704,9286,418,4.3
CN0510300000000,05,103,Ouachita County, AR,Jan-18,9628,9117,511,5.3
CN0510300000000,05,103,Ouachita County, AR,Feb-18,9786,9291,495,5.1
CN0510300000000,05,103,Ouachita County, AR,Mar-18,9841,9355,486,4.9
CN0510300000000,05,103,Ouachita County, AR,Apr-18(p),9830,9402,428,4.4
CN2111700000000,21,117,Kenton County, KY,Mar-17,85705,81801,3904,4.6
CN2111700000000,21,117,Kenton County, KY,Apr-17,85751,82365,3386,3.9
CN2111700000000,21,117,Kenton County, KY,May-17,86305,82762,3543,4.1
CN2111700000000,21,117,Kenton County, KY,Jun-17,87480,83584,3896,4.5
CN2111700000000,21,117,Kenton County, KY,Jul-17,88010,84282,3728,4.2
CN2111700000000,21,117,Kenton County, KY,Aug-17,86954,83637,3317,3.8
CN2111700000000,21,117,Kenton County, KY,Sep-17,86907,83924,2983,3.4
CN2111700000000,21,117,Kenton County, KY,Oct-17,85726,82861,2865,3.3
CN2111700000000,21,117,Kenton County, KY,Nov-17,85476,82724,2752,3.2
CN2111700000000,21,117,Kenton County, KY,Dec-17,84823,82187,2636,3.1
CN2111700000000,21,117,Kenton County, KY,Jan-18,84439,81419,3020,3.6
CN2111700000000,21,117,Kenton County, KY,Feb-18,86052,82710,3342,3.9
CN2111700000000,21,117,Kenton County, KY,Mar-18,86618,83503,3115,3.6
CN2111700000000,21,117,Kenton County, KY,Apr-18(p),86688,83971,2717,3.1
CN3702900000000,37,029,Camden County, NC,Mar-17,4733,4524,209,4.4
CN3702900000000,37,029,Camden County, NC,Apr-17,4740,4551,189,4.0
CN3702900000000,37,029,Camden County, NC,May-17,4716,4520,196,4.2
CN3702900000000,37,029,Camden County, NC,Jun-17,4664,4454,210,4.5
CN3702900000000,37,029,Camden County, NC,Jul-17,4740,4519,221,4.7
CN3702900000000,37,029,Camden County, NC,Aug-17,4643,4417,226,4.9
CN3702900000000,37,029,Camden County, NC,Sep-17,4702,4509,193,4.1
CN3702900000000,37,029,Camden County, NC,Oct-17,4688,4498,190,4.1
CN3702900000000,37,029,Camden County, NC,Nov-17,4637,4433,204,4.4
CN3702900000000,37,029,Camden County, NC,Dec-17,4639,4440,199,4.3
CN3702900000000,37,029,Camden County, NC,Jan-18,4622,4412,210,4.5
CN3702900000000,37,029,Camden County, NC,Feb-18,4708,4502,206,4.4
CN3702900000000,37,029,Camden County, NC,Mar-18,4717,4512,205,4.3
CN3702900000000,37,029,Camden County, NC,Apr-18(p),4721,4558,163,3.5
CN4611100000000,46,111,Sanborn County, SD,Mar-17,1170,1118,52,4.4
CN4611100000000,46,111,Sanborn County, SD,Apr-17,1172,1137,35,3.0
CN4611100000000,46,111,Sanborn County, SD,May-17,1201,1162,39,3.2
CN4611100000000,46,111,Sanborn County, SD,Jun-17,1256,1219,37,2.9
CN4611100000000,46,111,Sanborn County, SD,Jul-17,1201,1165,36,3.0
CN4611100000000,46,111,Sanborn County, SD,Aug-17,1157,1116,41,3.5
CN4611100000000,46,111,Sanborn County, SD,Sep-17,1146,1108,38,3.3
CN4611100000000,46,111,Sanborn County, SD,Oct-17,1108,1073,35,3.2
CN4611100000000,46,111,Sanborn County, SD,Nov-17,1103,1065,38,3.4
CN4611100000000,46,111,Sanborn County, SD,Dec-17,1141,1108,33,2.9
CN4611100000000,46,111,Sanborn County, SD,Jan-18,1143,1105,38,3.3
CN4611100000000,46,111,Sanborn County, SD,Feb-18,1147,1113,34,3.0
CN4611100000000,46,111,Sanborn County, SD,Mar-18,1174,1137,37,3.2
CN4611100000000,46,111,Sanborn County, SD,Apr-18(p),1136,1095,41,3.6
CN0219500000000,02,195,Petersburg Borough, AK,Mar-17,1342,1194,148,11.0
CN0219500000000,02,195,Petersburg Borough, AK,Apr-17,1356,1223,133,9.8
CN0219500000000,02,195,Petersburg Borough, AK,May-17,1378,1257,121,8.8
CN0219500000000,02,195,Petersburg Borough, AK,Jun-17,1484,1352,132,8.9
CN0219500000000,02,195,Petersburg Borough, AK,Jul-17,1626,1501,125,7.7
CN0219500000000,02,195,Petersburg Borough, AK,Aug-17,1600,1480,120,7.5
CN0219500000000,02,195,Petersburg Borough, AK,Sep-17,1492,1375,117,7.8
CN0219500000000,02,195,Petersburg Borough, AK,Oct-17,1380,1270,110,8.0
CN0219500000000,02,195,Petersburg Borough, AK,Nov-17,1328,1208,120,9.0
CN0219500000000,02,195,Petersburg Borough, AK,Dec-17,1333,1201,132,9.9
CN0219500000000,02,195,Petersburg Borough, AK,Jan-18,1320,1150,170,12.9
CN0219500000000,02,195,Petersburg Borough, AK,Feb-18,1336,1172,164,12.3
CN0219500000000,02,195,Petersburg Borough, AK,Mar-18,1371,1200,171,12.5
CN0219500000000,02,195,Petersburg Borough, AK,Apr-18(p),1360,1223,137,10.1
CN1905900000000,19,059,Dickinson County, IA,Mar-17,9617,9173,444,4.6
CN1905900000000,19,059,Dickinson County, IA,Apr-17,9836,9497,339,3.4
CN1905900000000,19,059,Dickinson County, IA,May-17,10426,10065,361,3.5
CN1905900000000,19,059,Dickinson County, IA,Jun-17,11390,11093,297,2.6
CN1905900000000,19,059,Dickinson County, IA,Jul-17,11356,11069,287,2.5
CN1905900000000,19,059,Dickinson County, IA,Aug-17,10989,10670,319,2.9
CN1905900000000,19,059,Dickinson County, IA,Sep-17,10148,9867,281,2.8
CN1905900000000,19,059,Dickinson County, IA,Oct-17,9696,9459,237,2.4
CN1905900000000,19,059,Dickinson County, IA,Nov-17,9559,9278,281,2.9
CN1905900000000,19,059,Dickinson County, IA,Dec-17,9741,9185,556,5.7
CN1905900000000,19,059,Dickinson County, IA,Jan-18,9470,8977,493,5.2
CN1905900000000,19,059,Dickinson County, IA,Feb-18,9514,9065,449,4.7
CN1905900000000,19,059,Dickinson County, IA,Mar-18,9512,9114,398,4.2
CN1905900000000,19,059,Dickinson County, IA,Apr-18(p),9727,9377,350,3.6
CN5501100000000,55,011,Buffalo County, WI,Mar-17,6467,6174,293,4.5
CN5501100000000,55,011,Buffalo County, WI,Apr-17,6641,6411,230,3.5
CN5501100000000,55,011,Buffalo County, WI,May-17,6684,6473,211,3.2
CN5501100000000,55,011,Buffalo County, WI,Jun-17,6950,6674,276,4.0
CN5501100000000,55,011,Buffalo County, WI,Jul-17,6675,6431,244,3.7
CN5501100000000,55,011,Buffalo County, WI,Aug-17,6567,6335,232,3.5
CN5501100000000,55,011,Buffalo County, WI,Sep-17,6533,6336,197,3.0
CN5501100000000,55,011,Buffalo County, WI,Oct-17,6631,6455,176,2.7
CN5501100000000,55,011,Buffalo County, WI,Nov-17,6680,6494,186,2.8
CN5501100000000,55,011,Buffalo County, WI,Dec-17,6678,6466,212,3.2
CN5501100000000,55,011,Buffalo County, WI,Jan-18,6670,6403,267,4.0
CN5501100000000,55,011,Buffalo County, WI,Feb-18,6557,6271,286,4.4
CN5501100000000,55,011,Buffalo County, WI,Mar-18,6630,6379,251,3.8
CN5501100000000,55,011,Buffalo County, WI,Apr-18(p),6803,6585,218,3.2
CN3907500000000,39,075,Holmes County, OH,Mar-17,21310,20572,738,3.5
CN3907500000000,39,075,Holmes County, OH,Apr-17,21068,20448,620,2.9
CN3907500000000,39,075,Holmes County, OH,May-17,20867,20203,664,3.2
CN3907500000000,39,075,Holmes County, OH,Jun-17,20963,20155,808,3.9
CN3907500000000,39,075,Holmes County, OH,Jul-17,20570,19751,819,4.0
CN3907500000000,39,075,Holmes County, OH,Aug-17,21395,20630,765,3.6
CN3907500000000,39,075,Holmes County, OH,Sep-17,20953,20231,722,3.4
CN3907500000000,39,075,Holmes County, OH,Oct-17,20813,20158,655,3.1
CN3907500000000,39,075,Holmes County, OH,Nov-17,20782,20126,656,3.2
CN3907500000000,39,075,Holmes County, OH,Dec-17,20114,19474,640,3.2
CN3907500000000,39,075,Holmes County, OH,Jan-18,19795,19083,712,3.6
CN3907500000000,39,075,Holmes County, OH,Feb-18,20434,19756,678,3.3
CN3907500000000,39,075,Holmes County, OH,Mar-18,20947,20348,599,2.9
CN3907500000000,39,075,Holmes County, OH,Apr-18(p),20700,20132,568,2.7
CN1607300000000,16,073,Owyhee County, ID,Mar-17,5067,4845,222,4.4
CN1607300000000,16,073,Owyhee County, ID,Apr-17,5150,4963,187,3.6
CN1607300000000,16,073,Owyhee County, ID,May-17,5186,5006,180,3.5
CN1607300000000,16,073,Owyhee County, ID,Jun-17,5451,5257,194,3.6
CN1607300000000,16,073,Owyhee County, ID,Jul-17,5410,5217,193,3.6
CN1607300000000,16,073,Owyhee County, ID,Aug-17,5422,5248,174,3.2
CN1607300000000,16,073,Owyhee County, ID,Sep-17,5318,5154,164,3.1
CN1607300000000,16,073,Owyhee County, ID,Oct-17,5092,4935,157,3.1
CN1607300000000,16,073,Owyhee County, ID,Nov-17,5072,4875,197,3.9
CN1607300000000,16,073,Owyhee County, ID,Dec-17,4966,4742,224,4.5
CN1607300000000,16,073,Owyhee County, ID,Jan-18,4993,4694,299,6.0
CN1607300000000,16,073,Owyhee County, ID,Feb-18,5177,4933,244,4.7
CN1607300000000,16,073,Owyhee County, ID,Mar-18,5287,5083,204,3.9
CN1607300000000,16,073,Owyhee County, ID,Apr-18(p),5366,5181,185,3.4
CN3803100000000,38,031,Foster County, ND,Mar-17,1664,1606,58,3.5
CN3803100000000,38,031,Foster County, ND,Apr-17,1678,1628,50,3.0
CN3803100000000,38,031,Foster County, ND,May-17,1675,1639,36,2.1
CN3803100000000,38,031,Foster County, ND,Jun-17,1713,1674,39,2.3
CN3803100000000,38,031,Foster County, ND,Jul-17,1740,1706,34,2.0
CN3803100000000,38,031,Foster County, ND,Aug-17,1733,1702,31,1.8
CN3803100000000,38,031,Foster County, ND,Sep-17,1696,1667,29,1.7
CN3803100000000,38,031,Foster County, ND,Oct-17,1679,1656,23,1.4
CN3803100000000,38,031,Foster County, ND,Nov-17,1632,1603,29,1.8
CN3803100000000,38,031,Foster County, ND,Dec-17,1631,1589,42,2.6
CN3803100000000,38,031,Foster County, ND,Jan-18,1625,1565,60,3.7
CN3803100000000,38,031,Foster County, ND,Feb-18,1604,1551,53,3.3
CN3803100000000,38,031,Foster County, ND,Mar-18,1635,1577,58,3.5
CN3803100000000,38,031,Foster County, ND,Apr-18(p),1635,1583,52,3.2
CN2800500000000,28,005,Amite County, MS,Mar-17,4576,4270,306,6.7
CN2800500000000,28,005,Amite County, MS,Apr-17,4557,4284,273,6.0
CN2800500000000,28,005,Amite County, MS,May-17,4569,4259,310,6.8
CN2800500000000,28,005,Amite County, MS,Jun-17,4587,4233,354,7.7
CN2800500000000,28,005,Amite County, MS,Jul-17,4509,4160,349,7.7
CN2800500000000,28,005,Amite County, MS,Aug-17,4529,4219,310,6.8
CN2800500000000,28,005,Amite County, MS,Sep-17,4519,4257,262,5.8
CN2800500000000,28,005,Amite County, MS,Oct-17,4419,4172,247,5.6
CN2800500000000,28,005,Amite County, MS,Nov-17,4404,4167,237,5.4
CN2800500000000,28,005,Amite County, MS,Dec-17,4427,4183,244,5.5
CN2800500000000,28,005,Amite County, MS,Jan-18,4359,4111,248,5.7
CN2800500000000,28,005,Amite County, MS,Feb-18,4397,4162,235,5.3
CN2800500000000,28,005,Amite County, MS,Mar-18,4444,4236,208,4.7
CN2800500000000,28,005,Amite County, MS,Apr-18(p),4441,4215,226,5.1
CN3714100000000,37,141,Pender County, NC,Mar-17,27249,26003,1246,4.6
CN3714100000000,37,141,Pender County, NC,Apr-17,27350,26222,1128,4.1
CN3714100000000,37,141,Pender County, NC,May-17,27487,26289,1198,4.4
CN3714100000000,37,141,Pender County, NC,Jun-17,27492,26208,1284,4.7
CN3714100000000,37,141,Pender County, NC,Jul-17,27926,26555,1371,4.9
CN3714100000000,37,141,Pender County, NC,Aug-17,27639,26268,1371,5.0
CN3714100000000,37,141,Pender County, NC,Sep-17,27693,26497,1196,4.3
CN3714100000000,37,141,Pender County, NC,Oct-17,27383,26148,1235,4.5
CN3714100000000,37,141,Pender County, NC,Nov-17,27430,26111,1319,4.8
CN3714100000000,37,141,Pender County, NC,Dec-17,27076,25785,1291,4.8
CN3714100000000,37,141,Pender County, NC,Jan-18,26890,25537,1353,5.0
CN3714100000000,37,141,Pender County, NC,Feb-18,27362,26082,1280,4.7
CN3714100000000,37,141,Pender County, NC,Mar-18,27470,26262,1208,4.4
CN3714100000000,37,141,Pender County, NC,Apr-18(p),27518,26479,1039,3.8
CN4705500000000,47,055,Giles County, TN,Mar-17,15855,15309,546,3.4
CN4705500000000,47,055,Giles County, TN,Apr-17,15703,15249,454,2.9
CN4705500000000,47,055,Giles County, TN,May-17,15462,14988,474,3.1
CN4705500000000,47,055,Giles County, TN,Jun-17,15533,14923,610,3.9
CN4705500000000,47,055,Giles County, TN,Jul-17,15519,14937,582,3.8
CN4705500000000,47,055,Giles County, TN,Aug-17,15470,14929,541,3.5
CN4705500000000,47,055,Giles County, TN,Sep-17,15498,15026,472,3.0
CN4705500000000,47,055,Giles County, TN,Oct-17,15467,14992,475,3.1
CN4705500000000,47,055,Giles County, TN,Nov-17,15507,15036,471,3.0
CN4705500000000,47,055,Giles County, TN,Dec-17,15653,15159,494,3.2
CN4705500000000,47,055,Giles County, TN,Jan-18,15685,15074,611,3.9
CN4705500000000,47,055,Giles County, TN,Feb-18,15848,15253,595,3.8
CN4705500000000,47,055,Giles County, TN,Mar-18,15826,15258,568,3.6
CN4705500000000,47,055,Giles County, TN,Apr-18(p),15903,15417,486,3.1
CN1811500000000,18,115,Ohio County, IN,Mar-17,3207,3076,131,4.1
CN1811500000000,18,115,Ohio County, IN,Apr-17,3217,3119,98,3.0
CN1811500000000,18,115,Ohio County, IN,May-17,3222,3116,106,3.3
CN1811500000000,18,115,Ohio County, IN,Jun-17,3264,3155,109,3.3
CN1811500000000,18,115,Ohio County, IN,Jul-17,3286,3170,116,3.5
CN1811500000000,18,115,Ohio County, IN,Aug-17,3227,3109,118,3.7
CN1811500000000,18,115,Ohio County, IN,Sep-17,3212,3105,107,3.3
CN1811500000000,18,115,Ohio County, IN,Oct-17,3198,3092,106,3.3
CN1811500000000,18,115,Ohio County, IN,Nov-17,3164,3067,97,3.1
CN1811500000000,18,115,Ohio County, IN,Dec-17,3146,3046,100,3.2
CN1811500000000,18,115,Ohio County, IN,Jan-18,3148,3030,118,3.7
CN1811500000000,18,115,Ohio County, IN,Feb-18,3197,3077,120,3.8
CN1811500000000,18,115,Ohio County, IN,Mar-18,3221,3114,107,3.3
CN1811500000000,18,115,Ohio County, IN,Apr-18(p),3248,3152,96,3.0
CN7201500000000,72,015,Arroyo Municipio, PR,Mar-17,5217,4229,988,18.9
CN7201500000000,72,015,Arroyo Municipio, PR,Apr-17,5173,4153,1020,19.7
CN7201500000000,72,015,Arroyo Municipio, PR,May-17,5051,4136,915,18.1
CN7201500000000,72,015,Arroyo Municipio, PR,Jun-17,4860,4064,796,16.4
CN7201500000000,72,015,Arroyo Municipio, PR,Jul-17,4994,4096,898,18.0
CN7201500000000,72,015,Arroyo Municipio, PR,Aug-17,5025,4042,983,19.6
CN7201500000000,72,015,Arroyo Municipio, PR,Sep-17(y),4904,4080,824,16.8
CN7201500000000,72,015,Arroyo Municipio, PR,Oct-17,4672,3946,726,15.5
CN7201500000000,72,015,Arroyo Municipio, PR,Nov-17,4933,4151,782,15.9
CN7201500000000,72,015,Arroyo Municipio, PR,Dec-17,4973,4194,779,15.7
CN7201500000000,72,015,Arroyo Municipio, PR,Jan-18,4956,4122,834,16.8
CN7201500000000,72,015,Arroyo Municipio, PR,Feb-18,4885,4127,758,15.5
CN7201500000000,72,015,Arroyo Municipio, PR,Mar-18,4866,4143,723,14.9
CN7201500000000,72,015,Arroyo Municipio, PR,Apr-18(p),4850,4181,669,13.8
CN1900500000000,19,005,Allamakee County, IA,Mar-17,7466,7022,444,5.9
CN1900500000000,19,005,Allamakee County, IA,Apr-17,7544,7207,337,4.5
CN1900500000000,19,005,Allamakee County, IA,May-17,7612,7362,250,3.3
CN1900500000000,19,005,Allamakee County, IA,Jun-17,7676,7427,249,3.2
CN1900500000000,19,005,Allamakee County, IA,Jul-17,7685,7455,230,3.0
CN1900500000000,19,005,Allamakee County, IA,Aug-17,7524,7297,227,3.0
CN1900500000000,19,005,Allamakee County, IA,Sep-17,7474,7281,193,2.6
CN1900500000000,19,005,Allamakee County, IA,Oct-17,7494,7314,180,2.4
CN1900500000000,19,005,Allamakee County, IA,Nov-17,7416,7214,202,2.7
CN1900500000000,19,005,Allamakee County, IA,Dec-17,7425,7133,292,3.9
CN1900500000000,19,005,Allamakee County, IA,Jan-18,7359,6944,415,5.6
CN1900500000000,19,005,Allamakee County, IA,Feb-18,7421,7026,395,5.3
CN1900500000000,19,005,Allamakee County, IA,Mar-18,7341,6999,342,4.7
CN1900500000000,19,005,Allamakee County, IA,Apr-18(p),7361,7099,262,3.6
CN3716500000000,37,165,Scotland County, NC,Mar-17,11734,10845,889,7.6
CN3716500000000,37,165,Scotland County, NC,Apr-17,11508,10677,831,7.2
CN3716500000000,37,165,Scotland County, NC,May-17,11498,10615,883,7.7
CN3716500000000,37,165,Scotland County, NC,Jun-17,11486,10571,915,8.0
CN3716500000000,37,165,Scotland County, NC,Jul-17,11510,10596,914,7.9
CN3716500000000,37,165,Scotland County, NC,Aug-17,11349,10423,926,8.2
CN3716500000000,37,165,Scotland County, NC,Sep-17,11482,10652,830,7.2
CN3716500000000,37,165,Scotland County, NC,Oct-17,11503,10661,842,7.3
CN3716500000000,37,165,Scotland County, NC,Nov-17,11469,10572,897,7.8
CN3716500000000,37,165,Scotland County, NC,Dec-17,11442,10553,889,7.8
CN3716500000000,37,165,Scotland County, NC,Jan-18,11631,10614,1017,8.7
CN3716500000000,37,165,Scotland County, NC,Feb-18,11630,10685,945,8.1
CN3716500000000,37,165,Scotland County, NC,Mar-18,11585,10669,916,7.9
CN3716500000000,37,165,Scotland County, NC,Apr-18(p),11453,10627,826,7.2
CN5503500000000,55,035,Eau Claire County, WI,Mar-17,59400,57572,1828,3.1
CN5503500000000,55,035,Eau Claire County, WI,Apr-17,59636,58076,1560,2.6
CN5503500000000,55,035,Eau Claire County, WI,May-17,59417,57777,1640,2.8
CN5503500000000,55,035,Eau Claire County, WI,Jun-17,59691,57651,2040,3.4
CN5503500000000,55,035,Eau Claire County, WI,Jul-17,60172,58283,1889,3.1
CN5503500000000,55,035,Eau Claire County, WI,Aug-17,59483,57696,1787,3.0
CN5503500000000,55,035,Eau Claire County, WI,Sep-17,59817,58298,1519,2.5
CN5503500000000,55,035,Eau Claire County, WI,Oct-17,59788,58337,1451,2.4
CN5503500000000,55,035,Eau Claire County, WI,Nov-17,59670,58236,1434,2.4
CN5503500000000,55,035,Eau Claire County, WI,Dec-17,59194,57783,1411,2.4
CN5503500000000,55,035,Eau Claire County, WI,Jan-18,58138,56525,1613,2.8
CN5503500000000,55,035,Eau Claire County, WI,Feb-18,59463,57822,1641,2.8
CN5503500000000,55,035,Eau Claire County, WI,Mar-18,59884,58294,1590,2.7
CN5503500000000,55,035,Eau Claire County, WI,Apr-18(p),59790,58446,1344,2.2
CN1909700000000,19,097,Jackson County, IA,Mar-17,10767,10322,445,4.1
CN1909700000000,19,097,Jackson County, IA,Apr-17,10792,10448,344,3.2
CN1909700000000,19,097,Jackson County, IA,May-17,10950,10632,318,2.9
CN1909700000000,19,097,Jackson County, IA,Jun-17,11030,10688,342,3.1
CN1909700000000,19,097,Jackson County, IA,Jul-17,11122,10788,334,3.0
CN1909700000000,19,097,Jackson County, IA,Aug-17,10896,10528,368,3.4
CN1909700000000,19,097,Jackson County, IA,Sep-17,10863,10563,300,2.8
CN1909700000000,19,097,Jackson County, IA,Oct-17,10911,10653,258,2.4
CN1909700000000,19,097,Jackson County, IA,Nov-17,10813,10548,265,2.5
CN1909700000000,19,097,Jackson County, IA,Dec-17,10790,10430,360,3.3
CN1909700000000,19,097,Jackson County, IA,Jan-18,10755,10231,524,4.9
CN1909700000000,19,097,Jackson County, IA,Feb-18,10799,10306,493,4.6
CN1909700000000,19,097,Jackson County, IA,Mar-18,10676,10271,405,3.8
CN1909700000000,19,097,Jackson County, IA,Apr-18(p),10706,10390,316,3.0
CN2808500000000,28,085,Lincoln County, MS,Mar-17,14464,13748,716,5.0
CN2808500000000,28,085,Lincoln County, MS,Apr-17,14450,13766,684,4.7
CN2808500000000,28,085,Lincoln County, MS,May-17,14572,13769,803,5.5
CN2808500000000,28,085,Lincoln County, MS,Jun-17,14780,13847,933,6.3
CN2808500000000,28,085,Lincoln County, MS,Jul-17,14883,13987,896,6.0
CN2808500000000,28,085,Lincoln County, MS,Aug-17,14552,13774,778,5.3
CN2808500000000,28,085,Lincoln County, MS,Sep-17,14692,14001,691,4.7
CN2808500000000,28,085,Lincoln County, MS,Oct-17,14499,13883,616,4.2
CN2808500000000,28,085,Lincoln County, MS,Nov-17,14534,13899,635,4.4
CN2808500000000,28,085,Lincoln County, MS,Dec-17,14550,13875,675,4.6
CN2808500000000,28,085,Lincoln County, MS,Jan-18,14405,13712,693,4.8
CN2808500000000,28,085,Lincoln County, MS,Feb-18,14441,13843,598,4.1
CN2808500000000,28,085,Lincoln County, MS,Mar-18,14478,13896,582,4.0
CN2808500000000,28,085,Lincoln County, MS,Apr-18(p),14535,13942,593,4.1
CN4707300000000,47,073,Hawkins County, TN,Mar-17,23915,22806,1109,4.6
CN4707300000000,47,073,Hawkins County, TN,Apr-17,23831,22926,905,3.8
CN4707300000000,47,073,Hawkins County, TN,May-17,23869,22998,871,3.6
CN4707300000000,47,073,Hawkins County, TN,Jun-17,24066,22983,1083,4.5
CN4707300000000,47,073,Hawkins County, TN,Jul-17,23975,22914,1061,4.4
CN4707300000000,47,073,Hawkins County, TN,Aug-17,23770,22799,971,4.1
CN4707300000000,47,073,Hawkins County, TN,Sep-17,23937,23034,903,3.8
CN4707300000000,47,073,Hawkins County, TN,Oct-17,23816,22943,873,3.7
CN4707300000000,47,073,Hawkins County, TN,Nov-17,23671,22834,837,3.5
CN4707300000000,47,073,Hawkins County, TN,Dec-17,23620,22790,830,3.5
CN4707300000000,47,073,Hawkins County, TN,Jan-18,23699,22695,1004,4.2
CN4707300000000,47,073,Hawkins County, TN,Feb-18,24010,23007,1003,4.2
CN4707300000000,47,073,Hawkins County, TN,Mar-18,24028,23072,956,4.0
CN4707300000000,47,073,Hawkins County, TN,Apr-18(p),24164,23373,791,3.3
CN2119100000000,21,191,Pendleton County, KY,Mar-17,6994,6614,380,5.4
CN2119100000000,21,191,Pendleton County, KY,Apr-17,6989,6664,325,4.7
CN2119100000000,21,191,Pendleton County, KY,May-17,6998,6679,319,4.6
CN2119100000000,21,191,Pendleton County, KY,Jun-17,7073,6713,360,5.1
CN2119100000000,21,191,Pendleton County, KY,Jul-17,7046,6704,342,4.9
CN2119100000000,21,191,Pendleton County, KY,Aug-17,6942,6640,302,4.4
CN2119100000000,21,191,Pendleton County, KY,Sep-17,6959,6666,293,4.2
CN2119100000000,21,191,Pendleton County, KY,Oct-17,6899,6636,263,3.8
CN2119100000000,21,191,Pendleton County, KY,Nov-17,6872,6612,260,3.8
CN2119100000000,21,191,Pendleton County, KY,Dec-17,6858,6590,268,3.9
CN2119100000000,21,191,Pendleton County, KY,Jan-18,6861,6543,318,4.6
CN2119100000000,21,191,Pendleton County, KY,Feb-18,6977,6623,354,5.1
CN2119100000000,21,191,Pendleton County, KY,Mar-18,7039,6719,320,4.5
CN2119100000000,21,191,Pendleton County, KY,Apr-18(p),7023,6759,264,3.8
CN1707300000000,17,073,Henry County, IL,Mar-17,24689,23303,1386,5.6
CN1707300000000,17,073,Henry County, IL,Apr-17,24703,23614,1089,4.4
CN1707300000000,17,073,Henry County, IL,May-17,24735,23636,1099,4.4
CN1707300000000,17,073,Henry County, IL,Jun-17,25096,23921,1175,4.7
CN1707300000000,17,073,Henry County, IL,Jul-17,25236,24030,1206,4.8
CN1707300000000,17,073,Henry County, IL,Aug-17,24933,23738,1195,4.8
CN1707300000000,17,073,Henry County, IL,Sep-17,24680,23564,1116,4.5
CN1707300000000,17,073,Henry County, IL,Oct-17,24623,23543,1080,4.4
CN1707300000000,17,073,Henry County, IL,Nov-17,24776,23715,1061,4.3
CN1707300000000,17,073,Henry County, IL,Dec-17,24596,23446,1150,4.7
CN1707300000000,17,073,Henry County, IL,Jan-18,24631,23354,1277,5.2
CN1707300000000,17,073,Henry County, IL,Feb-18,24640,23456,1184,4.8
CN1707300000000,17,073,Henry County, IL,Mar-18,25145,23949,1196,4.8
CN1707300000000,17,073,Henry County, IL,Apr-18(p),25144,24181,963,3.8
CN3719900000000,37,199,Yancey County, NC,Mar-17,7457,7100,357,4.8
CN3719900000000,37,199,Yancey County, NC,Apr-17,7429,7119,310,4.2
CN3719900000000,37,199,Yancey County, NC,May-17,7493,7163,330,4.4
CN3719900000000,37,199,Yancey County, NC,Jun-17,7326,6979,347,4.7
CN3719900000000,37,199,Yancey County, NC,Jul-17,7308,6955,353,4.8
CN3719900000000,37,199,Yancey County, NC,Aug-17,7543,7189,354,4.7
CN3719900000000,37,199,Yancey County, NC,Sep-17,7600,7286,314,4.1
CN3719900000000,37,199,Yancey County, NC,Oct-17,7581,7279,302,4.0
CN3719900000000,37,199,Yancey County, NC,Nov-17,7511,7194,317,4.2
CN3719900000000,37,199,Yancey County, NC,Dec-17,7377,7067,310,4.2
CN3719900000000,37,199,Yancey County, NC,Jan-18,7323,6983,340,4.6
CN3719900000000,37,199,Yancey County, NC,Feb-18,7374,7023,351,4.8
CN3719900000000,37,199,Yancey County, NC,Mar-18,7381,7051,330,4.5
CN3719900000000,37,199,Yancey County, NC,Apr-18(p),7388,7123,265,3.6
CN2606100000000,26,061,Houghton County, MI,Mar-17,16904,15780,1124,6.6
CN2606100000000,26,061,Houghton County, MI,Apr-17,16481,15485,996,6.0
CN2606100000000,26,061,Houghton County, MI,May-17,15528,14587,941,6.1
CN2606100000000,26,061,Houghton County, MI,Jun-17,16006,14971,1035,6.5
CN2606100000000,26,061,Houghton County, MI,Jul-17,15996,14847,1149,7.2
CN2606100000000,26,061,Houghton County, MI,Aug-17,15959,14943,1016,6.4
CN2606100000000,26,061,Houghton County, MI,Sep-17,17002,16146,856,5.0
CN2606100000000,26,061,Houghton County, MI,Oct-17,17057,16299,758,4.4
CN2606100000000,26,061,Houghton County, MI,Nov-17,17026,16178,848,5.0
CN2606100000000,26,061,Houghton County, MI,Dec-17,16872,15908,964,5.7
CN2606100000000,26,061,Houghton County, MI,Jan-18,16509,15469,1040,6.3
CN2606100000000,26,061,Houghton County, MI,Feb-18,17177,15992,1185,6.9
CN2606100000000,26,061,Houghton County, MI,Mar-18,16938,15900,1038,6.1
CN2606100000000,26,061,Houghton County, MI,Apr-18(p),16592,15620,972,5.9
CN3606100000000,36,061,New York County, NY,Mar-17,943821,906652,37169,3.9
CN3606100000000,36,061,New York County, NY,Apr-17,938690,903858,34832,3.7
CN3606100000000,36,061,New York County, NY,May-17,937818,901138,36680,3.9
CN3606100000000,36,061,New York County, NY,Jun-17,939001,901124,37877,4.0
CN3606100000000,36,061,New York County, NY,Jul-17,946591,905171,41420,4.4
CN3606100000000,36,061,New York County, NY,Aug-17,940582,898597,41985,4.5
CN3606100000000,36,061,New York County, NY,Sep-17,944157,906047,38110,4.0
CN3606100000000,36,061,New York County, NY,Oct-17,940596,903831,36765,3.9
CN3606100000000,36,061,New York County, NY,Nov-17,936026,902205,33821,3.6
CN3606100000000,36,061,New York County, NY,Dec-17,932581,899563,33018,3.5
CN3606100000000,36,061,New York County, NY,Jan-18,940418,902156,38262,4.1
CN3606100000000,36,061,New York County, NY,Feb-18,951001,914199,36802,3.9
CN3606100000000,36,061,New York County, NY,Mar-18,944979,909621,35358,3.7
CN3606100000000,36,061,New York County, NY,Apr-18(p),938402,904171,34231,3.6
CN4014900000000,40,149,Washita County, OK,Mar-17,5256,4993,263,5.0
CN4014900000000,40,149,Washita County, OK,Apr-17,5389,5154,235,4.4
CN4014900000000,40,149,Washita County, OK,May-17,5403,5153,250,4.6
CN4014900000000,40,149,Washita County, OK,Jun-17,5371,5119,252,4.7
CN4014900000000,40,149,Washita County, OK,Jul-17,5292,5063,229,4.3
CN4014900000000,40,149,Washita County, OK,Aug-17,5656,5427,229,4.0
CN4014900000000,40,149,Washita County, OK,Sep-17,5545,5328,217,3.9
CN4014900000000,40,149,Washita County, OK,Oct-17,5558,5337,221,4.0
CN4014900000000,40,149,Washita County, OK,Nov-17,5621,5416,205,3.6
CN4014900000000,40,149,Washita County, OK,Dec-17,5486,5292,194,3.5
CN4014900000000,40,149,Washita County, OK,Jan-18,5379,5165,214,4.0
CN4014900000000,40,149,Washita County, OK,Feb-18,5442,5241,201,3.7
CN4014900000000,40,149,Washita County, OK,Mar-18,5393,5195,198,3.7
CN4014900000000,40,149,Washita County, OK,Apr-18(p),5365,5167,198,3.7
CN1601100000000,16,011,Bingham County, ID,Mar-17,22212,21413,799,3.6
CN1601100000000,16,011,Bingham County, ID,Apr-17,22855,22209,646,2.8
CN1601100000000,16,011,Bingham County, ID,May-17,22956,22398,558,2.4
CN1601100000000,16,011,Bingham County, ID,Jun-17,23162,22552,610,2.6
CN1601100000000,16,011,Bingham County, ID,Jul-17,23022,22397,625,2.7
CN1601100000000,16,011,Bingham County, ID,Aug-17,23099,22484,615,2.7
CN1601100000000,16,011,Bingham County, ID,Sep-17,24070,23470,600,2.5
CN1601100000000,16,011,Bingham County, ID,Oct-17,24474,23923,551,2.3
CN1601100000000,16,011,Bingham County, ID,Nov-17,22914,22272,642,2.8
CN1601100000000,16,011,Bingham County, ID,Dec-17,22554,21878,676,3.0
CN1601100000000,16,011,Bingham County, ID,Jan-18,22301,21415,886,4.0
CN1601100000000,16,011,Bingham County, ID,Feb-18,22720,21960,760,3.3
CN1601100000000,16,011,Bingham County, ID,Mar-18,22904,22206,698,3.0
CN1601100000000,16,011,Bingham County, ID,Apr-18(p),23355,22745,610,2.6
CN1803500000000,18,035,Delaware County, IN,Mar-17,55603,53179,2424,4.4
CN1803500000000,18,035,Delaware County, IN,Apr-17,54549,52599,1950,3.6
CN1803500000000,18,035,Delaware County, IN,May-17,54450,52387,2063,3.8
CN1803500000000,18,035,Delaware County, IN,Jun-17,54621,52329,2292,4.2
CN1803500000000,18,035,Delaware County, IN,Jul-17,53916,51481,2435,4.5
CN1803500000000,18,035,Delaware County, IN,Aug-17,55321,52673,2648,4.8
CN1803500000000,18,035,Delaware County, IN,Sep-17,55333,53172,2161,3.9
CN1803500000000,18,035,Delaware County, IN,Oct-17,55356,53294,2062,3.7
CN1803500000000,18,035,Delaware County, IN,Nov-17,55294,53139,2155,3.9
CN1803500000000,18,035,Delaware County, IN,Dec-17,54555,52567,1988,3.6
CN1803500000000,18,035,Delaware County, IN,Jan-18,54188,51983,2205,4.1
CN1803500000000,18,035,Delaware County, IN,Feb-18,55383,53000,2383,4.3
CN1803500000000,18,035,Delaware County, IN,Mar-18,55686,53583,2103,3.8
CN1803500000000,18,035,Delaware County, IN,Apr-18(p),56192,54327,1865,3.3
CN3702300000000,37,023,Burke County, NC,Mar-17,40818,39099,1719,4.2
CN3702300000000,37,023,Burke County, NC,Apr-17,40743,39198,1545,3.8
CN3702300000000,37,023,Burke County, NC,May-17,40656,39015,1641,4.0
CN3702300000000,37,023,Burke County, NC,Jun-17,40666,38929,1737,4.3
CN3702300000000,37,023,Burke County, NC,Jul-17,40715,38856,1859,4.6
CN3702300000000,37,023,Burke County, NC,Aug-17,40308,38461,1847,4.6
CN3702300000000,37,023,Burke County, NC,Sep-17,40816,39202,1614,4.0
CN3702300000000,37,023,Burke County, NC,Oct-17,40550,38919,1631,4.0
CN3702300000000,37,023,Burke County, NC,Nov-17,40609,38892,1717,4.2
CN3702300000000,37,023,Burke County, NC,Dec-17,40275,38641,1634,4.1
CN3702300000000,37,023,Burke County, NC,Jan-18,40656,38928,1728,4.3
CN3702300000000,37,023,Burke County, NC,Feb-18,40991,39324,1667,4.1
CN3702300000000,37,023,Burke County, NC,Mar-18,41014,39388,1626,4.0
CN3702300000000,37,023,Burke County, NC,Apr-18(p),40857,39470,1387,3.4
CN4601100000000,46,011,Brookings County, SD,Mar-17,19023,18415,608,3.2
CN4601100000000,46,011,Brookings County, SD,Apr-17,19014,18413,601,3.2
CN4601100000000,46,011,Brookings County, SD,May-17,18750,18125,625,3.3
CN4601100000000,46,011,Brookings County, SD,Jun-17,18465,17809,656,3.6
CN4601100000000,46,011,Brookings County, SD,Jul-17,18438,17787,651,3.5
CN4601100000000,46,011,Brookings County, SD,Aug-17,18272,17659,613,3.4
CN4601100000000,46,011,Brookings County, SD,Sep-17,18737,18205,532,2.8
CN4601100000000,46,011,Brookings County, SD,Oct-17,19236,18715,521,2.7
CN4601100000000,46,011,Brookings County, SD,Nov-17,19258,18742,516,2.7
CN4601100000000,46,011,Brookings County, SD,Dec-17,19017,18400,617,3.2
CN4601100000000,46,011,Brookings County, SD,Jan-18,18720,18072,648,3.5
CN4601100000000,46,011,Brookings County, SD,Feb-18,19166,18549,617,3.2
CN4601100000000,46,011,Brookings County, SD,Mar-18,19111,18549,562,2.9
CN4601100000000,46,011,Brookings County, SD,Apr-18(p),19142,18525,617,3.2
CN3104900000000,31,049,Deuel County, NE,Mar-17,1010,987,23,2.3
CN3104900000000,31,049,Deuel County, NE,Apr-17,1023,1001,22,2.2
CN3104900000000,31,049,Deuel County, NE,May-17,1051,1026,25,2.4
CN3104900000000,31,049,Deuel County, NE,Jun-17,1103,1078,25,2.3
CN3104900000000,31,049,Deuel County, NE,Jul-17,1063,1037,26,2.4
CN3104900000000,31,049,Deuel County, NE,Aug-17,1045,1017,28,2.7
CN3104900000000,31,049,Deuel County, NE,Sep-17,1001,978,23,2.3
CN3104900000000,31,049,Deuel County, NE,Oct-17,1022,995,27,2.6
CN3104900000000,31,049,Deuel County, NE,Nov-17,1026,1002,24,2.3
CN3104900000000,31,049,Deuel County, NE,Dec-17,1025,991,34,3.3
CN3104900000000,31,049,Deuel County, NE,Jan-18,1035,1002,33,3.2
CN3104900000000,31,049,Deuel County, NE,Feb-18,1036,1000,36,3.5
CN3104900000000,31,049,Deuel County, NE,Mar-18,1044,1010,34,3.3
CN3104900000000,31,049,Deuel County, NE,Apr-18(p),1038,1004,34,3.3
CN1204700000000,12,047,Hamilton County, FL,Mar-17,4302,4087,215,5.0
CN1204700000000,12,047,Hamilton County, FL,Apr-17,4281,4082,199,4.6
CN1204700000000,12,047,Hamilton County, FL,May-17,4353,4141,212,4.9
CN1204700000000,12,047,Hamilton County, FL,Jun-17,4823,4604,219,4.5
CN1204700000000,12,047,Hamilton County, FL,Jul-17,4540,4319,221,4.9
CN1204700000000,12,047,Hamilton County, FL,Aug-17,4655,4433,222,4.8
CN1204700000000,12,047,Hamilton County, FL,Sep-17,4842,4633,209,4.3
CN1204700000000,12,047,Hamilton County, FL,Oct-17,4497,4308,189,4.2
CN1204700000000,12,047,Hamilton County, FL,Nov-17,4310,4123,187,4.3
CN1204700000000,12,047,Hamilton County, FL,Dec-17,4181,4008,173,4.1
CN1204700000000,12,047,Hamilton County, FL,Jan-18,4181,3966,215,5.1
CN1204700000000,12,047,Hamilton County, FL,Feb-18,4227,4032,195,4.6
CN1204700000000,12,047,Hamilton County, FL,Mar-18,4283,4086,197,4.6
CN1204700000000,12,047,Hamilton County, FL,Apr-18(p),4267,4094,173,4.1
CN0104900000000,01,049,DeKalb County, AL,Mar-17,29157,27661,1496,5.1
CN0104900000000,01,049,DeKalb County, AL,Apr-17,29073,27830,1243,4.3
CN0104900000000,01,049,DeKalb County, AL,May-17,29006,27833,1173,4.0
CN0104900000000,01,049,DeKalb County, AL,Jun-17,29378,27941,1437,4.9
CN0104900000000,01,049,DeKalb County, AL,Jul-17,29386,28075,1311,4.5
CN0104900000000,01,049,DeKalb County, AL,Aug-17,28907,27672,1235,4.3
CN0104900000000,01,049,DeKalb County, AL,Sep-17,29331,28285,1046,3.6
CN0104900000000,01,049,DeKalb County, AL,Oct-17,29095,28057,1038,3.6
CN0104900000000,01,049,DeKalb County, AL,Nov-17,28750,27766,984,3.4
CN0104900000000,01,049,DeKalb County, AL,Dec-17,28420,27488,932,3.3
CN0104900000000,01,049,DeKalb County, AL,Jan-18,28049,26868,1181,4.2
CN0104900000000,01,049,DeKalb County, AL,Feb-18,29009,27809,1200,4.1
CN0104900000000,01,049,DeKalb County, AL,Mar-18,29138,28009,1129,3.9
CN0104900000000,01,049,DeKalb County, AL,Apr-18(p),29332,28349,983,3.4
CN0511100000000,05,111,Poinsett County, AR,Mar-17,10278,9866,412,4.0
CN0511100000000,05,111,Poinsett County, AR,Apr-17,10327,9952,375,3.6
CN0511100000000,05,111,Poinsett County, AR,May-17,10382,9983,399,3.8
CN0511100000000,05,111,Poinsett County, AR,Jun-17,10471,10001,470,4.5
CN0511100000000,05,111,Poinsett County, AR,Jul-17,10567,10092,475,4.5
CN0511100000000,05,111,Poinsett County, AR,Aug-17,10417,9951,466,4.5
CN0511100000000,05,111,Poinsett County, AR,Sep-17,10370,9969,401,3.9
CN0511100000000,05,111,Poinsett County, AR,Oct-17,10393,10014,379,3.6
CN0511100000000,05,111,Poinsett County, AR,Nov-17,10355,9987,368,3.6
CN0511100000000,05,111,Poinsett County, AR,Dec-17,10266,9871,395,3.8
CN0511100000000,05,111,Poinsett County, AR,Jan-18,10128,9627,501,4.9
CN0511100000000,05,111,Poinsett County, AR,Feb-18,10246,9781,465,4.5
CN0511100000000,05,111,Poinsett County, AR,Mar-18,10234,9819,415,4.1
CN0511100000000,05,111,Poinsett County, AR,Apr-18(p),10244,9898,346,3.4
CN2904700000000,29,047,Clay County, MO,Mar-17,134427,128773,5654,4.2
CN2904700000000,29,047,Clay County, MO,Apr-17,133448,129467,3981,3.0
CN2904700000000,29,047,Clay County, MO,May-17,133621,129444,4177,3.1
CN2904700000000,29,047,Clay County, MO,Jun-17,134915,130569,4346,3.2
CN2904700000000,29,047,Clay County, MO,Jul-17,137982,131805,6177,4.5
CN2904700000000,29,047,Clay County, MO,Aug-17,135709,129813,5896,4.3
CN2904700000000,29,047,Clay County, MO,Sep-17,134793,130965,3828,2.8
CN2904700000000,29,047,Clay County, MO,Oct-17,135558,130461,5097,3.8
CN2904700000000,29,047,Clay County, MO,Nov-17,133442,129790,3652,2.7
CN2904700000000,29,047,Clay County, MO,Dec-17,133331,129488,3843,2.9
CN2904700000000,29,047,Clay County, MO,Jan-18,133038,127934,5104,3.8
CN2904700000000,29,047,Clay County, MO,Feb-18,133392,129047,4345,3.3
CN2904700000000,29,047,Clay County, MO,Mar-18,133618,129346,4272,3.2
CN2904700000000,29,047,Clay County, MO,Apr-18(p),133680,129849,3831,2.9
CN3904700000000,39,047,Fayette County, OH,Mar-17,14798,14149,649,4.4
CN3904700000000,39,047,Fayette County, OH,Apr-17,14507,13968,539,3.7
CN3904700000000,39,047,Fayette County, OH,May-17,14509,13941,568,3.9
CN3904700000000,39,047,Fayette County, OH,Jun-17,14502,13855,647,4.5
CN3904700000000,39,047,Fayette County, OH,Jul-17,14286,13655,631,4.4
CN3904700000000,39,047,Fayette County, OH,Aug-17,14613,14016,597,4.1
CN3904700000000,39,047,Fayette County, OH,Sep-17,14315,13762,553,3.9
CN3904700000000,39,047,Fayette County, OH,Oct-17,14419,13880,539,3.7
CN3904700000000,39,047,Fayette County, OH,Nov-17,14567,14014,553,3.8
CN3904700000000,39,047,Fayette County, OH,Dec-17,14361,13789,572,4.0
CN3904700000000,39,047,Fayette County, OH,Jan-18,14041,13392,649,4.6
CN3904700000000,39,047,Fayette County, OH,Feb-18,14204,13596,608,4.3
CN3904700000000,39,047,Fayette County, OH,Mar-18,14521,13945,576,4.0
CN3904700000000,39,047,Fayette County, OH,Apr-18(p),14301,13775,526,3.7
CN4803500000000,48,035,Bosque County, TX,Mar-17,8268,7918,350,4.2
CN4803500000000,48,035,Bosque County, TX,Apr-17,8225,7911,314,3.8
CN4803500000000,48,035,Bosque County, TX,May-17,8250,7925,325,3.9
CN4803500000000,48,035,Bosque County, TX,Jun-17,8250,7906,344,4.2
CN4803500000000,48,035,Bosque County, TX,Jul-17,8166,7824,342,4.2
CN4803500000000,48,035,Bosque County, TX,Aug-17,8160,7834,326,4.0
CN4803500000000,48,035,Bosque County, TX,Sep-17,8172,7877,295,3.6
CN4803500000000,48,035,Bosque County, TX,Oct-17,8115,7846,269,3.3
CN4803500000000,48,035,Bosque County, TX,Nov-17,8097,7804,293,3.6
CN4803500000000,48,035,Bosque County, TX,Dec-17,8113,7827,286,3.5
CN4803500000000,48,035,Bosque County, TX,Jan-18,8128,7801,327,4.0
CN4803500000000,48,035,Bosque County, TX,Feb-18,8223,7899,324,3.9
CN4803500000000,48,035,Bosque County, TX,Mar-18,8334,8006,328,3.9
CN4803500000000,48,035,Bosque County, TX,Apr-18(p),8289,7997,292,3.5
CN5601100000000,56,011,Crook County, WY,Mar-17,3430,3266,164,4.8
CN5601100000000,56,011,Crook County, WY,Apr-17,3500,3369,131,3.7
CN5601100000000,56,011,Crook County, WY,May-17,3704,3582,122,3.3
CN5601100000000,56,011,Crook County, WY,Jun-17,3996,3876,120,3.0
CN5601100000000,56,011,Crook County, WY,Jul-17,3869,3763,106,2.7
CN5601100000000,56,011,Crook County, WY,Aug-17,3886,3780,106,2.7
CN5601100000000,56,011,Crook County, WY,Sep-17,3765,3661,104,2.8
CN5601100000000,56,011,Crook County, WY,Oct-17,3716,3609,107,2.9
CN5601100000000,56,011,Crook County, WY,Nov-17,3712,3606,106,2.9
CN5601100000000,56,011,Crook County, WY,Dec-17,3566,3455,111,3.1
CN5601100000000,56,011,Crook County, WY,Jan-18,3572,3451,121,3.4
CN5601100000000,56,011,Crook County, WY,Feb-18,3539,3403,136,3.8
CN5601100000000,56,011,Crook County, WY,Mar-18,3443,3319,124,3.6
CN5601100000000,56,011,Crook County, WY,Apr-18(p),3437,3326,111,3.2
CN2003700000000,20,037,Crawford County, KS,Mar-17,19281,18482,799,4.1
CN2003700000000,20,037,Crawford County, KS,Apr-17,19226,18482,744,3.9
CN2003700000000,20,037,Crawford County, KS,May-17,19107,18357,750,3.9
CN2003700000000,20,037,Crawford County, KS,Jun-17,19239,18397,842,4.4
CN2003700000000,20,037,Crawford County, KS,Jul-17,19248,18317,931,4.8
CN2003700000000,20,037,Crawford County, KS,Aug-17,18871,17994,877,4.6
CN2003700000000,20,037,Crawford County, KS,Sep-17,19035,18275,760,4.0
CN2003700000000,20,037,Crawford County, KS,Oct-17,19036,18351,685,3.6
CN2003700000000,20,037,Crawford County, KS,Nov-17,19184,18482,702,3.7
CN2003700000000,20,037,Crawford County, KS,Dec-17,19065,18391,674,3.5
CN2003700000000,20,037,Crawford County, KS,Jan-18,18956,18163,793,4.2
CN2003700000000,20,037,Crawford County, KS,Feb-18,19030,18219,811,4.3
CN2003700000000,20,037,Crawford County, KS,Mar-18,19078,18328,750,3.9
CN2003700000000,20,037,Crawford County, KS,Apr-18(p),19106,18405,701,3.7
CN1714900000000,17,149,Pike County, IL,Mar-17,7190,6842,348,4.8
CN1714900000000,17,149,Pike County, IL,Apr-17,7267,6983,284,3.9
CN1714900000000,17,149,Pike County, IL,May-17,7258,6988,270,3.7
CN1714900000000,17,149,Pike County, IL,Jun-17,7410,7123,287,3.9
CN1714900000000,17,149,Pike County, IL,Jul-17,7304,7002,302,4.1
CN1714900000000,17,149,Pike County, IL,Aug-17,7250,6944,306,4.2
CN1714900000000,17,149,Pike County, IL,Sep-17,7178,6906,272,3.8
CN1714900000000,17,149,Pike County, IL,Oct-17,7189,6914,275,3.8
CN1714900000000,17,149,Pike County, IL,Nov-17,7080,6793,287,4.1
CN1714900000000,17,149,Pike County, IL,Dec-17,6992,6693,299,4.3
CN1714900000000,17,149,Pike County, IL,Jan-18,6952,6611,341,4.9
CN1714900000000,17,149,Pike County, IL,Feb-18,6903,6588,315,4.6
CN1714900000000,17,149,Pike County, IL,Mar-18,7103,6766,337,4.7
CN1714900000000,17,149,Pike County, IL,Apr-18(p),7213,6941,272,3.8
CN2714900000000,27,149,Stevens County, MN,Mar-17,5533,5352,181,3.3
CN2714900000000,27,149,Stevens County, MN,Apr-17,5572,5445,127,2.3
CN2714900000000,27,149,Stevens County, MN,May-17,5474,5348,126,2.3
CN2714900000000,27,149,Stevens County, MN,Jun-17,5533,5387,146,2.6
CN2714900000000,27,149,Stevens County, MN,Jul-17,5500,5366,134,2.4
CN2714900000000,27,149,Stevens County, MN,Aug-17,5409,5269,140,2.6
CN2714900000000,27,149,Stevens County, MN,Sep-17,5437,5315,122,2.2
CN2714900000000,27,149,Stevens County, MN,Oct-17,5612,5524,88,1.6
CN2714900000000,27,149,Stevens County, MN,Nov-17,5566,5466,100,1.8
CN2714900000000,27,149,Stevens County, MN,Dec-17,5590,5431,159,2.8
CN2714900000000,27,149,Stevens County, MN,Jan-18,5445,5258,187,3.4
CN2714900000000,27,149,Stevens County, MN,Feb-18,5494,5308,186,3.4
CN2714900000000,27,149,Stevens County, MN,Mar-18,5511,5333,178,3.2
CN2714900000000,27,149,Stevens County, MN,Apr-18(p),5562,5429,133,2.4
CN3008700000000,30,087,Rosebud County, MT,Mar-17,3999,3759,240,6.0
CN3008700000000,30,087,Rosebud County, MT,Apr-17,4056,3868,188,4.6
CN3008700000000,30,087,Rosebud County, MT,May-17,4315,4148,167,3.9
CN3008700000000,30,087,Rosebud County, MT,Jun-17,4311,4105,206,4.8
CN3008700000000,30,087,Rosebud County, MT,Jul-17,3996,3785,211,5.3
CN3008700000000,30,087,Rosebud County, MT,Aug-17,3946,3718,228,5.8
CN3008700000000,30,087,Rosebud County, MT,Sep-17,3936,3750,186,4.7
CN3008700000000,30,087,Rosebud County, MT,Oct-17,3962,3782,180,4.5
CN3008700000000,30,087,Rosebud County, MT,Nov-17,3989,3780,209,5.2
CN3008700000000,30,087,Rosebud County, MT,Dec-17,3927,3717,210,5.3
CN3008700000000,30,087,Rosebud County, MT,Jan-18,3933,3662,271,6.9
CN3008700000000,30,087,Rosebud County, MT,Feb-18,3957,3682,275,6.9
CN3008700000000,30,087,Rosebud County, MT,Mar-18,3878,3626,252,6.5
CN3008700000000,30,087,Rosebud County, MT,Apr-18(p),3946,3742,204,5.2
CN3718500000000,37,185,Warren County, NC,Mar-17,6951,6498,453,6.5
CN3718500000000,37,185,Warren County, NC,Apr-17,6932,6485,447,6.4
CN3718500000000,37,185,Warren County, NC,May-17,6915,6445,470,6.8
CN3718500000000,37,185,Warren County, NC,Jun-17,6967,6488,479,6.9
CN3718500000000,37,185,Warren County, NC,Jul-17,6888,6399,489,7.1
CN3718500000000,37,185,Warren County, NC,Aug-17,6771,6289,482,7.1
CN3718500000000,37,185,Warren County, NC,Sep-17,6798,6345,453,6.7
CN3718500000000,37,185,Warren County, NC,Oct-17,6854,6400,454,6.6
CN3718500000000,37,185,Warren County, NC,Nov-17,6840,6364,476,7.0
CN3718500000000,37,185,Warren County, NC,Dec-17,6751,6300,451,6.7
CN3718500000000,37,185,Warren County, NC,Jan-18,6835,6334,501,7.3
CN3718500000000,37,185,Warren County, NC,Feb-18,6742,6266,476,7.1
CN3718500000000,37,185,Warren County, NC,Mar-18,6691,6240,451,6.7
CN3718500000000,37,185,Warren County, NC,Apr-18(p),6691,6293,398,5.9
CN4613700000000,46,137,Ziebach County, SD,Mar-17,952,914,38,4.0
CN4613700000000,46,137,Ziebach County, SD,Apr-17,953,912,41,4.3
CN4613700000000,46,137,Ziebach County, SD,May-17,978,929,49,5.0
CN4613700000000,46,137,Ziebach County, SD,Jun-17,1015,949,66,6.5
CN4613700000000,46,137,Ziebach County, SD,Jul-17,974,901,73,7.5
CN4613700000000,46,137,Ziebach County, SD,Aug-17,956,883,73,7.6
CN4613700000000,46,137,Ziebach County, SD,Sep-17,974,924,50,5.1
CN4613700000000,46,137,Ziebach County, SD,Oct-17,949,899,50,5.3
CN4613700000000,46,137,Ziebach County, SD,Nov-17,950,903,47,4.9
CN4613700000000,46,137,Ziebach County, SD,Dec-17,960,914,46,4.8
CN4613700000000,46,137,Ziebach County, SD,Jan-18,949,907,42,4.4
CN4613700000000,46,137,Ziebach County, SD,Feb-18,956,910,46,4.8
CN4613700000000,46,137,Ziebach County, SD,Mar-18,962,925,37,3.8
CN4613700000000,46,137,Ziebach County, SD,Apr-18(p),937,891,46,4.9
CN5512500000000,55,125,Vilas County, WI,Mar-17,9413,8827,586,6.2
CN5512500000000,55,125,Vilas County, WI,Apr-17,9570,9053,517,5.4
CN5512500000000,55,125,Vilas County, WI,May-17,10026,9664,362,3.6
CN5512500000000,55,125,Vilas County, WI,Jun-17,11082,10655,427,3.9
CN5512500000000,55,125,Vilas County, WI,Jul-17,11420,11027,393,3.4
CN5512500000000,55,125,Vilas County, WI,Aug-17,11205,10817,388,3.5
CN5512500000000,55,125,Vilas County, WI,Sep-17,10516,10171,345,3.3
CN5512500000000,55,125,Vilas County, WI,Oct-17,10292,9974,318,3.1
CN5512500000000,55,125,Vilas County, WI,Nov-17,9907,9523,384,3.9
CN5512500000000,55,125,Vilas County, WI,Dec-17,9732,9301,431,4.4
CN5512500000000,55,125,Vilas County, WI,Jan-18,9615,9195,420,4.4
CN5512500000000,55,125,Vilas County, WI,Feb-18,9613,9102,511,5.3
CN5512500000000,55,125,Vilas County, WI,Mar-18,9547,9017,530,5.6
CN5512500000000,55,125,Vilas County, WI,Apr-18(p),9616,9120,496,5.2
CN2019300000000,20,193,Thomas County, KS,Mar-17,4224,4115,109,2.6
CN2019300000000,20,193,Thomas County, KS,Apr-17,4197,4092,105,2.5
CN2019300000000,20,193,Thomas County, KS,May-17,4155,4050,105,2.5
CN2019300000000,20,193,Thomas County, KS,Jun-17,4340,4211,129,3.0
CN2019300000000,20,193,Thomas County, KS,Jul-17,4264,4126,138,3.2
CN2019300000000,20,193,Thomas County, KS,Aug-17,4326,4207,119,2.8
CN2019300000000,20,193,Thomas County, KS,Sep-17,4296,4197,99,2.3
CN2019300000000,20,193,Thomas County, KS,Oct-17,4368,4277,91,2.1
CN2019300000000,20,193,Thomas County, KS,Nov-17,4314,4213,101,2.3
CN2019300000000,20,193,Thomas County, KS,Dec-17,4285,4189,96,2.2
CN2019300000000,20,193,Thomas County, KS,Jan-18,4182,4082,100,2.4
CN2019300000000,20,193,Thomas County, KS,Feb-18,4189,4077,112,2.7
CN2019300000000,20,193,Thomas County, KS,Mar-18,4136,4026,110,2.7
CN2019300000000,20,193,Thomas County, KS,Apr-18(p),4042,3929,113,2.8
CN7209100000000,72,091,Manati Municipio, PR,Mar-17,11707,10467,1240,10.6
CN7209100000000,72,091,Manati Municipio, PR,Apr-17,11602,10269,1333,11.5
CN7209100000000,72,091,Manati Municipio, PR,May-17,11461,10284,1177,10.3
CN7209100000000,72,091,Manati Municipio, PR,Jun-17,11328,10275,1053,9.3
CN7209100000000,72,091,Manati Municipio, PR,Jul-17,11520,10312,1208,10.5
CN7209100000000,72,091,Manati Municipio, PR,Aug-17,11554,10173,1381,12.0
CN7209100000000,72,091,Manati Municipio, PR,Sep-17(y),11482,10205,1277,11.1
CN7209100000000,72,091,Manati Municipio, PR,Oct-17,11140,9747,1393,12.5
CN7209100000000,72,091,Manati Municipio, PR,Nov-17,11670,10499,1171,10.0
CN7209100000000,72,091,Manati Municipio, PR,Dec-17,11700,10580,1120,9.6
CN7209100000000,72,091,Manati Municipio, PR,Jan-18,11493,10328,1165,10.1
CN7209100000000,72,091,Manati Municipio, PR,Feb-18,11278,10219,1059,9.4
CN7209100000000,72,091,Manati Municipio, PR,Mar-18,11315,10275,1040,9.2
CN7209100000000,72,091,Manati Municipio, PR,Apr-18(p),11371,10332,1039,9.1
CN3103500000000,31,035,Clay County, NE,Mar-17,3244,3122,122,3.8
CN3103500000000,31,035,Clay County, NE,Apr-17,3306,3214,92,2.8
CN3103500000000,31,035,Clay County, NE,May-17,3371,3284,87,2.6
CN3103500000000,31,035,Clay County, NE,Jun-17,3454,3359,95,2.8
CN3103500000000,31,035,Clay County, NE,Jul-17,3361,3261,100,3.0
CN3103500000000,31,035,Clay County, NE,Aug-17,3250,3157,93,2.9
CN3103500000000,31,035,Clay County, NE,Sep-17,3153,3073,80,2.5
CN3103500000000,31,035,Clay County, NE,Oct-17,3177,3100,77,2.4
CN3103500000000,31,035,Clay County, NE,Nov-17,3196,3113,83,2.6
CN3103500000000,31,035,Clay County, NE,Dec-17,3207,3089,118,3.7
CN3103500000000,31,035,Clay County, NE,Jan-18,3248,3109,139,4.3
CN3103500000000,31,035,Clay County, NE,Feb-18,3194,3072,122,3.8
CN3103500000000,31,035,Clay County, NE,Mar-18,3257,3141,116,3.6
CN3103500000000,31,035,Clay County, NE,Apr-18(p),3219,3112,107,3.3
CN5002300000000,50,023,Washington County, VT,Mar-17,34211,33035,1176,3.4
CN5002300000000,50,023,Washington County, VT,Apr-17,33714,32641,1073,3.2
CN5002300000000,50,023,Washington County, VT,May-17,33883,32977,906,2.7
CN5002300000000,50,023,Washington County, VT,Jun-17,34792,33742,1050,3.0
CN5002300000000,50,023,Washington County, VT,Jul-17,34242,33228,1014,3.0
CN5002300000000,50,023,Washington County, VT,Aug-17,34332,33390,942,2.7
CN5002300000000,50,023,Washington County, VT,Sep-17,33834,32893,941,2.8
CN5002300000000,50,023,Washington County, VT,Oct-17,33996,33276,720,2.1
CN5002300000000,50,023,Washington County, VT,Nov-17,34034,33198,836,2.5
CN5002300000000,50,023,Washington County, VT,Dec-17,34203,33392,811,2.4
CN5002300000000,50,023,Washington County, VT,Jan-18,34659,33368,1291,3.7
CN5002300000000,50,023,Washington County, VT,Feb-18,34969,33874,1095,3.1
CN5002300000000,50,023,Washington County, VT,Mar-18,35193,34094,1099,3.1
CN5002300000000,50,023,Washington County, VT,Apr-18(p),34550,33546,1004,2.9
CN1322700000000,13,227,Pickens County, GA,Mar-17,14793,14139,654,4.4
CN1322700000000,13,227,Pickens County, GA,Apr-17,14785,14170,615,4.2
CN1322700000000,13,227,Pickens County, GA,May-17,14842,14197,645,4.3
CN1322700000000,13,227,Pickens County, GA,Jun-17,14850,14182,668,4.5
CN1322700000000,13,227,Pickens County, GA,Jul-17,14947,14282,665,4.4
CN1322700000000,13,227,Pickens County, GA,Aug-17,14865,14212,653,4.4
CN1322700000000,13,227,Pickens County, GA,Sep-17,14995,14405,590,3.9
CN1322700000000,13,227,Pickens County, GA,Oct-17,14933,14348,585,3.9
CN1322700000000,13,227,Pickens County, GA,Nov-17,14963,14397,566,3.8
CN1322700000000,13,227,Pickens County, GA,Dec-17,14965,14390,575,3.8
CN1322700000000,13,227,Pickens County, GA,Jan-18,14969,14364,605,4.0
CN1322700000000,13,227,Pickens County, GA,Feb-18,15221,14603,618,4.1
CN1322700000000,13,227,Pickens County, GA,Mar-18,15231,14654,577,3.8
CN1322700000000,13,227,Pickens County, GA,Apr-18(p),15102,14613,489,3.2
CN1813300000000,18,133,Putnam County, IN,Mar-17,16530,15881,649,3.9
CN1813300000000,18,133,Putnam County, IN,Apr-17,16560,16064,496,3.0
CN1813300000000,18,133,Putnam County, IN,May-17,16739,16208,531,3.2
CN1813300000000,18,133,Putnam County, IN,Jun-17,16894,16302,592,3.5
CN1813300000000,18,133,Putnam County, IN,Jul-17,16875,16247,628,3.7
CN1813300000000,18,133,Putnam County, IN,Aug-17,16740,16058,682,4.1
CN1813300000000,18,133,Putnam County, IN,Sep-17,16526,16016,510,3.1
CN1813300000000,18,133,Putnam County, IN,Oct-17,16482,15974,508,3.1
CN1813300000000,18,133,Putnam County, IN,Nov-17,16589,16036,553,3.3
CN1813300000000,18,133,Putnam County, IN,Dec-17,16397,15888,509,3.1
CN1813300000000,18,133,Putnam County, IN,Jan-18,16407,15800,607,3.7
CN1813300000000,18,133,Putnam County, IN,Feb-18,16674,16017,657,3.9
CN1813300000000,18,133,Putnam County, IN,Mar-18,16820,16246,574,3.4
CN1813300000000,18,133,Putnam County, IN,Apr-18(p),16836,16316,520,3.1
CN5300900000000,53,009,Clallam County, WA,Mar-17,27570,25559,2011,7.3
CN5300900000000,53,009,Clallam County, WA,Apr-17,27610,25715,1895,6.9
CN5300900000000,53,009,Clallam County, WA,May-17,27797,25985,1812,6.5
CN5300900000000,53,009,Clallam County, WA,Jun-17,27978,26200,1778,6.4
CN5300900000000,53,009,Clallam County, WA,Jul-17,28227,26385,1842,6.5
CN5300900000000,53,009,Clallam County, WA,Aug-17,28068,26231,1837,6.5
CN5300900000000,53,009,Clallam County, WA,Sep-17,28035,26304,1731,6.2
CN5300900000000,53,009,Clallam County, WA,Oct-17,28038,26390,1648,5.9
CN5300900000000,53,009,Clallam County, WA,Nov-17,28194,26421,1773,6.3
CN5300900000000,53,009,Clallam County, WA,Dec-17,27994,26011,1983,7.1
CN5300900000000,53,009,Clallam County, WA,Jan-18,27639,25458,2181,7.9
CN5300900000000,53,009,Clallam County, WA,Feb-18,27538,25326,2212,8.0
CN5300900000000,53,009,Clallam County, WA,Mar-18,27495,25441,2054,7.5
CN5300900000000,53,009,Clallam County, WA,Apr-18(p),27404,25534,1870,6.8
CN3712100000000,37,121,Mitchell County, NC,Mar-17,6154,5810,344,5.6
CN3712100000000,37,121,Mitchell County, NC,Apr-17,6186,5869,317,5.1
CN3712100000000,37,121,Mitchell County, NC,May-17,6156,5844,312,5.1
CN3712100000000,37,121,Mitchell County, NC,Jun-17,6072,5757,315,5.2
CN3712100000000,37,121,Mitchell County, NC,Jul-17,6122,5786,336,5.5
CN3712100000000,37,121,Mitchell County, NC,Aug-17,6130,5797,333,5.4
CN3712100000000,37,121,Mitchell County, NC,Sep-17,6249,5961,288,4.6
CN3712100000000,37,121,Mitchell County, NC,Oct-17,6126,5848,278,4.5
CN3712100000000,37,121,Mitchell County, NC,Nov-17,6076,5789,287,4.7
CN3712100000000,37,121,Mitchell County, NC,Dec-17,5971,5676,295,4.9
CN3712100000000,37,121,Mitchell County, NC,Jan-18,5944,5596,348,5.9
CN3712100000000,37,121,Mitchell County, NC,Feb-18,6048,5697,351,5.8
CN3712100000000,37,121,Mitchell County, NC,Mar-18,6093,5775,318,5.2
CN3712100000000,37,121,Mitchell County, NC,Apr-18(p),6124,5848,276,4.5
CN2807100000000,28,071,Lafayette County, MS,Mar-17,26978,25918,1060,3.9
CN2807100000000,28,071,Lafayette County, MS,Apr-17,26879,25880,999,3.7
CN2807100000000,28,071,Lafayette County, MS,May-17,26919,25666,1253,4.7
CN2807100000000,28,071,Lafayette County, MS,Jun-17,26262,24678,1584,6.0
CN2807100000000,28,071,Lafayette County, MS,Jul-17,25278,23912,1366,5.4
CN2807100000000,28,071,Lafayette County, MS,Aug-17,26327,25207,1120,4.3
CN2807100000000,28,071,Lafayette County, MS,Sep-17,27454,26398,1056,3.8
CN2807100000000,28,071,Lafayette County, MS,Oct-17,27451,26496,955,3.5
CN2807100000000,28,071,Lafayette County, MS,Nov-17,27536,26592,944,3.4
CN2807100000000,28,071,Lafayette County, MS,Dec-17,26956,25998,958,3.6
CN2807100000000,28,071,Lafayette County, MS,Jan-18,26094,25058,1036,4.0
CN2807100000000,28,071,Lafayette County, MS,Feb-18,27352,26389,963,3.5
CN2807100000000,28,071,Lafayette County, MS,Mar-18,27220,26283,937,3.4
CN2807100000000,28,071,Lafayette County, MS,Apr-18(p),27607,26620,987,3.6
CN2013500000000,20,135,Ness County, KS,Mar-17,1390,1350,40,2.9
CN2013500000000,20,135,Ness County, KS,Apr-17,1345,1308,37,2.8
CN2013500000000,20,135,Ness County, KS,May-17,1341,1301,40,3.0
CN2013500000000,20,135,Ness County, KS,Jun-17,1378,1338,40,2.9
CN2013500000000,20,135,Ness County, KS,Jul-17,1396,1348,48,3.4
CN2013500000000,20,135,Ness County, KS,Aug-17,1361,1319,42,3.1
CN2013500000000,20,135,Ness County, KS,Sep-17,1380,1349,31,2.2
CN2013500000000,20,135,Ness County, KS,Oct-17,1394,1361,33,2.4
CN2013500000000,20,135,Ness County, KS,Nov-17,1368,1332,36,2.6
CN2013500000000,20,135,Ness County, KS,Dec-17,1359,1328,31,2.3
CN2013500000000,20,135,Ness County, KS,Jan-18,1331,1301,30,2.3
CN2013500000000,20,135,Ness County, KS,Feb-18,1320,1287,33,2.5
CN2013500000000,20,135,Ness County, KS,Mar-18,1328,1290,38,2.9
CN2013500000000,20,135,Ness County, KS,Apr-18(p),1261,1223,38,3.0
CN3914500000000,39,145,Scioto County, OH,Mar-17,30046,27809,2237,7.4
CN3914500000000,39,145,Scioto County, OH,Apr-17,29829,27854,1975,6.6
CN3914500000000,39,145,Scioto County, OH,May-17,29549,27699,1850,6.3
CN3914500000000,39,145,Scioto County, OH,Jun-17,29584,27458,2126,7.2
CN3914500000000,39,145,Scioto County, OH,Jul-17,29650,27538,2112,7.1
CN3914500000000,39,145,Scioto County, OH,Aug-17,29452,27375,2077,7.1
CN3914500000000,39,145,Scioto County, OH,Sep-17,29654,27785,1869,6.3
CN3914500000000,39,145,Scioto County, OH,Oct-17,29649,27884,1765,6.0
CN3914500000000,39,145,Scioto County, OH,Nov-17,29587,27699,1888,6.4
CN3914500000000,39,145,Scioto County, OH,Dec-17,29592,27578,2014,6.8
CN3914500000000,39,145,Scioto County, OH,Jan-18,29108,26821,2287,7.9
CN3914500000000,39,145,Scioto County, OH,Feb-18,29779,27584,2195,7.4
CN3914500000000,39,145,Scioto County, OH,Mar-18,30054,28078,1976,6.6
CN3914500000000,39,145,Scioto County, OH,Apr-18(p),29950,28129,1821,6.1
CN0501300000000,05,013,Calhoun County, AR,Mar-17,2346,2260,86,3.7
CN0501300000000,05,013,Calhoun County, AR,Apr-17,2358,2275,83,3.5
CN0501300000000,05,013,Calhoun County, AR,May-17,2372,2285,87,3.7
CN0501300000000,05,013,Calhoun County, AR,Jun-17,2422,2325,97,4.0
CN0501300000000,05,013,Calhoun County, AR,Jul-17,2391,2283,108,4.5
CN0501300000000,05,013,Calhoun County, AR,Aug-17,2344,2253,91,3.9
CN0501300000000,05,013,Calhoun County, AR,Sep-17,2375,2284,91,3.8
CN0501300000000,05,013,Calhoun County, AR,Oct-17,2369,2285,84,3.5
CN0501300000000,05,013,Calhoun County, AR,Nov-17,2346,2261,85,3.6
CN0501300000000,05,013,Calhoun County, AR,Dec-17,2343,2249,94,4.0
CN0501300000000,05,013,Calhoun County, AR,Jan-18,2298,2188,110,4.8
CN0501300000000,05,013,Calhoun County, AR,Feb-18,2339,2228,111,4.7
CN0501300000000,05,013,Calhoun County, AR,Mar-18,2350,2240,110,4.7
CN0501300000000,05,013,Calhoun County, AR,Apr-18(p),2351,2259,92,3.9
CN2400100000000,24,001,Allegany County, MD,Mar-17,32746,30644,2102,6.4
CN2400100000000,24,001,Allegany County, MD,Apr-17,32440,30647,1793,5.5
CN2400100000000,24,001,Allegany County, MD,May-17,32394,30711,1683,5.2
CN2400100000000,24,001,Allegany County, MD,Jun-17,32359,30436,1923,5.9
CN2400100000000,24,001,Allegany County, MD,Jul-17,32506,30655,1851,5.7
CN2400100000000,24,001,Allegany County, MD,Aug-17,32112,30331,1781,5.5
CN2400100000000,24,001,Allegany County, MD,Sep-17,32609,31023,1586,4.9
CN2400100000000,24,001,Allegany County, MD,Oct-17,32745,31116,1629,5.0
CN2400100000000,24,001,Allegany County, MD,Nov-17,32554,30898,1656,5.1
CN2400100000000,24,001,Allegany County, MD,Dec-17,32601,30818,1783,5.5
CN2400100000000,24,001,Allegany County, MD,Jan-18,32326,30059,2267,7.0
CN2400100000000,24,001,Allegany County, MD,Feb-18,32746,30506,2240,6.8
CN2400100000000,24,001,Allegany County, MD,Mar-18,32733,30570,2163,6.6
CN2400100000000,24,001,Allegany County, MD,Apr-18(p),32558,30714,1844,5.7
CN1708700000000,17,087,Johnson County, IL,Mar-17,4212,3893,319,7.6
CN1708700000000,17,087,Johnson County, IL,Apr-17,4208,3948,260,6.2
CN1708700000000,17,087,Johnson County, IL,May-17,4108,3837,271,6.6
CN1708700000000,17,087,Johnson County, IL,Jun-17,4032,3736,296,7.3
CN1708700000000,17,087,Johnson County, IL,Jul-17,4018,3718,300,7.5
CN1708700000000,17,087,Johnson County, IL,Aug-17,4011,3700,311,7.8
CN1708700000000,17,087,Johnson County, IL,Sep-17,4045,3785,260,6.4
CN1708700000000,17,087,Johnson County, IL,Oct-17,3999,3756,243,6.1
CN1708700000000,17,087,Johnson County, IL,Nov-17,3997,3734,263,6.6
CN1708700000000,17,087,Johnson County, IL,Dec-17,3971,3694,277,7.0
CN1708700000000,17,087,Johnson County, IL,Jan-18,4046,3722,324,8.0
CN1708700000000,17,087,Johnson County, IL,Feb-18,4087,3781,306,7.5
CN1708700000000,17,087,Johnson County, IL,Mar-18,4163,3854,309,7.4
CN1708700000000,17,087,Johnson County, IL,Apr-18(p),4187,3933,254,6.1
CN1210300000000,12,103,Pinellas County, FL,Mar-17,487559,469180,18379,3.8
CN1210300000000,12,103,Pinellas County, FL,Apr-17,487590,470061,17529,3.6
CN1210300000000,12,103,Pinellas County, FL,May-17,489108,471060,18048,3.7
CN1210300000000,12,103,Pinellas County, FL,Jun-17,491860,472958,18902,3.8
CN1210300000000,12,103,Pinellas County, FL,Jul-17,493785,474814,18971,3.8
CN1210300000000,12,103,Pinellas County, FL,Aug-17,491669,472890,18779,3.8
CN1210300000000,12,103,Pinellas County, FL,Sep-17,498722,481234,17488,3.5
CN1210300000000,12,103,Pinellas County, FL,Oct-17,494188,477467,16721,3.4
CN1210300000000,12,103,Pinellas County, FL,Nov-17,491906,475131,16775,3.4
CN1210300000000,12,103,Pinellas County, FL,Dec-17,489424,473493,15931,3.3
CN1210300000000,12,103,Pinellas County, FL,Jan-18,492532,474068,18464,3.7
CN1210300000000,12,103,Pinellas County, FL,Feb-18,496934,479920,17014,3.4
CN1210300000000,12,103,Pinellas County, FL,Mar-18,498117,481253,16864,3.4
CN1210300000000,12,103,Pinellas County, FL,Apr-18(p),497411,482227,15184,3.1
CN1602500000000,16,025,Camas County, ID,Mar-17,656,631,25,3.8
CN1602500000000,16,025,Camas County, ID,Apr-17,662,639,23,3.5
CN1602500000000,16,025,Camas County, ID,May-17,659,642,17,2.6
CN1602500000000,16,025,Camas County, ID,Jun-17,690,671,19,2.8
CN1602500000000,16,025,Camas County, ID,Jul-17,709,694,15,2.1
CN1602500000000,16,025,Camas County, ID,Aug-17,700,686,14,2.0
CN1602500000000,16,025,Camas County, ID,Sep-17,703,690,13,1.8
CN1602500000000,16,025,Camas County, ID,Oct-17,706,695,11,1.6
CN1602500000000,16,025,Camas County, ID,Nov-17,665,652,13,2.0
CN1602500000000,16,025,Camas County, ID,Dec-17,665,648,17,2.6
CN1602500000000,16,025,Camas County, ID,Jan-18,667,641,26,3.9
CN1602500000000,16,025,Camas County, ID,Feb-18,660,641,19,2.9
CN1602500000000,16,025,Camas County, ID,Mar-18,669,649,20,3.0
CN1602500000000,16,025,Camas County, ID,Apr-18(p),665,652,13,2.0
CN5400100000000,54,001,Barbour County, WV,Mar-17,7073,6607,466,6.6
CN5400100000000,54,001,Barbour County, WV,Apr-17,7020,6636,384,5.5
CN5400100000000,54,001,Barbour County, WV,May-17,6880,6527,353,5.1
CN5400100000000,54,001,Barbour County, WV,Jun-17,6787,6363,424,6.2
CN5400100000000,54,001,Barbour County, WV,Jul-17,6711,6312,399,5.9
CN5400100000000,54,001,Barbour County, WV,Aug-17,6709,6304,405,6.0
CN5400100000000,54,001,Barbour County, WV,Sep-17,7051,6702,349,4.9
CN5400100000000,54,001,Barbour County, WV,Oct-17,7043,6721,322,4.6
CN5400100000000,54,001,Barbour County, WV,Nov-17,6986,6618,368,5.3
CN5400100000000,54,001,Barbour County, WV,Dec-17,6901,6527,374,5.4
CN5400100000000,54,001,Barbour County, WV,Jan-18,7017,6550,467,6.7
CN5400100000000,54,001,Barbour County, WV,Feb-18,7115,6594,521,7.3
CN5400100000000,54,001,Barbour County, WV,Mar-18,7042,6568,474,6.7
CN5400100000000,54,001,Barbour County, WV,Apr-18(p),7106,6674,432,6.1
CN5153000000000,51,530,Buena Vista city, VA,Mar-17,3480,3321,159,4.6
CN5153000000000,51,530,Buena Vista city, VA,Apr-17,3305,3177,128,3.9
CN5153000000000,51,530,Buena Vista city, VA,May-17,3207,3070,137,4.3
CN5153000000000,51,530,Buena Vista city, VA,Jun-17,3222,3055,167,5.2
CN5153000000000,51,530,Buena Vista city, VA,Jul-17,3280,3107,173,5.3
CN5153000000000,51,530,Buena Vista city, VA,Aug-17,3292,3119,173,5.3
CN5153000000000,51,530,Buena Vista city, VA,Sep-17,3428,3294,134,3.9
CN5153000000000,51,530,Buena Vista city, VA,Oct-17,3295,3175,120,3.6
CN5153000000000,51,530,Buena Vista city, VA,Nov-17,3255,3132,123,3.8
CN5153000000000,51,530,Buena Vista city, VA,Dec-17,3128,3014,114,3.6
CN5153000000000,51,530,Buena Vista city, VA,Jan-18,3267,3135,132,4.0
CN5153000000000,51,530,Buena Vista city, VA,Feb-18,3371,3254,117,3.5
CN5153000000000,51,530,Buena Vista city, VA,Mar-18,3395,3281,114,3.4
CN5153000000000,51,530,Buena Vista city, VA,Apr-18(p),3357,3266,91,2.7
CN2109300000000,21,093,Hardin County, KY,Mar-17,48244,45725,2519,5.2
CN2109300000000,21,093,Hardin County, KY,Apr-17,48593,46360,2233,4.6
CN2109300000000,21,093,Hardin County, KY,May-17,48561,46302,2259,4.7
CN2109300000000,21,093,Hardin County, KY,Jun-17,49453,46919,2534,5.1
CN2109300000000,21,093,Hardin County, KY,Jul-17,49655,47070,2585,5.2
CN2109300000000,21,093,Hardin County, KY,Aug-17,48731,46549,2182,4.5
CN2109300000000,21,093,Hardin County, KY,Sep-17,48439,46453,1986,4.1
CN2109300000000,21,093,Hardin County, KY,Oct-17,47773,45939,1834,3.8
CN2109300000000,21,093,Hardin County, KY,Nov-17,47872,46146,1726,3.6
CN2109300000000,21,093,Hardin County, KY,Dec-17,47553,45877,1676,3.5
CN2109300000000,21,093,Hardin County, KY,Jan-18,47585,45704,1881,4.0
CN2109300000000,21,093,Hardin County, KY,Feb-18,48461,46323,2138,4.4
CN2109300000000,21,093,Hardin County, KY,Mar-18,48796,46770,2026,4.2
CN2109300000000,21,093,Hardin County, KY,Apr-18(p),48771,47019,1752,3.6
CN3008100000000,30,081,Ravalli County, MT,Mar-17,19670,18582,1088,5.5
CN3008100000000,30,081,Ravalli County, MT,Apr-17,19612,18738,874,4.5
CN3008100000000,30,081,Ravalli County, MT,May-17,19834,19033,801,4.0
CN3008100000000,30,081,Ravalli County, MT,Jun-17,20148,19266,882,4.4
CN3008100000000,30,081,Ravalli County, MT,Jul-17,19802,18986,816,4.1
CN3008100000000,30,081,Ravalli County, MT,Aug-17,19954,19153,801,4.0
CN3008100000000,30,081,Ravalli County, MT,Sep-17,19839,19067,772,3.9
CN3008100000000,30,081,Ravalli County, MT,Oct-17,20034,19216,818,4.1
CN3008100000000,30,081,Ravalli County, MT,Nov-17,19896,19014,882,4.4
CN3008100000000,30,081,Ravalli County, MT,Dec-17,19771,18814,957,4.8
CN3008100000000,30,081,Ravalli County, MT,Jan-18,19707,18491,1216,6.2
CN3008100000000,30,081,Ravalli County, MT,Feb-18,19830,18666,1164,5.9
CN3008100000000,30,081,Ravalli County, MT,Mar-18,19963,18942,1021,5.1
CN3008100000000,30,081,Ravalli County, MT,Apr-18(p),19797,19055,742,3.7
CN4008100000000,40,081,Lincoln County, OK,Mar-17,15775,15061,714,4.5
CN4008100000000,40,081,Lincoln County, OK,Apr-17,15734,15090,644,4.1
CN4008100000000,40,081,Lincoln County, OK,May-17,15711,14993,718,4.6
CN4008100000000,40,081,Lincoln County, OK,Jun-17,15900,15140,760,4.8
CN4008100000000,40,081,Lincoln County, OK,Jul-17,15978,15274,704,4.4
CN4008100000000,40,081,Lincoln County, OK,Aug-17,15849,15166,683,4.3
CN4008100000000,40,081,Lincoln County, OK,Sep-17,15994,15346,648,4.1
CN4008100000000,40,081,Lincoln County, OK,Oct-17,16037,15412,625,3.9
CN4008100000000,40,081,Lincoln County, OK,Nov-17,16105,15502,603,3.7
CN4008100000000,40,081,Lincoln County, OK,Dec-17,15961,15335,626,3.9
CN4008100000000,40,081,Lincoln County, OK,Jan-18,15793,15141,652,4.1
CN4008100000000,40,081,Lincoln County, OK,Feb-18,16050,15397,653,4.1
CN4008100000000,40,081,Lincoln County, OK,Mar-18,16130,15480,650,4.0
CN4008100000000,40,081,Lincoln County, OK,Apr-18(p),16058,15427,631,3.9
CN3501300000000,35,013,Dona Ana County, NM,Mar-17,94369,87521,6848,7.3
CN3501300000000,35,013,Dona Ana County, NM,Apr-17,94519,88097,6422,6.8
CN3501300000000,35,013,Dona Ana County, NM,May-17,94059,87820,6239,6.6
CN3501300000000,35,013,Dona Ana County, NM,Jun-17,94054,86926,7128,7.6
CN3501300000000,35,013,Dona Ana County, NM,Jul-17,92488,85577,6911,7.5
CN3501300000000,35,013,Dona Ana County, NM,Aug-17,93567,87274,6293,6.7
CN3501300000000,35,013,Dona Ana County, NM,Sep-17,93241,87218,6023,6.5
CN3501300000000,35,013,Dona Ana County, NM,Oct-17,93446,87702,5744,6.1
CN3501300000000,35,013,Dona Ana County, NM,Nov-17,93835,87927,5908,6.3
CN3501300000000,35,013,Dona Ana County, NM,Dec-17,94214,88285,5929,6.3
CN3501300000000,35,013,Dona Ana County, NM,Jan-18,92856,86458,6398,6.9
CN3501300000000,35,013,Dona Ana County, NM,Feb-18,94076,87729,6347,6.7
CN3501300000000,35,013,Dona Ana County, NM,Mar-18,93667,87684,5983,6.4
CN3501300000000,35,013,Dona Ana County, NM,Apr-18(p),93727,88550,5177,5.5
CN1909100000000,19,091,Humboldt County, IA,Mar-17,5193,5004,189,3.6
CN1909100000000,19,091,Humboldt County, IA,Apr-17,5302,5143,159,3.0
CN1909100000000,19,091,Humboldt County, IA,May-17,5296,5159,137,2.6
CN1909100000000,19,091,Humboldt County, IA,Jun-17,5450,5292,158,2.9
CN1909100000000,19,091,Humboldt County, IA,Jul-17,5375,5219,156,2.9
CN1909100000000,19,091,Humboldt County, IA,Aug-17,5265,5105,160,3.0
CN1909100000000,19,091,Humboldt County, IA,Sep-17,5296,5151,145,2.7
CN1909100000000,19,091,Humboldt County, IA,Oct-17,5289,5171,118,2.2
CN1909100000000,19,091,Humboldt County, IA,Nov-17,5213,5084,129,2.5
CN1909100000000,19,091,Humboldt County, IA,Dec-17,5203,5038,165,3.2
CN1909100000000,19,091,Humboldt County, IA,Jan-18,5178,4990,188,3.6
CN1909100000000,19,091,Humboldt County, IA,Feb-18,5181,4991,190,3.7
CN1909100000000,19,091,Humboldt County, IA,Mar-18,5149,4990,159,3.1
CN1909100000000,19,091,Humboldt County, IA,Apr-18(p),5183,5039,144,2.8
CN2404300000000,24,043,Washington County, MD,Mar-17,76062,72276,3786,5.0
CN2404300000000,24,043,Washington County, MD,Apr-17,75730,72540,3190,4.2
CN2404300000000,24,043,Washington County, MD,May-17,75705,72430,3275,4.3
CN2404300000000,24,043,Washington County, MD,Jun-17,76765,73188,3577,4.7
CN2404300000000,24,043,Washington County, MD,Jul-17,76703,73168,3535,4.6
CN2404300000000,24,043,Washington County, MD,Aug-17,75780,72213,3567,4.7
CN2404300000000,24,043,Washington County, MD,Sep-17,75644,72487,3157,4.2
CN2404300000000,24,043,Washington County, MD,Oct-17,76330,73126,3204,4.2
CN2404300000000,24,043,Washington County, MD,Nov-17,76776,73528,3248,4.2
CN2404300000000,24,043,Washington County, MD,Dec-17,76855,73614,3241,4.2
CN2404300000000,24,043,Washington County, MD,Jan-18,76349,72329,4020,5.3
CN2404300000000,24,043,Washington County, MD,Feb-18,76371,72196,4175,5.5
CN2404300000000,24,043,Washington County, MD,Mar-18,75876,71873,4003,5.3
CN2404300000000,24,043,Washington County, MD,Apr-18(p),75543,72228,3315,4.4
CN4600300000000,46,003,Aurora County, SD,Mar-17,1479,1437,42,2.8
CN4600300000000,46,003,Aurora County, SD,Apr-17,1527,1486,41,2.7
CN4600300000000,46,003,Aurora County, SD,May-17,1578,1537,41,2.6
CN4600300000000,46,003,Aurora County, SD,Jun-17,1609,1570,39,2.4
CN4600300000000,46,003,Aurora County, SD,Jul-17,1572,1532,40,2.5
CN4600300000000,46,003,Aurora County, SD,Aug-17,1519,1472,47,3.1
CN4600300000000,46,003,Aurora County, SD,Sep-17,1502,1459,43,2.9
CN4600300000000,46,003,Aurora County, SD,Oct-17,1482,1438,44,3.0
CN4600300000000,46,003,Aurora County, SD,Nov-17,1484,1430,54,3.6
CN4600300000000,46,003,Aurora County, SD,Dec-17,1516,1458,58,3.8
CN4600300000000,46,003,Aurora County, SD,Jan-18,1511,1451,60,4.0
CN4600300000000,46,003,Aurora County, SD,Feb-18,1517,1462,55,3.6
CN4600300000000,46,003,Aurora County, SD,Mar-18,1540,1489,51,3.3
CN4600300000000,46,003,Aurora County, SD,Apr-18(p),1502,1458,44,2.9
CN2012100000000,20,121,Miami County, KS,Mar-17,16981,16302,679,4.0
CN2012100000000,20,121,Miami County, KS,Apr-17,17006,16414,592,3.5
CN2012100000000,20,121,Miami County, KS,May-17,17008,16405,603,3.5
CN2012100000000,20,121,Miami County, KS,Jun-17,17359,16705,654,3.8
CN2012100000000,20,121,Miami County, KS,Jul-17,17682,16971,711,4.0
CN2012100000000,20,121,Miami County, KS,Aug-17,17340,16659,681,3.9
CN2012100000000,20,121,Miami County, KS,Sep-17,17134,16563,571,3.3
CN2012100000000,20,121,Miami County, KS,Oct-17,17084,16554,530,3.1
CN2012100000000,20,121,Miami County, KS,Nov-17,17198,16670,528,3.1
CN2012100000000,20,121,Miami County, KS,Dec-17,17157,16606,551,3.2
CN2012100000000,20,121,Miami County, KS,Jan-18,17253,16523,730,4.2
CN2012100000000,20,121,Miami County, KS,Feb-18,17246,16507,739,4.3
CN2012100000000,20,121,Miami County, KS,Mar-18,17079,16458,621,3.6
CN2012100000000,20,121,Miami County, KS,Apr-18(p),17186,16618,568,3.3
CN3113300000000,31,133,Pawnee County, NE,Mar-17,1520,1470,50,3.3
CN3113300000000,31,133,Pawnee County, NE,Apr-17,1508,1467,41,2.7
CN3113300000000,31,133,Pawnee County, NE,May-17,1531,1488,43,2.8
CN3113300000000,31,133,Pawnee County, NE,Jun-17,1570,1518,52,3.3
CN3113300000000,31,133,Pawnee County, NE,Jul-17,1500,1448,52,3.5
CN3113300000000,31,133,Pawnee County, NE,Aug-17,1475,1434,41,2.8
CN3113300000000,31,133,Pawnee County, NE,Sep-17,1451,1407,44,3.0
CN3113300000000,31,133,Pawnee County, NE,Oct-17,1452,1414,38,2.6
CN3113300000000,31,133,Pawnee County, NE,Nov-17,1464,1427,37,2.5
CN3113300000000,31,133,Pawnee County, NE,Dec-17,1481,1439,42,2.8
CN3113300000000,31,133,Pawnee County, NE,Jan-18,1499,1464,35,2.3
CN3113300000000,31,133,Pawnee County, NE,Feb-18,1486,1447,39,2.6
CN3113300000000,31,133,Pawnee County, NE,Mar-18,1500,1461,39,2.6
CN3113300000000,31,133,Pawnee County, NE,Apr-18(p),1493,1453,40,2.7
CN2606700000000,26,067,Ionia County, MI,Mar-17,29885,28696,1189,4.0
CN2606700000000,26,067,Ionia County, MI,Apr-17,29812,28847,965,3.2
CN2606700000000,26,067,Ionia County, MI,May-17,29941,28891,1050,3.5
CN2606700000000,26,067,Ionia County, MI,Jun-17,30157,28922,1235,4.1
CN2606700000000,26,067,Ionia County, MI,Jul-17,30023,28484,1539,5.1
CN2606700000000,26,067,Ionia County, MI,Aug-17,29815,28450,1365,4.6
CN2606700000000,26,067,Ionia County, MI,Sep-17,29858,28716,1142,3.8
CN2606700000000,26,067,Ionia County, MI,Oct-17,29863,28842,1021,3.4
CN2606700000000,26,067,Ionia County, MI,Nov-17,29989,28922,1067,3.6
CN2606700000000,26,067,Ionia County, MI,Dec-17,29899,28793,1106,3.7
CN2606700000000,26,067,Ionia County, MI,Jan-18,29926,28466,1460,4.9
CN2606700000000,26,067,Ionia County, MI,Feb-18,30280,28877,1403,4.6
CN2606700000000,26,067,Ionia County, MI,Mar-18,30329,29095,1234,4.1
CN2606700000000,26,067,Ionia County, MI,Apr-18(p),30303,29262,1041,3.4
CN4802700000000,48,027,Bell County, TX,Mar-17,140976,134699,6277,4.5
CN4802700000000,48,027,Bell County, TX,Apr-17,141407,135678,5729,4.1
CN4802700000000,48,027,Bell County, TX,May-17,141560,135788,5772,4.1
CN4802700000000,48,027,Bell County, TX,Jun-17,141219,135040,6179,4.4
CN4802700000000,48,027,Bell County, TX,Jul-17,141539,135325,6214,4.4
CN4802700000000,48,027,Bell County, TX,Aug-17,141150,135066,6084,4.3
CN4802700000000,48,027,Bell County, TX,Sep-17,141839,136251,5588,3.9
CN4802700000000,48,027,Bell County, TX,Oct-17,140859,135621,5238,3.7
CN4802700000000,48,027,Bell County, TX,Nov-17,141495,136078,5417,3.8
CN4802700000000,48,027,Bell County, TX,Dec-17,140794,135647,5147,3.7
CN4802700000000,48,027,Bell County, TX,Jan-18,141348,135482,5866,4.2
CN4802700000000,48,027,Bell County, TX,Feb-18,143306,137357,5949,4.2
CN4802700000000,48,027,Bell County, TX,Mar-18,143458,137508,5950,4.1
CN4802700000000,48,027,Bell County, TX,Apr-18(p),143816,138262,5554,3.9
CN2003100000000,20,031,Coffey County, KS,Mar-17,4147,3923,224,5.4
CN2003100000000,20,031,Coffey County, KS,Apr-17,4190,3985,205,4.9
CN2003100000000,20,031,Coffey County, KS,May-17,4060,3854,206,5.1
CN2003100000000,20,031,Coffey County, KS,Jun-17,4226,3987,239,5.7
CN2003100000000,20,031,Coffey County, KS,Jul-17,4099,3860,239,5.8
CN2003100000000,20,031,Coffey County, KS,Aug-17,3986,3763,223,5.6
CN2003100000000,20,031,Coffey County, KS,Sep-17,4071,3881,190,4.7
CN2003100000000,20,031,Coffey County, KS,Oct-17,4101,3936,165,4.0
CN2003100000000,20,031,Coffey County, KS,Nov-17,4050,3882,168,4.1
CN2003100000000,20,031,Coffey County, KS,Dec-17,4075,3900,175,4.3
CN2003100000000,20,031,Coffey County, KS,Jan-18,4171,3957,214,5.1
CN2003100000000,20,031,Coffey County, KS,Feb-18,4249,4041,208,4.9
CN2003100000000,20,031,Coffey County, KS,Mar-18,4206,4012,194,4.6
CN2003100000000,20,031,Coffey County, KS,Apr-18(p),4052,3880,172,4.2
CN1331100000000,13,311,White County, GA,Mar-17,15639,15005,634,4.1
CN1331100000000,13,311,White County, GA,Apr-17,15648,15067,581,3.7
CN1331100000000,13,311,White County, GA,May-17,15579,15002,577,3.7
CN1331100000000,13,311,White County, GA,Jun-17,15831,15184,647,4.1
CN1331100000000,13,311,White County, GA,Jul-17,16015,15378,637,4.0
CN1331100000000,13,311,White County, GA,Aug-17,15793,15165,628,4.0
CN1331100000000,13,311,White County, GA,Sep-17,16074,15483,591,3.7
CN1331100000000,13,311,White County, GA,Oct-17,15972,15417,555,3.5
CN1331100000000,13,311,White County, GA,Nov-17,15871,15342,529,3.3
CN1331100000000,13,311,White County, GA,Dec-17,15808,15265,543,3.4
CN1331100000000,13,311,White County, GA,Jan-18,16089,15483,606,3.8
CN1331100000000,13,311,White County, GA,Feb-18,16292,15700,592,3.6
CN1331100000000,13,311,White County, GA,Mar-18,16350,15829,521,3.2
CN1331100000000,13,311,White County, GA,Apr-18(p),16371,15926,445,2.7
CN2205500000000,22,055,Lafayette Parish, LA,Mar-17,113112,107182,5930,5.2
CN2205500000000,22,055,Lafayette Parish, LA,Apr-17,113232,107687,5545,4.9
CN2205500000000,22,055,Lafayette Parish, LA,May-17,112846,107249,5597,5.0
CN2205500000000,22,055,Lafayette Parish, LA,Jun-17,114150,107869,6281,5.5
CN2205500000000,22,055,Lafayette Parish, LA,Jul-17,114768,108775,5993,5.2
CN2205500000000,22,055,Lafayette Parish, LA,Aug-17,113558,107644,5914,5.2
CN2205500000000,22,055,Lafayette Parish, LA,Sep-17,113501,108228,5273,4.6
CN2205500000000,22,055,Lafayette Parish, LA,Oct-17,113266,108682,4584,4.0
CN2205500000000,22,055,Lafayette Parish, LA,Nov-17,113200,108723,4477,4.0
CN2205500000000,22,055,Lafayette Parish, LA,Dec-17,112172,107988,4184,3.7
CN2205500000000,22,055,Lafayette Parish, LA,Jan-18,112414,107761,4653,4.1
CN2205500000000,22,055,Lafayette Parish, LA,Feb-18,112988,108714,4274,3.8
CN2205500000000,22,055,Lafayette Parish, LA,Mar-18,113730,109019,4711,4.1
CN2205500000000,22,055,Lafayette Parish, LA,Apr-18(p),113982,109350,4632,4.1
CN3104300000000,31,043,Dakota County, NE,Mar-17,10688,10150,538,5.0
CN3104300000000,31,043,Dakota County, NE,Apr-17,10614,10211,403,3.8
CN3104300000000,31,043,Dakota County, NE,May-17,10611,10252,359,3.4
CN3104300000000,31,043,Dakota County, NE,Jun-17,10739,10295,444,4.1
CN3104300000000,31,043,Dakota County, NE,Jul-17,10742,10276,466,4.3
CN3104300000000,31,043,Dakota County, NE,Aug-17,10551,10182,369,3.5
CN3104300000000,31,043,Dakota County, NE,Sep-17,10560,10239,321,3.0
CN3104300000000,31,043,Dakota County, NE,Oct-17,10595,10290,305,2.9
CN3104300000000,31,043,Dakota County, NE,Nov-17,10615,10290,325,3.1
CN3104300000000,31,043,Dakota County, NE,Dec-17,10584,10199,385,3.6
CN3104300000000,31,043,Dakota County, NE,Jan-18,10603,10112,491,4.6
CN3104300000000,31,043,Dakota County, NE,Feb-18,10723,10257,466,4.3
CN3104300000000,31,043,Dakota County, NE,Mar-18,10711,10275,436,4.1
CN3104300000000,31,043,Dakota County, NE,Apr-18(p),10696,10324,372,3.5
CN5502700000000,55,027,Dodge County, WI,Mar-17,47925,46284,1641,3.4
CN5502700000000,55,027,Dodge County, WI,Apr-17,48161,46820,1341,2.8
CN5502700000000,55,027,Dodge County, WI,May-17,48186,46892,1294,2.7
CN5502700000000,55,027,Dodge County, WI,Jun-17,49815,48225,1590,3.2
CN5502700000000,55,027,Dodge County, WI,Jul-17,49534,48043,1491,3.0
CN5502700000000,55,027,Dodge County, WI,Aug-17,49105,47710,1395,2.8
CN5502700000000,55,027,Dodge County, WI,Sep-17,48917,47719,1198,2.4
CN5502700000000,55,027,Dodge County, WI,Oct-17,48619,47484,1135,2.3
CN5502700000000,55,027,Dodge County, WI,Nov-17,48613,47448,1165,2.4
CN5502700000000,55,027,Dodge County, WI,Dec-17,48480,47342,1138,2.3
CN5502700000000,55,027,Dodge County, WI,Jan-18,48700,47315,1385,2.8
CN5502700000000,55,027,Dodge County, WI,Feb-18,48796,47241,1555,3.2
CN5502700000000,55,027,Dodge County, WI,Mar-18,49069,47660,1409,2.9
CN5502700000000,55,027,Dodge County, WI,Apr-18(p),49098,47966,1132,2.3
CN4002900000000,40,029,Coal County, OK,Mar-17,2340,2208,132,5.6
CN4002900000000,40,029,Coal County, OK,Apr-17,2290,2175,115,5.0
CN4002900000000,40,029,Coal County, OK,May-17,2318,2193,125,5.4
CN4002900000000,40,029,Coal County, OK,Jun-17,2240,2104,136,6.1
CN4002900000000,40,029,Coal County, OK,Jul-17,2087,1956,131,6.3
CN4002900000000,40,029,Coal County, OK,Aug-17,2186,2069,117,5.4
CN4002900000000,40,029,Coal County, OK,Sep-17,2272,2162,110,4.8
CN4002900000000,40,029,Coal County, OK,Oct-17,2383,2271,112,4.7
CN4002900000000,40,029,Coal County, OK,Nov-17,2377,2265,112,4.7
CN4002900000000,40,029,Coal County, OK,Dec-17,2350,2244,106,4.5
CN4002900000000,40,029,Coal County, OK,Jan-18,2338,2227,111,4.7
CN4002900000000,40,029,Coal County, OK,Feb-18,2275,2168,107,4.7
CN4002900000000,40,029,Coal County, OK,Mar-18,2272,2166,106,4.7
CN4002900000000,40,029,Coal County, OK,Apr-18(p),2232,2131,101,4.5
CN5511700000000,55,117,Sheboygan County, WI,Mar-17,61802,59985,1817,2.9
CN5511700000000,55,117,Sheboygan County, WI,Apr-17,62242,60605,1637,2.6
CN5511700000000,55,117,Sheboygan County, WI,May-17,62693,61006,1687,2.7
CN5511700000000,55,117,Sheboygan County, WI,Jun-17,64731,62680,2051,3.2
CN5511700000000,55,117,Sheboygan County, WI,Jul-17,64941,63067,1874,2.9
CN5511700000000,55,117,Sheboygan County, WI,Aug-17,64439,62682,1757,2.7
CN5511700000000,55,117,Sheboygan County, WI,Sep-17,63760,62137,1623,2.5
CN5511700000000,55,117,Sheboygan County, WI,Oct-17,63092,61549,1543,2.4
CN5511700000000,55,117,Sheboygan County, WI,Nov-17,62923,61417,1506,2.4
CN5511700000000,55,117,Sheboygan County, WI,Dec-17,62728,61317,1411,2.2
CN5511700000000,55,117,Sheboygan County, WI,Jan-18,62854,61279,1575,2.5
CN5511700000000,55,117,Sheboygan County, WI,Feb-18,63313,61614,1699,2.7
CN5511700000000,55,117,Sheboygan County, WI,Mar-18,63562,61920,1642,2.6
CN5511700000000,55,117,Sheboygan County, WI,Apr-18(p),63133,61751,1382,2.2
CN5179000000000,51,790,Staunton city, VA,Mar-17,11918,11462,456,3.8
CN5179000000000,51,790,Staunton city, VA,Apr-17,11926,11540,386,3.2
CN5179000000000,51,790,Staunton city, VA,May-17,11888,11455,433,3.6
CN5179000000000,51,790,Staunton city, VA,Jun-17,11891,11430,461,3.9
CN5179000000000,51,790,Staunton city, VA,Jul-17,11898,11448,450,3.8
CN5179000000000,51,790,Staunton city, VA,Aug-17,11757,11314,443,3.8
CN5179000000000,51,790,Staunton city, VA,Sep-17,11875,11459,416,3.5
CN5179000000000,51,790,Staunton city, VA,Oct-17,11842,11437,405,3.4
CN5179000000000,51,790,Staunton city, VA,Nov-17,11823,11432,391,3.3
CN5179000000000,51,790,Staunton city, VA,Dec-17,11772,11391,381,3.2
CN5179000000000,51,790,Staunton city, VA,Jan-18,11807,11372,435,3.7
CN5179000000000,51,790,Staunton city, VA,Feb-18,11979,11593,386,3.2
CN5179000000000,51,790,Staunton city, VA,Mar-18,12055,11675,380,3.2
CN5179000000000,51,790,Staunton city, VA,Apr-18(p),12056,11732,324,2.7
CN5406500000000,54,065,Morgan County, WV,Mar-17,7569,7238,331,4.4
CN5406500000000,54,065,Morgan County, WV,Apr-17,7702,7436,266,3.5
CN5406500000000,54,065,Morgan County, WV,May-17,7724,7463,261,3.4
CN5406500000000,54,065,Morgan County, WV,Jun-17,7949,7626,323,4.1
CN5406500000000,54,065,Morgan County, WV,Jul-17,7853,7543,310,3.9
CN5406500000000,54,065,Morgan County, WV,Aug-17,7823,7482,341,4.4
CN5406500000000,54,065,Morgan County, WV,Sep-17,7732,7447,285,3.7
CN5406500000000,54,065,Morgan County, WV,Oct-17,7768,7488,280,3.6
CN5406500000000,54,065,Morgan County, WV,Nov-17,7738,7453,285,3.7
CN5406500000000,54,065,Morgan County, WV,Dec-17,7567,7286,281,3.7
CN5406500000000,54,065,Morgan County, WV,Jan-18,7654,7332,322,4.2
CN5406500000000,54,065,Morgan County, WV,Feb-18,7799,7408,391,5.0
CN5406500000000,54,065,Morgan County, WV,Mar-18,7689,7327,362,4.7
CN5406500000000,54,065,Morgan County, WV,Apr-18(p),7800,7456,344,4.4
CN4815500000000,48,155,Foard County, TX,Mar-17,586,564,22,3.8
CN4815500000000,48,155,Foard County, TX,Apr-17,592,572,20,3.4
CN4815500000000,48,155,Foard County, TX,May-17,608,585,23,3.8
CN4815500000000,48,155,Foard County, TX,Jun-17,596,577,19,3.2
CN4815500000000,48,155,Foard County, TX,Jul-17,607,587,20,3.3
CN4815500000000,48,155,Foard County, TX,Aug-17,610,591,19,3.1
CN4815500000000,48,155,Foard County, TX,Sep-17,609,592,17,2.8
CN4815500000000,48,155,Foard County, TX,Oct-17,614,597,17,2.8
CN4815500000000,48,155,Foard County, TX,Nov-17,607,591,16,2.6
CN4815500000000,48,155,Foard County, TX,Dec-17,596,581,15,2.5
CN4815500000000,48,155,Foard County, TX,Jan-18,599,582,17,2.8
CN4815500000000,48,155,Foard County, TX,Feb-18,611,592,19,3.1
CN4815500000000,48,155,Foard County, TX,Mar-18,626,609,17,2.7
CN4815500000000,48,155,Foard County, TX,Apr-18(p),616,600,16,2.6
CN3703700000000,37,037,Chatham County, NC,Mar-17,35132,33786,1346,3.8
CN3703700000000,37,037,Chatham County, NC,Apr-17,35042,33835,1207,3.4
CN3703700000000,37,037,Chatham County, NC,May-17,35103,33817,1286,3.7
CN3703700000000,37,037,Chatham County, NC,Jun-17,35153,33786,1367,3.9
CN3703700000000,37,037,Chatham County, NC,Jul-17,35779,34319,1460,4.1
CN3703700000000,37,037,Chatham County, NC,Aug-17,35211,33741,1470,4.2
CN3703700000000,37,037,Chatham County, NC,Sep-17,35590,34294,1296,3.6
CN3703700000000,37,037,Chatham County, NC,Oct-17,35340,34049,1291,3.7
CN3703700000000,37,037,Chatham County, NC,Nov-17,35297,33954,1343,3.8
CN3703700000000,37,037,Chatham County, NC,Dec-17,34911,33612,1299,3.7
CN3703700000000,37,037,Chatham County, NC,Jan-18,35007,33621,1386,4.0
CN3703700000000,37,037,Chatham County, NC,Feb-18,35676,34281,1395,3.9
CN3703700000000,37,037,Chatham County, NC,Mar-18,35657,34349,1308,3.7
CN3703700000000,37,037,Chatham County, NC,Apr-18(p),35497,34382,1115,3.1
CN3116900000000,31,169,Thayer County, NE,Mar-17,2823,2763,60,2.1
CN3116900000000,31,169,Thayer County, NE,Apr-17,2877,2818,59,2.1
CN3116900000000,31,169,Thayer County, NE,May-17,2907,2845,62,2.1
CN3116900000000,31,169,Thayer County, NE,Jun-17,3002,2937,65,2.2
CN3116900000000,31,169,Thayer County, NE,Jul-17,2963,2895,68,2.3
CN3116900000000,31,169,Thayer County, NE,Aug-17,2868,2803,65,2.3
CN3116900000000,31,169,Thayer County, NE,Sep-17,2763,2699,64,2.3
CN3116900000000,31,169,Thayer County, NE,Oct-17,2799,2742,57,2.0
CN3116900000000,31,169,Thayer County, NE,Nov-17,2804,2745,59,2.1
CN3116900000000,31,169,Thayer County, NE,Dec-17,2823,2751,72,2.6
CN3116900000000,31,169,Thayer County, NE,Jan-18,2848,2779,69,2.4
CN3116900000000,31,169,Thayer County, NE,Feb-18,2818,2744,74,2.6
CN3116900000000,31,169,Thayer County, NE,Mar-18,2850,2783,67,2.4
CN3116900000000,31,169,Thayer County, NE,Apr-18(p),2855,2785,70,2.5
CN3913100000000,39,131,Pike County, OH,Mar-17,11052,10204,848,7.7
CN3913100000000,39,131,Pike County, OH,Apr-17,10859,10166,693,6.4
CN3913100000000,39,131,Pike County, OH,May-17,10782,10141,641,5.9
CN3913100000000,39,131,Pike County, OH,Jun-17,10967,10211,756,6.9
CN3913100000000,39,131,Pike County, OH,Jul-17,10941,10166,775,7.1
CN3913100000000,39,131,Pike County, OH,Aug-17,11005,10270,735,6.7
CN3913100000000,39,131,Pike County, OH,Sep-17,10889,10241,648,6.0
CN3913100000000,39,131,Pike County, OH,Oct-17,10786,10182,604,5.6
CN3913100000000,39,131,Pike County, OH,Nov-17,10746,10095,651,6.1
CN3913100000000,39,131,Pike County, OH,Dec-17,10674,9944,730,6.8
CN3913100000000,39,131,Pike County, OH,Jan-18,10605,9759,846,8.0
CN3913100000000,39,131,Pike County, OH,Feb-18,10767,9977,790,7.3
CN3913100000000,39,131,Pike County, OH,Mar-18,10940,10213,727,6.6
CN3913100000000,39,131,Pike County, OH,Apr-18(p),10861,10210,651,6.0
CN4210300000000,42,103,Pike County, PA,Mar-17,24941,23343,1598,6.4
CN4210300000000,42,103,Pike County, PA,Apr-17,24790,23413,1377,5.6
CN4210300000000,42,103,Pike County, PA,May-17,24864,23420,1444,5.8
CN4210300000000,42,103,Pike County, PA,Jun-17,25269,23868,1401,5.5
CN4210300000000,42,103,Pike County, PA,Jul-17,25230,23711,1519,6.0
CN4210300000000,42,103,Pike County, PA,Aug-17,24897,23368,1529,6.1
CN4210300000000,42,103,Pike County, PA,Sep-17,24650,23323,1327,5.4
CN4210300000000,42,103,Pike County, PA,Oct-17,24505,23208,1297,5.3
CN4210300000000,42,103,Pike County, PA,Nov-17,24537,23190,1347,5.5
CN4210300000000,42,103,Pike County, PA,Dec-17,24550,23173,1377,5.6
CN4210300000000,42,103,Pike County, PA,Jan-18,24611,22952,1659,6.7
CN4210300000000,42,103,Pike County, PA,Feb-18,24766,23114,1652,6.7
CN4210300000000,42,103,Pike County, PA,Mar-18,24417,22886,1531,6.3
CN4210300000000,42,103,Pike County, PA,Apr-18(p),24223,22945,1278,5.3
CN2500500000000,25,005,Bristol County, MA,Mar-17,294390,277792,16598,5.6
CN2500500000000,25,005,Bristol County, MA,Apr-17,291719,278401,13318,4.6
CN2500500000000,25,005,Bristol County, MA,May-17,291388,278232,13156,4.5
CN2500500000000,25,005,Bristol County, MA,Jun-17,294812,280607,14205,4.8
CN2500500000000,25,005,Bristol County, MA,Jul-17,294756,280300,14456,4.9
CN2500500000000,25,005,Bristol County, MA,Aug-17,293381,280153,13228,4.5
CN2500500000000,25,005,Bristol County, MA,Sep-17,290422,278021,12401,4.3
CN2500500000000,25,005,Bristol County, MA,Oct-17,289808,278941,10867,3.7
CN2500500000000,25,005,Bristol County, MA,Nov-17,291077,280156,10921,3.8
CN2500500000000,25,005,Bristol County, MA,Dec-17,290220,278825,11395,3.9
CN2500500000000,25,005,Bristol County, MA,Jan-18,294378,277743,16635,5.7
CN2500500000000,25,005,Bristol County, MA,Feb-18,297971,281284,16687,5.6
CN2500500000000,25,005,Bristol County, MA,Mar-18,299922,284331,15591,5.2
CN2500500000000,25,005,Bristol County, MA,Apr-18(p),299787,287094,12693,4.2
CN1304500000000,13,045,Carroll County, GA,Mar-17,54813,51951,2862,5.2
CN1304500000000,13,045,Carroll County, GA,Apr-17,54777,52102,2675,4.9
CN1304500000000,13,045,Carroll County, GA,May-17,54882,52209,2673,4.9
CN1304500000000,13,045,Carroll County, GA,Jun-17,55164,52195,2969,5.4
CN1304500000000,13,045,Carroll County, GA,Jul-17,55462,52503,2959,5.3
CN1304500000000,13,045,Carroll County, GA,Aug-17,55071,52227,2844,5.2
CN1304500000000,13,045,Carroll County, GA,Sep-17,55500,52914,2586,4.7
CN1304500000000,13,045,Carroll County, GA,Oct-17,55217,52743,2474,4.5
CN1304500000000,13,045,Carroll County, GA,Nov-17,55315,52903,2412,4.4
CN1304500000000,13,045,Carroll County, GA,Dec-17,55319,52895,2424,4.4
CN1304500000000,13,045,Carroll County, GA,Jan-18,55423,52858,2565,4.6
CN1304500000000,13,045,Carroll County, GA,Feb-18,56179,53596,2583,4.6
CN1304500000000,13,045,Carroll County, GA,Mar-18,56104,53763,2341,4.2
CN1304500000000,13,045,Carroll County, GA,Apr-18(p),55784,53677,2107,3.8
CN2702900000000,27,029,Clearwater County, MN,Mar-17,4729,4122,607,12.8
CN2702900000000,27,029,Clearwater County, MN,Apr-17,4624,4178,446,9.6
CN2702900000000,27,029,Clearwater County, MN,May-17,4551,4244,307,6.7
CN2702900000000,27,029,Clearwater County, MN,Jun-17,4594,4305,289,6.3
CN2702900000000,27,029,Clearwater County, MN,Jul-17,4542,4257,285,6.3
CN2702900000000,27,029,Clearwater County, MN,Aug-17,4481,4205,276,6.2
CN2702900000000,27,029,Clearwater County, MN,Sep-17,4485,4262,223,5.0
CN2702900000000,27,029,Clearwater County, MN,Oct-17,4536,4326,210,4.6
CN2702900000000,27,029,Clearwater County, MN,Nov-17,4673,4302,371,7.9
CN2702900000000,27,029,Clearwater County, MN,Dec-17,4753,4288,465,9.8
CN2702900000000,27,029,Clearwater County, MN,Jan-18,4946,4255,691,14.0
CN2702900000000,27,029,Clearwater County, MN,Feb-18,4864,4256,608,12.5
CN2702900000000,27,029,Clearwater County, MN,Mar-18,4868,4246,622,12.8
CN2702900000000,27,029,Clearwater County, MN,Apr-18(p),4767,4296,471,9.9
CN0401200000000,04,012,La Paz County, AZ,Mar-17,8971,8495,476,5.3
CN0401200000000,04,012,La Paz County, AZ,Apr-17,8670,8221,449,5.2
CN0401200000000,04,012,La Paz County, AZ,May-17,8672,8234,438,5.1
CN0401200000000,04,012,La Paz County, AZ,Jun-17,8554,8101,453,5.3
CN0401200000000,04,012,La Paz County, AZ,Jul-17,8297,7850,447,5.4
CN0401200000000,04,012,La Paz County, AZ,Aug-17,8308,7829,479,5.8
CN0401200000000,04,012,La Paz County, AZ,Sep-17,8655,8184,471,5.4
CN0401200000000,04,012,La Paz County, AZ,Oct-17,8975,8532,443,4.9
CN0401200000000,04,012,La Paz County, AZ,Nov-17,8881,8427,454,5.1
CN0401200000000,04,012,La Paz County, AZ,Dec-17,9144,8651,493,5.4
CN0401200000000,04,012,La Paz County, AZ,Jan-18,8765,8205,560,6.4
CN0401200000000,04,012,La Paz County, AZ,Feb-18,8661,8088,573,6.6
CN0401200000000,04,012,La Paz County, AZ,Mar-18,9085,8517,568,6.3
CN0401200000000,04,012,La Paz County, AZ,Apr-18(p),8517,7991,526,6.2
CN1303100000000,13,031,Bulloch County, GA,Mar-17,36872,35036,1836,5.0
CN1303100000000,13,031,Bulloch County, GA,Apr-17,37372,35595,1777,4.8
CN1303100000000,13,031,Bulloch County, GA,May-17,37306,35525,1781,4.8
CN1303100000000,13,031,Bulloch County, GA,Jun-17,37008,34887,2121,5.7
CN1303100000000,13,031,Bulloch County, GA,Jul-17,36942,34842,2100,5.7
CN1303100000000,13,031,Bulloch County, GA,Aug-17,37209,35295,1914,5.1
CN1303100000000,13,031,Bulloch County, GA,Sep-17,37729,35921,1808,4.8
CN1303100000000,13,031,Bulloch County, GA,Oct-17,37478,35792,1686,4.5
CN1303100000000,13,031,Bulloch County, GA,Nov-17,37604,35935,1669,4.4
CN1303100000000,13,031,Bulloch County, GA,Dec-17,37333,35707,1626,4.4
CN1303100000000,13,031,Bulloch County, GA,Jan-18,37621,35937,1684,4.5
CN1303100000000,13,031,Bulloch County, GA,Feb-18,38324,36567,1757,4.6
CN1303100000000,13,031,Bulloch County, GA,Mar-18,38497,36807,1690,4.4
CN1303100000000,13,031,Bulloch County, GA,Apr-18(p),38562,37104,1458,3.8
CN1601700000000,16,017,Bonner County, ID,Mar-17,18811,17613,1198,6.4
CN1601700000000,16,017,Bonner County, ID,Apr-17,18603,17602,1001,5.4
CN1601700000000,16,017,Bonner County, ID,May-17,18758,18008,750,4.0
CN1601700000000,16,017,Bonner County, ID,Jun-17,19538,18832,706,3.6
CN1601700000000,16,017,Bonner County, ID,Jul-17,19898,19190,708,3.6
CN1601700000000,16,017,Bonner County, ID,Aug-17,19894,19179,715,3.6
CN1601700000000,16,017,Bonner County, ID,Sep-17,19134,18459,675,3.5
CN1601700000000,16,017,Bonner County, ID,Oct-17,18834,18136,698,3.7
CN1601700000000,16,017,Bonner County, ID,Nov-17,19104,18300,804,4.2
CN1601700000000,16,017,Bonner County, ID,Dec-17,19241,18422,819,4.3
CN1601700000000,16,017,Bonner County, ID,Jan-18,19310,18227,1083,5.6
CN1601700000000,16,017,Bonner County, ID,Feb-18,19421,18384,1037,5.3
CN1601700000000,16,017,Bonner County, ID,Mar-18,19317,18319,998,5.2
CN1601700000000,16,017,Bonner County, ID,Apr-18(p),19032,18179,853,4.5
CN2019900000000,20,199,Wallace County, KS,Mar-17,842,821,21,2.5
CN2019900000000,20,199,Wallace County, KS,Apr-17,840,819,21,2.5
CN2019900000000,20,199,Wallace County, KS,May-17,846,824,22,2.6
CN2019900000000,20,199,Wallace County, KS,Jun-17,868,845,23,2.6
CN2019900000000,20,199,Wallace County, KS,Jul-17,846,819,27,3.2
CN2019900000000,20,199,Wallace County, KS,Aug-17,851,828,23,2.7
CN2019900000000,20,199,Wallace County, KS,Sep-17,861,841,20,2.3
CN2019900000000,20,199,Wallace County, KS,Oct-17,875,856,19,2.2
CN2019900000000,20,199,Wallace County, KS,Nov-17,854,834,20,2.3
CN2019900000000,20,199,Wallace County, KS,Dec-17,829,811,18,2.2
CN2019900000000,20,199,Wallace County, KS,Jan-18,813,794,19,2.3
CN2019900000000,20,199,Wallace County, KS,Feb-18,813,795,18,2.2
CN2019900000000,20,199,Wallace County, KS,Mar-18,833,814,19,2.3
CN2019900000000,20,199,Wallace County, KS,Apr-18(p),763,744,19,2.5
CN2209700000000,22,097,St. Landry Parish, LA,Mar-17,32193,29965,2228,6.9
CN2209700000000,22,097,St. Landry Parish, LA,Apr-17,32146,30052,2094,6.5
CN2209700000000,22,097,St. Landry Parish, LA,May-17,32057,29901,2156,6.7
CN2209700000000,22,097,St. Landry Parish, LA,Jun-17,33110,30541,2569,7.8
CN2209700000000,22,097,St. Landry Parish, LA,Jul-17,32824,30422,2402,7.3
CN2209700000000,22,097,St. Landry Parish, LA,Aug-17,32360,30016,2344,7.2
CN2209700000000,22,097,St. Landry Parish, LA,Sep-17,32047,30005,2042,6.4
CN2209700000000,22,097,St. Landry Parish, LA,Oct-17,31834,30077,1757,5.5
CN2209700000000,22,097,St. Landry Parish, LA,Nov-17,31809,30081,1728,5.4
CN2209700000000,22,097,St. Landry Parish, LA,Dec-17,31659,29958,1701,5.4
CN2209700000000,22,097,St. Landry Parish, LA,Jan-18,31775,29913,1862,5.9
CN2209700000000,22,097,St. Landry Parish, LA,Feb-18,31684,30005,1679,5.3
CN2209700000000,22,097,St. Landry Parish, LA,Mar-18,32009,30174,1835,5.7
CN2209700000000,22,097,St. Landry Parish, LA,Apr-18(p),31965,30187,1778,5.6
CN5108500000000,51,085,Hanover County, VA,Mar-17,58084,56083,2001,3.4
CN5108500000000,51,085,Hanover County, VA,Apr-17,58123,56328,1795,3.1
CN5108500000000,51,085,Hanover County, VA,May-17,58269,56351,1918,3.3
CN5108500000000,51,085,Hanover County, VA,Jun-17,58640,56611,2029,3.5
CN5108500000000,51,085,Hanover County, VA,Jul-17,59015,56993,2022,3.4
CN5108500000000,51,085,Hanover County, VA,Aug-17,58386,56337,2049,3.5
CN5108500000000,51,085,Hanover County, VA,Sep-17,58567,56647,1920,3.3
CN5108500000000,51,085,Hanover County, VA,Oct-17,58229,56426,1803,3.1
CN5108500000000,51,085,Hanover County, VA,Nov-17,57787,55979,1808,3.1
CN5108500000000,51,085,Hanover County, VA,Dec-17,57548,55832,1716,3.0
CN5108500000000,51,085,Hanover County, VA,Jan-18,57544,55701,1843,3.2
CN5108500000000,51,085,Hanover County, VA,Feb-18,58164,56516,1648,2.8
CN5108500000000,51,085,Hanover County, VA,Mar-18,58522,56838,1684,2.9
CN5108500000000,51,085,Hanover County, VA,Apr-18(p),58616,57182,1434,2.4
CN2206900000000,22,069,Natchitoches Parish, LA,Mar-17,16787,15794,993,5.9
CN2206900000000,22,069,Natchitoches Parish, LA,Apr-17,16729,15797,932,5.6
CN2206900000000,22,069,Natchitoches Parish, LA,May-17,16838,15873,965,5.7
CN2206900000000,22,069,Natchitoches Parish, LA,Jun-17,16454,15275,1179,7.2
CN2206900000000,22,069,Natchitoches Parish, LA,Jul-17,16077,14982,1095,6.8
CN2206900000000,22,069,Natchitoches Parish, LA,Aug-17,15738,14641,1097,7.0
CN2206900000000,22,069,Natchitoches Parish, LA,Sep-17,16480,15505,975,5.9
CN2206900000000,22,069,Natchitoches Parish, LA,Oct-17,16595,15775,820,4.9
CN2206900000000,22,069,Natchitoches Parish, LA,Nov-17,16575,15759,816,4.9
CN2206900000000,22,069,Natchitoches Parish, LA,Dec-17,16558,15799,759,4.6
CN2206900000000,22,069,Natchitoches Parish, LA,Jan-18,16050,15144,906,5.6
CN2206900000000,22,069,Natchitoches Parish, LA,Feb-18,16411,15651,760,4.6
CN2206900000000,22,069,Natchitoches Parish, LA,Mar-18,16527,15713,814,4.9
CN2206900000000,22,069,Natchitoches Parish, LA,Apr-18(p),16498,15665,833,5.0
CN4843500000000,48,435,Sutton County, TX,Mar-17,1522,1430,92,6.0
CN4843500000000,48,435,Sutton County, TX,Apr-17,1515,1434,81,5.3
CN4843500000000,48,435,Sutton County, TX,May-17,1522,1448,74,4.9
CN4843500000000,48,435,Sutton County, TX,Jun-17,1527,1443,84,5.5
CN4843500000000,48,435,Sutton County, TX,Jul-17,1553,1479,74,4.8
CN4843500000000,48,435,Sutton County, TX,Aug-17,1536,1469,67,4.4
CN4843500000000,48,435,Sutton County, TX,Sep-17,1528,1466,62,4.1
CN4843500000000,48,435,Sutton County, TX,Oct-17,1497,1438,59,3.9
CN4843500000000,48,435,Sutton County, TX,Nov-17,1499,1436,63,4.2
CN4843500000000,48,435,Sutton County, TX,Dec-17,1473,1412,61,4.1
CN4843500000000,48,435,Sutton County, TX,Jan-18,1467,1401,66,4.5
CN4843500000000,48,435,Sutton County, TX,Feb-18,1470,1404,66,4.5
CN4843500000000,48,435,Sutton County, TX,Mar-18,1482,1420,62,4.2
CN4843500000000,48,435,Sutton County, TX,Apr-18(p),1519,1462,57,3.8
CN2801300000000,28,013,Calhoun County, MS,Mar-17,6120,5861,259,4.2
CN2801300000000,28,013,Calhoun County, MS,Apr-17,6169,5921,248,4.0
CN2801300000000,28,013,Calhoun County, MS,May-17,6216,5915,301,4.8
CN2801300000000,28,013,Calhoun County, MS,Jun-17,6253,5925,328,5.2
CN2801300000000,28,013,Calhoun County, MS,Jul-17,5976,5673,303,5.1
CN2801300000000,28,013,Calhoun County, MS,Aug-17,6181,5915,266,4.3
CN2801300000000,28,013,Calhoun County, MS,Sep-17,6362,6111,251,3.9
CN2801300000000,28,013,Calhoun County, MS,Oct-17,6307,6078,229,3.6
CN2801300000000,28,013,Calhoun County, MS,Nov-17,6149,5931,218,3.5
CN2801300000000,28,013,Calhoun County, MS,Dec-17,6034,5810,224,3.7
CN2801300000000,28,013,Calhoun County, MS,Jan-18,5824,5590,234,4.0
CN2801300000000,28,013,Calhoun County, MS,Feb-18,5898,5663,235,4.0
CN2801300000000,28,013,Calhoun County, MS,Mar-18,6022,5795,227,3.8
CN2801300000000,28,013,Calhoun County, MS,Apr-18(p),6104,5868,236,3.9
CN2004500000000,20,045,Douglas County, KS,Mar-17,65924,63865,2059,3.1
CN2004500000000,20,045,Douglas County, KS,Apr-17,66434,64432,2002,3.0
CN2004500000000,20,045,Douglas County, KS,May-17,65356,63279,2077,3.2
CN2004500000000,20,045,Douglas County, KS,Jun-17,63813,61510,2303,3.6
CN2004500000000,20,045,Douglas County, KS,Jul-17,63476,61040,2436,3.8
CN2004500000000,20,045,Douglas County, KS,Aug-17,62776,60498,2278,3.6
CN2004500000000,20,045,Douglas County, KS,Sep-17,65838,63962,1876,2.8
CN2004500000000,20,045,Douglas County, KS,Oct-17,66051,64373,1678,2.5
CN2004500000000,20,045,Douglas County, KS,Nov-17,66575,64732,1843,2.8
CN2004500000000,20,045,Douglas County, KS,Dec-17,65592,63908,1684,2.6
CN2004500000000,20,045,Douglas County, KS,Jan-18,63657,61753,1904,3.0
CN2004500000000,20,045,Douglas County, KS,Feb-18,66195,64054,2141,3.2
CN2004500000000,20,045,Douglas County, KS,Mar-18,65831,63796,2035,3.1
CN2004500000000,20,045,Douglas County, KS,Apr-18(p),66498,64563,1935,2.9
CN1323500000000,13,235,Pulaski County, GA,Mar-17,4153,3921,232,5.6
CN1323500000000,13,235,Pulaski County, GA,Apr-17,4151,3928,223,5.4
CN1323500000000,13,235,Pulaski County, GA,May-17,4150,3933,217,5.2
CN1323500000000,13,235,Pulaski County, GA,Jun-17,4156,3930,226,5.4
CN1323500000000,13,235,Pulaski County, GA,Jul-17,4149,3932,217,5.2
CN1323500000000,13,235,Pulaski County, GA,Aug-17,4143,3925,218,5.3
CN1323500000000,13,235,Pulaski County, GA,Sep-17,4149,3951,198,4.8
CN1323500000000,13,235,Pulaski County, GA,Oct-17,4164,3938,226,5.4
CN1323500000000,13,235,Pulaski County, GA,Nov-17,4133,3950,183,4.4
CN1323500000000,13,235,Pulaski County, GA,Dec-17,4136,3958,178,4.3
CN1323500000000,13,235,Pulaski County, GA,Jan-18,4208,4004,204,4.8
CN1323500000000,13,235,Pulaski County, GA,Feb-18,4180,3990,190,4.5
CN1323500000000,13,235,Pulaski County, GA,Mar-18,4178,4008,170,4.1
CN1323500000000,13,235,Pulaski County, GA,Apr-18(p),4163,4013,150,3.6
CN4819700000000,48,197,Hardeman County, TX,Mar-17,1678,1610,68,4.1
CN4819700000000,48,197,Hardeman County, TX,Apr-17,1671,1611,60,3.6
CN4819700000000,48,197,Hardeman County, TX,May-17,1693,1633,60,3.5
CN4819700000000,48,197,Hardeman County, TX,Jun-17,1668,1604,64,3.8
CN4819700000000,48,197,Hardeman County, TX,Jul-17,1657,1591,66,4.0
CN4819700000000,48,197,Hardeman County, TX,Aug-17,1653,1584,69,4.2
CN4819700000000,48,197,Hardeman County, TX,Sep-17,1649,1585,64,3.9
CN4819700000000,48,197,Hardeman County, TX,Oct-17,1638,1579,59,3.6
CN4819700000000,48,197,Hardeman County, TX,Nov-17,1617,1556,61,3.8
CN4819700000000,48,197,Hardeman County, TX,Dec-17,1633,1573,60,3.7
CN4819700000000,48,197,Hardeman County, TX,Jan-18,1640,1574,66,4.0
CN4819700000000,48,197,Hardeman County, TX,Feb-18,1668,1597,71,4.3
CN4819700000000,48,197,Hardeman County, TX,Mar-18,1700,1628,72,4.2
CN4819700000000,48,197,Hardeman County, TX,Apr-18(p),1657,1596,61,3.7
CN4203900000000,42,039,Crawford County, PA,Mar-17,39682,37353,2329,5.9
CN4203900000000,42,039,Crawford County, PA,Apr-17,39771,37771,2000,5.0
CN4203900000000,42,039,Crawford County, PA,May-17,39890,37815,2075,5.2
CN4203900000000,42,039,Crawford County, PA,Jun-17,40228,37965,2263,5.6
CN4203900000000,42,039,Crawford County, PA,Jul-17,40080,37739,2341,5.8
CN4203900000000,42,039,Crawford County, PA,Aug-17,39341,37009,2332,5.9
CN4203900000000,42,039,Crawford County, PA,Sep-17,38921,37125,1796,4.6
CN4203900000000,42,039,Crawford County, PA,Oct-17,38745,36991,1754,4.5
CN4203900000000,42,039,Crawford County, PA,Nov-17,38547,36658,1889,4.9
CN4203900000000,42,039,Crawford County, PA,Dec-17,38623,36660,1963,5.1
CN4203900000000,42,039,Crawford County, PA,Jan-18,38564,36188,2376,6.2
CN4203900000000,42,039,Crawford County, PA,Feb-18,38653,36309,2344,6.1
CN4203900000000,42,039,Crawford County, PA,Mar-18,38216,36194,2022,5.3
CN4203900000000,42,039,Crawford County, PA,Apr-18(p),38299,36546,1753,4.6
CN3809300000000,38,093,Stutsman County, ND,Mar-17,11146,10804,342,3.1
CN3809300000000,38,093,Stutsman County, ND,Apr-17,11072,10795,277,2.5
CN3809300000000,38,093,Stutsman County, ND,May-17,11111,10887,224,2.0
CN3809300000000,38,093,Stutsman County, ND,Jun-17,11374,11089,285,2.5
CN3809300000000,38,093,Stutsman County, ND,Jul-17,11332,11099,233,2.1
CN3809300000000,38,093,Stutsman County, ND,Aug-17,11276,11048,228,2.0
CN3809300000000,38,093,Stutsman County, ND,Sep-17,11071,10885,186,1.7
CN3809300000000,38,093,Stutsman County, ND,Oct-17,10967,10810,157,1.4
CN3809300000000,38,093,Stutsman County, ND,Nov-17,10753,10557,196,1.8
CN3809300000000,38,093,Stutsman County, ND,Dec-17,10715,10488,227,2.1
CN3809300000000,38,093,Stutsman County, ND,Jan-18,10840,10498,342,3.2
CN3809300000000,38,093,Stutsman County, ND,Feb-18,10865,10523,342,3.1
CN3809300000000,38,093,Stutsman County, ND,Mar-18,10960,10614,346,3.2
CN3809300000000,38,093,Stutsman County, ND,Apr-18(p),10817,10525,292,2.7
CN4824500000000,48,245,Jefferson County, TX,Mar-17,108517,100557,7960,7.3
CN4824500000000,48,245,Jefferson County, TX,Apr-17,107974,100458,7516,7.0
CN4824500000000,48,245,Jefferson County, TX,May-17,107069,99927,7142,6.7
CN4824500000000,48,245,Jefferson County, TX,Jun-17,107395,99750,7645,7.1
CN4824500000000,48,245,Jefferson County, TX,Jul-17,106794,99209,7585,7.1
CN4824500000000,48,245,Jefferson County, TX,Aug-17,105682,97971,7711,7.3
CN4824500000000,48,245,Jefferson County, TX,Sep-17,107526,98385,9141,8.5
CN4824500000000,48,245,Jefferson County, TX,Oct-17,106660,99350,7310,6.9
CN4824500000000,48,245,Jefferson County, TX,Nov-17,106734,99474,7260,6.8
CN4824500000000,48,245,Jefferson County, TX,Dec-17,106597,99261,7336,6.9
CN4824500000000,48,245,Jefferson County, TX,Jan-18,107481,99251,8230,7.7
CN4824500000000,48,245,Jefferson County, TX,Feb-18,108275,100567,7708,7.1
CN4824500000000,48,245,Jefferson County, TX,Mar-18,108185,100677,7508,6.9
CN4824500000000,48,245,Jefferson County, TX,Apr-18(p),107258,100376,6882,6.4
CN4600900000000,46,009,Bon Homme County, SD,Mar-17,2886,2788,98,3.4
CN4600900000000,46,009,Bon Homme County, SD,Apr-17,2926,2837,89,3.0
CN4600900000000,46,009,Bon Homme County, SD,May-17,2996,2914,82,2.7
CN4600900000000,46,009,Bon Homme County, SD,Jun-17,3098,3011,87,2.8
CN4600900000000,46,009,Bon Homme County, SD,Jul-17,3047,2962,85,2.8
CN4600900000000,46,009,Bon Homme County, SD,Aug-17,2970,2877,93,3.1
CN4600900000000,46,009,Bon Homme County, SD,Sep-17,2891,2812,79,2.7
CN4600900000000,46,009,Bon Homme County, SD,Oct-17,2832,2755,77,2.7
CN4600900000000,46,009,Bon Homme County, SD,Nov-17,2811,2724,87,3.1
CN4600900000000,46,009,Bon Homme County, SD,Dec-17,2859,2780,79,2.8
CN4600900000000,46,009,Bon Homme County, SD,Jan-18,2864,2780,84,2.9
CN4600900000000,46,009,Bon Homme County, SD,Feb-18,2855,2771,84,2.9
CN4600900000000,46,009,Bon Homme County, SD,Mar-18,2891,2813,78,2.7
CN4600900000000,46,009,Bon Homme County, SD,Apr-18(p),2841,2762,79,2.8
CN3905500000000,39,055,Geauga County, OH,Mar-17,48898,46321,2577,5.3
CN3905500000000,39,055,Geauga County, OH,Apr-17,49476,47262,2214,4.5
CN3905500000000,39,055,Geauga County, OH,May-17,48682,46464,2218,4.6
CN3905500000000,39,055,Geauga County, OH,Jun-17,49274,46747,2527,5.1
CN3905500000000,39,055,Geauga County, OH,Jul-17,49528,47063,2465,5.0
CN3905500000000,39,055,Geauga County, OH,Aug-17,49185,46788,2397,4.9
CN3905500000000,39,055,Geauga County, OH,Sep-17,49065,47037,2028,4.1
CN3905500000000,39,055,Geauga County, OH,Oct-17,48271,46437,1834,3.8
CN3905500000000,39,055,Geauga County, OH,Nov-17,48338,46557,1781,3.7
CN3905500000000,39,055,Geauga County, OH,Dec-17,47470,45512,1958,4.1
CN3905500000000,39,055,Geauga County, OH,Jan-18,47790,45380,2410,5.0
CN3905500000000,39,055,Geauga County, OH,Feb-18,48577,46101,2476,5.1
CN3905500000000,39,055,Geauga County, OH,Mar-18,48475,46432,2043,4.2
CN3905500000000,39,055,Geauga County, OH,Apr-18(p),49075,47200,1875,3.8
CN2100700000000,21,007,Ballard County, KY,Mar-17,3710,3390,320,8.6
CN2100700000000,21,007,Ballard County, KY,Apr-17,3709,3418,291,7.8
CN2100700000000,21,007,Ballard County, KY,May-17,3678,3393,285,7.7
CN2100700000000,21,007,Ballard County, KY,Jun-17,3692,3414,278,7.5
CN2100700000000,21,007,Ballard County, KY,Jul-17,3644,3369,275,7.5
CN2100700000000,21,007,Ballard County, KY,Aug-17,3607,3350,257,7.1
CN2100700000000,21,007,Ballard County, KY,Sep-17,3586,3360,226,6.3
CN2100700000000,21,007,Ballard County, KY,Oct-17,3587,3373,214,6.0
CN2100700000000,21,007,Ballard County, KY,Nov-17,3601,3377,224,6.2
CN2100700000000,21,007,Ballard County, KY,Dec-17,3613,3369,244,6.8
CN2100700000000,21,007,Ballard County, KY,Jan-18,3610,3334,276,7.6
CN2100700000000,21,007,Ballard County, KY,Feb-18,3622,3320,302,8.3
CN2100700000000,21,007,Ballard County, KY,Mar-18,3647,3372,275,7.5
CN2100700000000,21,007,Ballard County, KY,Apr-18(p),3651,3402,249,6.8
CN1201900000000,12,019,Clay County, FL,Mar-17,103231,99249,3982,3.9
CN1201900000000,12,019,Clay County, FL,Apr-17,103613,99830,3783,3.7
CN1201900000000,12,019,Clay County, FL,May-17,104554,100687,3867,3.7
CN1201900000000,12,019,Clay County, FL,Jun-17,105237,100958,4279,4.1
CN1201900000000,12,019,Clay County, FL,Jul-17,106103,101785,4318,4.1
CN1201900000000,12,019,Clay County, FL,Aug-17,105325,101225,4100,3.9
CN1201900000000,12,019,Clay County, FL,Sep-17,106949,103138,3811,3.6
CN1201900000000,12,019,Clay County, FL,Oct-17,105619,102034,3585,3.4
CN1201900000000,12,019,Clay County, FL,Nov-17,105307,101650,3657,3.5
CN1201900000000,12,019,Clay County, FL,Dec-17,104925,101544,3381,3.2
CN1201900000000,12,019,Clay County, FL,Jan-18,104764,100797,3967,3.8
CN1201900000000,12,019,Clay County, FL,Feb-18,105600,101985,3615,3.4
CN1201900000000,12,019,Clay County, FL,Mar-18,105827,102260,3567,3.4
CN1201900000000,12,019,Clay County, FL,Apr-18(p),105369,102095,3274,3.1
CN2804300000000,28,043,Grenada County, MS,Mar-17,9680,9235,445,4.6
CN2804300000000,28,043,Grenada County, MS,Apr-17,9707,9300,407,4.2
CN2804300000000,28,043,Grenada County, MS,May-17,9792,9298,494,5.0
CN2804300000000,28,043,Grenada County, MS,Jun-17,9945,9410,535,5.4
CN2804300000000,28,043,Grenada County, MS,Jul-17,9889,9371,518,5.2
CN2804300000000,28,043,Grenada County, MS,Aug-17,9583,9170,413,4.3
CN2804300000000,28,043,Grenada County, MS,Sep-17,9546,9140,406,4.3
CN2804300000000,28,043,Grenada County, MS,Oct-17,9476,9097,379,4.0
CN2804300000000,28,043,Grenada County, MS,Nov-17,9452,9088,364,3.9
CN2804300000000,28,043,Grenada County, MS,Dec-17,9490,9110,380,4.0
CN2804300000000,28,043,Grenada County, MS,Jan-18,9501,9116,385,4.1
CN2804300000000,28,043,Grenada County, MS,Feb-18,9598,9210,388,4.0
CN2804300000000,28,043,Grenada County, MS,Mar-18,9631,9263,368,3.8
CN2804300000000,28,043,Grenada County, MS,Apr-18(p),9778,9411,367,3.8
CN3703100000000,37,031,Carteret County, NC,Mar-17,31497,30048,1449,4.6
CN3703100000000,37,031,Carteret County, NC,Apr-17,31883,30591,1292,4.1
CN3703100000000,37,031,Carteret County, NC,May-17,32439,31098,1341,4.1
CN3703100000000,37,031,Carteret County, NC,Jun-17,33385,31994,1391,4.2
CN3703100000000,37,031,Carteret County, NC,Jul-17,33534,32078,1456,4.3
CN3703100000000,37,031,Carteret County, NC,Aug-17,32731,31274,1457,4.5
CN3703100000000,37,031,Carteret County, NC,Sep-17,32285,30970,1315,4.1
CN3703100000000,37,031,Carteret County, NC,Oct-17,31988,30661,1327,4.1
CN3703100000000,37,031,Carteret County, NC,Nov-17,31720,30323,1397,4.4
CN3703100000000,37,031,Carteret County, NC,Dec-17,31256,29863,1393,4.5
CN3703100000000,37,031,Carteret County, NC,Jan-18,31005,29422,1583,5.1
CN3703100000000,37,031,Carteret County, NC,Feb-18,30742,29210,1532,5.0
CN3703100000000,37,031,Carteret County, NC,Mar-18,31012,29591,1421,4.6
CN3703100000000,37,031,Carteret County, NC,Apr-18(p),31677,30478,1199,3.8
CN2900500000000,29,005,Atchison County, MO,Mar-17,2881,2769,112,3.9
CN2900500000000,29,005,Atchison County, MO,Apr-17,3032,2934,98,3.2
CN2900500000000,29,005,Atchison County, MO,May-17,2946,2845,101,3.4
CN2900500000000,29,005,Atchison County, MO,Jun-17,2947,2832,115,3.9
CN2900500000000,29,005,Atchison County, MO,Jul-17,2737,2616,121,4.4
CN2900500000000,29,005,Atchison County, MO,Aug-17,2650,2545,105,4.0
CN2900500000000,29,005,Atchison County, MO,Sep-17,2720,2635,85,3.1
CN2900500000000,29,005,Atchison County, MO,Oct-17,2797,2738,59,2.1
CN2900500000000,29,005,Atchison County, MO,Nov-17,2784,2711,73,2.6
CN2900500000000,29,005,Atchison County, MO,Dec-17,2700,2634,66,2.4
CN2900500000000,29,005,Atchison County, MO,Jan-18,2718,2630,88,3.2
CN2900500000000,29,005,Atchison County, MO,Feb-18,2766,2687,79,2.9
CN2900500000000,29,005,Atchison County, MO,Mar-18,2776,2697,79,2.8
CN2900500000000,29,005,Atchison County, MO,Apr-18(p),2875,2814,61,2.1
CN0508500000000,05,085,Lonoke County, AR,Mar-17,33549,32536,1013,3.0
CN0508500000000,05,085,Lonoke County, AR,Apr-17,33727,32801,926,2.7
CN0508500000000,05,085,Lonoke County, AR,May-17,33914,32880,1034,3.0
CN0508500000000,05,085,Lonoke County, AR,Jun-17,34324,33178,1146,3.3
CN0508500000000,05,085,Lonoke County, AR,Jul-17,34755,33561,1194,3.4
CN0508500000000,05,085,Lonoke County, AR,Aug-17,34196,33062,1134,3.3
CN0508500000000,05,085,Lonoke County, AR,Sep-17,34021,32949,1072,3.2
CN0508500000000,05,085,Lonoke County, AR,Oct-17,33933,32970,963,2.8
CN0508500000000,05,085,Lonoke County, AR,Nov-17,33795,32821,974,2.9
CN0508500000000,05,085,Lonoke County, AR,Dec-17,33832,32521,1311,3.9
CN0508500000000,05,085,Lonoke County, AR,Jan-18,33104,31844,1260,3.8
CN0508500000000,05,085,Lonoke County, AR,Feb-18,33459,32204,1255,3.8
CN0508500000000,05,085,Lonoke County, AR,Mar-18,33674,32508,1166,3.5
CN0508500000000,05,085,Lonoke County, AR,Apr-18(p),33513,32498,1015,3.0
CN2811900000000,28,119,Quitman County, MS,Mar-17,2532,2324,208,8.2
CN2811900000000,28,119,Quitman County, MS,Apr-17,2527,2329,198,7.8
CN2811900000000,28,119,Quitman County, MS,May-17,2513,2286,227,9.0
CN2811900000000,28,119,Quitman County, MS,Jun-17,2537,2277,260,10.2
CN2811900000000,28,119,Quitman County, MS,Jul-17,2523,2264,259,10.3
CN2811900000000,28,119,Quitman County, MS,Aug-17,2487,2289,198,8.0
CN2811900000000,28,119,Quitman County, MS,Sep-17,2492,2312,180,7.2
CN2811900000000,28,119,Quitman County, MS,Oct-17,2476,2302,174,7.0
CN2811900000000,28,119,Quitman County, MS,Nov-17,2416,2244,172,7.1
CN2811900000000,28,119,Quitman County, MS,Dec-17,2412,2213,199,8.3
CN2811900000000,28,119,Quitman County, MS,Jan-18,2333,2133,200,8.6
CN2811900000000,28,119,Quitman County, MS,Feb-18,2373,2186,187,7.9
CN2811900000000,28,119,Quitman County, MS,Mar-18,2458,2271,187,7.6
CN2811900000000,28,119,Quitman County, MS,Apr-18(p),2435,2273,162,6.7
CN2000100000000,20,001,Allen County, KS,Mar-17,6392,6067,325,5.1
CN2000100000000,20,001,Allen County, KS,Apr-17,6330,6032,298,4.7
CN2000100000000,20,001,Allen County, KS,May-17,6351,6056,295,4.6
CN2000100000000,20,001,Allen County, KS,Jun-17,6363,5985,378,5.9
CN2000100000000,20,001,Allen County, KS,Jul-17,6150,5791,359,5.8
CN2000100000000,20,001,Allen County, KS,Aug-17,6053,5740,313,5.2
CN2000100000000,20,001,Allen County, KS,Sep-17,6349,6101,248,3.9
CN2000100000000,20,001,Allen County, KS,Oct-17,6351,6124,227,3.6
CN2000100000000,20,001,Allen County, KS,Nov-17,6337,6109,228,3.6
CN2000100000000,20,001,Allen County, KS,Dec-17,6277,6054,223,3.6
CN2000100000000,20,001,Allen County, KS,Jan-18,6119,5865,254,4.2
CN2000100000000,20,001,Allen County, KS,Feb-18,6260,5993,267,4.3
CN2000100000000,20,001,Allen County, KS,Mar-18,6461,6039,422,6.5
CN2000100000000,20,001,Allen County, KS,Apr-18(p),6202,5988,214,3.5
CN2122500000000,21,225,Union County, KY,Mar-17,6255,5816,439,7.0
CN2122500000000,21,225,Union County, KY,Apr-17,6349,5977,372,5.9
CN2122500000000,21,225,Union County, KY,May-17,6305,5930,375,5.9
CN2122500000000,21,225,Union County, KY,Jun-17,6376,5949,427,6.7
CN2122500000000,21,225,Union County, KY,Jul-17,6126,5734,392,6.4
CN2122500000000,21,225,Union County, KY,Aug-17,6096,5737,359,5.9
CN2122500000000,21,225,Union County, KY,Sep-17,6055,5737,318,5.3
CN2122500000000,21,225,Union County, KY,Oct-17,6064,5779,285,4.7
CN2122500000000,21,225,Union County, KY,Nov-17,6132,5848,284,4.6
CN2122500000000,21,225,Union County, KY,Dec-17,6090,5810,280,4.6
CN2122500000000,21,225,Union County, KY,Jan-18,6032,5739,293,4.9
CN2122500000000,21,225,Union County, KY,Feb-18,6010,5669,341,5.7
CN2122500000000,21,225,Union County, KY,Mar-18,6035,5715,320,5.3
CN2122500000000,21,225,Union County, KY,Apr-18(p),6070,5783,287,4.7
CN4508500000000,45,085,Sumter County, SC,Mar-17,44071,41972,2099,4.8
CN4508500000000,45,085,Sumter County, SC,Apr-17,43999,41901,2098,4.8
CN4508500000000,45,085,Sumter County, SC,May-17,43846,41728,2118,4.8
CN4508500000000,45,085,Sumter County, SC,Jun-17,44372,41891,2481,5.6
CN4508500000000,45,085,Sumter County, SC,Jul-17,44411,41972,2439,5.5
CN4508500000000,45,085,Sumter County, SC,Aug-17,44477,41799,2678,6.0
CN4508500000000,45,085,Sumter County, SC,Sep-17,44084,41784,2300,5.2
CN4508500000000,45,085,Sumter County, SC,Oct-17,44029,41771,2258,5.1
CN4508500000000,45,085,Sumter County, SC,Nov-17,43760,41601,2159,4.9
CN4508500000000,45,085,Sumter County, SC,Dec-17,43797,41590,2207,5.0
CN4508500000000,45,085,Sumter County, SC,Jan-18,44377,41746,2631,5.9
CN4508500000000,45,085,Sumter County, SC,Feb-18,44195,41777,2418,5.5
CN4508500000000,45,085,Sumter County, SC,Mar-18,44074,41887,2187,5.0
CN4508500000000,45,085,Sumter County, SC,Apr-18(p),43483,41970,1513,3.5
CN5407300000000,54,073,Pleasants County, WV,Mar-17,2832,2623,209,7.4
CN5407300000000,54,073,Pleasants County, WV,Apr-17,2838,2637,201,7.1
CN5407300000000,54,073,Pleasants County, WV,May-17,2847,2670,177,6.2
CN5407300000000,54,073,Pleasants County, WV,Jun-17,2889,2679,210,7.3
CN5407300000000,54,073,Pleasants County, WV,Jul-17,2884,2695,189,6.6
CN5407300000000,54,073,Pleasants County, WV,Aug-17,2896,2690,206,7.1
CN5407300000000,54,073,Pleasants County, WV,Sep-17,2847,2682,165,5.8
CN5407300000000,54,073,Pleasants County, WV,Oct-17,2846,2688,158,5.6
CN5407300000000,54,073,Pleasants County, WV,Nov-17,2829,2646,183,6.5
CN5407300000000,54,073,Pleasants County, WV,Dec-17,2833,2625,208,7.3
CN5407300000000,54,073,Pleasants County, WV,Jan-18,2887,2653,234,8.1
CN5407300000000,54,073,Pleasants County, WV,Feb-18,2884,2647,237,8.2
CN5407300000000,54,073,Pleasants County, WV,Mar-18,2852,2661,191,6.7
CN5407300000000,54,073,Pleasants County, WV,Apr-18(p),2847,2674,173,6.1
CN4005900000000,40,059,Harper County, OK,Mar-17,1851,1782,69,3.7
CN4005900000000,40,059,Harper County, OK,Apr-17,1848,1791,57,3.1
CN4005900000000,40,059,Harper County, OK,May-17,1815,1752,63,3.5
CN4005900000000,40,059,Harper County, OK,Jun-17,1732,1668,64,3.7
CN4005900000000,40,059,Harper County, OK,Jul-17,1804,1746,58,3.2
CN4005900000000,40,059,Harper County, OK,Aug-17,1921,1866,55,2.9
CN4005900000000,40,059,Harper County, OK,Sep-17,1855,1806,49,2.6
CN4005900000000,40,059,Harper County, OK,Oct-17,1861,1819,42,2.3
CN4005900000000,40,059,Harper County, OK,Nov-17,1886,1844,42,2.2
CN4005900000000,40,059,Harper County, OK,Dec-17,1827,1782,45,2.5
CN4005900000000,40,059,Harper County, OK,Jan-18,1766,1719,47,2.7
CN4005900000000,40,059,Harper County, OK,Feb-18,1846,1797,49,2.7
CN4005900000000,40,059,Harper County, OK,Mar-18,1810,1760,50,2.8
CN4005900000000,40,059,Harper County, OK,Apr-18(p),1755,1707,48,2.7
CN4201900000000,42,019,Butler County, PA,Mar-17,98316,93332,4984,5.1
CN4201900000000,42,019,Butler County, PA,Apr-17,98162,94082,4080,4.2
CN4201900000000,42,019,Butler County, PA,May-17,98292,94026,4266,4.3
CN4201900000000,42,019,Butler County, PA,Jun-17,99068,94454,4614,4.7
CN4201900000000,42,019,Butler County, PA,Jul-17,99694,94887,4807,4.8
CN4201900000000,42,019,Butler County, PA,Aug-17,98618,93804,4814,4.9
CN4201900000000,42,019,Butler County, PA,Sep-17,98121,94276,3845,3.9
CN4201900000000,42,019,Butler County, PA,Oct-17,97572,93841,3731,3.8
CN4201900000000,42,019,Butler County, PA,Nov-17,98178,94199,3979,4.1
CN4201900000000,42,019,Butler County, PA,Dec-17,97732,93707,4025,4.1
CN4201900000000,42,019,Butler County, PA,Jan-18,97693,92546,5147,5.3
CN4201900000000,42,019,Butler County, PA,Feb-18,97612,92644,4968,5.1
CN4201900000000,42,019,Butler County, PA,Mar-18,96544,92311,4233,4.4
CN4201900000000,42,019,Butler County, PA,Apr-18(p),96720,93236,3484,3.6
CN0101300000000,01,013,Butler County, AL,Mar-17,9029,8491,538,6.0
CN0101300000000,01,013,Butler County, AL,Apr-17,9004,8537,467,5.2
CN0101300000000,01,013,Butler County, AL,May-17,8948,8508,440,4.9
CN0101300000000,01,013,Butler County, AL,Jun-17,9012,8481,531,5.9
CN0101300000000,01,013,Butler County, AL,Jul-17,9024,8445,579,6.4
CN0101300000000,01,013,Butler County, AL,Aug-17,8902,8423,479,5.4
CN0101300000000,01,013,Butler County, AL,Sep-17,8962,8538,424,4.7
CN0101300000000,01,013,Butler County, AL,Oct-17,8905,8496,409,4.6
CN0101300000000,01,013,Butler County, AL,Nov-17,8842,8462,380,4.3
CN0101300000000,01,013,Butler County, AL,Dec-17,8753,8374,379,4.3
CN0101300000000,01,013,Butler County, AL,Jan-18,8741,8278,463,5.3
CN0101300000000,01,013,Butler County, AL,Feb-18,8727,8262,465,5.3
CN0101300000000,01,013,Butler County, AL,Mar-18,8750,8327,423,4.8
CN0101300000000,01,013,Butler County, AL,Apr-18(p),8821,8437,384,4.4
CN2208900000000,22,089,St. Charles Parish, LA,Mar-17,25110,23935,1175,4.7
CN2208900000000,22,089,St. Charles Parish, LA,Apr-17,25215,24117,1098,4.4
CN2208900000000,22,089,St. Charles Parish, LA,May-17,25181,24050,1131,4.5
CN2208900000000,22,089,St. Charles Parish, LA,Jun-17,25376,24064,1312,5.2
CN2208900000000,22,089,St. Charles Parish, LA,Jul-17,25373,24112,1261,5.0
CN2208900000000,22,089,St. Charles Parish, LA,Aug-17,25227,23971,1256,5.0
CN2208900000000,22,089,St. Charles Parish, LA,Sep-17,25313,24183,1130,4.5
CN2208900000000,22,089,St. Charles Parish, LA,Oct-17,25308,24359,949,3.7
CN2208900000000,22,089,St. Charles Parish, LA,Nov-17,25357,24407,950,3.7
CN2208900000000,22,089,St. Charles Parish, LA,Dec-17,25209,24341,868,3.4
CN2208900000000,22,089,St. Charles Parish, LA,Jan-18,25325,24347,978,3.9
CN2208900000000,22,089,St. Charles Parish, LA,Feb-18,25493,24598,895,3.5
CN2208900000000,22,089,St. Charles Parish, LA,Mar-18,25554,24592,962,3.8
CN2208900000000,22,089,St. Charles Parish, LA,Apr-18(p),25710,24718,992,3.9
CN4101300000000,41,013,Crook County, OR,Mar-17,9390,8766,624,6.6
CN4101300000000,41,013,Crook County, OR,Apr-17,9356,8778,578,6.2
CN4101300000000,41,013,Crook County, OR,May-17,9499,8962,537,5.7
CN4101300000000,41,013,Crook County, OR,Jun-17,9735,9169,566,5.8
CN4101300000000,41,013,Crook County, OR,Jul-17,9767,9183,584,6.0
CN4101300000000,41,013,Crook County, OR,Aug-17,9897,9299,598,6.0
CN4101300000000,41,013,Crook County, OR,Sep-17,9823,9277,546,5.6
CN4101300000000,41,013,Crook County, OR,Oct-17,9642,9092,550,5.7
CN4101300000000,41,013,Crook County, OR,Nov-17,9551,8985,566,5.9
CN4101300000000,41,013,Crook County, OR,Dec-17,9458,8834,624,6.6
CN4101300000000,41,013,Crook County, OR,Jan-18,9502,8800,702,7.4
CN4101300000000,41,013,Crook County, OR,Feb-18,9433,8799,634,6.7
CN4101300000000,41,013,Crook County, OR,Mar-18,9505,8876,629,6.6
CN4101300000000,41,013,Crook County, OR,Apr-18(p),9470,8952,518,5.5
CN5173500000000,51,735,Poquoson city, VA,Mar-17,6208,5996,212,3.4
CN5173500000000,51,735,Poquoson city, VA,Apr-17,6265,6074,191,3.0
CN5173500000000,51,735,Poquoson city, VA,May-17,6278,6059,219,3.5
CN5173500000000,51,735,Poquoson city, VA,Jun-17,6360,6129,231,3.6
CN5173500000000,51,735,Poquoson city, VA,Jul-17,6404,6172,232,3.6
CN5173500000000,51,735,Poquoson city, VA,Aug-17,6327,6084,243,3.8
CN5173500000000,51,735,Poquoson city, VA,Sep-17,6309,6083,226,3.6
CN5173500000000,51,735,Poquoson city, VA,Oct-17,6224,6018,206,3.3
CN5173500000000,51,735,Poquoson city, VA,Nov-17,6182,5975,207,3.3
CN5173500000000,51,735,Poquoson city, VA,Dec-17,6165,5968,197,3.2
CN5173500000000,51,735,Poquoson city, VA,Jan-18,6109,5897,212,3.5
CN5173500000000,51,735,Poquoson city, VA,Feb-18,6192,6005,187,3.0
CN5173500000000,51,735,Poquoson city, VA,Mar-18,6211,6028,183,2.9
CN5173500000000,51,735,Poquoson city, VA,Apr-18(p),6254,6099,155,2.5
CN3901100000000,39,011,Auglaize County, OH,Mar-17,24878,23938,940,3.8
CN3901100000000,39,011,Auglaize County, OH,Apr-17,24839,23957,882,3.6
CN3901100000000,39,011,Auglaize County, OH,May-17,24846,23987,859,3.5
CN3901100000000,39,011,Auglaize County, OH,Jun-17,25110,24129,981,3.9
CN3901100000000,39,011,Auglaize County, OH,Jul-17,24981,23972,1009,4.0
CN3901100000000,39,011,Auglaize County, OH,Aug-17,25122,24160,962,3.8
CN3901100000000,39,011,Auglaize County, OH,Sep-17,24694,23842,852,3.5
CN3901100000000,39,011,Auglaize County, OH,Oct-17,24642,23845,797,3.2
CN3901100000000,39,011,Auglaize County, OH,Nov-17,24568,23777,791,3.2
CN3901100000000,39,011,Auglaize County, OH,Dec-17,24382,23567,815,3.3
CN3901100000000,39,011,Auglaize County, OH,Jan-18,24024,23185,839,3.5
CN3901100000000,39,011,Auglaize County, OH,Feb-18,24543,23744,799,3.3
CN3901100000000,39,011,Auglaize County, OH,Mar-18,24916,24206,710,2.8
CN3901100000000,39,011,Auglaize County, OH,Apr-18(p),24771,24068,703,2.8
CN5301700000000,53,017,Douglas County, WA,Mar-17,19874,18436,1438,7.2
CN5301700000000,53,017,Douglas County, WA,Apr-17,20142,18987,1155,5.7
CN5301700000000,53,017,Douglas County, WA,May-17,20571,19400,1171,5.7
CN5301700000000,53,017,Douglas County, WA,Jun-17,21914,20884,1030,4.7
CN5301700000000,53,017,Douglas County, WA,Jul-17,24738,23759,979,4.0
CN5301700000000,53,017,Douglas County, WA,Aug-17,21980,20929,1051,4.8
CN5301700000000,53,017,Douglas County, WA,Sep-17,21941,21034,907,4.1
CN5301700000000,53,017,Douglas County, WA,Oct-17,21487,20577,910,4.2
CN5301700000000,53,017,Douglas County, WA,Nov-17,20227,19147,1080,5.3
CN5301700000000,53,017,Douglas County, WA,Dec-17,19975,18653,1322,6.6
CN5301700000000,53,017,Douglas County, WA,Jan-18,19546,18040,1506,7.7
CN5301700000000,53,017,Douglas County, WA,Feb-18,19663,18130,1533,7.8
CN5301700000000,53,017,Douglas County, WA,Mar-18,20013,18637,1376,6.9
CN5301700000000,53,017,Douglas County, WA,Apr-18(p),20267,19113,1154,5.7
CN3117700000000,31,177,Washington County, NE,Mar-17,11064,10702,362,3.3
CN3117700000000,31,177,Washington County, NE,Apr-17,11111,10766,345,3.1
CN3117700000000,31,177,Washington County, NE,May-17,11129,10796,333,3.0
CN3117700000000,31,177,Washington County, NE,Jun-17,11206,10845,361,3.2
CN3117700000000,31,177,Washington County, NE,Jul-17,11286,10928,358,3.2
CN3117700000000,31,177,Washington County, NE,Aug-17,11141,10809,332,3.0
CN3117700000000,31,177,Washington County, NE,Sep-17,11012,10702,310,2.8
CN3117700000000,31,177,Washington County, NE,Oct-17,11118,10816,302,2.7
CN3117700000000,31,177,Washington County, NE,Nov-17,11140,10837,303,2.7
CN3117700000000,31,177,Washington County, NE,Dec-17,11067,10762,305,2.8
CN3117700000000,31,177,Washington County, NE,Jan-18,11018,10667,351,3.2
CN3117700000000,31,177,Washington County, NE,Feb-18,11099,10757,342,3.1
CN3117700000000,31,177,Washington County, NE,Mar-18,11119,10797,322,2.9
CN3117700000000,31,177,Washington County, NE,Apr-18(p),11216,10893,323,2.9
CN5111900000000,51,119,Middlesex County, VA,Mar-17,5024,4838,186,3.7
CN5111900000000,51,119,Middlesex County, VA,Apr-17,5190,5031,159,3.1
CN5111900000000,51,119,Middlesex County, VA,May-17,5276,5097,179,3.4
CN5111900000000,51,119,Middlesex County, VA,Jun-17,5417,5240,177,3.3
CN5111900000000,51,119,Middlesex County, VA,Jul-17,5422,5244,178,3.3
CN5111900000000,51,119,Middlesex County, VA,Aug-17,5281,5109,172,3.3
CN5111900000000,51,119,Middlesex County, VA,Sep-17,5236,5072,164,3.1
CN5111900000000,51,119,Middlesex County, VA,Oct-17,5238,5077,161,3.1
CN5111900000000,51,119,Middlesex County, VA,Nov-17,5188,5027,161,3.1
CN5111900000000,51,119,Middlesex County, VA,Dec-17,5146,4992,154,3.0
CN5111900000000,51,119,Middlesex County, VA,Jan-18,5093,4910,183,3.6
CN5111900000000,51,119,Middlesex County, VA,Feb-18,5103,4953,150,2.9
CN5111900000000,51,119,Middlesex County, VA,Mar-18,5133,4980,153,3.0
CN5111900000000,51,119,Middlesex County, VA,Apr-18(p),5234,5107,127,2.4
CN2301700000000,23,017,Oxford County, ME,Mar-17,26997,25876,1121,4.2
CN2301700000000,23,017,Oxford County, ME,Apr-17,26354,25280,1074,4.1
CN2301700000000,23,017,Oxford County, ME,May-17,26293,25218,1075,4.1
CN2301700000000,23,017,Oxford County, ME,Jun-17,27255,26192,1063,3.9
CN2301700000000,23,017,Oxford County, ME,Jul-17,27834,26762,1072,3.9
CN2301700000000,23,017,Oxford County, ME,Aug-17,27665,26758,907,3.3
CN2301700000000,23,017,Oxford County, ME,Sep-17,26476,25586,890,3.4
CN2301700000000,23,017,Oxford County, ME,Oct-17,26805,25939,866,3.2
CN2301700000000,23,017,Oxford County, ME,Nov-17,26288,25349,939,3.6
CN2301700000000,23,017,Oxford County, ME,Dec-17,26793,25975,818,3.1
CN2301700000000,23,017,Oxford County, ME,Jan-18,27363,26339,1024,3.7
CN2301700000000,23,017,Oxford County, ME,Feb-18,27227,26236,991,3.6
CN2301700000000,23,017,Oxford County, ME,Mar-18,27136,26176,960,3.5
CN2301700000000,23,017,Oxford County, ME,Apr-18(p),26346,25397,949,3.6
CN4706500000000,47,065,Hamilton County, TN,Mar-17,175377,168507,6870,3.9
CN4706500000000,47,065,Hamilton County, TN,Apr-17,175099,169332,5767,3.3
CN4706500000000,47,065,Hamilton County, TN,May-17,175265,169695,5570,3.2
CN4706500000000,47,065,Hamilton County, TN,Jun-17,179746,172612,7134,4.0
CN4706500000000,47,065,Hamilton County, TN,Jul-17,179028,172130,6898,3.9
CN4706500000000,47,065,Hamilton County, TN,Aug-17,176222,169721,6501,3.7
CN4706500000000,47,065,Hamilton County, TN,Sep-17,177526,171813,5713,3.2
CN4706500000000,47,065,Hamilton County, TN,Oct-17,177808,172165,5643,3.2
CN4706500000000,47,065,Hamilton County, TN,Nov-17,177775,172312,5463,3.1
CN4706500000000,47,065,Hamilton County, TN,Dec-17,177037,171664,5373,3.0
CN4706500000000,47,065,Hamilton County, TN,Jan-18,177064,170661,6403,3.6
CN4706500000000,47,065,Hamilton County, TN,Feb-18,179161,172945,6216,3.5
CN4706500000000,47,065,Hamilton County, TN,Mar-18,179569,173581,5988,3.3
CN4706500000000,47,065,Hamilton County, TN,Apr-18(p),181405,176366,5039,2.8
CN2007900000000,20,079,Harvey County, KS,Mar-17,16908,16321,587,3.5
CN2007900000000,20,079,Harvey County, KS,Apr-17,16926,16365,561,3.3
CN2007900000000,20,079,Harvey County, KS,May-17,16852,16272,580,3.4
CN2007900000000,20,079,Harvey County, KS,Jun-17,17081,16450,631,3.7
CN2007900000000,20,079,Harvey County, KS,Jul-17,17616,16549,1067,6.1
CN2007900000000,20,079,Harvey County, KS,Aug-17,17386,16308,1078,6.2
CN2007900000000,20,079,Harvey County, KS,Sep-17,16919,16272,647,3.8
CN2007900000000,20,079,Harvey County, KS,Oct-17,16935,16354,581,3.4
CN2007900000000,20,079,Harvey County, KS,Nov-17,16938,16319,619,3.7
CN2007900000000,20,079,Harvey County, KS,Dec-17,16874,16292,582,3.4
CN2007900000000,20,079,Harvey County, KS,Jan-18,16806,16248,558,3.3
CN2007900000000,20,079,Harvey County, KS,Feb-18,16801,16209,592,3.5
CN2007900000000,20,079,Harvey County, KS,Mar-18,16746,16184,562,3.4
CN2007900000000,20,079,Harvey County, KS,Apr-18(p),16772,16228,544,3.2
CN3908900000000,39,089,Licking County, OH,Mar-17,89229,85375,3854,4.3
CN3908900000000,39,089,Licking County, OH,Apr-17,89065,85733,3332,3.7
CN3908900000000,39,089,Licking County, OH,May-17,89557,86193,3364,3.8
CN3908900000000,39,089,Licking County, OH,Jun-17,90603,86606,3997,4.4
CN3908900000000,39,089,Licking County, OH,Jul-17,91100,87112,3988,4.4
CN3908900000000,39,089,Licking County, OH,Aug-17,91094,87131,3963,4.4
CN3908900000000,39,089,Licking County, OH,Sep-17,90034,86504,3530,3.9
CN3908900000000,39,089,Licking County, OH,Oct-17,89765,86464,3301,3.7
CN3908900000000,39,089,Licking County, OH,Nov-17,89850,86465,3385,3.8
CN3908900000000,39,089,Licking County, OH,Dec-17,89811,86375,3436,3.8
CN3908900000000,39,089,Licking County, OH,Jan-18,88449,84681,3768,4.3
CN3908900000000,39,089,Licking County, OH,Feb-18,89641,86113,3528,3.9
CN3908900000000,39,089,Licking County, OH,Mar-18,90667,87414,3253,3.6
CN3908900000000,39,089,Licking County, OH,Apr-18(p),90251,87204,3047,3.4
CN7200500000000,72,005,Aguadilla Municipio, PR,Mar-17,15369,13139,2230,14.5
CN7200500000000,72,005,Aguadilla Municipio, PR,Apr-17,15226,12978,2248,14.8
CN7200500000000,72,005,Aguadilla Municipio, PR,May-17,14894,12955,1939,13.0
CN7200500000000,72,005,Aguadilla Municipio, PR,Jun-17,14686,12848,1838,12.5
CN7200500000000,72,005,Aguadilla Municipio, PR,Jul-17,15057,12842,2215,14.7
CN7200500000000,72,005,Aguadilla Municipio, PR,Aug-17,15134,12704,2430,16.1
CN7200500000000,72,005,Aguadilla Municipio, PR,Sep-17(y),14982,12761,2221,14.8
CN7200500000000,72,005,Aguadilla Municipio, PR,Oct-17,14773,12436,2337,15.8
CN7200500000000,72,005,Aguadilla Municipio, PR,Nov-17,15378,13120,2258,14.7
CN7200500000000,72,005,Aguadilla Municipio, PR,Dec-17,15291,13234,2057,13.5
CN7200500000000,72,005,Aguadilla Municipio, PR,Jan-18,15249,13041,2208,14.5
CN7200500000000,72,005,Aguadilla Municipio, PR,Feb-18,15057,13017,2040,13.5
CN7200500000000,72,005,Aguadilla Municipio, PR,Mar-18,15127,13078,2049,13.5
CN7200500000000,72,005,Aguadilla Municipio, PR,Apr-18(p),15054,13146,1908,12.7
CN3010700000000,30,107,Wheatland County, MT,Mar-17,770,732,38,4.9
CN3010700000000,30,107,Wheatland County, MT,Apr-17,788,757,31,3.9
CN3010700000000,30,107,Wheatland County, MT,May-17,814,790,24,2.9
CN3010700000000,30,107,Wheatland County, MT,Jun-17,792,757,35,4.4
CN3010700000000,30,107,Wheatland County, MT,Jul-17,801,771,30,3.7
CN3010700000000,30,107,Wheatland County, MT,Aug-17,789,760,29,3.7
CN3010700000000,30,107,Wheatland County, MT,Sep-17,762,732,30,3.9
CN3010700000000,30,107,Wheatland County, MT,Oct-17,772,739,33,4.3
CN3010700000000,30,107,Wheatland County, MT,Nov-17,778,738,40,5.1
CN3010700000000,30,107,Wheatland County, MT,Dec-17,755,715,40,5.3
CN3010700000000,30,107,Wheatland County, MT,Jan-18,771,724,47,6.1
CN3010700000000,30,107,Wheatland County, MT,Feb-18,778,722,56,7.2
CN3010700000000,30,107,Wheatland County, MT,Mar-18,749,708,41,5.5
CN3010700000000,30,107,Wheatland County, MT,Apr-18(p),746,713,33,4.4
CN2302500000000,23,025,Somerset County, ME,Mar-17,23233,21860,1373,5.9
CN2302500000000,23,025,Somerset County, ME,Apr-17,23302,22024,1278,5.5
CN2302500000000,23,025,Somerset County, ME,May-17,23296,22081,1215,5.2
CN2302500000000,23,025,Somerset County, ME,Jun-17,23832,22758,1074,4.5
CN2302500000000,23,025,Somerset County, ME,Jul-17,24159,23031,1128,4.7
CN2302500000000,23,025,Somerset County, ME,Aug-17,23910,22983,927,3.9
CN2302500000000,23,025,Somerset County, ME,Sep-17,23269,22360,909,3.9
CN2302500000000,23,025,Somerset County, ME,Oct-17,23290,22363,927,4.0
CN2302500000000,23,025,Somerset County, ME,Nov-17,22916,21987,929,4.1
CN2302500000000,23,025,Somerset County, ME,Dec-17,22832,21951,881,3.9
CN2302500000000,23,025,Somerset County, ME,Jan-18,22933,21799,1134,4.9
CN2302500000000,23,025,Somerset County, ME,Feb-18,23202,22080,1122,4.8
CN2302500000000,23,025,Somerset County, ME,Mar-18,23161,22126,1035,4.5
CN2302500000000,23,025,Somerset County, ME,Apr-18(p),23149,22123,1026,4.4
CN4201300000000,42,013,Blair County, PA,Mar-17,60164,57060,3104,5.2
CN4201300000000,42,013,Blair County, PA,Apr-17,60403,57685,2718,4.5
CN4201300000000,42,013,Blair County, PA,May-17,60661,57772,2889,4.8
CN4201300000000,42,013,Blair County, PA,Jun-17,61488,58365,3123,5.1
CN4201300000000,42,013,Blair County, PA,Jul-17,61649,58427,3222,5.2
CN4201300000000,42,013,Blair County, PA,Aug-17,61119,57980,3139,5.1
CN4201300000000,42,013,Blair County, PA,Sep-17,60194,57672,2522,4.2
CN4201300000000,42,013,Blair County, PA,Oct-17,58737,56354,2383,4.1
CN4201300000000,42,013,Blair County, PA,Nov-17,59192,56703,2489,4.2
CN4201300000000,42,013,Blair County, PA,Dec-17,58860,56342,2518,4.3
CN4201300000000,42,013,Blair County, PA,Jan-18,59094,56111,2983,5.0
CN4201300000000,42,013,Blair County, PA,Feb-18,58924,55965,2959,5.0
CN4201300000000,42,013,Blair County, PA,Mar-18,58558,55997,2561,4.4
CN4201300000000,42,013,Blair County, PA,Apr-18(p),58838,56587,2251,3.8
CN1812500000000,18,125,Pike County, IN,Mar-17,6495,6281,214,3.3
CN1812500000000,18,125,Pike County, IN,Apr-17,6486,6310,176,2.7
CN1812500000000,18,125,Pike County, IN,May-17,6601,6418,183,2.8
CN1812500000000,18,125,Pike County, IN,Jun-17,6646,6426,220,3.3
CN1812500000000,18,125,Pike County, IN,Jul-17,6567,6341,226,3.4
CN1812500000000,18,125,Pike County, IN,Aug-17,6518,6260,258,4.0
CN1812500000000,18,125,Pike County, IN,Sep-17,6256,6066,190,3.0
CN1812500000000,18,125,Pike County, IN,Oct-17,6417,6242,175,2.7
CN1812500000000,18,125,Pike County, IN,Nov-17,6437,6241,196,3.0
CN1812500000000,18,125,Pike County, IN,Dec-17,6433,6226,207,3.2
CN1812500000000,18,125,Pike County, IN,Jan-18,6390,6166,224,3.5
CN1812500000000,18,125,Pike County, IN,Feb-18,6345,6105,240,3.8
CN1812500000000,18,125,Pike County, IN,Mar-18,6383,6175,208,3.3
CN1812500000000,18,125,Pike County, IN,Apr-18(p),6421,6236,185,2.9
CN2106300000000,21,063,Elliott County, KY,Mar-17,2302,2034,268,11.6
CN2106300000000,21,063,Elliott County, KY,Apr-17,2275,2050,225,9.9
CN2106300000000,21,063,Elliott County, KY,May-17,2268,2030,238,10.5
CN2106300000000,21,063,Elliott County, KY,Jun-17,2266,2020,246,10.9
CN2106300000000,21,063,Elliott County, KY,Jul-17,2186,1962,224,10.2
CN2106300000000,21,063,Elliott County, KY,Aug-17,2144,1931,213,9.9
CN2106300000000,21,063,Elliott County, KY,Sep-17,2168,1992,176,8.1
CN2106300000000,21,063,Elliott County, KY,Oct-17,2157,2001,156,7.2
CN2106300000000,21,063,Elliott County, KY,Nov-17,2173,2006,167,7.7
CN2106300000000,21,063,Elliott County, KY,Dec-17,2191,2000,191,8.7
CN2106300000000,21,063,Elliott County, KY,Jan-18,2257,1999,258,11.4
CN2106300000000,21,063,Elliott County, KY,Feb-18,2222,1974,248,11.2
CN2106300000000,21,063,Elliott County, KY,Mar-18,2192,1995,197,9.0
CN2106300000000,21,063,Elliott County, KY,Apr-18(p),2177,2008,169,7.8
CN2711300000000,27,113,Pennington County, MN,Mar-17,9112,8315,797,8.7
CN2711300000000,27,113,Pennington County, MN,Apr-17,9025,8222,803,8.9
CN2711300000000,27,113,Pennington County, MN,May-17,8850,8501,349,3.9
CN2711300000000,27,113,Pennington County, MN,Jun-17,8858,8521,337,3.8
CN2711300000000,27,113,Pennington County, MN,Jul-17,8597,8277,320,3.7
CN2711300000000,27,113,Pennington County, MN,Aug-17,8607,8259,348,4.0
CN2711300000000,27,113,Pennington County, MN,Sep-17,8592,8339,253,2.9
CN2711300000000,27,113,Pennington County, MN,Oct-17,8583,8373,210,2.4
CN2711300000000,27,113,Pennington County, MN,Nov-17,8665,8353,312,3.6
CN2711300000000,27,113,Pennington County, MN,Dec-17,8958,8321,637,7.1
CN2711300000000,27,113,Pennington County, MN,Jan-18,9047,8306,741,8.2
CN2711300000000,27,113,Pennington County, MN,Feb-18,9011,8351,660,7.3
CN2711300000000,27,113,Pennington County, MN,Mar-18,9073,8389,684,7.5
CN2711300000000,27,113,Pennington County, MN,Apr-18(p),8826,8394,432,4.9
CN3711300000000,37,113,Macon County, NC,Mar-17,15115,14351,764,5.1
CN3711300000000,37,113,Macon County, NC,Apr-17,15075,14424,651,4.3
CN3711300000000,37,113,Macon County, NC,May-17,15288,14608,680,4.4
CN3711300000000,37,113,Macon County, NC,Jun-17,15477,14780,697,4.5
CN3711300000000,37,113,Macon County, NC,Jul-17,15624,14889,735,4.7
CN3711300000000,37,113,Macon County, NC,Aug-17,15411,14672,739,4.8
CN3711300000000,37,113,Macon County, NC,Sep-17,15532,14891,641,4.1
CN3711300000000,37,113,Macon County, NC,Oct-17,15382,14750,632,4.1
CN3711300000000,37,113,Macon County, NC,Nov-17,15202,14537,665,4.4
CN3711300000000,37,113,Macon County, NC,Dec-17,14919,14271,648,4.3
CN3711300000000,37,113,Macon County, NC,Jan-18,14672,13915,757,5.2
CN3711300000000,37,113,Macon County, NC,Feb-18,14775,14007,768,5.2
CN3711300000000,37,113,Macon County, NC,Mar-18,14805,14098,707,4.8
CN3711300000000,37,113,Macon County, NC,Apr-18(p),14968,14371,597,4.0
CN4610100000000,46,101,Moody County, SD,Mar-17,3912,3750,162,4.1
CN4610100000000,46,101,Moody County, SD,Apr-17,3989,3859,130,3.3
CN4610100000000,46,101,Moody County, SD,May-17,4025,3901,124,3.1
CN4610100000000,46,101,Moody County, SD,Jun-17,4186,3995,191,4.6
CN4610100000000,46,101,Moody County, SD,Jul-17,4105,3913,192,4.7
CN4610100000000,46,101,Moody County, SD,Aug-17,4011,3867,144,3.6
CN4610100000000,46,101,Moody County, SD,Sep-17,4033,3897,136,3.4
CN4610100000000,46,101,Moody County, SD,Oct-17,3988,3865,123,3.1
CN4610100000000,46,101,Moody County, SD,Nov-17,3956,3817,139,3.5
CN4610100000000,46,101,Moody County, SD,Dec-17,3929,3801,128,3.3
CN4610100000000,46,101,Moody County, SD,Jan-18,3908,3762,146,3.7
CN4610100000000,46,101,Moody County, SD,Feb-18,3906,3749,157,4.0
CN4610100000000,46,101,Moody County, SD,Mar-18,3939,3792,147,3.7
CN4610100000000,46,101,Moody County, SD,Apr-18(p),3913,3782,131,3.3
CN3113900000000,31,139,Pierce County, NE,Mar-17,4116,3998,118,2.9
CN3113900000000,31,139,Pierce County, NE,Apr-17,4127,4033,94,2.3
CN3113900000000,31,139,Pierce County, NE,May-17,4158,4064,94,2.3
CN3113900000000,31,139,Pierce County, NE,Jun-17,4257,4144,113,2.7
CN3113900000000,31,139,Pierce County, NE,Jul-17,4220,4106,114,2.7
CN3113900000000,31,139,Pierce County, NE,Aug-17,4124,4012,112,2.7
CN3113900000000,31,139,Pierce County, NE,Sep-17,4022,3926,96,2.4
CN3113900000000,31,139,Pierce County, NE,Oct-17,4052,3947,105,2.6
CN3113900000000,31,139,Pierce County, NE,Nov-17,4053,3943,110,2.7
CN3113900000000,31,139,Pierce County, NE,Dec-17,4015,3900,115,2.9
CN3113900000000,31,139,Pierce County, NE,Jan-18,4078,3943,135,3.3
CN3113900000000,31,139,Pierce County, NE,Feb-18,4070,3936,134,3.3
CN3113900000000,31,139,Pierce County, NE,Mar-18,4079,3943,136,3.3
CN3113900000000,31,139,Pierce County, NE,Apr-18(p),4076,3964,112,2.7
CN3904100000000,39,041,Delaware County, OH,Mar-17,105616,102004,3612,3.4
CN3904100000000,39,041,Delaware County, OH,Apr-17,105779,102540,3239,3.1
CN3904100000000,39,041,Delaware County, OH,May-17,106785,103308,3477,3.3
CN3904100000000,39,041,Delaware County, OH,Jun-17,108025,103905,4120,3.8
CN3904100000000,39,041,Delaware County, OH,Jul-17,108872,104755,4117,3.8
CN3904100000000,39,041,Delaware County, OH,Aug-17,108441,104371,4070,3.8
CN3904100000000,39,041,Delaware County, OH,Sep-17,107386,103740,3646,3.4
CN3904100000000,39,041,Delaware County, OH,Oct-17,107200,103749,3451,3.2
CN3904100000000,39,041,Delaware County, OH,Nov-17,107113,103692,3421,3.2
CN3904100000000,39,041,Delaware County, OH,Dec-17,107279,103859,3420,3.2
CN3904100000000,39,041,Delaware County, OH,Jan-18,105245,101787,3458,3.3
CN3904100000000,39,041,Delaware County, OH,Feb-18,106712,103322,3390,3.2
CN3904100000000,39,041,Delaware County, OH,Mar-18,107928,104747,3181,2.9
CN3904100000000,39,041,Delaware County, OH,Apr-18(p),107713,104649,3064,2.8
CN1912500000000,19,125,Marion County, IA,Mar-17,17268,16745,523,3.0
CN1912500000000,19,125,Marion County, IA,Apr-17,17388,16936,452,2.6
CN1912500000000,19,125,Marion County, IA,May-17,17402,16966,436,2.5
CN1912500000000,19,125,Marion County, IA,Jun-17,17491,17016,475,2.7
CN1912500000000,19,125,Marion County, IA,Jul-17,17505,17058,447,2.6
CN1912500000000,19,125,Marion County, IA,Aug-17,17336,16873,463,2.7
CN1912500000000,19,125,Marion County, IA,Sep-17,17581,17167,414,2.4
CN1912500000000,19,125,Marion County, IA,Oct-17,17422,17076,346,2.0
CN1912500000000,19,125,Marion County, IA,Nov-17,17332,16995,337,1.9
CN1912500000000,19,125,Marion County, IA,Dec-17,17237,16859,378,2.2
CN1912500000000,19,125,Marion County, IA,Jan-18,16957,16428,529,3.1
CN1912500000000,19,125,Marion County, IA,Feb-18,17250,16726,524,3.0
CN1912500000000,19,125,Marion County, IA,Mar-18,17310,16875,435,2.5
CN1912500000000,19,125,Marion County, IA,Apr-18(p),17497,17155,342,2.0
CN4716300000000,47,163,Sullivan County, TN,Mar-17,70423,67287,3136,4.5
CN4716300000000,47,163,Sullivan County, TN,Apr-17,70212,67664,2548,3.6
CN4716300000000,47,163,Sullivan County, TN,May-17,70367,67920,2447,3.5
CN4716300000000,47,163,Sullivan County, TN,Jun-17,70989,67839,3150,4.4
CN4716300000000,47,163,Sullivan County, TN,Jul-17,70630,67613,3017,4.3
CN4716300000000,47,163,Sullivan County, TN,Aug-17,69973,67223,2750,3.9
CN4716300000000,47,163,Sullivan County, TN,Sep-17,70410,67917,2493,3.5
CN4716300000000,47,163,Sullivan County, TN,Oct-17,70114,67710,2404,3.4
CN4716300000000,47,163,Sullivan County, TN,Nov-17,69689,67313,2376,3.4
CN4716300000000,47,163,Sullivan County, TN,Dec-17,69500,67215,2285,3.3
CN4716300000000,47,163,Sullivan County, TN,Jan-18,69723,66989,2734,3.9
CN4716300000000,47,163,Sullivan County, TN,Feb-18,70613,67891,2722,3.9
CN4716300000000,47,163,Sullivan County, TN,Mar-18,70752,68132,2620,3.7
CN4716300000000,47,163,Sullivan County, TN,Apr-18(p),71171,69032,2139,3.0
CN3705700000000,37,057,Davidson County, NC,Mar-17,80298,76865,3433,4.3
CN3705700000000,37,057,Davidson County, NC,Apr-17,79944,76793,3151,3.9
CN3705700000000,37,057,Davidson County, NC,May-17,80036,76697,3339,4.2
CN3705700000000,37,057,Davidson County, NC,Jun-17,80083,76554,3529,4.4
CN3705700000000,37,057,Davidson County, NC,Jul-17,80506,76836,3670,4.6
CN3705700000000,37,057,Davidson County, NC,Aug-17,79656,76011,3645,4.6
CN3705700000000,37,057,Davidson County, NC,Sep-17,80913,77658,3255,4.0
CN3705700000000,37,057,Davidson County, NC,Oct-17,80539,77277,3262,4.1
CN3705700000000,37,057,Davidson County, NC,Nov-17,80467,77023,3444,4.3
CN3705700000000,37,057,Davidson County, NC,Dec-17,79837,76546,3291,4.1
CN3705700000000,37,057,Davidson County, NC,Jan-18,80163,76721,3442,4.3
CN3705700000000,37,057,Davidson County, NC,Feb-18,80830,77450,3380,4.2
CN3705700000000,37,057,Davidson County, NC,Mar-18,80996,77726,3270,4.0
CN3705700000000,37,057,Davidson County, NC,Apr-18(p),80983,78188,2795,3.5
CN2917500000000,29,175,Randolph County, MO,Mar-17,10260,9750,510,5.0
CN2917500000000,29,175,Randolph County, MO,Apr-17,10301,9819,482,4.7
CN2917500000000,29,175,Randolph County, MO,May-17,10170,9726,444,4.4
CN2917500000000,29,175,Randolph County, MO,Jun-17,10082,9592,490,4.9
CN2917500000000,29,175,Randolph County, MO,Jul-17,9919,9358,561,5.7
CN2917500000000,29,175,Randolph County, MO,Aug-17,9740,9219,521,5.3
CN2917500000000,29,175,Randolph County, MO,Sep-17,10111,9705,406,4.0
CN2917500000000,29,175,Randolph County, MO,Oct-17,10002,9701,301,3.0
CN2917500000000,29,175,Randolph County, MO,Nov-17,10014,9649,365,3.6
CN2917500000000,29,175,Randolph County, MO,Dec-17,10051,9639,412,4.1
CN2917500000000,29,175,Randolph County, MO,Jan-18,9797,9313,484,4.9
CN2917500000000,29,175,Randolph County, MO,Feb-18,10093,9609,484,4.8
CN2917500000000,29,175,Randolph County, MO,Mar-18,10059,9629,430,4.3
CN2917500000000,29,175,Randolph County, MO,Apr-18(p),10065,9670,395,3.9
CN2112700000000,21,127,Lawrence County, KY,Mar-17,5257,4711,546,10.4
CN2112700000000,21,127,Lawrence County, KY,Apr-17,5256,4779,477,9.1
CN2112700000000,21,127,Lawrence County, KY,May-17,5237,4767,470,9.0
CN2112700000000,21,127,Lawrence County, KY,Jun-17,4864,4383,481,9.9
CN2112700000000,21,127,Lawrence County, KY,Jul-17,5077,4637,440,8.7
CN2112700000000,21,127,Lawrence County, KY,Aug-17,5084,4678,406,8.0
CN2112700000000,21,127,Lawrence County, KY,Sep-17,5090,4714,376,7.4
CN2112700000000,21,127,Lawrence County, KY,Oct-17,5043,4699,344,6.8
CN2112700000000,21,127,Lawrence County, KY,Nov-17,5046,4696,350,6.9
CN2112700000000,21,127,Lawrence County, KY,Dec-17,5008,4644,364,7.3
CN2112700000000,21,127,Lawrence County, KY,Jan-18,5025,4602,423,8.4
CN2112700000000,21,127,Lawrence County, KY,Feb-18,5111,4695,416,8.1
CN2112700000000,21,127,Lawrence County, KY,Mar-18,5129,4738,391,7.6
CN2112700000000,21,127,Lawrence County, KY,Apr-18(p),5140,4806,334,6.5
CN4011500000000,40,115,Ottawa County, OK,Mar-17,14432,13795,637,4.4
CN4011500000000,40,115,Ottawa County, OK,Apr-17,14496,13899,597,4.1
CN4011500000000,40,115,Ottawa County, OK,May-17,14483,13825,658,4.5
CN4011500000000,40,115,Ottawa County, OK,Jun-17,14648,13943,705,4.8
CN4011500000000,40,115,Ottawa County, OK,Jul-17,14525,13872,653,4.5
CN4011500000000,40,115,Ottawa County, OK,Aug-17,14449,13798,651,4.5
CN4011500000000,40,115,Ottawa County, OK,Sep-17,14402,13781,621,4.3
CN4011500000000,40,115,Ottawa County, OK,Oct-17,14402,13808,594,4.1
CN4011500000000,40,115,Ottawa County, OK,Nov-17,14448,13865,583,4.0
CN4011500000000,40,115,Ottawa County, OK,Dec-17,14304,13728,576,4.0
CN4011500000000,40,115,Ottawa County, OK,Jan-18,14212,13604,608,4.3
CN4011500000000,40,115,Ottawa County, OK,Feb-18,14382,13797,585,4.1
CN4011500000000,40,115,Ottawa County, OK,Mar-18,14364,13808,556,3.9
CN4011500000000,40,115,Ottawa County, OK,Apr-18(p),14335,13797,538,3.8
CN5604500000000,56,045,Weston County, WY,Mar-17,3847,3661,186,4.8
CN5604500000000,56,045,Weston County, WY,Apr-17,3752,3602,150,4.0
CN5604500000000,56,045,Weston County, WY,May-17,3785,3646,139,3.7
CN5604500000000,56,045,Weston County, WY,Jun-17,3802,3662,140,3.7
CN5604500000000,56,045,Weston County, WY,Jul-17,3702,3577,125,3.4
CN5604500000000,56,045,Weston County, WY,Aug-17,3683,3554,129,3.5
CN5604500000000,56,045,Weston County, WY,Sep-17,3746,3613,133,3.6
CN5604500000000,56,045,Weston County, WY,Oct-17,3734,3601,133,3.6
CN5604500000000,56,045,Weston County, WY,Nov-17,3778,3635,143,3.8
CN5604500000000,56,045,Weston County, WY,Dec-17,3720,3580,140,3.8
CN5604500000000,56,045,Weston County, WY,Jan-18,3670,3528,142,3.9
CN5604500000000,56,045,Weston County, WY,Feb-18,3663,3527,136,3.7
CN5604500000000,56,045,Weston County, WY,Mar-18,3693,3549,144,3.9
CN5604500000000,56,045,Weston County, WY,Apr-18(p),3656,3529,127,3.5
CN3715100000000,37,151,Randolph County, NC,Mar-17,67434,64488,2946,4.4
CN3715100000000,37,151,Randolph County, NC,Apr-17,67361,64709,2652,3.9
CN3715100000000,37,151,Randolph County, NC,May-17,67295,64471,2824,4.2
CN3715100000000,37,151,Randolph County, NC,Jun-17,67099,64075,3024,4.5
CN3715100000000,37,151,Randolph County, NC,Jul-17,67473,64298,3175,4.7
CN3715100000000,37,151,Randolph County, NC,Aug-17,66958,63767,3191,4.8
CN3715100000000,37,151,Randolph County, NC,Sep-17,67715,64904,2811,4.2
CN3715100000000,37,151,Randolph County, NC,Oct-17,67429,64661,2768,4.1
CN3715100000000,37,151,Randolph County, NC,Nov-17,67408,64505,2903,4.3
CN3715100000000,37,151,Randolph County, NC,Dec-17,66886,64086,2800,4.2
CN3715100000000,37,151,Randolph County, NC,Jan-18,66884,63925,2959,4.4
CN3715100000000,37,151,Randolph County, NC,Feb-18,67791,64894,2897,4.3
CN3715100000000,37,151,Randolph County, NC,Mar-18,67802,65014,2788,4.1
CN3715100000000,37,151,Randolph County, NC,Apr-18(p),67704,65322,2382,3.5
CN0505500000000,05,055,Greene County, AR,Mar-17,19939,19229,710,3.6
CN0505500000000,05,055,Greene County, AR,Apr-17,19766,19165,601,3.0
CN0505500000000,05,055,Greene County, AR,May-17,19926,19241,685,3.4
CN0505500000000,05,055,Greene County, AR,Jun-17,20308,19489,819,4.0
CN0505500000000,05,055,Greene County, AR,Jul-17,20134,19277,857,4.3
CN0505500000000,05,055,Greene County, AR,Aug-17,19721,18997,724,3.7
CN0505500000000,05,055,Greene County, AR,Sep-17,19763,19087,676,3.4
CN0505500000000,05,055,Greene County, AR,Oct-17,19756,19131,625,3.2
CN0505500000000,05,055,Greene County, AR,Nov-17,19670,19042,628,3.2
CN0505500000000,05,055,Greene County, AR,Dec-17,19554,18874,680,3.5
CN0505500000000,05,055,Greene County, AR,Jan-18,19422,18590,832,4.3
CN0505500000000,05,055,Greene County, AR,Feb-18,19550,18741,809,4.1
CN0505500000000,05,055,Greene County, AR,Mar-18,19591,18847,744,3.8
CN0505500000000,05,055,Greene County, AR,Apr-18(p),19554,18959,595,3.0
CN4811700000000,48,117,Deaf Smith County, TX,Mar-17,8628,8346,282,3.3
CN4811700000000,48,117,Deaf Smith County, TX,Apr-17,8583,8338,245,2.9
CN4811700000000,48,117,Deaf Smith County, TX,May-17,8611,8359,252,2.9
CN4811700000000,48,117,Deaf Smith County, TX,Jun-17,8540,8257,283,3.3
CN4811700000000,48,117,Deaf Smith County, TX,Jul-17,8257,7970,287,3.5
CN4811700000000,48,117,Deaf Smith County, TX,Aug-17,8338,8079,259,3.1
CN4811700000000,48,117,Deaf Smith County, TX,Sep-17,8147,7924,223,2.7
CN4811700000000,48,117,Deaf Smith County, TX,Oct-17,8222,8019,203,2.5
CN4811700000000,48,117,Deaf Smith County, TX,Nov-17,8086,7865,221,2.7
CN4811700000000,48,117,Deaf Smith County, TX,Dec-17,8118,7893,225,2.8
CN4811700000000,48,117,Deaf Smith County, TX,Jan-18,7983,7737,246,3.1
CN4811700000000,48,117,Deaf Smith County, TX,Feb-18,8177,7924,253,3.1
CN4811700000000,48,117,Deaf Smith County, TX,Mar-18,8487,8225,262,3.1
CN4811700000000,48,117,Deaf Smith County, TX,Apr-18(p),8313,8085,228,2.7
CN0104300000000,01,043,Cullman County, AL,Mar-17,37925,36329,1596,4.2
CN0104300000000,01,043,Cullman County, AL,Apr-17,37670,36353,1317,3.5
CN0104300000000,01,043,Cullman County, AL,May-17,37532,36268,1264,3.4
CN0104300000000,01,043,Cullman County, AL,Jun-17,37806,36271,1535,4.1
CN0104300000000,01,043,Cullman County, AL,Jul-17,37503,36069,1434,3.8
CN0104300000000,01,043,Cullman County, AL,Aug-17,37320,35957,1363,3.7
CN0104300000000,01,043,Cullman County, AL,Sep-17,37863,36701,1162,3.1
CN0104300000000,01,043,Cullman County, AL,Oct-17,37849,36679,1170,3.1
CN0104300000000,01,043,Cullman County, AL,Nov-17,37607,36526,1081,2.9
CN0104300000000,01,043,Cullman County, AL,Dec-17,37272,36215,1057,2.8
CN0104300000000,01,043,Cullman County, AL,Jan-18,37008,35718,1290,3.5
CN0104300000000,01,043,Cullman County, AL,Feb-18,37413,36080,1333,3.6
CN0104300000000,01,043,Cullman County, AL,Mar-18,37584,36383,1201,3.2
CN0104300000000,01,043,Cullman County, AL,Apr-18(p),37939,36866,1073,2.8
CN2903900000000,29,039,Cedar County, MO,Mar-17,5693,5432,261,4.6
CN2903900000000,29,039,Cedar County, MO,Apr-17,5823,5612,211,3.6
CN2903900000000,29,039,Cedar County, MO,May-17,5750,5534,216,3.8
CN2903900000000,29,039,Cedar County, MO,Jun-17,5810,5567,243,4.2
CN2903900000000,29,039,Cedar County, MO,Jul-17,5718,5439,279,4.9
CN2903900000000,29,039,Cedar County, MO,Aug-17,5564,5279,285,5.1
CN2903900000000,29,039,Cedar County, MO,Sep-17,5622,5419,203,3.6
CN2903900000000,29,039,Cedar County, MO,Oct-17,5611,5473,138,2.5
CN2903900000000,29,039,Cedar County, MO,Nov-17,5572,5386,186,3.3
CN2903900000000,29,039,Cedar County, MO,Dec-17,5518,5324,194,3.5
CN2903900000000,29,039,Cedar County, MO,Jan-18,5573,5344,229,4.1
CN2903900000000,29,039,Cedar County, MO,Feb-18,5615,5380,235,4.2
CN2903900000000,29,039,Cedar County, MO,Mar-18,5626,5397,229,4.1
CN2903900000000,29,039,Cedar County, MO,Apr-18(p),5716,5523,193,3.4
CN4505500000000,45,055,Kershaw County, SC,Mar-17,29124,27891,1233,4.2
CN4505500000000,45,055,Kershaw County, SC,Apr-17,29153,27994,1159,4.0
CN4505500000000,45,055,Kershaw County, SC,May-17,29194,27995,1199,4.1
CN4505500000000,45,055,Kershaw County, SC,Jun-17,29496,28100,1396,4.7
CN4505500000000,45,055,Kershaw County, SC,Jul-17,29546,28190,1356,4.6
CN4505500000000,45,055,Kershaw County, SC,Aug-17,29126,27651,1475,5.1
CN4505500000000,45,055,Kershaw County, SC,Sep-17,29033,27699,1334,4.6
CN4505500000000,45,055,Kershaw County, SC,Oct-17,28978,27681,1297,4.5
CN4505500000000,45,055,Kershaw County, SC,Nov-17,28760,27526,1234,4.3
CN4505500000000,45,055,Kershaw County, SC,Dec-17,28796,27521,1275,4.4
CN4505500000000,45,055,Kershaw County, SC,Jan-18,28884,27399,1485,5.1
CN4505500000000,45,055,Kershaw County, SC,Feb-18,29040,27697,1343,4.6
CN4505500000000,45,055,Kershaw County, SC,Mar-18,28912,27715,1197,4.1
CN4505500000000,45,055,Kershaw County, SC,Apr-18(p),28559,27736,823,2.9
CN1202700000000,12,027,DeSoto County, FL,Mar-17,14174,13569,605,4.3
CN1202700000000,12,027,DeSoto County, FL,Apr-17,14648,14096,552,3.8
CN1202700000000,12,027,DeSoto County, FL,May-17,14658,14105,553,3.8
CN1202700000000,12,027,DeSoto County, FL,Jun-17,13495,12866,629,4.7
CN1202700000000,12,027,DeSoto County, FL,Jul-17,13287,12633,654,4.9
CN1202700000000,12,027,DeSoto County, FL,Aug-17,13484,12837,647,4.8
CN1202700000000,12,027,DeSoto County, FL,Sep-17,13603,12986,617,4.5
CN1202700000000,12,027,DeSoto County, FL,Oct-17,13294,12720,574,4.3
CN1202700000000,12,027,DeSoto County, FL,Nov-17,13440,12868,572,4.3
CN1202700000000,12,027,DeSoto County, FL,Dec-17,13850,13327,523,3.8
CN1202700000000,12,027,DeSoto County, FL,Jan-18,14154,13545,609,4.3
CN1202700000000,12,027,DeSoto County, FL,Feb-18,14207,13652,555,3.9
CN1202700000000,12,027,DeSoto County, FL,Mar-18,14285,13746,539,3.8
CN1202700000000,12,027,DeSoto County, FL,Apr-18(p),14813,14337,476,3.2
CN2805100000000,28,051,Holmes County, MS,Mar-17,5903,5316,587,9.9
CN2805100000000,28,051,Holmes County, MS,Apr-17,5802,5300,502,8.7
CN2805100000000,28,051,Holmes County, MS,May-17,5810,5275,535,9.2
CN2805100000000,28,051,Holmes County, MS,Jun-17,5876,5257,619,10.5
CN2805100000000,28,051,Holmes County, MS,Jul-17,5828,5155,673,11.5
CN2805100000000,28,051,Holmes County, MS,Aug-17,5743,5230,513,8.9
CN2805100000000,28,051,Holmes County, MS,Sep-17,5756,5264,492,8.5
CN2805100000000,28,051,Holmes County, MS,Oct-17,5701,5247,454,8.0
CN2805100000000,28,051,Holmes County, MS,Nov-17,5667,5216,451,8.0
CN2805100000000,28,051,Holmes County, MS,Dec-17,5657,5174,483,8.5
CN2805100000000,28,051,Holmes County, MS,Jan-18,5638,5102,536,9.5
CN2805100000000,28,051,Holmes County, MS,Feb-18,5679,5164,515,9.1
CN2805100000000,28,051,Holmes County, MS,Mar-18,5718,5222,496,8.7
CN2805100000000,28,051,Holmes County, MS,Apr-18(p),5691,5240,451,7.9
CN3719300000000,37,193,Wilkes County, NC,Mar-17,31036,29731,1305,4.2
CN3719300000000,37,193,Wilkes County, NC,Apr-17,31318,30156,1162,3.7
CN3719300000000,37,193,Wilkes County, NC,May-17,31202,29952,1250,4.0
CN3719300000000,37,193,Wilkes County, NC,Jun-17,31042,29672,1370,4.4
CN3719300000000,37,193,Wilkes County, NC,Jul-17,31022,29559,1463,4.7
CN3719300000000,37,193,Wilkes County, NC,Aug-17,30772,29335,1437,4.7
CN3719300000000,37,193,Wilkes County, NC,Sep-17,31172,29892,1280,4.1
CN3719300000000,37,193,Wilkes County, NC,Oct-17,31824,30553,1271,4.0
CN3719300000000,37,193,Wilkes County, NC,Nov-17,31917,30585,1332,4.2
CN3719300000000,37,193,Wilkes County, NC,Dec-17,31637,30352,1285,4.1
CN3719300000000,37,193,Wilkes County, NC,Jan-18,31798,30429,1369,4.3
CN3719300000000,37,193,Wilkes County, NC,Feb-18,31216,29886,1330,4.3
CN3719300000000,37,193,Wilkes County, NC,Mar-18,31273,30011,1262,4.0
CN3719300000000,37,193,Wilkes County, NC,Apr-18(p),31428,30333,1095,3.5
CN4104300000000,41,043,Linn County, OR,Mar-17,57457,54626,2831,4.9
CN4104300000000,41,043,Linn County, OR,Apr-17,57705,55145,2560,4.4
CN4104300000000,41,043,Linn County, OR,May-17,57715,55229,2486,4.3
CN4104300000000,41,043,Linn County, OR,Jun-17,58328,55502,2826,4.8
CN4104300000000,41,043,Linn County, OR,Jul-17,57859,54833,3026,5.2
CN4104300000000,41,043,Linn County, OR,Aug-17,58283,55245,3038,5.2
CN4104300000000,41,043,Linn County, OR,Sep-17,58123,55409,2714,4.7
CN4104300000000,41,043,Linn County, OR,Oct-17,58834,56144,2690,4.6
CN4104300000000,41,043,Linn County, OR,Nov-17,58679,56064,2615,4.5
CN4104300000000,41,043,Linn County, OR,Dec-17,58513,55957,2556,4.4
CN4104300000000,41,043,Linn County, OR,Jan-18,58834,56002,2832,4.8
CN4104300000000,41,043,Linn County, OR,Feb-18,59256,56303,2953,5.0
CN4104300000000,41,043,Linn County, OR,Mar-18,58957,56083,2874,4.9
CN4104300000000,41,043,Linn County, OR,Apr-18(p),58387,55826,2561,4.4
CN2910300000000,29,103,Knox County, MO,Mar-17,1954,1884,70,3.6
CN2910300000000,29,103,Knox County, MO,Apr-17,2045,1993,52,2.5
CN2910300000000,29,103,Knox County, MO,May-17,1990,1916,74,3.7
CN2910300000000,29,103,Knox County, MO,Jun-17,2011,1937,74,3.7
CN2910300000000,29,103,Knox County, MO,Jul-17,1960,1887,73,3.7
CN2910300000000,29,103,Knox County, MO,Aug-17,1925,1853,72,3.7
CN2910300000000,29,103,Knox County, MO,Sep-17,1896,1848,48,2.5
CN2910300000000,29,103,Knox County, MO,Oct-17,1950,1913,37,1.9
CN2910300000000,29,103,Knox County, MO,Nov-17,1935,1889,46,2.4
CN2910300000000,29,103,Knox County, MO,Dec-17,1905,1851,54,2.8
CN2910300000000,29,103,Knox County, MO,Jan-18,1942,1865,77,4.0
CN2910300000000,29,103,Knox County, MO,Feb-18,1956,1878,78,4.0
CN2910300000000,29,103,Knox County, MO,Mar-18,1964,1885,79,4.0
CN2910300000000,29,103,Knox County, MO,Apr-18(p),1984,1934,50,2.5
CN2714300000000,27,143,Sibley County, MN,Mar-17,8571,8138,433,5.1
CN2714300000000,27,143,Sibley County, MN,Apr-17,8559,8244,315,3.7
CN2714300000000,27,143,Sibley County, MN,May-17,8480,8234,246,2.9
CN2714300000000,27,143,Sibley County, MN,Jun-17,8466,8198,268,3.2
CN2714300000000,27,143,Sibley County, MN,Jul-17,8506,8258,248,2.9
CN2714300000000,27,143,Sibley County, MN,Aug-17,8349,8111,238,2.9
CN2714300000000,27,143,Sibley County, MN,Sep-17,8291,8080,211,2.5
CN2714300000000,27,143,Sibley County, MN,Oct-17,8599,8421,178,2.1
CN2714300000000,27,143,Sibley County, MN,Nov-17,8508,8302,206,2.4
CN2714300000000,27,143,Sibley County, MN,Dec-17,8555,8215,340,4.0
CN2714300000000,27,143,Sibley County, MN,Jan-18,8617,8192,425,4.9
CN2714300000000,27,143,Sibley County, MN,Feb-18,8659,8247,412,4.8
CN2714300000000,27,143,Sibley County, MN,Mar-18,8640,8252,388,4.5
CN2714300000000,27,143,Sibley County, MN,Apr-18(p),8635,8335,300,3.5
CN1804900000000,18,049,Fulton County, IN,Mar-17,9693,9335,358,3.7
CN1804900000000,18,049,Fulton County, IN,Apr-17,9671,9383,288,3.0
CN1804900000000,18,049,Fulton County, IN,May-17,10070,9771,299,3.0
CN1804900000000,18,049,Fulton County, IN,Jun-17,10045,9714,331,3.3
CN1804900000000,18,049,Fulton County, IN,Jul-17,9996,9664,332,3.3
CN1804900000000,18,049,Fulton County, IN,Aug-17,9812,9442,370,3.8
CN1804900000000,18,049,Fulton County, IN,Sep-17,9652,9348,304,3.1
CN1804900000000,18,049,Fulton County, IN,Oct-17,9549,9267,282,3.0
CN1804900000000,18,049,Fulton County, IN,Nov-17,9590,9295,295,3.1
CN1804900000000,18,049,Fulton County, IN,Dec-17,9392,9104,288,3.1
CN1804900000000,18,049,Fulton County, IN,Jan-18,9171,8800,371,4.0
CN1804900000000,18,049,Fulton County, IN,Feb-18,9444,9049,395,4.2
CN1804900000000,18,049,Fulton County, IN,Mar-18,9556,9229,327,3.4
CN1804900000000,18,049,Fulton County, IN,Apr-18(p),9585,9301,284,3.0
CN0215000000000,02,150,Kodiak Island Borough, AK,Mar-17,6615,6306,309,4.7
CN0215000000000,02,150,Kodiak Island Borough, AK,Apr-17,6311,5996,315,5.0
CN0215000000000,02,150,Kodiak Island Borough, AK,May-17,6134,5823,311,5.1
CN0215000000000,02,150,Kodiak Island Borough, AK,Jun-17,6376,6032,344,5.4
CN0215000000000,02,150,Kodiak Island Borough, AK,Jul-17,6815,6481,334,4.9
CN0215000000000,02,150,Kodiak Island Borough, AK,Aug-17,6870,6592,278,4.0
CN0215000000000,02,150,Kodiak Island Borough, AK,Sep-17,6519,6212,307,4.7
CN0215000000000,02,150,Kodiak Island Borough, AK,Oct-17,6615,6294,321,4.9
CN0215000000000,02,150,Kodiak Island Borough, AK,Nov-17,6356,6055,301,4.7
CN0215000000000,02,150,Kodiak Island Borough, AK,Dec-17,6200,5752,448,7.2
CN0215000000000,02,150,Kodiak Island Borough, AK,Jan-18,6291,5765,526,8.4
CN0215000000000,02,150,Kodiak Island Borough, AK,Feb-18,6679,6316,363,5.4
CN0215000000000,02,150,Kodiak Island Borough, AK,Mar-18,6734,6397,337,5.0
CN0215000000000,02,150,Kodiak Island Borough, AK,Apr-18(p),6415,6027,388,6.0
CN5109300000000,51,093,Isle of Wight County, VA,Mar-17,19043,18277,766,4.0
CN5109300000000,51,093,Isle of Wight County, VA,Apr-17,19172,18481,691,3.6
CN5109300000000,51,093,Isle of Wight County, VA,May-17,19175,18448,727,3.8
CN5109300000000,51,093,Isle of Wight County, VA,Jun-17,19421,18661,760,3.9
CN5109300000000,51,093,Isle of Wight County, VA,Jul-17,19574,18773,801,4.1
CN5109300000000,51,093,Isle of Wight County, VA,Aug-17,19346,18516,830,4.3
CN5109300000000,51,093,Isle of Wight County, VA,Sep-17,19231,18502,729,3.8
CN5109300000000,51,093,Isle of Wight County, VA,Oct-17,18977,18310,667,3.5
CN5109300000000,51,093,Isle of Wight County, VA,Nov-17,18866,18205,661,3.5
CN5109300000000,51,093,Isle of Wight County, VA,Dec-17,18843,18186,657,3.5
CN5109300000000,51,093,Isle of Wight County, VA,Jan-18,18686,17983,703,3.8
CN5109300000000,51,093,Isle of Wight County, VA,Feb-18,18928,18311,617,3.3
CN5109300000000,51,093,Isle of Wight County, VA,Mar-18,19022,18404,618,3.2
CN5109300000000,51,093,Isle of Wight County, VA,Apr-18(p),19107,18593,514,2.7
CN1800100000000,18,001,Adams County, IN,Mar-17,17144,16652,492,2.9
CN1800100000000,18,001,Adams County, IN,Apr-17,17186,16816,370,2.2
CN1800100000000,18,001,Adams County, IN,May-17,17643,17250,393,2.2
CN1800100000000,18,001,Adams County, IN,Jun-17,17685,17232,453,2.6
CN1800100000000,18,001,Adams County, IN,Jul-17,17367,16903,464,2.7
CN1800100000000,18,001,Adams County, IN,Aug-17,17252,16720,532,3.1
CN1800100000000,18,001,Adams County, IN,Sep-17,17221,16810,411,2.4
CN1800100000000,18,001,Adams County, IN,Oct-17,17252,16872,380,2.2
CN1800100000000,18,001,Adams County, IN,Nov-17,17261,16848,413,2.4
CN1800100000000,18,001,Adams County, IN,Dec-17,17077,16710,367,2.1
CN1800100000000,18,001,Adams County, IN,Jan-18,16923,16466,457,2.7
CN1800100000000,18,001,Adams County, IN,Feb-18,17117,16639,478,2.8
CN1800100000000,18,001,Adams County, IN,Mar-18,17288,16860,428,2.5
CN1800100000000,18,001,Adams County, IN,Apr-18(p),17421,17036,385,2.2
CN2116900000000,21,169,Metcalfe County, KY,Mar-17,4249,4053,196,4.6
CN2116900000000,21,169,Metcalfe County, KY,Apr-17,4303,4130,173,4.0
CN2116900000000,21,169,Metcalfe County, KY,May-17,4298,4121,177,4.1
CN2116900000000,21,169,Metcalfe County, KY,Jun-17,4290,4089,201,4.7
CN2116900000000,21,169,Metcalfe County, KY,Jul-17,4152,3957,195,4.7
CN2116900000000,21,169,Metcalfe County, KY,Aug-17,4077,3917,160,3.9
CN2116900000000,21,169,Metcalfe County, KY,Sep-17,4065,3921,144,3.5
CN2116900000000,21,169,Metcalfe County, KY,Oct-17,4100,3963,137,3.3
CN2116900000000,21,169,Metcalfe County, KY,Nov-17,4093,3958,135,3.3
CN2116900000000,21,169,Metcalfe County, KY,Dec-17,4087,3955,132,3.2
CN2116900000000,21,169,Metcalfe County, KY,Jan-18,4161,3995,166,4.0
CN2116900000000,21,169,Metcalfe County, KY,Feb-18,4168,3970,198,4.8
CN2116900000000,21,169,Metcalfe County, KY,Mar-18,4227,4043,184,4.4
CN2116900000000,21,169,Metcalfe County, KY,Apr-18(p),4250,4090,160,3.8
CN5407900000000,54,079,Putnam County, WV,Mar-17,25760,24483,1277,5.0
CN5407900000000,54,079,Putnam County, WV,Apr-17,25988,24821,1167,4.5
CN5407900000000,54,079,Putnam County, WV,May-17,25974,24876,1098,4.2
CN5407900000000,54,079,Putnam County, WV,Jun-17,26206,24938,1268,4.8
CN5407900000000,54,079,Putnam County, WV,Jul-17,26111,24919,1192,4.6
CN5407900000000,54,079,Putnam County, WV,Aug-17,26103,24840,1263,4.8
CN5407900000000,54,079,Putnam County, WV,Sep-17,26312,25207,1105,4.2
CN5407900000000,54,079,Putnam County, WV,Oct-17,26221,25118,1103,4.2
CN5407900000000,54,079,Putnam County, WV,Nov-17,26120,24902,1218,4.7
CN5407900000000,54,079,Putnam County, WV,Dec-17,25932,24698,1234,4.8
CN5407900000000,54,079,Putnam County, WV,Jan-18,25766,24393,1373,5.3
CN5407900000000,54,079,Putnam County, WV,Feb-18,26110,24566,1544,5.9
CN5407900000000,54,079,Putnam County, WV,Mar-18,25832,24367,1465,5.7
CN5407900000000,54,079,Putnam County, WV,Apr-18(p),25939,24648,1291,5.0
CN1918100000000,19,181,Warren County, IA,Mar-17,27235,26361,874,3.2
CN1918100000000,19,181,Warren County, IA,Apr-17,27127,26411,716,2.6
CN1918100000000,19,181,Warren County, IA,May-17,27155,26455,700,2.6
CN1918100000000,19,181,Warren County, IA,Jun-17,27636,26847,789,2.9
CN1918100000000,19,181,Warren County, IA,Jul-17,27772,27038,734,2.6
CN1918100000000,19,181,Warren County, IA,Aug-17,27460,26728,732,2.7
CN1918100000000,19,181,Warren County, IA,Sep-17,27151,26502,649,2.4
CN1918100000000,19,181,Warren County, IA,Oct-17,27109,26569,540,2.0
CN1918100000000,19,181,Warren County, IA,Nov-17,27226,26646,580,2.1
CN1918100000000,19,181,Warren County, IA,Dec-17,27124,26480,644,2.4
CN1918100000000,19,181,Warren County, IA,Jan-18,27242,26343,899,3.3
CN1918100000000,19,181,Warren County, IA,Feb-18,27319,26428,891,3.3
CN1918100000000,19,181,Warren County, IA,Mar-18,27296,26538,758,2.8
CN1918100000000,19,181,Warren County, IA,Apr-18(p),27430,26833,597,2.2
CN2605300000000,26,053,Gogebic County, MI,Mar-17,6453,6050,403,6.2
CN2605300000000,26,053,Gogebic County, MI,Apr-17,6185,5777,408,6.6
CN2605300000000,26,053,Gogebic County, MI,May-17,6238,5850,388,6.2
CN2605300000000,26,053,Gogebic County, MI,Jun-17,6350,5956,394,6.2
CN2605300000000,26,053,Gogebic County, MI,Jul-17,6252,5828,424,6.8
CN2605300000000,26,053,Gogebic County, MI,Aug-17,6233,5845,388,6.2
CN2605300000000,26,053,Gogebic County, MI,Sep-17,6166,5835,331,5.4
CN2605300000000,26,053,Gogebic County, MI,Oct-17,6162,5850,312,5.1
CN2605300000000,26,053,Gogebic County, MI,Nov-17,6125,5797,328,5.4
CN2605300000000,26,053,Gogebic County, MI,Dec-17,6284,5889,395,6.3
CN2605300000000,26,053,Gogebic County, MI,Jan-18,6412,6032,380,5.9
CN2605300000000,26,053,Gogebic County, MI,Feb-18,6475,6079,396,6.1
CN2605300000000,26,053,Gogebic County, MI,Mar-18,6445,6059,386,6.0
CN2605300000000,26,053,Gogebic County, MI,Apr-18(p),6194,5784,410,6.6
CN3500500000000,35,005,Chaves County, NM,Mar-17,27456,25633,1823,6.6
CN3500500000000,35,005,Chaves County, NM,Apr-17,27202,25593,1609,5.9
CN3500500000000,35,005,Chaves County, NM,May-17,27075,25427,1648,6.1
CN3500500000000,35,005,Chaves County, NM,Jun-17,27246,25285,1961,7.2
CN3500500000000,35,005,Chaves County, NM,Jul-17,27241,25263,1978,7.3
CN3500500000000,35,005,Chaves County, NM,Aug-17,27067,25296,1771,6.5
CN3500500000000,35,005,Chaves County, NM,Sep-17,27114,25428,1686,6.2
CN3500500000000,35,005,Chaves County, NM,Oct-17,27157,25551,1606,5.9
CN3500500000000,35,005,Chaves County, NM,Nov-17,27235,25664,1571,5.8
CN3500500000000,35,005,Chaves County, NM,Dec-17,27305,25801,1504,5.5
CN3500500000000,35,005,Chaves County, NM,Jan-18,27417,25880,1537,5.6
CN3500500000000,35,005,Chaves County, NM,Feb-18,27180,25723,1457,5.4
CN3500500000000,35,005,Chaves County, NM,Mar-18,27029,25715,1314,4.9
CN3500500000000,35,005,Chaves County, NM,Apr-18(p),26886,25761,1125,4.2
CN1717100000000,17,171,Scott County, IL,Mar-17,2467,2327,140,5.7
CN1717100000000,17,171,Scott County, IL,Apr-17,2485,2380,105,4.2
CN1717100000000,17,171,Scott County, IL,May-17,2481,2389,92,3.7
CN1717100000000,17,171,Scott County, IL,Jun-17,2511,2412,99,3.9
CN1717100000000,17,171,Scott County, IL,Jul-17,2449,2342,107,4.4
CN1717100000000,17,171,Scott County, IL,Aug-17,2439,2331,108,4.4
CN1717100000000,17,171,Scott County, IL,Sep-17,2444,2343,101,4.1
CN1717100000000,17,171,Scott County, IL,Oct-17,2433,2332,101,4.2
CN1717100000000,17,171,Scott County, IL,Nov-17,2424,2312,112,4.6
CN1717100000000,17,171,Scott County, IL,Dec-17,2445,2296,149,6.1
CN1717100000000,17,171,Scott County, IL,Jan-18,2412,2253,159,6.6
CN1717100000000,17,171,Scott County, IL,Feb-18,2432,2284,148,6.1
CN1717100000000,17,171,Scott County, IL,Mar-18,2494,2359,135,5.4
CN1717100000000,17,171,Scott County, IL,Apr-18(p),2528,2423,105,4.2
CN4828300000000,48,283,La Salle County, TX,Mar-17,3967,3793,174,4.4
CN4828300000000,48,283,La Salle County, TX,Apr-17,4099,3939,160,3.9
CN4828300000000,48,283,La Salle County, TX,May-17,4397,4242,155,3.5
CN4828300000000,48,283,La Salle County, TX,Jun-17,4536,4377,159,3.5
CN4828300000000,48,283,La Salle County, TX,Jul-17,4434,4268,166,3.7
CN4828300000000,48,283,La Salle County, TX,Aug-17,4282,4128,154,3.6
CN4828300000000,48,283,La Salle County, TX,Sep-17,4290,4160,130,3.0
CN4828300000000,48,283,La Salle County, TX,Oct-17,4236,4119,117,2.8
CN4828300000000,48,283,La Salle County, TX,Nov-17,4226,4108,118,2.8
CN4828300000000,48,283,La Salle County, TX,Dec-17,4181,4067,114,2.7
CN4828300000000,48,283,La Salle County, TX,Jan-18,4302,4168,134,3.1
CN4828300000000,48,283,La Salle County, TX,Feb-18,4185,4058,127,3.0
CN4828300000000,48,283,La Salle County, TX,Mar-18,4200,4080,120,2.9
CN4828300000000,48,283,La Salle County, TX,Apr-18(p),4387,4272,115,2.6
CN5171000000000,51,710,Norfolk city, VA,Mar-17,111586,106328,5258,4.7
CN5171000000000,51,710,Norfolk city, VA,Apr-17,111914,107093,4821,4.3
CN5171000000000,51,710,Norfolk city, VA,May-17,112079,107056,5023,4.5
CN5171000000000,51,710,Norfolk city, VA,Jun-17,113166,107676,5490,4.9
CN5171000000000,51,710,Norfolk city, VA,Jul-17,114204,108635,5569,4.9
CN5171000000000,51,710,Norfolk city, VA,Aug-17,113239,107597,5642,5.0
CN5171000000000,51,710,Norfolk city, VA,Sep-17,112296,107307,4989,4.4
CN5171000000000,51,710,Norfolk city, VA,Oct-17,111240,106576,4664,4.2
CN5171000000000,51,710,Norfolk city, VA,Nov-17,110410,105750,4660,4.2
CN5171000000000,51,710,Norfolk city, VA,Dec-17,109697,105044,4653,4.2
CN5171000000000,51,710,Norfolk city, VA,Jan-18,109578,104729,4849,4.4
CN5171000000000,51,710,Norfolk city, VA,Feb-18,110859,106361,4498,4.1
CN5171000000000,51,710,Norfolk city, VA,Mar-18,111640,107184,4456,4.0
CN5171000000000,51,710,Norfolk city, VA,Apr-18(p),111528,107717,3811,3.4
CN4825300000000,48,253,Jones County, TX,Mar-17,5690,5403,287,5.0
CN4825300000000,48,253,Jones County, TX,Apr-17,5698,5409,289,5.1
CN4825300000000,48,253,Jones County, TX,May-17,5702,5393,309,5.4
CN4825300000000,48,253,Jones County, TX,Jun-17,5649,5336,313,5.5
CN4825300000000,48,253,Jones County, TX,Jul-17,5576,5253,323,5.8
CN4825300000000,48,253,Jones County, TX,Aug-17,5605,5291,314,5.6
CN4825300000000,48,253,Jones County, TX,Sep-17,5612,5337,275,4.9
CN4825300000000,48,253,Jones County, TX,Oct-17,5631,5362,269,4.8
CN4825300000000,48,253,Jones County, TX,Nov-17,5639,5357,282,5.0
CN4825300000000,48,253,Jones County, TX,Dec-17,5627,5361,266,4.7
CN4825300000000,48,253,Jones County, TX,Jan-18,5611,5311,300,5.3
CN4825300000000,48,253,Jones County, TX,Feb-18,5729,5427,302,5.3
CN4825300000000,48,253,Jones County, TX,Mar-18,5787,5498,289,5.0
CN4825300000000,48,253,Jones County, TX,Apr-18(p),5750,5481,269,4.7
CN7212900000000,72,129,San Lorenzo Municipio, PR,Mar-17,12144,10590,1554,12.8
CN7212900000000,72,129,San Lorenzo Municipio, PR,Apr-17,12134,10469,1665,13.7
CN7212900000000,72,129,San Lorenzo Municipio, PR,May-17,11908,10440,1468,12.3
CN7212900000000,72,129,San Lorenzo Municipio, PR,Jun-17,11774,10388,1386,11.8
CN7212900000000,72,129,San Lorenzo Municipio, PR,Jul-17,11861,10364,1497,12.6
CN7212900000000,72,129,San Lorenzo Municipio, PR,Aug-17,11926,10225,1701,14.3
CN7212900000000,72,129,San Lorenzo Municipio, PR,Sep-17(y),11950,10315,1635,13.7
CN7212900000000,72,129,San Lorenzo Municipio, PR,Oct-17,11469,9892,1577,13.8
CN7212900000000,72,129,San Lorenzo Municipio, PR,Nov-17,11910,10461,1449,12.2
CN7212900000000,72,129,San Lorenzo Municipio, PR,Dec-17,11929,10532,1397,11.7
CN7212900000000,72,129,San Lorenzo Municipio, PR,Jan-18,11739,10325,1414,12.0
CN7212900000000,72,129,San Lorenzo Municipio, PR,Feb-18,11645,10355,1290,11.1
CN7212900000000,72,129,San Lorenzo Municipio, PR,Mar-18,11622,10373,1249,10.7
CN7212900000000,72,129,San Lorenzo Municipio, PR,Apr-18(p),11616,10430,1186,10.2
CN2112100000000,21,121,Knox County, KY,Mar-17,10336,9494,842,8.1
CN2112100000000,21,121,Knox County, KY,Apr-17,10172,9449,723,7.1
CN2112100000000,21,121,Knox County, KY,May-17,10236,9425,811,7.9
CN2112100000000,21,121,Knox County, KY,Jun-17,10397,9496,901,8.7
CN2112100000000,21,121,Knox County, KY,Jul-17,10341,9500,841,8.1
CN2112100000000,21,121,Knox County, KY,Aug-17,10179,9390,789,7.8
CN2112100000000,21,121,Knox County, KY,Sep-17,10241,9523,718,7.0
CN2112100000000,21,121,Knox County, KY,Oct-17,10088,9442,646,6.4
CN2112100000000,21,121,Knox County, KY,Nov-17,10068,9438,630,6.3
CN2112100000000,21,121,Knox County, KY,Dec-17,10075,9462,613,6.1
CN2112100000000,21,121,Knox County, KY,Jan-18,10072,9441,631,6.3
CN2112100000000,21,121,Knox County, KY,Feb-18,10241,9534,707,6.9
CN2112100000000,21,121,Knox County, KY,Mar-18,10349,9682,667,6.4
CN2112100000000,21,121,Knox County, KY,Apr-18(p),10282,9688,594,5.8
CN1807900000000,18,079,Jennings County, IN,Mar-17,13242,12682,560,4.2
CN1807900000000,18,079,Jennings County, IN,Apr-17,13181,12766,415,3.1
CN1807900000000,18,079,Jennings County, IN,May-17,13247,12795,452,3.4
CN1807900000000,18,079,Jennings County, IN,Jun-17,13361,12889,472,3.5
CN1807900000000,18,079,Jennings County, IN,Jul-17,13322,12833,489,3.7
CN1807900000000,18,079,Jennings County, IN,Aug-17,13279,12728,551,4.1
CN1807900000000,18,079,Jennings County, IN,Sep-17,13145,12708,437,3.3
CN1807900000000,18,079,Jennings County, IN,Oct-17,12966,12537,429,3.3
CN1807900000000,18,079,Jennings County, IN,Nov-17,12983,12534,449,3.5
CN1807900000000,18,079,Jennings County, IN,Dec-17,12890,12438,452,3.5
CN1807900000000,18,079,Jennings County, IN,Jan-18,12762,12183,579,4.5
CN1807900000000,18,079,Jennings County, IN,Feb-18,13027,12418,609,4.7
CN1807900000000,18,079,Jennings County, IN,Mar-18,13173,12657,516,3.9
CN1807900000000,18,079,Jennings County, IN,Apr-18(p),13212,12795,417,3.2
CN2706700000000,27,067,Kandiyohi County, MN,Mar-17,24667,23564,1103,4.5
CN2706700000000,27,067,Kandiyohi County, MN,Apr-17,24756,23952,804,3.2
CN2706700000000,27,067,Kandiyohi County, MN,May-17,24884,24205,679,2.7
CN2706700000000,27,067,Kandiyohi County, MN,Jun-17,25183,24447,736,2.9
CN2706700000000,27,067,Kandiyohi County, MN,Jul-17,24871,24199,672,2.7
CN2706700000000,27,067,Kandiyohi County, MN,Aug-17,24740,24057,683,2.8
CN2706700000000,27,067,Kandiyohi County, MN,Sep-17,24546,24007,539,2.2
CN2706700000000,27,067,Kandiyohi County, MN,Oct-17,24792,24336,456,1.8
CN2706700000000,27,067,Kandiyohi County, MN,Nov-17,24836,24221,615,2.5
CN2706700000000,27,067,Kandiyohi County, MN,Dec-17,25012,24103,909,3.6
CN2706700000000,27,067,Kandiyohi County, MN,Jan-18,25223,24091,1132,4.5
CN2706700000000,27,067,Kandiyohi County, MN,Feb-18,25202,24105,1097,4.4
CN2706700000000,27,067,Kandiyohi County, MN,Mar-18,25282,24191,1091,4.3
CN2706700000000,27,067,Kandiyohi County, MN,Apr-18(p),25406,24559,847,3.3
CN5403100000000,54,031,Hardy County, WV,Mar-17,5907,5595,312,5.3
CN5403100000000,54,031,Hardy County, WV,Apr-17,5899,5657,242,4.1
CN5403100000000,54,031,Hardy County, WV,May-17,5820,5580,240,4.1
CN5403100000000,54,031,Hardy County, WV,Jun-17,5933,5629,304,5.1
CN5403100000000,54,031,Hardy County, WV,Jul-17,5833,5537,296,5.1
CN5403100000000,54,031,Hardy County, WV,Aug-17,5814,5538,276,4.7
CN5403100000000,54,031,Hardy County, WV,Sep-17,5801,5555,246,4.2
CN5403100000000,54,031,Hardy County, WV,Oct-17,5791,5548,243,4.2
CN5403100000000,54,031,Hardy County, WV,Nov-17,5695,5435,260,4.6
CN5403100000000,54,031,Hardy County, WV,Dec-17,5634,5310,324,5.8
CN5403100000000,54,031,Hardy County, WV,Jan-18,5829,5467,362,6.2
CN5403100000000,54,031,Hardy County, WV,Feb-18,5913,5506,407,6.9
CN5403100000000,54,031,Hardy County, WV,Mar-18,5805,5440,365,6.3
CN5403100000000,54,031,Hardy County, WV,Apr-18(p),5785,5495,290,5.0
CN2201100000000,22,011,Beauregard Parish, LA,Mar-17,14622,13840,782,5.3
CN2201100000000,22,011,Beauregard Parish, LA,Apr-17,14924,14143,781,5.2
CN2201100000000,22,011,Beauregard Parish, LA,May-17,14956,14142,814,5.4
CN2201100000000,22,011,Beauregard Parish, LA,Jun-17,15069,14202,867,5.8
CN2201100000000,22,011,Beauregard Parish, LA,Jul-17,14894,14022,872,5.9
CN2201100000000,22,011,Beauregard Parish, LA,Aug-17,14745,13896,849,5.8
CN2201100000000,22,011,Beauregard Parish, LA,Sep-17,14647,13857,790,5.4
CN2201100000000,22,011,Beauregard Parish, LA,Oct-17,14915,14275,640,4.3
CN2201100000000,22,011,Beauregard Parish, LA,Nov-17,14891,14237,654,4.4
CN2201100000000,22,011,Beauregard Parish, LA,Dec-17,14553,13923,630,4.3
CN2201100000000,22,011,Beauregard Parish, LA,Jan-18,14750,14023,727,4.9
CN2201100000000,22,011,Beauregard Parish, LA,Feb-18,14569,13944,625,4.3
CN2201100000000,22,011,Beauregard Parish, LA,Mar-18,14632,13971,661,4.5
CN2201100000000,22,011,Beauregard Parish, LA,Apr-18(p),14820,14120,700,4.7
CN3916500000000,39,165,Warren County, OH,Mar-17,115377,110702,4675,4.1
CN3916500000000,39,165,Warren County, OH,Apr-17,115415,111223,4192,3.6
CN3916500000000,39,165,Warren County, OH,May-17,116561,112211,4350,3.7
CN3916500000000,39,165,Warren County, OH,Jun-17,118028,112901,5127,4.3
CN3916500000000,39,165,Warren County, OH,Jul-17,118380,113228,5152,4.4
CN3916500000000,39,165,Warren County, OH,Aug-17,117749,112646,5103,4.3
CN3916500000000,39,165,Warren County, OH,Sep-17,116951,112309,4642,4.0
CN3916500000000,39,165,Warren County, OH,Oct-17,116733,112271,4462,3.8
CN3916500000000,39,165,Warren County, OH,Nov-17,116222,111786,4436,3.8
CN3916500000000,39,165,Warren County, OH,Dec-17,115827,111399,4428,3.8
CN3916500000000,39,165,Warren County, OH,Jan-18,114057,109454,4603,4.0
CN3916500000000,39,165,Warren County, OH,Feb-18,115514,111062,4452,3.9
CN3916500000000,39,165,Warren County, OH,Mar-18,116744,112572,4172,3.6
CN3916500000000,39,165,Warren County, OH,Apr-18(p),116475,112516,3959,3.4
CN2000700000000,20,007,Barber County, KS,Mar-17,2441,2374,67,2.7
CN2000700000000,20,007,Barber County, KS,Apr-17,2419,2354,65,2.7
CN2000700000000,20,007,Barber County, KS,May-17,2419,2347,72,3.0
CN2000700000000,20,007,Barber County, KS,Jun-17,2553,2476,77,3.0
CN2000700000000,20,007,Barber County, KS,Jul-17,2455,2372,83,3.4
CN2000700000000,20,007,Barber County, KS,Aug-17,2453,2362,91,3.7
CN2000700000000,20,007,Barber County, KS,Sep-17,2519,2452,67,2.7
CN2000700000000,20,007,Barber County, KS,Oct-17,2563,2507,56,2.2
CN2000700000000,20,007,Barber County, KS,Nov-17,2508,2447,61,2.4
CN2000700000000,20,007,Barber County, KS,Dec-17,2493,2437,56,2.2
CN2000700000000,20,007,Barber County, KS,Jan-18,2426,2368,58,2.4
CN2000700000000,20,007,Barber County, KS,Feb-18,2417,2353,64,2.6
CN2000700000000,20,007,Barber County, KS,Mar-18,2373,2313,60,2.5
CN2000700000000,20,007,Barber County, KS,Apr-18(p),2291,2228,63,2.7
CN0218000000000,02,180,Nome Census Area, AK,Mar-17,4180,3671,509,12.2
CN0218000000000,02,180,Nome Census Area, AK,Apr-17,4105,3576,529,12.9
CN0218000000000,02,180,Nome Census Area, AK,May-17,4026,3490,536,13.3
CN0218000000000,02,180,Nome Census Area, AK,Jun-17,4167,3585,582,14.0
CN0218000000000,02,180,Nome Census Area, AK,Jul-17,3898,3354,544,14.0
CN0218000000000,02,180,Nome Census Area, AK,Aug-17,3861,3343,518,13.4
CN0218000000000,02,180,Nome Census Area, AK,Sep-17,4203,3736,467,11.1
CN0218000000000,02,180,Nome Census Area, AK,Oct-17,4091,3637,454,11.1
CN0218000000000,02,180,Nome Census Area, AK,Nov-17,4072,3592,480,11.8
CN0218000000000,02,180,Nome Census Area, AK,Dec-17,4106,3628,478,11.6
CN0218000000000,02,180,Nome Census Area, AK,Jan-18,4117,3579,538,13.1
CN0218000000000,02,180,Nome Census Area, AK,Feb-18,4215,3640,575,13.6
CN0218000000000,02,180,Nome Census Area, AK,Mar-18,4206,3647,559,13.3
CN0218000000000,02,180,Nome Census Area, AK,Apr-18(p),4080,3536,544,13.3
CN3117100000000,31,171,Thomas County, NE,Mar-17,415,401,14,3.4
CN3117100000000,31,171,Thomas County, NE,Apr-17,426,409,17,4.0
CN3117100000000,31,171,Thomas County, NE,May-17,442,426,16,3.6
CN3117100000000,31,171,Thomas County, NE,Jun-17,471,458,13,2.8
CN3117100000000,31,171,Thomas County, NE,Jul-17,474,462,12,2.5
CN3117100000000,31,171,Thomas County, NE,Aug-17,462,447,15,3.2
CN3117100000000,31,171,Thomas County, NE,Sep-17,454,443,11,2.4
CN3117100000000,31,171,Thomas County, NE,Oct-17,444,435,9,2.0
CN3117100000000,31,171,Thomas County, NE,Nov-17,449,436,13,2.9
CN3117100000000,31,171,Thomas County, NE,Dec-17,440,426,14,3.2
CN3117100000000,31,171,Thomas County, NE,Jan-18,446,432,14,3.1
CN3117100000000,31,171,Thomas County, NE,Feb-18,426,411,15,3.5
CN3117100000000,31,171,Thomas County, NE,Mar-18,438,424,14,3.2
CN3117100000000,31,171,Thomas County, NE,Apr-18(p),437,426,11,2.5
CN4811100000000,48,111,Dallam County, TX,Mar-17,4094,4010,84,2.1
CN4811100000000,48,111,Dallam County, TX,Apr-17,4131,4058,73,1.8
CN4811100000000,48,111,Dallam County, TX,May-17,4150,4066,84,2.0
CN4811100000000,48,111,Dallam County, TX,Jun-17,4147,4053,94,2.3
CN4811100000000,48,111,Dallam County, TX,Jul-17,4054,3953,101,2.5
CN4811100000000,48,111,Dallam County, TX,Aug-17,4052,3958,94,2.3
CN4811100000000,48,111,Dallam County, TX,Sep-17,4005,3924,81,2.0
CN4811100000000,48,111,Dallam County, TX,Oct-17,4104,4026,78,1.9
CN4811100000000,48,111,Dallam County, TX,Nov-17,4035,3957,78,1.9
CN4811100000000,48,111,Dallam County, TX,Dec-17,4025,3952,73,1.8
CN4811100000000,48,111,Dallam County, TX,Jan-18,4010,3931,79,2.0
CN4811100000000,48,111,Dallam County, TX,Feb-18,4097,4010,87,2.1
CN4811100000000,48,111,Dallam County, TX,Mar-18,4224,4135,89,2.1
CN4811100000000,48,111,Dallam County, TX,Apr-18(p),4273,4200,73,1.7
CN2605900000000,26,059,Hillsdale County, MI,Mar-17,21051,20048,1003,4.8
CN2605900000000,26,059,Hillsdale County, MI,Apr-17,20900,20069,831,4.0
CN2605900000000,26,059,Hillsdale County, MI,May-17,21025,20129,896,4.3
CN2605900000000,26,059,Hillsdale County, MI,Jun-17,21408,20340,1068,5.0
CN2605900000000,26,059,Hillsdale County, MI,Jul-17,21478,20096,1382,6.4
CN2605900000000,26,059,Hillsdale County, MI,Aug-17,21171,19947,1224,5.8
CN2605900000000,26,059,Hillsdale County, MI,Sep-17,21015,20010,1005,4.8
CN2605900000000,26,059,Hillsdale County, MI,Oct-17,20970,20062,908,4.3
CN2605900000000,26,059,Hillsdale County, MI,Nov-17,21087,20176,911,4.3
CN2605900000000,26,059,Hillsdale County, MI,Dec-17,20979,20049,930,4.4
CN2605900000000,26,059,Hillsdale County, MI,Jan-18,20951,19846,1105,5.3
CN2605900000000,26,059,Hillsdale County, MI,Feb-18,21231,20157,1074,5.1
CN2605900000000,26,059,Hillsdale County, MI,Mar-18,21233,20275,958,4.5
CN2605900000000,26,059,Hillsdale County, MI,Apr-18(p),21151,20314,837,4.0
CN3504700000000,35,047,San Miguel County, NM,Mar-17,11066,10236,830,7.5
CN3504700000000,35,047,San Miguel County, NM,Apr-17,11024,10266,758,6.9
CN3504700000000,35,047,San Miguel County, NM,May-17,10942,10190,752,6.9
CN3504700000000,35,047,San Miguel County, NM,Jun-17,10722,9807,915,8.5
CN3504700000000,35,047,San Miguel County, NM,Jul-17,10708,9823,885,8.3
CN3504700000000,35,047,San Miguel County, NM,Aug-17,10661,9835,826,7.7
CN3504700000000,35,047,San Miguel County, NM,Sep-17,10913,10129,784,7.2
CN3504700000000,35,047,San Miguel County, NM,Oct-17,10915,10166,749,6.9
CN3504700000000,35,047,San Miguel County, NM,Nov-17,10953,10203,750,6.8
CN3504700000000,35,047,San Miguel County, NM,Dec-17,10568,9827,741,7.0
CN3504700000000,35,047,San Miguel County, NM,Jan-18,10675,9914,761,7.1
CN3504700000000,35,047,San Miguel County, NM,Feb-18,10939,10221,718,6.6
CN3504700000000,35,047,San Miguel County, NM,Mar-18,10892,10223,669,6.1
CN3504700000000,35,047,San Miguel County, NM,Apr-18(p),10883,10312,571,5.2
CN5111300000000,51,113,Madison County, VA,Mar-17,7189,6960,229,3.2
CN5111300000000,51,113,Madison County, VA,Apr-17,7237,7040,197,2.7
CN5111300000000,51,113,Madison County, VA,May-17,7298,7081,217,3.0
CN5111300000000,51,113,Madison County, VA,Jun-17,7446,7221,225,3.0
CN5111300000000,51,113,Madison County, VA,Jul-17,7342,7113,229,3.1
CN5111300000000,51,113,Madison County, VA,Aug-17,7193,6968,225,3.1
CN5111300000000,51,113,Madison County, VA,Sep-17,7326,7123,203,2.8
CN5111300000000,51,113,Madison County, VA,Oct-17,7312,7120,192,2.6
CN5111300000000,51,113,Madison County, VA,Nov-17,7425,7229,196,2.6
CN5111300000000,51,113,Madison County, VA,Dec-17,7404,7217,187,2.5
CN5111300000000,51,113,Madison County, VA,Jan-18,7265,7048,217,3.0
CN5111300000000,51,113,Madison County, VA,Feb-18,7347,7145,202,2.7
CN5111300000000,51,113,Madison County, VA,Mar-18,7342,7140,202,2.8
CN5111300000000,51,113,Madison County, VA,Apr-18(p),7428,7256,172,2.3
CN3603100000000,36,031,Essex County, NY,Mar-17,17354,16209,1145,6.6
CN3603100000000,36,031,Essex County, NY,Apr-17,16574,15499,1075,6.5
CN3603100000000,36,031,Essex County, NY,May-17,16411,15533,878,5.4
CN3603100000000,36,031,Essex County, NY,Jun-17,17606,16762,844,4.8
CN3603100000000,36,031,Essex County, NY,Jul-17,18508,17683,825,4.5
CN3603100000000,36,031,Essex County, NY,Aug-17,18315,17495,820,4.5
CN3603100000000,36,031,Essex County, NY,Sep-17,17287,16514,773,4.5
CN3603100000000,36,031,Essex County, NY,Oct-17,16762,16014,748,4.5
CN3603100000000,36,031,Essex County, NY,Nov-17,16634,15674,960,5.8
CN3603100000000,36,031,Essex County, NY,Dec-17,17075,16006,1069,6.3
CN3603100000000,36,031,Essex County, NY,Jan-18,17801,16544,1257,7.1
CN3603100000000,36,031,Essex County, NY,Feb-18,17574,16275,1299,7.4
CN3603100000000,36,031,Essex County, NY,Mar-18,17062,15851,1211,7.1
CN3603100000000,36,031,Essex County, NY,Apr-18(p),16300,15257,1043,6.4
CN3901700000000,39,017,Butler County, OH,Mar-17,190437,182251,8186,4.3
CN3901700000000,39,017,Butler County, OH,Apr-17,190823,183137,7686,4.0
CN3901700000000,39,017,Butler County, OH,May-17,192553,184898,7655,4.0
CN3901700000000,39,017,Butler County, OH,Jun-17,195410,186086,9324,4.8
CN3901700000000,39,017,Butler County, OH,Jul-17,196158,186719,9439,4.8
CN3901700000000,39,017,Butler County, OH,Aug-17,194800,185565,9235,4.7
CN3901700000000,39,017,Butler County, OH,Sep-17,193207,185023,8184,4.2
CN3901700000000,39,017,Butler County, OH,Oct-17,192929,185028,7901,4.1
CN3901700000000,39,017,Butler County, OH,Nov-17,191977,184166,7811,4.1
CN3901700000000,39,017,Butler County, OH,Dec-17,191416,183617,7799,4.1
CN3901700000000,39,017,Butler County, OH,Jan-18,188586,180383,8203,4.3
CN3901700000000,39,017,Butler County, OH,Feb-18,190892,183039,7853,4.1
CN3901700000000,39,017,Butler County, OH,Mar-18,192751,185464,7287,3.8
CN3901700000000,39,017,Butler County, OH,Apr-18(p),192364,185412,6952,3.6
CN0610700000000,06,107,Tulare County, CA,Mar-17,205222,179437,25785,12.6
CN0610700000000,06,107,Tulare County, CA,Apr-17,211127,189149,21978,10.4
CN0610700000000,06,107,Tulare County, CA,May-17,210220,190724,19496,9.3
CN0610700000000,06,107,Tulare County, CA,Jun-17,208802,188558,20244,9.7
CN0610700000000,06,107,Tulare County, CA,Jul-17,204064,183033,21031,10.3
CN0610700000000,06,107,Tulare County, CA,Aug-17,205251,184819,20432,10.0
CN0610700000000,06,107,Tulare County, CA,Sep-17,204865,186752,18113,8.8
CN0610700000000,06,107,Tulare County, CA,Oct-17,201257,182878,18379,9.1
CN0610700000000,06,107,Tulare County, CA,Nov-17,201885,183180,18705,9.3
CN0610700000000,06,107,Tulare County, CA,Dec-17,202360,181688,20672,10.2
CN0610700000000,06,107,Tulare County, CA,Jan-18,203861,181297,22564,11.1
CN0610700000000,06,107,Tulare County, CA,Feb-18,206880,183317,23563,11.4
CN0610700000000,06,107,Tulare County, CA,Mar-18,204780,182071,22709,11.1
CN0610700000000,06,107,Tulare County, CA,Apr-18(p),209717,190474,19243,9.2
CN2922100000000,29,221,Washington County, MO,Mar-17,10252,9558,694,6.8
CN2922100000000,29,221,Washington County, MO,Apr-17,10216,9669,547,5.4
CN2922100000000,29,221,Washington County, MO,May-17,10191,9662,529,5.2
CN2922100000000,29,221,Washington County, MO,Jun-17,10379,9861,518,5.0
CN2922100000000,29,221,Washington County, MO,Jul-17,9943,9396,547,5.5
CN2922100000000,29,221,Washington County, MO,Aug-17,10047,9493,554,5.5
CN2922100000000,29,221,Washington County, MO,Sep-17,10229,9775,454,4.4
CN2922100000000,29,221,Washington County, MO,Oct-17,10072,9641,431,4.3
CN2922100000000,29,221,Washington County, MO,Nov-17,10002,9587,415,4.1
CN2922100000000,29,221,Washington County, MO,Dec-17,10008,9529,479,4.8
CN2922100000000,29,221,Washington County, MO,Jan-18,10017,9392,625,6.2
CN2922100000000,29,221,Washington County, MO,Feb-18,10164,9544,620,6.1
CN2922100000000,29,221,Washington County, MO,Mar-18,10156,9586,570,5.6
CN2922100000000,29,221,Washington County, MO,Apr-18(p),10179,9705,474,4.7
CN4610700000000,46,107,Potter County, SD,Mar-17,1102,1060,42,3.8
CN4610700000000,46,107,Potter County, SD,Apr-17,1146,1110,36,3.1
CN4610700000000,46,107,Potter County, SD,May-17,1180,1147,33,2.8
CN4610700000000,46,107,Potter County, SD,Jun-17,1237,1206,31,2.5
CN4610700000000,46,107,Potter County, SD,Jul-17,1204,1171,33,2.7
CN4610700000000,46,107,Potter County, SD,Aug-17,1155,1116,39,3.4
CN4610700000000,46,107,Potter County, SD,Sep-17,1125,1091,34,3.0
CN4610700000000,46,107,Potter County, SD,Oct-17,1107,1074,33,3.0
CN4610700000000,46,107,Potter County, SD,Nov-17,1110,1063,47,4.2
CN4610700000000,46,107,Potter County, SD,Dec-17,1138,1089,49,4.3
CN4610700000000,46,107,Potter County, SD,Jan-18,1106,1049,57,5.2
CN4610700000000,46,107,Potter County, SD,Feb-18,1102,1049,53,4.8
CN4610700000000,46,107,Potter County, SD,Mar-18,1134,1081,53,4.7
CN4610700000000,46,107,Potter County, SD,Apr-18(p),1118,1071,47,4.2
CN4818900000000,48,189,Hale County, TX,Mar-17,12824,12093,731,5.7
CN4818900000000,48,189,Hale County, TX,Apr-17,12699,12094,605,4.8
CN4818900000000,48,189,Hale County, TX,May-17,12645,12030,615,4.9
CN4818900000000,48,189,Hale County, TX,Jun-17,12482,11718,764,6.1
CN4818900000000,48,189,Hale County, TX,Jul-17,12246,11491,755,6.2
CN4818900000000,48,189,Hale County, TX,Aug-17,12359,11689,670,5.4
CN4818900000000,48,189,Hale County, TX,Sep-17,12318,11754,564,4.6
CN4818900000000,48,189,Hale County, TX,Oct-17,12275,11754,521,4.2
CN4818900000000,48,189,Hale County, TX,Nov-17,12153,11643,510,4.2
CN4818900000000,48,189,Hale County, TX,Dec-17,12124,11628,496,4.1
CN4818900000000,48,189,Hale County, TX,Jan-18,12072,11516,556,4.6
CN4818900000000,48,189,Hale County, TX,Feb-18,12319,11732,587,4.8
CN4818900000000,48,189,Hale County, TX,Mar-18,12689,11996,693,5.5
CN4818900000000,48,189,Hale County, TX,Apr-18(p),12820,12256,564,4.4
CN4700900000000,47,009,Blount County, TN,Mar-17,61597,59201,2396,3.9
CN4700900000000,47,009,Blount County, TN,Apr-17,61598,59686,1912,3.1
CN4700900000000,47,009,Blount County, TN,May-17,61624,59841,1783,2.9
CN4700900000000,47,009,Blount County, TN,Jun-17,62253,59860,2393,3.8
CN4700900000000,47,009,Blount County, TN,Jul-17,62449,60174,2275,3.6
CN4700900000000,47,009,Blount County, TN,Aug-17,61685,59604,2081,3.4
CN4700900000000,47,009,Blount County, TN,Sep-17,62283,60426,1857,3.0
CN4700900000000,47,009,Blount County, TN,Oct-17,61916,60143,1773,2.9
CN4700900000000,47,009,Blount County, TN,Nov-17,62033,60204,1829,2.9
CN4700900000000,47,009,Blount County, TN,Dec-17,61589,59761,1828,3.0
CN4700900000000,47,009,Blount County, TN,Jan-18,61467,59199,2268,3.7
CN4700900000000,47,009,Blount County, TN,Feb-18,62491,60291,2200,3.5
CN4700900000000,47,009,Blount County, TN,Mar-18,62278,60270,2008,3.2
CN4700900000000,47,009,Blount County, TN,Apr-18(p),62188,60608,1580,2.5
CN1804300000000,18,043,Floyd County, IN,Mar-17,40765,39373,1392,3.4
CN1804300000000,18,043,Floyd County, IN,Apr-17,40945,39785,1160,2.8
CN1804300000000,18,043,Floyd County, IN,May-17,40980,39736,1244,3.0
CN1804300000000,18,043,Floyd County, IN,Jun-17,41801,40430,1371,3.3
CN1804300000000,18,043,Floyd County, IN,Jul-17,42067,40678,1389,3.3
CN1804300000000,18,043,Floyd County, IN,Aug-17,41406,39865,1541,3.7
CN1804300000000,18,043,Floyd County, IN,Sep-17,41192,39917,1275,3.1
CN1804300000000,18,043,Floyd County, IN,Oct-17,40938,39743,1195,2.9
CN1804300000000,18,043,Floyd County, IN,Nov-17,41034,39803,1231,3.0
CN1804300000000,18,043,Floyd County, IN,Dec-17,40950,39741,1209,3.0
CN1804300000000,18,043,Floyd County, IN,Jan-18,40488,39154,1334,3.3
CN1804300000000,18,043,Floyd County, IN,Feb-18,41027,39614,1413,3.4
CN1804300000000,18,043,Floyd County, IN,Mar-18,41421,40151,1270,3.1
CN1804300000000,18,043,Floyd County, IN,Apr-18(p),41788,40641,1147,2.7
CN7206100000000,72,061,Guaynabo Municipio, PR,Mar-17,37556,35549,2007,5.3
CN7206100000000,72,061,Guaynabo Municipio, PR,Apr-17,37449,35337,2112,5.6
CN7206100000000,72,061,Guaynabo Municipio, PR,May-17,36809,35005,1804,4.9
CN7206100000000,72,061,Guaynabo Municipio, PR,Jun-17,36407,34793,1614,4.4
CN7206100000000,72,061,Guaynabo Municipio, PR,Jul-17,36434,34607,1827,5.0
CN7206100000000,72,061,Guaynabo Municipio, PR,Aug-17,36222,34161,2061,5.7
CN7206100000000,72,061,Guaynabo Municipio, PR,Sep-17(y),36640,34645,1995,5.4
CN7206100000000,72,061,Guaynabo Municipio, PR,Oct-17,34965,33167,1798,5.1
CN7206100000000,72,061,Guaynabo Municipio, PR,Nov-17,37125,35313,1812,4.9
CN7206100000000,72,061,Guaynabo Municipio, PR,Dec-17,37406,35672,1734,4.6
CN7206100000000,72,061,Guaynabo Municipio, PR,Jan-18,36786,34992,1794,4.9
CN7206100000000,72,061,Guaynabo Municipio, PR,Feb-18,36686,35029,1657,4.5
CN7206100000000,72,061,Guaynabo Municipio, PR,Mar-18,36658,35035,1623,4.4
CN7206100000000,72,061,Guaynabo Municipio, PR,Apr-18(p),37017,35409,1608,4.3
CN1202100000000,12,021,Collier County, FL,Mar-17,178140,171507,6633,3.7
CN1202100000000,12,021,Collier County, FL,Apr-17,176748,170539,6209,3.5
CN1202100000000,12,021,Collier County, FL,May-17,174070,167664,6406,3.7
CN1202100000000,12,021,Collier County, FL,Jun-17,169821,162730,7091,4.2
CN1202100000000,12,021,Collier County, FL,Jul-17,169435,161818,7617,4.5
CN1202100000000,12,021,Collier County, FL,Aug-17,169344,161440,7904,4.7
CN1202100000000,12,021,Collier County, FL,Sep-17,163836,156272,7564,4.6
CN1202100000000,12,021,Collier County, FL,Oct-17,166744,159767,6977,4.2
CN1202100000000,12,021,Collier County, FL,Nov-17,170952,164320,6632,3.9
CN1202100000000,12,021,Collier County, FL,Dec-17,171696,165627,6069,3.5
CN1202100000000,12,021,Collier County, FL,Jan-18,173981,167239,6742,3.9
CN1202100000000,12,021,Collier County, FL,Feb-18,175077,168991,6086,3.5
CN1202100000000,12,021,Collier County, FL,Mar-18,176269,170304,5965,3.4
CN1202100000000,12,021,Collier County, FL,Apr-18(p),174140,168784,5356,3.1
CN2900900000000,29,009,Barry County, MO,Mar-17,15186,14639,547,3.6
CN2900900000000,29,009,Barry County, MO,Apr-17,15500,15030,470,3.0
CN2900900000000,29,009,Barry County, MO,May-17,15278,14755,523,3.4
CN2900900000000,29,009,Barry County, MO,Jun-17,15326,14796,530,3.5
CN2900900000000,29,009,Barry County, MO,Jul-17,15068,14504,564,3.7
CN2900900000000,29,009,Barry County, MO,Aug-17,14739,14184,555,3.8
CN2900900000000,29,009,Barry County, MO,Sep-17,15134,14664,470,3.1
CN2900900000000,29,009,Barry County, MO,Oct-17,14934,14617,317,2.1
CN2900900000000,29,009,Barry County, MO,Nov-17,14991,14559,432,2.9
CN2900900000000,29,009,Barry County, MO,Dec-17,14798,14328,470,3.2
CN2900900000000,29,009,Barry County, MO,Jan-18,14919,14301,618,4.1
CN2900900000000,29,009,Barry County, MO,Feb-18,15331,14703,628,4.1
CN2900900000000,29,009,Barry County, MO,Mar-18,15236,14677,559,3.7
CN2900900000000,29,009,Barry County, MO,Apr-18(p),15403,14932,471,3.1
CN5104100000000,51,041,Chesterfield County, VA,Mar-17,183885,177099,6786,3.7
CN5104100000000,51,041,Chesterfield County, VA,Apr-17,183757,177517,6240,3.4
CN5104100000000,51,041,Chesterfield County, VA,May-17,184177,177722,6455,3.5
CN5104100000000,51,041,Chesterfield County, VA,Jun-17,185227,178311,6916,3.7
CN5104100000000,51,041,Chesterfield County, VA,Jul-17,186538,179532,7006,3.8
CN5104100000000,51,041,Chesterfield County, VA,Aug-17,184853,177680,7173,3.9
CN5104100000000,51,041,Chesterfield County, VA,Sep-17,185155,178544,6611,3.6
CN5104100000000,51,041,Chesterfield County, VA,Oct-17,184198,178018,6180,3.4
CN5104100000000,51,041,Chesterfield County, VA,Nov-17,182862,176670,6192,3.4
CN5104100000000,51,041,Chesterfield County, VA,Dec-17,181937,175987,5950,3.3
CN5104100000000,51,041,Chesterfield County, VA,Jan-18,182326,175972,6354,3.5
CN5104100000000,51,041,Chesterfield County, VA,Feb-18,184326,178455,5871,3.2
CN5104100000000,51,041,Chesterfield County, VA,Mar-18,185579,179673,5906,3.2
CN5104100000000,51,041,Chesterfield County, VA,Apr-18(p),185550,180424,5126,2.8
CN1306500000000,13,065,Clinch County, GA,Mar-17,2758,2620,138,5.0
CN1306500000000,13,065,Clinch County, GA,Apr-17,3007,2877,130,4.3
CN1306500000000,13,065,Clinch County, GA,May-17,3012,2884,128,4.2
CN1306500000000,13,065,Clinch County, GA,Jun-17,2797,2642,155,5.5
CN1306500000000,13,065,Clinch County, GA,Jul-17,2819,2619,200,7.1
CN1306500000000,13,065,Clinch County, GA,Aug-17,2764,2622,142,5.1
CN1306500000000,13,065,Clinch County, GA,Sep-17,2804,2634,170,6.1
CN1306500000000,13,065,Clinch County, GA,Oct-17,2777,2624,153,5.5
CN1306500000000,13,065,Clinch County, GA,Nov-17,2783,2637,146,5.2
CN1306500000000,13,065,Clinch County, GA,Dec-17,2801,2655,146,5.2
CN1306500000000,13,065,Clinch County, GA,Jan-18,2881,2704,177,6.1
CN1306500000000,13,065,Clinch County, GA,Feb-18,2671,2533,138,5.2
CN1306500000000,13,065,Clinch County, GA,Mar-18,2654,2530,124,4.7
CN1306500000000,13,065,Clinch County, GA,Apr-18(p),2686,2560,126,4.7
CN3600500000000,36,005,Bronx County, NY,Mar-17,623699,585645,38054,6.1
CN3600500000000,36,005,Bronx County, NY,Apr-17,619569,584257,35312,5.7
CN3600500000000,36,005,Bronx County, NY,May-17,618434,582302,36132,5.8
CN3600500000000,36,005,Bronx County, NY,Jun-17,620842,582559,38283,6.2
CN3600500000000,36,005,Bronx County, NY,Jul-17,628641,585681,42960,6.8
CN3600500000000,36,005,Bronx County, NY,Aug-17,624978,582076,42902,6.9
CN3600500000000,36,005,Bronx County, NY,Sep-17,623589,585988,37601,6.0
CN3600500000000,36,005,Bronx County, NY,Oct-17,621186,584499,36687,5.9
CN3600500000000,36,005,Bronx County, NY,Nov-17,618613,583456,35157,5.7
CN3600500000000,36,005,Bronx County, NY,Dec-17,616409,582167,34242,5.6
CN3600500000000,36,005,Bronx County, NY,Jan-18,623270,583661,39609,6.4
CN3600500000000,36,005,Bronx County, NY,Feb-18,629104,591290,37814,6.0
CN3600500000000,36,005,Bronx County, NY,Mar-18,624025,587863,36162,5.8
CN3600500000000,36,005,Bronx County, NY,Apr-18(p),618345,583835,34510,5.6
CN0110300000000,01,103,Morgan County, AL,Mar-17,55129,52591,2538,4.6
CN0110300000000,01,103,Morgan County, AL,Apr-17,54733,52595,2138,3.9
CN0110300000000,01,103,Morgan County, AL,May-17,54835,52796,2039,3.7
CN0110300000000,01,103,Morgan County, AL,Jun-17,55275,52781,2494,4.5
CN0110300000000,01,103,Morgan County, AL,Jul-17,55026,52704,2322,4.2
CN0110300000000,01,103,Morgan County, AL,Aug-17,54542,52354,2188,4.0
CN0110300000000,01,103,Morgan County, AL,Sep-17,54566,52669,1897,3.5
CN0110300000000,01,103,Morgan County, AL,Oct-17,54710,52852,1858,3.4
CN0110300000000,01,103,Morgan County, AL,Nov-17,54839,53090,1749,3.2
CN0110300000000,01,103,Morgan County, AL,Dec-17,54646,52932,1714,3.1
CN0110300000000,01,103,Morgan County, AL,Jan-18,54455,52345,2110,3.9
CN0110300000000,01,103,Morgan County, AL,Feb-18,55005,52802,2203,4.0
CN0110300000000,01,103,Morgan County, AL,Mar-18,55360,53376,1984,3.6
CN0110300000000,01,103,Morgan County, AL,Apr-18(p),55567,53767,1800,3.2
CN3802900000000,38,029,Emmons County, ND,Mar-17,1573,1479,94,6.0
CN3802900000000,38,029,Emmons County, ND,Apr-17,1598,1527,71,4.4
CN3802900000000,38,029,Emmons County, ND,May-17,1578,1532,46,2.9
CN3802900000000,38,029,Emmons County, ND,Jun-17,1639,1584,55,3.4
CN3802900000000,38,029,Emmons County, ND,Jul-17,1571,1528,43,2.7
CN3802900000000,38,029,Emmons County, ND,Aug-17,1583,1543,40,2.5
CN3802900000000,38,029,Emmons County, ND,Sep-17,1618,1578,40,2.5
CN3802900000000,38,029,Emmons County, ND,Oct-17,1615,1574,41,2.5
CN3802900000000,38,029,Emmons County, ND,Nov-17,1567,1512,55,3.5
CN3802900000000,38,029,Emmons County, ND,Dec-17,1553,1477,76,4.9
CN3802900000000,38,029,Emmons County, ND,Jan-18,1537,1429,108,7.0
CN3802900000000,38,029,Emmons County, ND,Feb-18,1515,1406,109,7.2
CN3802900000000,38,029,Emmons County, ND,Mar-18,1538,1429,109,7.1
CN3802900000000,38,029,Emmons County, ND,Apr-18(p),1537,1439,98,6.4
CN3910100000000,39,101,Marion County, OH,Mar-17,28000,26532,1468,5.2
CN3910100000000,39,101,Marion County, OH,Apr-17,27883,26607,1276,4.6
CN3910100000000,39,101,Marion County, OH,May-17,27911,26645,1266,4.5
CN3910100000000,39,101,Marion County, OH,Jun-17,28354,26882,1472,5.2
CN3910100000000,39,101,Marion County, OH,Jul-17,28330,26855,1475,5.2
CN3910100000000,39,101,Marion County, OH,Aug-17,28341,26901,1440,5.1
CN3910100000000,39,101,Marion County, OH,Sep-17,28052,26739,1313,4.7
CN3910100000000,39,101,Marion County, OH,Oct-17,27981,26716,1265,4.5
CN3910100000000,39,101,Marion County, OH,Nov-17,27920,26648,1272,4.6
CN3910100000000,39,101,Marion County, OH,Dec-17,27833,26484,1349,4.8
CN3910100000000,39,101,Marion County, OH,Jan-18,27401,26033,1368,5.0
CN3910100000000,39,101,Marion County, OH,Feb-18,27641,26381,1260,4.6
CN3910100000000,39,101,Marion County, OH,Mar-18,27958,26784,1174,4.2
CN3910100000000,39,101,Marion County, OH,Apr-18(p),27857,26741,1116,4.0
CN2113500000000,21,135,Lewis County, KY,Mar-17,5119,4579,540,10.5
CN2113500000000,21,135,Lewis County, KY,Apr-17,5017,4572,445,8.9
CN2113500000000,21,135,Lewis County, KY,May-17,5001,4590,411,8.2
CN2113500000000,21,135,Lewis County, KY,Jun-17,4999,4550,449,9.0
CN2113500000000,21,135,Lewis County, KY,Jul-17,4902,4485,417,8.5
CN2113500000000,21,135,Lewis County, KY,Aug-17,4858,4457,401,8.3
CN2113500000000,21,135,Lewis County, KY,Sep-17,4819,4472,347,7.2
CN2113500000000,21,135,Lewis County, KY,Oct-17,4719,4407,312,6.6
CN2113500000000,21,135,Lewis County, KY,Nov-17,4736,4390,346,7.3
CN2113500000000,21,135,Lewis County, KY,Dec-17,4781,4384,397,8.3
CN2113500000000,21,135,Lewis County, KY,Jan-18,4967,4450,517,10.4
CN2113500000000,21,135,Lewis County, KY,Feb-18,4956,4466,490,9.9
CN2113500000000,21,135,Lewis County, KY,Mar-18,4968,4541,427,8.6
CN2113500000000,21,135,Lewis County, KY,Apr-18(p),4889,4495,394,8.1
CN2015500000000,20,155,Reno County, KS,Mar-17,29883,28716,1167,3.9
CN2015500000000,20,155,Reno County, KS,Apr-17,29902,28831,1071,3.6
CN2015500000000,20,155,Reno County, KS,May-17,29876,28773,1103,3.7
CN2015500000000,20,155,Reno County, KS,Jun-17,30596,29373,1223,4.0
CN2015500000000,20,155,Reno County, KS,Jul-17,30380,28991,1389,4.6
CN2015500000000,20,155,Reno County, KS,Aug-17,29496,28212,1284,4.4
CN2015500000000,20,155,Reno County, KS,Sep-17,30650,29587,1063,3.5
CN2015500000000,20,155,Reno County, KS,Oct-17,29975,29012,963,3.2
CN2015500000000,20,155,Reno County, KS,Nov-17,30072,29019,1053,3.5
CN2015500000000,20,155,Reno County, KS,Dec-17,29865,28843,1022,3.4
CN2015500000000,20,155,Reno County, KS,Jan-18,29432,28339,1093,3.7
CN2015500000000,20,155,Reno County, KS,Feb-18,29691,28522,1169,3.9
CN2015500000000,20,155,Reno County, KS,Mar-18,29810,28680,1130,3.8
CN2015500000000,20,155,Reno County, KS,Apr-18(p),29860,28779,1081,3.6
CN1328300000000,13,283,Treutlen County, GA,Mar-17,2743,2559,184,6.7
CN1328300000000,13,283,Treutlen County, GA,Apr-17,2784,2598,186,6.7
CN1328300000000,13,283,Treutlen County, GA,May-17,2810,2649,161,5.7
CN1328300000000,13,283,Treutlen County, GA,Jun-17,2784,2597,187,6.7
CN1328300000000,13,283,Treutlen County, GA,Jul-17,2798,2566,232,8.3
CN1328300000000,13,283,Treutlen County, GA,Aug-17,2712,2535,177,6.5
CN1328300000000,13,283,Treutlen County, GA,Sep-17,2742,2563,179,6.5
CN1328300000000,13,283,Treutlen County, GA,Oct-17,2690,2542,148,5.5
CN1328300000000,13,283,Treutlen County, GA,Nov-17,2702,2553,149,5.5
CN1328300000000,13,283,Treutlen County, GA,Dec-17,2729,2572,157,5.8
CN1328300000000,13,283,Treutlen County, GA,Jan-18,2755,2574,181,6.6
CN1328300000000,13,283,Treutlen County, GA,Feb-18,2689,2521,168,6.2
CN1328300000000,13,283,Treutlen County, GA,Mar-18,2684,2522,162,6.0
CN1328300000000,13,283,Treutlen County, GA,Apr-18(p),2691,2536,155,5.8
CN4012300000000,40,123,Pontotoc County, OK,Mar-17,18833,18096,737,3.9
CN4012300000000,40,123,Pontotoc County, OK,Apr-17,18578,17971,607,3.3
CN4012300000000,40,123,Pontotoc County, OK,May-17,18657,17944,713,3.8
CN4012300000000,40,123,Pontotoc County, OK,Jun-17,18672,17889,783,4.2
CN4012300000000,40,123,Pontotoc County, OK,Jul-17,18330,17599,731,4.0
CN4012300000000,40,123,Pontotoc County, OK,Aug-17,18473,17719,754,4.1
CN4012300000000,40,123,Pontotoc County, OK,Sep-17,18608,17925,683,3.7
CN4012300000000,40,123,Pontotoc County, OK,Oct-17,19130,18438,692,3.6
CN4012300000000,40,123,Pontotoc County, OK,Nov-17,19149,18498,651,3.4
CN4012300000000,40,123,Pontotoc County, OK,Dec-17,19004,18366,638,3.4
CN4012300000000,40,123,Pontotoc County, OK,Jan-18,19123,18414,709,3.7
CN4012300000000,40,123,Pontotoc County, OK,Feb-18,18846,18203,643,3.4
CN4012300000000,40,123,Pontotoc County, OK,Mar-18,18924,18263,661,3.5
CN4012300000000,40,123,Pontotoc County, OK,Apr-18(p),18684,18032,652,3.5
CN4508900000000,45,089,Williamsburg County, SC,Mar-17,12129,11406,723,6.0
CN4508900000000,45,089,Williamsburg County, SC,Apr-17,12209,11531,678,5.6
CN4508900000000,45,089,Williamsburg County, SC,May-17,12190,11517,673,5.5
CN4508900000000,45,089,Williamsburg County, SC,Jun-17,12563,11729,834,6.6
CN4508900000000,45,089,Williamsburg County, SC,Jul-17,12569,11728,841,6.7
CN4508900000000,45,089,Williamsburg County, SC,Aug-17,12527,11625,902,7.2
CN4508900000000,45,089,Williamsburg County, SC,Sep-17,12435,11677,758,6.1
CN4508900000000,45,089,Williamsburg County, SC,Oct-17,12446,11705,741,6.0
CN4508900000000,45,089,Williamsburg County, SC,Nov-17,12456,11741,715,5.7
CN4508900000000,45,089,Williamsburg County, SC,Dec-17,12630,11838,792,6.3
CN4508900000000,45,089,Williamsburg County, SC,Jan-18,12733,11753,980,7.7
CN4508900000000,45,089,Williamsburg County, SC,Feb-18,12758,11877,881,6.9
CN4508900000000,45,089,Williamsburg County, SC,Mar-18,12605,11795,810,6.4
CN4508900000000,45,089,Williamsburg County, SC,Apr-18(p),12377,11795,582,4.7
CN4709900000000,47,099,Lawrence County, TN,Mar-17,17774,16957,817,4.6
CN4709900000000,47,099,Lawrence County, TN,Apr-17,17799,17120,679,3.8
CN4709900000000,47,099,Lawrence County, TN,May-17,17768,17113,655,3.7
CN4709900000000,47,099,Lawrence County, TN,Jun-17,17594,16734,860,4.9
CN4709900000000,47,099,Lawrence County, TN,Jul-17,17499,16656,843,4.8
CN4709900000000,47,099,Lawrence County, TN,Aug-17,17832,17037,795,4.5
CN4709900000000,47,099,Lawrence County, TN,Sep-17,17991,17297,694,3.9
CN4709900000000,47,099,Lawrence County, TN,Oct-17,17855,17179,676,3.8
CN4709900000000,47,099,Lawrence County, TN,Nov-17,17759,17094,665,3.7
CN4709900000000,47,099,Lawrence County, TN,Dec-17,17870,17180,690,3.9
CN4709900000000,47,099,Lawrence County, TN,Jan-18,17917,17079,838,4.7
CN4709900000000,47,099,Lawrence County, TN,Feb-18,18013,17218,795,4.4
CN4709900000000,47,099,Lawrence County, TN,Mar-18,17907,17182,725,4.0
CN4709900000000,47,099,Lawrence County, TN,Apr-18(p),18132,17517,615,3.4
CN2922700000000,29,227,Worth County, MO,Mar-17,1166,1137,29,2.5
CN2922700000000,29,227,Worth County, MO,Apr-17,1256,1228,28,2.2
CN2922700000000,29,227,Worth County, MO,May-17,1213,1180,33,2.7
CN2922700000000,29,227,Worth County, MO,Jun-17,1223,1185,38,3.1
CN2922700000000,29,227,Worth County, MO,Jul-17,1095,1053,42,3.8
CN2922700000000,29,227,Worth County, MO,Aug-17,1112,1082,30,2.7
CN2922700000000,29,227,Worth County, MO,Sep-17,1139,1118,21,1.8
CN2922700000000,29,227,Worth County, MO,Oct-17,1161,1138,23,2.0
CN2922700000000,29,227,Worth County, MO,Nov-17,1150,1126,24,2.1
CN2922700000000,29,227,Worth County, MO,Dec-17,1113,1090,23,2.1
CN2922700000000,29,227,Worth County, MO,Jan-18,1134,1097,37,3.3
CN2922700000000,29,227,Worth County, MO,Feb-18,1185,1145,40,3.4
CN2922700000000,29,227,Worth County, MO,Mar-18,1178,1137,41,3.5
CN2922700000000,29,227,Worth County, MO,Apr-18(p),1225,1186,39,3.2
CN1817100000000,18,171,Warren County, IN,Mar-17,4083,3935,148,3.6
CN1817100000000,18,171,Warren County, IN,Apr-17,4025,3916,109,2.7
CN1817100000000,18,171,Warren County, IN,May-17,4161,4032,129,3.1
CN1817100000000,18,171,Warren County, IN,Jun-17,4065,3931,134,3.3
CN1817100000000,18,171,Warren County, IN,Jul-17,4077,3935,142,3.5
CN1817100000000,18,171,Warren County, IN,Aug-17,4099,3954,145,3.5
CN1817100000000,18,171,Warren County, IN,Sep-17,4060,3937,123,3.0
CN1817100000000,18,171,Warren County, IN,Oct-17,3995,3886,109,2.7
CN1817100000000,18,171,Warren County, IN,Nov-17,4032,3917,115,2.9
CN1817100000000,18,171,Warren County, IN,Dec-17,3951,3831,120,3.0
CN1817100000000,18,171,Warren County, IN,Jan-18,3867,3729,138,3.6
CN1817100000000,18,171,Warren County, IN,Feb-18,4025,3880,145,3.6
CN1817100000000,18,171,Warren County, IN,Mar-18,4068,3938,130,3.2
CN1817100000000,18,171,Warren County, IN,Apr-18(p),4070,3964,106,2.6
CN2921300000000,29,213,Taney County, MO,Mar-17,25412,23604,1808,7.1
CN2921300000000,29,213,Taney County, MO,Apr-17,25845,24500,1345,5.2
CN2921300000000,29,213,Taney County, MO,May-17,26241,24960,1281,4.9
CN2921300000000,29,213,Taney County, MO,Jun-17,28521,27319,1202,4.2
CN2921300000000,29,213,Taney County, MO,Jul-17,28433,27208,1225,4.3
CN2921300000000,29,213,Taney County, MO,Aug-17,27494,26241,1253,4.6
CN2921300000000,29,213,Taney County, MO,Sep-17,26660,25618,1042,3.9
CN2921300000000,29,213,Taney County, MO,Oct-17,26341,25526,815,3.1
CN2921300000000,29,213,Taney County, MO,Nov-17,26464,25491,973,3.7
CN2921300000000,29,213,Taney County, MO,Dec-17,25926,24772,1154,4.5
CN2921300000000,29,213,Taney County, MO,Jan-18,25699,22512,3187,12.4
CN2921300000000,29,213,Taney County, MO,Feb-18,25318,21927,3391,13.4
CN2921300000000,29,213,Taney County, MO,Mar-18,25895,24101,1794,6.9
CN2921300000000,29,213,Taney County, MO,Apr-18(p),26274,25004,1270,4.8
CN4827900000000,48,279,Lamb County, TX,Mar-17,5347,5044,303,5.7
CN4827900000000,48,279,Lamb County, TX,Apr-17,5294,5024,270,5.1
CN4827900000000,48,279,Lamb County, TX,May-17,5303,5031,272,5.1
CN4827900000000,48,279,Lamb County, TX,Jun-17,5322,5026,296,5.6
CN4827900000000,48,279,Lamb County, TX,Jul-17,5121,4837,284,5.5
CN4827900000000,48,279,Lamb County, TX,Aug-17,5158,4887,271,5.3
CN4827900000000,48,279,Lamb County, TX,Sep-17,5110,4870,240,4.7
CN4827900000000,48,279,Lamb County, TX,Oct-17,5211,4997,214,4.1
CN4827900000000,48,279,Lamb County, TX,Nov-17,5120,4907,213,4.2
CN4827900000000,48,279,Lamb County, TX,Dec-17,5151,4958,193,3.7
CN4827900000000,48,279,Lamb County, TX,Jan-18,5089,4858,231,4.5
CN4827900000000,48,279,Lamb County, TX,Feb-18,5194,4945,249,4.8
CN4827900000000,48,279,Lamb County, TX,Mar-18,5397,5136,261,4.8
CN4827900000000,48,279,Lamb County, TX,Apr-18(p),5262,5026,236,4.5
CN4820100000000,48,201,Harris County, TX,Mar-17,2266288,2147268,119020,5.3
CN4820100000000,48,201,Harris County, TX,Apr-17,2267061,2156035,111026,4.9
CN4820100000000,48,201,Harris County, TX,May-17,2260587,2151782,108805,4.8
CN4820100000000,48,201,Harris County, TX,Jun-17,2269645,2152656,116989,5.2
CN4820100000000,48,201,Harris County, TX,Jul-17,2276881,2161150,115731,5.1
CN4820100000000,48,201,Harris County, TX,Aug-17,2265119,2148317,116802,5.2
CN4820100000000,48,201,Harris County, TX,Sep-17,2277647,2166041,111606,4.9
CN4820100000000,48,201,Harris County, TX,Oct-17,2262869,2162813,100056,4.4
CN4820100000000,48,201,Harris County, TX,Nov-17,2278881,2177231,101650,4.5
CN4820100000000,48,201,Harris County, TX,Dec-17,2281345,2181799,99546,4.4
CN4820100000000,48,201,Harris County, TX,Jan-18,2286406,2174543,111863,4.9
CN4820100000000,48,201,Harris County, TX,Feb-18,2315779,2205311,110468,4.8
CN4820100000000,48,201,Harris County, TX,Mar-18,2316667,2208574,108093,4.7
CN4820100000000,48,201,Harris County, TX,Apr-18(p),2325412,2225122,100290,4.3
CN0812100000000,08,121,Washington County, CO,Mar-17,2847,2795,52,1.8
CN0812100000000,08,121,Washington County, CO,Apr-17,2990,2932,58,1.9
CN0812100000000,08,121,Washington County, CO,May-17,3064,3010,54,1.8
CN0812100000000,08,121,Washington County, CO,Jun-17,3076,3014,62,2.0
CN0812100000000,08,121,Washington County, CO,Jul-17,3063,3007,56,1.8
CN0812100000000,08,121,Washington County, CO,Aug-17,3036,2976,60,2.0
CN0812100000000,08,121,Washington County, CO,Sep-17,3028,2970,58,1.9
CN0812100000000,08,121,Washington County, CO,Oct-17,3287,3225,62,1.9
CN0812100000000,08,121,Washington County, CO,Nov-17,3213,3153,60,1.9
CN0812100000000,08,121,Washington County, CO,Dec-17,3182,3114,68,2.1
CN0812100000000,08,121,Washington County, CO,Jan-18,3124,3052,72,2.3
CN0812100000000,08,121,Washington County, CO,Feb-18,3011,2930,81,2.7
CN0812100000000,08,121,Washington County, CO,Mar-18,2992,2922,70,2.3
CN0812100000000,08,121,Washington County, CO,Apr-18(p),3092,3024,68,2.2
CN1500700000000,15,007,Kauai County, HI,Mar-17,36046,35097,949,2.6
CN1500700000000,15,007,Kauai County, HI,Apr-17,36271,35290,981,2.7
CN1500700000000,15,007,Kauai County, HI,May-17,36257,35340,917,2.5
CN1500700000000,15,007,Kauai County, HI,Jun-17,37061,36001,1060,2.9
CN1500700000000,15,007,Kauai County, HI,Jul-17,37067,36257,810,2.2
CN1500700000000,15,007,Kauai County, HI,Aug-17,36636,35893,743,2.0
CN1500700000000,15,007,Kauai County, HI,Sep-17,35749,34997,752,2.1
CN1500700000000,15,007,Kauai County, HI,Oct-17,35658,34976,682,1.9
CN1500700000000,15,007,Kauai County, HI,Nov-17,35555,34818,737,2.1
CN1500700000000,15,007,Kauai County, HI,Dec-17,35494,34898,596,1.7
CN1500700000000,15,007,Kauai County, HI,Jan-18,35956,35243,713,2.0
CN1500700000000,15,007,Kauai County, HI,Feb-18,35477,34844,633,1.8
CN1500700000000,15,007,Kauai County, HI,Mar-18,35882,35216,666,1.9
CN1500700000000,15,007,Kauai County, HI,Apr-18(p),36082,35444,638,1.8
CN0108700000000,01,087,Macon County, AL,Mar-17,7984,7467,517,6.5
CN0108700000000,01,087,Macon County, AL,Apr-17,7917,7509,408,5.2
CN0108700000000,01,087,Macon County, AL,May-17,7818,7411,407,5.2
CN0108700000000,01,087,Macon County, AL,Jun-17,7984,7433,551,6.9
CN0108700000000,01,087,Macon County, AL,Jul-17,7883,7353,530,6.7
CN0108700000000,01,087,Macon County, AL,Aug-17,7841,7376,465,5.9
CN0108700000000,01,087,Macon County, AL,Sep-17,7834,7458,376,4.8
CN0108700000000,01,087,Macon County, AL,Oct-17,7840,7485,355,4.5
CN0108700000000,01,087,Macon County, AL,Nov-17,7834,7494,340,4.3
CN0108700000000,01,087,Macon County, AL,Dec-17,7765,7430,335,4.3
CN0108700000000,01,087,Macon County, AL,Jan-18,7719,7310,409,5.3
CN0108700000000,01,087,Macon County, AL,Feb-18,7774,7364,410,5.3
CN0108700000000,01,087,Macon County, AL,Mar-18,7776,7381,395,5.1
CN0108700000000,01,087,Macon County, AL,Apr-18(p),7807,7459,348,4.5
CN0611100000000,06,111,Ventura County, CA,Mar-17,428848,408673,20175,4.7
CN0611100000000,06,111,Ventura County, CA,Apr-17,428492,410422,18070,4.2
CN0611100000000,06,111,Ventura County, CA,May-17,426084,409295,16789,3.9
CN0611100000000,06,111,Ventura County, CA,Jun-17,425868,407016,18852,4.4
CN0611100000000,06,111,Ventura County, CA,Jul-17,425120,404781,20339,4.8
CN0611100000000,06,111,Ventura County, CA,Aug-17,423454,403060,20394,4.8
CN0611100000000,06,111,Ventura County, CA,Sep-17,426819,408511,18308,4.3
CN0611100000000,06,111,Ventura County, CA,Oct-17,424930,407345,17585,4.1
CN0611100000000,06,111,Ventura County, CA,Nov-17,426128,408531,17597,4.1
CN0611100000000,06,111,Ventura County, CA,Dec-17,425256,408220,17036,4.0
CN0611100000000,06,111,Ventura County, CA,Jan-18,424682,406346,18336,4.3
CN0611100000000,06,111,Ventura County, CA,Feb-18,429181,412030,17151,4.0
CN0611100000000,06,111,Ventura County, CA,Mar-18,428329,412745,15584,3.6
CN0611100000000,06,111,Ventura County, CA,Apr-18(p),424509,410741,13768,3.2
CN1307900000000,13,079,Crawford County, GA,Mar-17,5754,5474,280,4.9
CN1307900000000,13,079,Crawford County, GA,Apr-17,5716,5447,269,4.7
CN1307900000000,13,079,Crawford County, GA,May-17,5727,5461,266,4.6
CN1307900000000,13,079,Crawford County, GA,Jun-17,5783,5490,293,5.1
CN1307900000000,13,079,Crawford County, GA,Jul-17,5768,5466,302,5.2
CN1307900000000,13,079,Crawford County, GA,Aug-17,5739,5449,290,5.1
CN1307900000000,13,079,Crawford County, GA,Sep-17,5765,5483,282,4.9
CN1307900000000,13,079,Crawford County, GA,Oct-17,5794,5470,324,5.6
CN1307900000000,13,079,Crawford County, GA,Nov-17,5743,5497,246,4.3
CN1307900000000,13,079,Crawford County, GA,Dec-17,5759,5515,244,4.2
CN1307900000000,13,079,Crawford County, GA,Jan-18,5848,5539,309,5.3
CN1307900000000,13,079,Crawford County, GA,Feb-18,5801,5538,263,4.5
CN1307900000000,13,079,Crawford County, GA,Mar-18,5787,5553,234,4.0
CN1307900000000,13,079,Crawford County, GA,Apr-18(p),5737,5529,208,3.6
CN1209900000000,12,099,Palm Beach County, FL,Mar-17,730171,701199,28972,4.0
CN1209900000000,12,099,Palm Beach County, FL,Apr-17,725733,698412,27321,3.8
CN1209900000000,12,099,Palm Beach County, FL,May-17,727021,698804,28217,3.9
CN1209900000000,12,099,Palm Beach County, FL,Jun-17,727736,696850,30886,4.2
CN1209900000000,12,099,Palm Beach County, FL,Jul-17,725325,693427,31898,4.4
CN1209900000000,12,099,Palm Beach County, FL,Aug-17,722695,690771,31924,4.4
CN1209900000000,12,099,Palm Beach County, FL,Sep-17,726793,697313,29480,4.1
CN1209900000000,12,099,Palm Beach County, FL,Oct-17,722965,695308,27657,3.8
CN1209900000000,12,099,Palm Beach County, FL,Nov-17,722811,695466,27345,3.8
CN1209900000000,12,099,Palm Beach County, FL,Dec-17,719053,693636,25417,3.5
CN1209900000000,12,099,Palm Beach County, FL,Jan-18,725255,696461,28794,4.0
CN1209900000000,12,099,Palm Beach County, FL,Feb-18,731637,704913,26724,3.7
CN1209900000000,12,099,Palm Beach County, FL,Mar-18,734338,708022,26316,3.6
CN1209900000000,12,099,Palm Beach County, FL,Apr-18(p),723696,700129,23567,3.3
CN2007500000000,20,075,Hamilton County, KS,Mar-17,1590,1549,41,2.6
CN2007500000000,20,075,Hamilton County, KS,Apr-17,1537,1497,40,2.6
CN2007500000000,20,075,Hamilton County, KS,May-17,1536,1497,39,2.5
CN2007500000000,20,075,Hamilton County, KS,Jun-17,1632,1592,40,2.5
CN2007500000000,20,075,Hamilton County, KS,Jul-17,1603,1558,45,2.8
CN2007500000000,20,075,Hamilton County, KS,Aug-17,1620,1580,40,2.5
CN2007500000000,20,075,Hamilton County, KS,Sep-17,1661,1627,34,2.0
CN2007500000000,20,075,Hamilton County, KS,Oct-17,1707,1679,28,1.6
CN2007500000000,20,075,Hamilton County, KS,Nov-17,1651,1618,33,2.0
CN2007500000000,20,075,Hamilton County, KS,Dec-17,1629,1601,28,1.7
CN2007500000000,20,075,Hamilton County, KS,Jan-18,1601,1573,28,1.7
CN2007500000000,20,075,Hamilton County, KS,Feb-18,1578,1552,26,1.6
CN2007500000000,20,075,Hamilton County, KS,Mar-18,1573,1542,31,2.0
CN2007500000000,20,075,Hamilton County, KS,Apr-18(p),1421,1392,29,2.0
CN2016900000000,20,169,Saline County, KS,Mar-17,30625,29619,1006,3.3
CN2016900000000,20,169,Saline County, KS,Apr-17,30730,29810,920,3.0
CN2016900000000,20,169,Saline County, KS,May-17,30599,29635,964,3.2
CN2016900000000,20,169,Saline County, KS,Jun-17,30676,29510,1166,3.8
CN2016900000000,20,169,Saline County, KS,Jul-17,31070,29965,1105,3.6
CN2016900000000,20,169,Saline County, KS,Aug-17,31019,29978,1041,3.4
CN2016900000000,20,169,Saline County, KS,Sep-17,30476,29609,867,2.8
CN2016900000000,20,169,Saline County, KS,Oct-17,30455,29669,786,2.6
CN2016900000000,20,169,Saline County, KS,Nov-17,30622,29777,845,2.8
CN2016900000000,20,169,Saline County, KS,Dec-17,30437,29646,791,2.6
CN2016900000000,20,169,Saline County, KS,Jan-18,30548,29639,909,3.0
CN2016900000000,20,169,Saline County, KS,Feb-18,30665,29667,998,3.3
CN2016900000000,20,169,Saline County, KS,Mar-18,30342,29374,968,3.2
CN2016900000000,20,169,Saline County, KS,Apr-18(p),30438,29570,868,2.9
CN2614300000000,26,143,Roscommon County, MI,Mar-17,7676,6850,826,10.8
CN2614300000000,26,143,Roscommon County, MI,Apr-17,7655,6996,659,8.6
CN2614300000000,26,143,Roscommon County, MI,May-17,7991,7383,608,7.6
CN2614300000000,26,143,Roscommon County, MI,Jun-17,8223,7597,626,7.6
CN2614300000000,26,143,Roscommon County, MI,Jul-17,8382,7644,738,8.8
CN2614300000000,26,143,Roscommon County, MI,Aug-17,8277,7602,675,8.2
CN2614300000000,26,143,Roscommon County, MI,Sep-17,8100,7540,560,6.9
CN2614300000000,26,143,Roscommon County, MI,Oct-17,7916,7388,528,6.7
CN2614300000000,26,143,Roscommon County, MI,Nov-17,7887,7302,585,7.4
CN2614300000000,26,143,Roscommon County, MI,Dec-17,7879,7087,792,10.1
CN2614300000000,26,143,Roscommon County, MI,Jan-18,7833,6898,935,11.9
CN2614300000000,26,143,Roscommon County, MI,Feb-18,7856,6911,945,12.0
CN2614300000000,26,143,Roscommon County, MI,Mar-18,7794,6960,834,10.7
CN2614300000000,26,143,Roscommon County, MI,Apr-18(p),7775,7071,704,9.1
CN3601900000000,36,019,Clinton County, NY,Mar-17,36127,34053,2074,5.7
CN3601900000000,36,019,Clinton County, NY,Apr-17,36267,34252,2015,5.6
CN3601900000000,36,019,Clinton County, NY,May-17,36197,34357,1840,5.1
CN3601900000000,36,019,Clinton County, NY,Jun-17,36676,34724,1952,5.3
CN3601900000000,36,019,Clinton County, NY,Jul-17,36856,34900,1956,5.3
CN3601900000000,36,019,Clinton County, NY,Aug-17,36478,34549,1929,5.3
CN3601900000000,36,019,Clinton County, NY,Sep-17,36430,34698,1732,4.8
CN3601900000000,36,019,Clinton County, NY,Oct-17,36018,34362,1656,4.6
CN3601900000000,36,019,Clinton County, NY,Nov-17,36195,34449,1746,4.8
CN3601900000000,36,019,Clinton County, NY,Dec-17,35781,33947,1834,5.1
CN3601900000000,36,019,Clinton County, NY,Jan-18,35893,33634,2259,6.3
CN3601900000000,36,019,Clinton County, NY,Feb-18,35886,33607,2279,6.4
CN3601900000000,36,019,Clinton County, NY,Mar-18,35350,33288,2062,5.8
CN3601900000000,36,019,Clinton County, NY,Apr-18(p),35390,33558,1832,5.2
CN3108700000000,31,087,Hitchcock County, NE,Mar-17,1219,1175,44,3.6
CN3108700000000,31,087,Hitchcock County, NE,Apr-17,1211,1170,41,3.4
CN3108700000000,31,087,Hitchcock County, NE,May-17,1255,1216,39,3.1
CN3108700000000,31,087,Hitchcock County, NE,Jun-17,1280,1237,43,3.4
CN3108700000000,31,087,Hitchcock County, NE,Jul-17,1271,1226,45,3.5
CN3108700000000,31,087,Hitchcock County, NE,Aug-17,1233,1191,42,3.4
CN3108700000000,31,087,Hitchcock County, NE,Sep-17,1206,1169,37,3.1
CN3108700000000,31,087,Hitchcock County, NE,Oct-17,1215,1176,39,3.2
CN3108700000000,31,087,Hitchcock County, NE,Nov-17,1201,1164,37,3.1
CN3108700000000,31,087,Hitchcock County, NE,Dec-17,1207,1159,48,4.0
CN3108700000000,31,087,Hitchcock County, NE,Jan-18,1214,1171,43,3.5
CN3108700000000,31,087,Hitchcock County, NE,Feb-18,1214,1169,45,3.7
CN3108700000000,31,087,Hitchcock County, NE,Mar-18,1225,1178,47,3.8
CN3108700000000,31,087,Hitchcock County, NE,Apr-18(p),1223,1181,42,3.4
CN5102900000000,51,029,Buckingham County, VA,Mar-17,6429,6044,385,6.0
CN5102900000000,51,029,Buckingham County, VA,Apr-17,6454,6133,321,5.0
CN5102900000000,51,029,Buckingham County, VA,May-17,6400,6084,316,4.9
CN5102900000000,51,029,Buckingham County, VA,Jun-17,6452,6105,347,5.4
CN5102900000000,51,029,Buckingham County, VA,Jul-17,6380,6038,342,5.4
CN5102900000000,51,029,Buckingham County, VA,Aug-17,6275,5938,337,5.4
CN5102900000000,51,029,Buckingham County, VA,Sep-17,6495,6197,298,4.6
CN5102900000000,51,029,Buckingham County, VA,Oct-17,6385,6105,280,4.4
CN5102900000000,51,029,Buckingham County, VA,Nov-17,6440,6129,311,4.8
CN5102900000000,51,029,Buckingham County, VA,Dec-17,6457,6123,334,5.2
CN5102900000000,51,029,Buckingham County, VA,Jan-18,6361,5997,364,5.7
CN5102900000000,51,029,Buckingham County, VA,Feb-18,6558,6210,348,5.3
CN5102900000000,51,029,Buckingham County, VA,Mar-18,6569,6232,337,5.1
CN5102900000000,51,029,Buckingham County, VA,Apr-18(p),6617,6353,264,4.0
CN4837700000000,48,377,Presidio County, TX,Mar-17,3114,2797,317,10.2
CN4837700000000,48,377,Presidio County, TX,Apr-17,3096,2790,306,9.9
CN4837700000000,48,377,Presidio County, TX,May-17,3077,2812,265,8.6
CN4837700000000,48,377,Presidio County, TX,Jun-17,3098,2795,303,9.8
CN4837700000000,48,377,Presidio County, TX,Jul-17,2955,2679,276,9.3
CN4837700000000,48,377,Presidio County, TX,Aug-17,2977,2700,277,9.3
CN4837700000000,48,377,Presidio County, TX,Sep-17,2974,2735,239,8.0
CN4837700000000,48,377,Presidio County, TX,Oct-17,2970,2766,204,6.9
CN4837700000000,48,377,Presidio County, TX,Nov-17,2935,2729,206,7.0
CN4837700000000,48,377,Presidio County, TX,Dec-17,2941,2725,216,7.3
CN4837700000000,48,377,Presidio County, TX,Jan-18,2946,2685,261,8.9
CN4837700000000,48,377,Presidio County, TX,Feb-18,3002,2759,243,8.1
CN4837700000000,48,377,Presidio County, TX,Mar-18,3055,2823,232,7.6
CN4837700000000,48,377,Presidio County, TX,Apr-18(p),2995,2770,225,7.5
CN3715500000000,37,155,Robeson County, NC,Mar-17,51026,47738,3288,6.4
CN3715500000000,37,155,Robeson County, NC,Apr-17,50468,47444,3024,6.0
CN3715500000000,37,155,Robeson County, NC,May-17,50039,46908,3131,6.3
CN3715500000000,37,155,Robeson County, NC,Jun-17,50228,46909,3319,6.6
CN3715500000000,37,155,Robeson County, NC,Jul-17,50118,46597,3521,7.0
CN3715500000000,37,155,Robeson County, NC,Aug-17,49427,45875,3552,7.2
CN3715500000000,37,155,Robeson County, NC,Sep-17,50265,47127,3138,6.2
CN3715500000000,37,155,Robeson County, NC,Oct-17,49922,46770,3152,6.3
CN3715500000000,37,155,Robeson County, NC,Nov-17,50204,46904,3300,6.6
CN3715500000000,37,155,Robeson County, NC,Dec-17,50081,46933,3148,6.3
CN3715500000000,37,155,Robeson County, NC,Jan-18,50219,46780,3439,6.8
CN3715500000000,37,155,Robeson County, NC,Feb-18,50155,46775,3380,6.7
CN3715500000000,37,155,Robeson County, NC,Mar-18,50013,46805,3208,6.4
CN3715500000000,37,155,Robeson County, NC,Apr-18(p),49766,46964,2802,5.6
CN0100500000000,01,005,Barbour County, AL,Mar-17,8230,7684,546,6.6
CN0100500000000,01,005,Barbour County, AL,Apr-17,8180,7718,462,5.6
CN0100500000000,01,005,Barbour County, AL,May-17,8202,7785,417,5.1
CN0100500000000,01,005,Barbour County, AL,Jun-17,8328,7799,529,6.4
CN0100500000000,01,005,Barbour County, AL,Jul-17,8299,7786,513,6.2
CN0100500000000,01,005,Barbour County, AL,Aug-17,8275,7780,495,6.0
CN0100500000000,01,005,Barbour County, AL,Sep-17,8325,7907,418,5.0
CN0100500000000,01,005,Barbour County, AL,Oct-17,8234,7828,406,4.9
CN0100500000000,01,005,Barbour County, AL,Nov-17,8148,7766,382,4.7
CN0100500000000,01,005,Barbour County, AL,Dec-17,8074,7704,370,4.6
CN0100500000000,01,005,Barbour County, AL,Jan-18,7945,7504,441,5.6
CN0100500000000,01,005,Barbour County, AL,Feb-18,8051,7594,457,5.7
CN0100500000000,01,005,Barbour County, AL,Mar-18,8065,7650,415,5.1
CN0100500000000,01,005,Barbour County, AL,Apr-18(p),8097,7703,394,4.9
CN1915100000000,19,151,Pocahontas County, IA,Mar-17,3909,3791,118,3.0
CN1915100000000,19,151,Pocahontas County, IA,Apr-17,3966,3870,96,2.4
CN1915100000000,19,151,Pocahontas County, IA,May-17,4034,3928,106,2.6
CN1915100000000,19,151,Pocahontas County, IA,Jun-17,4133,4021,112,2.7
CN1915100000000,19,151,Pocahontas County, IA,Jul-17,4218,4115,103,2.4
CN1915100000000,19,151,Pocahontas County, IA,Aug-17,4177,4072,105,2.5
CN1915100000000,19,151,Pocahontas County, IA,Sep-17,4405,4317,88,2.0
CN1915100000000,19,151,Pocahontas County, IA,Oct-17,4406,4337,69,1.6
CN1915100000000,19,151,Pocahontas County, IA,Nov-17,4248,4172,76,1.8
CN1915100000000,19,151,Pocahontas County, IA,Dec-17,4093,4008,85,2.1
CN1915100000000,19,151,Pocahontas County, IA,Jan-18,3943,3828,115,2.9
CN1915100000000,19,151,Pocahontas County, IA,Feb-18,3942,3828,114,2.9
CN1915100000000,19,151,Pocahontas County, IA,Mar-18,3881,3780,101,2.6
CN1915100000000,19,151,Pocahontas County, IA,Apr-18(p),3900,3824,76,1.9
CN4806500000000,48,065,Carson County, TX,Mar-17,3126,3019,107,3.4
CN4806500000000,48,065,Carson County, TX,Apr-17,3125,3025,100,3.2
CN4806500000000,48,065,Carson County, TX,May-17,3120,3014,106,3.4
CN4806500000000,48,065,Carson County, TX,Jun-17,3080,2975,105,3.4
CN4806500000000,48,065,Carson County, TX,Jul-17,3010,2907,103,3.4
CN4806500000000,48,065,Carson County, TX,Aug-17,3025,2926,99,3.3
CN4806500000000,48,065,Carson County, TX,Sep-17,3017,2931,86,2.9
CN4806500000000,48,065,Carson County, TX,Oct-17,3050,2972,78,2.6
CN4806500000000,48,065,Carson County, TX,Nov-17,3039,2955,84,2.8
CN4806500000000,48,065,Carson County, TX,Dec-17,3046,2968,78,2.6
CN4806500000000,48,065,Carson County, TX,Jan-18,3023,2931,92,3.0
CN4806500000000,48,065,Carson County, TX,Feb-18,3080,2985,95,3.1
CN4806500000000,48,065,Carson County, TX,Mar-18,3140,3047,93,3.0
CN4806500000000,48,065,Carson County, TX,Apr-18(p),3127,3040,87,2.8
CN4809100000000,48,091,Comal County, TX,Mar-17,66614,64161,2453,3.7
CN4809100000000,48,091,Comal County, TX,Apr-17,66528,64436,2092,3.1
CN4809100000000,48,091,Comal County, TX,May-17,66424,64254,2170,3.3
CN4809100000000,48,091,Comal County, TX,Jun-17,66842,64485,2357,3.5
CN4809100000000,48,091,Comal County, TX,Jul-17,67205,64799,2406,3.6
CN4809100000000,48,091,Comal County, TX,Aug-17,66889,64510,2379,3.6
CN4809100000000,48,091,Comal County, TX,Sep-17,67453,65380,2073,3.1
CN4809100000000,48,091,Comal County, TX,Oct-17,66903,64982,1921,2.9
CN4809100000000,48,091,Comal County, TX,Nov-17,67133,65101,2032,3.0
CN4809100000000,48,091,Comal County, TX,Dec-17,67325,65353,1972,2.9
CN4809100000000,48,091,Comal County, TX,Jan-18,67309,65085,2224,3.3
CN4809100000000,48,091,Comal County, TX,Feb-18,68265,65991,2274,3.3
CN4809100000000,48,091,Comal County, TX,Mar-18,68364,65966,2398,3.5
CN4809100000000,48,091,Comal County, TX,Apr-18(p),68284,66207,2077,3.0
CN3107900000000,31,079,Hall County, NE,Mar-17,31298,30202,1096,3.5
CN3107900000000,31,079,Hall County, NE,Apr-17,31608,30383,1225,3.9
CN3107900000000,31,079,Hall County, NE,May-17,31267,30339,928,3.0
CN3107900000000,31,079,Hall County, NE,Jun-17,31834,30832,1002,3.1
CN3107900000000,31,079,Hall County, NE,Jul-17,31878,30842,1036,3.2
CN3107900000000,31,079,Hall County, NE,Aug-17,31414,30474,940,3.0
CN3107900000000,31,079,Hall County, NE,Sep-17,31548,30679,869,2.8
CN3107900000000,31,079,Hall County, NE,Oct-17,31306,30458,848,2.7
CN3107900000000,31,079,Hall County, NE,Nov-17,31213,30317,896,2.9
CN3107900000000,31,079,Hall County, NE,Dec-17,31156,30108,1048,3.4
CN3107900000000,31,079,Hall County, NE,Jan-18,31619,30031,1588,5.0
CN3107900000000,31,079,Hall County, NE,Feb-18,31468,30417,1051,3.3
CN3107900000000,31,079,Hall County, NE,Mar-18,31631,30633,998,3.2
CN3107900000000,31,079,Hall County, NE,Apr-18(p),31557,30571,986,3.1
CN4905300000000,49,053,Washington County, UT,Mar-17,69763,67223,2540,3.6
CN4905300000000,49,053,Washington County, UT,Apr-17,70310,67913,2397,3.4
CN4905300000000,49,053,Washington County, UT,May-17,71083,68739,2344,3.3
CN4905300000000,49,053,Washington County, UT,Jun-17,70949,68199,2750,3.9
CN4905300000000,49,053,Washington County, UT,Jul-17,71083,68527,2556,3.6
CN4905300000000,49,053,Washington County, UT,Aug-17,71823,69212,2611,3.6
CN4905300000000,49,053,Washington County, UT,Sep-17,71671,69415,2256,3.1
CN4905300000000,49,053,Washington County, UT,Oct-17,72118,69900,2218,3.1
CN4905300000000,49,053,Washington County, UT,Nov-17,72319,70199,2120,2.9
CN4905300000000,49,053,Washington County, UT,Dec-17,71500,69199,2301,3.2
CN4905300000000,49,053,Washington County, UT,Jan-18,71152,68653,2499,3.5
CN4905300000000,49,053,Washington County, UT,Feb-18,72225,69612,2613,3.6
CN4905300000000,49,053,Washington County, UT,Mar-18,72974,70341,2633,3.6
CN4905300000000,49,053,Washington County, UT,Apr-18(p),73328,70909,2419,3.3
CN4840100000000,48,401,Rusk County, TX,Mar-17,22239,21014,1225,5.5
CN4840100000000,48,401,Rusk County, TX,Apr-17,22172,21056,1116,5.0
CN4840100000000,48,401,Rusk County, TX,May-17,21993,20932,1061,4.8
CN4840100000000,48,401,Rusk County, TX,Jun-17,22152,20995,1157,5.2
CN4840100000000,48,401,Rusk County, TX,Jul-17,22135,20989,1146,5.2
CN4840100000000,48,401,Rusk County, TX,Aug-17,22050,20936,1114,5.1
CN4840100000000,48,401,Rusk County, TX,Sep-17,22141,21114,1027,4.6
CN4840100000000,48,401,Rusk County, TX,Oct-17,22030,21081,949,4.3
CN4840100000000,48,401,Rusk County, TX,Nov-17,22073,21135,938,4.2
CN4840100000000,48,401,Rusk County, TX,Dec-17,22059,21134,925,4.2
CN4840100000000,48,401,Rusk County, TX,Jan-18,22111,21068,1043,4.7
CN4840100000000,48,401,Rusk County, TX,Feb-18,22245,21221,1024,4.6
CN4840100000000,48,401,Rusk County, TX,Mar-18,22257,21275,982,4.4
CN4840100000000,48,401,Rusk County, TX,Apr-18(p),22168,21279,889,4.0
CN3004300000000,30,043,Jefferson County, MT,Mar-17,5657,5385,272,4.8
CN3004300000000,30,043,Jefferson County, MT,Apr-17,5633,5401,232,4.1
CN3004300000000,30,043,Jefferson County, MT,May-17,5667,5449,218,3.8
CN3004300000000,30,043,Jefferson County, MT,Jun-17,5686,5432,254,4.5
CN3004300000000,30,043,Jefferson County, MT,Jul-17,5785,5569,216,3.7
CN3004300000000,30,043,Jefferson County, MT,Aug-17,5718,5506,212,3.7
CN3004300000000,30,043,Jefferson County, MT,Sep-17,5572,5357,215,3.9
CN3004300000000,30,043,Jefferson County, MT,Oct-17,5568,5354,214,3.8
CN3004300000000,30,043,Jefferson County, MT,Nov-17,5612,5373,239,4.3
CN3004300000000,30,043,Jefferson County, MT,Dec-17,5551,5307,244,4.4
CN3004300000000,30,043,Jefferson County, MT,Jan-18,5550,5265,285,5.1
CN3004300000000,30,043,Jefferson County, MT,Feb-18,5537,5254,283,5.1
CN3004300000000,30,043,Jefferson County, MT,Mar-18,5544,5270,274,4.9
CN3004300000000,30,043,Jefferson County, MT,Apr-18(p),5497,5289,208,3.8
CN2710500000000,27,105,Nobles County, MN,Mar-17,11511,11023,488,4.2
CN2710500000000,27,105,Nobles County, MN,Apr-17,11417,11088,329,2.9
CN2710500000000,27,105,Nobles County, MN,May-17,11344,11038,306,2.7
CN2710500000000,27,105,Nobles County, MN,Jun-17,11283,10938,345,3.1
CN2710500000000,27,105,Nobles County, MN,Jul-17,11192,10855,337,3.0
CN2710500000000,27,105,Nobles County, MN,Aug-17,11140,10759,381,3.4
CN2710500000000,27,105,Nobles County, MN,Sep-17,11102,10782,320,2.9
CN2710500000000,27,105,Nobles County, MN,Oct-17,11389,11143,246,2.2
CN2710500000000,27,105,Nobles County, MN,Nov-17,11284,11034,250,2.2
CN2710500000000,27,105,Nobles County, MN,Dec-17,11286,10968,318,2.8
CN2710500000000,27,105,Nobles County, MN,Jan-18,11400,10941,459,4.0
CN2710500000000,27,105,Nobles County, MN,Feb-18,11370,10966,404,3.6
CN2710500000000,27,105,Nobles County, MN,Mar-18,11396,11015,381,3.3
CN2710500000000,27,105,Nobles County, MN,Apr-18(p),11412,11103,309,2.7
CN1905300000000,19,053,Decatur County, IA,Mar-17,4241,4112,129,3.0
CN1905300000000,19,053,Decatur County, IA,Apr-17,4384,4263,121,2.8
CN1905300000000,19,053,Decatur County, IA,May-17,4342,4223,119,2.7
CN1905300000000,19,053,Decatur County, IA,Jun-17,4379,4256,123,2.8
CN1905300000000,19,053,Decatur County, IA,Jul-17,4422,4304,118,2.7
CN1905300000000,19,053,Decatur County, IA,Aug-17,4351,4237,114,2.6
CN1905300000000,19,053,Decatur County, IA,Sep-17,4381,4288,93,2.1
CN1905300000000,19,053,Decatur County, IA,Oct-17,4374,4297,77,1.8
CN1905300000000,19,053,Decatur County, IA,Nov-17,4343,4261,82,1.9
CN1905300000000,19,053,Decatur County, IA,Dec-17,4386,4290,96,2.2
CN1905300000000,19,053,Decatur County, IA,Jan-18,4349,4209,140,3.2
CN1905300000000,19,053,Decatur County, IA,Feb-18,4389,4252,137,3.1
CN1905300000000,19,053,Decatur County, IA,Mar-18,4302,4184,118,2.7
CN1905300000000,19,053,Decatur County, IA,Apr-18(p),4374,4273,101,2.3
CN3900300000000,39,003,Allen County, OH,Mar-17,48713,46210,2503,5.1
CN3900300000000,39,003,Allen County, OH,Apr-17,48604,46308,2296,4.7
CN3900300000000,39,003,Allen County, OH,May-17,48935,46712,2223,4.5
CN3900300000000,39,003,Allen County, OH,Jun-17,49453,46940,2513,5.1
CN3900300000000,39,003,Allen County, OH,Jul-17,49751,46905,2846,5.7
CN3900300000000,39,003,Allen County, OH,Aug-17,49183,46708,2475,5.0
CN3900300000000,39,003,Allen County, OH,Sep-17,48649,46403,2246,4.6
CN3900300000000,39,003,Allen County, OH,Oct-17,48855,46747,2108,4.3
CN3900300000000,39,003,Allen County, OH,Nov-17,48873,46767,2106,4.3
CN3900300000000,39,003,Allen County, OH,Dec-17,48828,46668,2160,4.4
CN3900300000000,39,003,Allen County, OH,Jan-18,47622,45311,2311,4.9
CN3900300000000,39,003,Allen County, OH,Feb-18,48145,45950,2195,4.6
CN3900300000000,39,003,Allen County, OH,Mar-18,48736,46695,2041,4.2
CN3900300000000,39,003,Allen County, OH,Apr-18(p),48288,46350,1938,4.0
CN1300100000000,13,001,Appling County, GA,Mar-17,9397,8905,492,5.2
CN1300100000000,13,001,Appling County, GA,Apr-17,9141,8699,442,4.8
CN1300100000000,13,001,Appling County, GA,May-17,9209,8735,474,5.1
CN1300100000000,13,001,Appling County, GA,Jun-17,9342,8751,591,6.3
CN1300100000000,13,001,Appling County, GA,Jul-17,9340,8763,577,6.2
CN1300100000000,13,001,Appling County, GA,Aug-17,9276,8698,578,6.2
CN1300100000000,13,001,Appling County, GA,Sep-17,9177,8712,465,5.1
CN1300100000000,13,001,Appling County, GA,Oct-17,9094,8660,434,4.8
CN1300100000000,13,001,Appling County, GA,Nov-17,9038,8615,423,4.7
CN1300100000000,13,001,Appling County, GA,Dec-17,9174,8681,493,5.4
CN1300100000000,13,001,Appling County, GA,Jan-18,9455,8948,507,5.4
CN1300100000000,13,001,Appling County, GA,Feb-18,9216,8783,433,4.7
CN1300100000000,13,001,Appling County, GA,Mar-18,9156,8763,393,4.3
CN1300100000000,13,001,Appling County, GA,Apr-18(p),8945,8607,338,3.8
CN3804100000000,38,041,Hettinger County, ND,Mar-17,1492,1451,41,2.7
CN3804100000000,38,041,Hettinger County, ND,Apr-17,1539,1509,30,1.9
CN3804100000000,38,041,Hettinger County, ND,May-17,1549,1528,21,1.4
CN3804100000000,38,041,Hettinger County, ND,Jun-17,1605,1577,28,1.7
CN3804100000000,38,041,Hettinger County, ND,Jul-17,1543,1520,23,1.5
CN3804100000000,38,041,Hettinger County, ND,Aug-17,1581,1559,22,1.4
CN3804100000000,38,041,Hettinger County, ND,Sep-17,1557,1536,21,1.3
CN3804100000000,38,041,Hettinger County, ND,Oct-17,1581,1563,18,1.1
CN3804100000000,38,041,Hettinger County, ND,Nov-17,1504,1483,21,1.4
CN3804100000000,38,041,Hettinger County, ND,Dec-17,1481,1449,32,2.2
CN3804100000000,38,041,Hettinger County, ND,Jan-18,1433,1401,32,2.2
CN3804100000000,38,041,Hettinger County, ND,Feb-18,1415,1370,45,3.2
CN3804100000000,38,041,Hettinger County, ND,Mar-18,1448,1405,43,3.0
CN3804100000000,38,041,Hettinger County, ND,Apr-18(p),1453,1425,28,1.9
CN4847900000000,48,479,Webb County, TX,Mar-17,115061,109801,5260,4.6
CN4847900000000,48,479,Webb County, TX,Apr-17,114546,109760,4786,4.2
CN4847900000000,48,479,Webb County, TX,May-17,114222,109522,4700,4.1
CN4847900000000,48,479,Webb County, TX,Jun-17,114807,109589,5218,4.5
CN4847900000000,48,479,Webb County, TX,Jul-17,115013,110034,4979,4.3
CN4847900000000,48,479,Webb County, TX,Aug-17,114649,109753,4896,4.3
CN4847900000000,48,479,Webb County, TX,Sep-17,115156,110991,4165,3.6
CN4847900000000,48,479,Webb County, TX,Oct-17,113960,110078,3882,3.4
CN4847900000000,48,479,Webb County, TX,Nov-17,114929,110897,4032,3.5
CN4847900000000,48,479,Webb County, TX,Dec-17,114790,110882,3908,3.4
CN4847900000000,48,479,Webb County, TX,Jan-18,114979,110488,4491,3.9
CN4847900000000,48,479,Webb County, TX,Feb-18,116383,111804,4579,3.9
CN4847900000000,48,479,Webb County, TX,Mar-18,116324,111702,4622,4.0
CN4847900000000,48,479,Webb County, TX,Apr-18(p),116292,112100,4192,3.6
CN2201700000000,22,017,Caddo Parish, LA,Mar-17,105644,99404,6240,5.9
CN2201700000000,22,017,Caddo Parish, LA,Apr-17,105403,99405,5998,5.7
CN2201700000000,22,017,Caddo Parish, LA,May-17,104781,98613,6168,5.9
CN2201700000000,22,017,Caddo Parish, LA,Jun-17,106829,99698,7131,6.7
CN2201700000000,22,017,Caddo Parish, LA,Jul-17,107241,100466,6775,6.3
CN2201700000000,22,017,Caddo Parish, LA,Aug-17,106341,99594,6747,6.3
CN2201700000000,22,017,Caddo Parish, LA,Sep-17,106230,100328,5902,5.6
CN2201700000000,22,017,Caddo Parish, LA,Oct-17,105650,100400,5250,5.0
CN2201700000000,22,017,Caddo Parish, LA,Nov-17,105471,100403,5068,4.8
CN2201700000000,22,017,Caddo Parish, LA,Dec-17,104965,100186,4779,4.6
CN2201700000000,22,017,Caddo Parish, LA,Jan-18,105389,100239,5150,4.9
CN2201700000000,22,017,Caddo Parish, LA,Feb-18,106654,101862,4792,4.5
CN2201700000000,22,017,Caddo Parish, LA,Mar-18,106538,101303,5235,4.9
CN2201700000000,22,017,Caddo Parish, LA,Apr-18(p),106364,101213,5151,4.8
CN1808700000000,18,087,LaGrange County, IN,Mar-17,19541,19013,528,2.7
CN1808700000000,18,087,LaGrange County, IN,Apr-17,19581,19170,411,2.1
CN1808700000000,18,087,LaGrange County, IN,May-17,20393,19932,461,2.3
CN1808700000000,18,087,LaGrange County, IN,Jun-17,20594,20049,545,2.6
CN1808700000000,18,087,LaGrange County, IN,Jul-17,20233,19686,547,2.7
CN1808700000000,18,087,LaGrange County, IN,Aug-17,20094,19481,613,3.1
CN1808700000000,18,087,LaGrange County, IN,Sep-17,19882,19412,470,2.4
CN1808700000000,18,087,LaGrange County, IN,Oct-17,19952,19510,442,2.2
CN1808700000000,18,087,LaGrange County, IN,Nov-17,19990,19529,461,2.3
CN1808700000000,18,087,LaGrange County, IN,Dec-17,19676,19287,389,2.0
CN1808700000000,18,087,LaGrange County, IN,Jan-18,19185,18726,459,2.4
CN1808700000000,18,087,LaGrange County, IN,Feb-18,19605,19111,494,2.5
CN1808700000000,18,087,LaGrange County, IN,Mar-18,19854,19426,428,2.2
CN1808700000000,18,087,LaGrange County, IN,Apr-18(p),20163,19761,402,2.0
CN2912900000000,29,129,Mercer County, MO,Mar-17,1949,1873,76,3.9
CN2912900000000,29,129,Mercer County, MO,Apr-17,2126,2060,66,3.1
CN2912900000000,29,129,Mercer County, MO,May-17,2018,1956,62,3.1
CN2912900000000,29,129,Mercer County, MO,Jun-17,2034,1958,76,3.7
CN2912900000000,29,129,Mercer County, MO,Jul-17,1817,1729,88,4.8
CN2912900000000,29,129,Mercer County, MO,Aug-17,1808,1725,83,4.6
CN2912900000000,29,129,Mercer County, MO,Sep-17,1904,1842,62,3.3
CN2912900000000,29,129,Mercer County, MO,Oct-17,1962,1916,46,2.3
CN2912900000000,29,129,Mercer County, MO,Nov-17,1951,1895,56,2.9
CN2912900000000,29,129,Mercer County, MO,Dec-17,1884,1823,61,3.2
CN2912900000000,29,129,Mercer County, MO,Jan-18,1934,1852,82,4.2
CN2912900000000,29,129,Mercer County, MO,Feb-18,2021,1933,88,4.4
CN2912900000000,29,129,Mercer County, MO,Mar-18,2002,1932,70,3.5
CN2912900000000,29,129,Mercer County, MO,Apr-18(p),2074,2008,66,3.2
CN5508300000000,55,083,Oconto County, WI,Mar-17,20603,19672,931,4.5
CN5508300000000,55,083,Oconto County, WI,Apr-17,20697,19936,761,3.7
CN5508300000000,55,083,Oconto County, WI,May-17,20663,20031,632,3.1
CN5508300000000,55,083,Oconto County, WI,Jun-17,21244,20493,751,3.5
CN5508300000000,55,083,Oconto County, WI,Jul-17,21050,20364,686,3.3
CN5508300000000,55,083,Oconto County, WI,Aug-17,20891,20225,666,3.2
CN5508300000000,55,083,Oconto County, WI,Sep-17,20725,20131,594,2.9
CN5508300000000,55,083,Oconto County, WI,Oct-17,20813,20251,562,2.7
CN5508300000000,55,083,Oconto County, WI,Nov-17,20867,20269,598,2.9
CN5508300000000,55,083,Oconto County, WI,Dec-17,20737,20093,644,3.1
CN5508300000000,55,083,Oconto County, WI,Jan-18,20820,20041,779,3.7
CN5508300000000,55,083,Oconto County, WI,Feb-18,20932,20033,899,4.3
CN5508300000000,55,083,Oconto County, WI,Mar-18,21029,20178,851,4.0
CN5508300000000,55,083,Oconto County, WI,Apr-18(p),21029,20314,715,3.4
CN1719700000000,17,197,Will County, IL,Mar-17,360992,342915,18077,5.0
CN1719700000000,17,197,Will County, IL,Apr-17,358561,341492,17069,4.8
CN1719700000000,17,197,Will County, IL,May-17,359303,343114,16189,4.5
CN1719700000000,17,197,Will County, IL,Jun-17,367055,346808,20247,5.5
CN1719700000000,17,197,Will County, IL,Jul-17,366560,346787,19773,5.4
CN1719700000000,17,197,Will County, IL,Aug-17,362029,341937,20092,5.5
CN1719700000000,17,197,Will County, IL,Sep-17,361141,343916,17225,4.8
CN1719700000000,17,197,Will County, IL,Oct-17,360702,343388,17314,4.8
CN1719700000000,17,197,Will County, IL,Nov-17,361647,344292,17355,4.8
CN1719700000000,17,197,Will County, IL,Dec-17,360672,342357,18315,5.1
CN1719700000000,17,197,Will County, IL,Jan-18,357959,336234,21725,6.1
CN1719700000000,17,197,Will County, IL,Feb-18,363350,342067,21283,5.9
CN1719700000000,17,197,Will County, IL,Mar-18,359072,342539,16533,4.6
CN1719700000000,17,197,Will County, IL,Apr-18(p),353754,340510,13244,3.7
CN7204900000000,72,049,Culebra Municipio, PR,Mar-17,959,921,38,4.0
CN7204900000000,72,049,Culebra Municipio, PR,Apr-17,978,939,39,4.0
CN7204900000000,72,049,Culebra Municipio, PR,May-17,946,916,30,3.2
CN7204900000000,72,049,Culebra Municipio, PR,Jun-17,946,919,27,2.9
CN7204900000000,72,049,Culebra Municipio, PR,Jul-17,937,904,33,3.5
CN7204900000000,72,049,Culebra Municipio, PR,Aug-17,919,884,35,3.8
CN7204900000000,72,049,Culebra Municipio, PR,Sep-17(y),946,900,46,4.9
CN7204900000000,72,049,Culebra Municipio, PR,Oct-17,933,878,55,5.9
CN7204900000000,72,049,Culebra Municipio, PR,Nov-17,981,929,52,5.3
CN7204900000000,72,049,Culebra Municipio, PR,Dec-17,999,938,61,6.1
CN7204900000000,72,049,Culebra Municipio, PR,Jan-18,946,888,58,6.1
CN7204900000000,72,049,Culebra Municipio, PR,Feb-18,963,919,44,4.6
CN7204900000000,72,049,Culebra Municipio, PR,Mar-18,973,932,41,4.2
CN7204900000000,72,049,Culebra Municipio, PR,Apr-18(p),988,947,41,4.1
CN1606300000000,16,063,Lincoln County, ID,Mar-17,2647,2514,133,5.0
CN1606300000000,16,063,Lincoln County, ID,Apr-17,2604,2524,80,3.1
CN1606300000000,16,063,Lincoln County, ID,May-17,2604,2535,69,2.6
CN1606300000000,16,063,Lincoln County, ID,Jun-17,2740,2674,66,2.4
CN1606300000000,16,063,Lincoln County, ID,Jul-17,2848,2782,66,2.3
CN1606300000000,16,063,Lincoln County, ID,Aug-17,2797,2738,59,2.1
CN1606300000000,16,063,Lincoln County, ID,Sep-17,2774,2719,55,2.0
CN1606300000000,16,063,Lincoln County, ID,Oct-17,2785,2726,59,2.1
CN1606300000000,16,063,Lincoln County, ID,Nov-17,2655,2576,79,3.0
CN1606300000000,16,063,Lincoln County, ID,Dec-17,2709,2612,97,3.6
CN1606300000000,16,063,Lincoln County, ID,Jan-18,2729,2587,142,5.2
CN1606300000000,16,063,Lincoln County, ID,Feb-18,2718,2584,134,4.9
CN1606300000000,16,063,Lincoln County, ID,Mar-18,2693,2573,120,4.5
CN1606300000000,16,063,Lincoln County, ID,Apr-18(p),2650,2564,86,3.2
CN1704300000000,17,043,DuPage County, IL,Mar-17,514046,494729,19317,3.8
CN1704300000000,17,043,DuPage County, IL,Apr-17,511075,492041,19034,3.7
CN1704300000000,17,043,DuPage County, IL,May-17,513749,495095,18654,3.6
CN1704300000000,17,043,DuPage County, IL,Jun-17,523458,500337,23121,4.4
CN1704300000000,17,043,DuPage County, IL,Jul-17,522509,500133,22376,4.3
CN1704300000000,17,043,DuPage County, IL,Aug-17,517078,493561,23517,4.5
CN1704300000000,17,043,DuPage County, IL,Sep-17,516646,496348,20298,3.9
CN1704300000000,17,043,DuPage County, IL,Oct-17,515797,495343,20454,4.0
CN1704300000000,17,043,DuPage County, IL,Nov-17,516794,496547,20247,3.9
CN1704300000000,17,043,DuPage County, IL,Dec-17,514388,494343,20045,3.9
CN1704300000000,17,043,DuPage County, IL,Jan-18,508164,485534,22630,4.5
CN1704300000000,17,043,DuPage County, IL,Feb-18,515346,493583,21763,4.2
CN1704300000000,17,043,DuPage County, IL,Mar-18,511983,494670,17313,3.4
CN1704300000000,17,043,DuPage County, IL,Apr-18(p),505490,491161,14329,2.8
CN4713700000000,47,137,Pickett County, TN,Mar-17,2431,2302,129,5.3
CN4713700000000,47,137,Pickett County, TN,Apr-17,2428,2330,98,4.0
CN4713700000000,47,137,Pickett County, TN,May-17,2499,2391,108,4.3
CN4713700000000,47,137,Pickett County, TN,Jun-17,2516,2398,118,4.7
CN4713700000000,47,137,Pickett County, TN,Jul-17,2508,2403,105,4.2
CN4713700000000,47,137,Pickett County, TN,Aug-17,2531,2442,89,3.5
CN4713700000000,47,137,Pickett County, TN,Sep-17,2475,2394,81,3.3
CN4713700000000,47,137,Pickett County, TN,Oct-17,2435,2352,83,3.4
CN4713700000000,47,137,Pickett County, TN,Nov-17,2417,2336,81,3.4
CN4713700000000,47,137,Pickett County, TN,Dec-17,2401,2316,85,3.5
CN4713700000000,47,137,Pickett County, TN,Jan-18,2415,2308,107,4.4
CN4713700000000,47,137,Pickett County, TN,Feb-18,2429,2329,100,4.1
CN4713700000000,47,137,Pickett County, TN,Mar-18,2442,2358,84,3.4
CN4713700000000,47,137,Pickett County, TN,Apr-18(p),2499,2433,66,2.6
CN0808300000000,08,083,Montezuma County, CO,Mar-17,12542,11974,568,4.5
CN0808300000000,08,083,Montezuma County, CO,Apr-17,12848,12380,468,3.6
CN0808300000000,08,083,Montezuma County, CO,May-17,13194,12780,414,3.1
CN0808300000000,08,083,Montezuma County, CO,Jun-17,13251,12763,488,3.7
CN0808300000000,08,083,Montezuma County, CO,Jul-17,13409,12952,457,3.4
CN0808300000000,08,083,Montezuma County, CO,Aug-17,13281,12846,435,3.3
CN0808300000000,08,083,Montezuma County, CO,Sep-17,13225,12784,441,3.3
CN0808300000000,08,083,Montezuma County, CO,Oct-17,13336,12876,460,3.4
CN0808300000000,08,083,Montezuma County, CO,Nov-17,13124,12583,541,4.1
CN0808300000000,08,083,Montezuma County, CO,Dec-17,12841,12193,648,5.0
CN0808300000000,08,083,Montezuma County, CO,Jan-18,12745,11961,784,6.2
CN0808300000000,08,083,Montezuma County, CO,Feb-18,12807,12069,738,5.8
CN0808300000000,08,083,Montezuma County, CO,Mar-18,12857,12194,663,5.2
CN0808300000000,08,083,Montezuma County, CO,Apr-18(p),13129,12607,522,4.0
CN4836300000000,48,363,Palo Pinto County, TX,Mar-17,13231,12628,603,4.6
CN4836300000000,48,363,Palo Pinto County, TX,Apr-17,13299,12766,533,4.0
CN4836300000000,48,363,Palo Pinto County, TX,May-17,13433,12902,531,4.0
CN4836300000000,48,363,Palo Pinto County, TX,Jun-17,13560,13007,553,4.1
CN4836300000000,48,363,Palo Pinto County, TX,Jul-17,13598,13037,561,4.1
CN4836300000000,48,363,Palo Pinto County, TX,Aug-17,13582,13042,540,4.0
CN4836300000000,48,363,Palo Pinto County, TX,Sep-17,13659,13160,499,3.7
CN4836300000000,48,363,Palo Pinto County, TX,Oct-17,13498,13038,460,3.4
CN4836300000000,48,363,Palo Pinto County, TX,Nov-17,13420,12953,467,3.5
CN4836300000000,48,363,Palo Pinto County, TX,Dec-17,13360,12924,436,3.3
CN4836300000000,48,363,Palo Pinto County, TX,Jan-18,13542,13045,497,3.7
CN4836300000000,48,363,Palo Pinto County, TX,Feb-18,13730,13229,501,3.6
CN4836300000000,48,363,Palo Pinto County, TX,Mar-18,13798,13305,493,3.6
CN4836300000000,48,363,Palo Pinto County, TX,Apr-18(p),13665,13233,432,3.2
CN0505100000000,05,051,Garland County, AR,Mar-17,40579,39063,1516,3.7
CN0505100000000,05,051,Garland County, AR,Apr-17,41056,39667,1389,3.4
CN0505100000000,05,051,Garland County, AR,May-17,40380,38823,1557,3.9
CN0505100000000,05,051,Garland County, AR,Jun-17,41465,39691,1774,4.3
CN0505100000000,05,051,Garland County, AR,Jul-17,42000,40102,1898,4.5
CN0505100000000,05,051,Garland County, AR,Aug-17,40994,39316,1678,4.1
CN0505100000000,05,051,Garland County, AR,Sep-17,40391,38788,1603,4.0
CN0505100000000,05,051,Garland County, AR,Oct-17,39659,38229,1430,3.6
CN0505100000000,05,051,Garland County, AR,Nov-17,39407,37998,1409,3.6
CN0505100000000,05,051,Garland County, AR,Dec-17,39164,37622,1542,3.9
CN0505100000000,05,051,Garland County, AR,Jan-18,39650,37767,1883,4.7
CN0505100000000,05,051,Garland County, AR,Feb-18,40039,38176,1863,4.7
CN0505100000000,05,051,Garland County, AR,Mar-18,40528,38793,1735,4.3
CN0505100000000,05,051,Garland County, AR,Apr-18(p),40726,39253,1473,3.6
CN3003500000000,30,035,Glacier County, MT,Mar-17,5513,5015,498,9.0
CN3003500000000,30,035,Glacier County, MT,Apr-17,5540,5088,452,8.2
CN3003500000000,30,035,Glacier County, MT,May-17,5771,5357,414,7.2
CN3003500000000,30,035,Glacier County, MT,Jun-17,6274,5724,550,8.8
CN3003500000000,30,035,Glacier County, MT,Jul-17,6138,5655,483,7.9
CN3003500000000,30,035,Glacier County, MT,Aug-17,6181,5709,472,7.6
CN3003500000000,30,035,Glacier County, MT,Sep-17,5945,5582,363,6.1
CN3003500000000,30,035,Glacier County, MT,Oct-17,5563,5175,388,7.0
CN3003500000000,30,035,Glacier County, MT,Nov-17,5487,5071,416,7.6
CN3003500000000,30,035,Glacier County, MT,Dec-17,5476,5060,416,7.6
CN3003500000000,30,035,Glacier County, MT,Jan-18,5475,4941,534,9.8
CN3003500000000,30,035,Glacier County, MT,Feb-18,5451,4935,516,9.5
CN3003500000000,30,035,Glacier County, MT,Mar-18,5428,4937,491,9.0
CN3003500000000,30,035,Glacier County, MT,Apr-18(p),5449,5020,429,7.9
CN0610300000000,06,103,Tehama County, CA,Mar-17,25543,23630,1913,7.5
CN0610300000000,06,103,Tehama County, CA,Apr-17,25286,23573,1713,6.8
CN0610300000000,06,103,Tehama County, CA,May-17,25295,23745,1550,6.1
CN0610300000000,06,103,Tehama County, CA,Jun-17,25705,24027,1678,6.5
CN0610300000000,06,103,Tehama County, CA,Jul-17,25567,23830,1737,6.8
CN0610300000000,06,103,Tehama County, CA,Aug-17,25825,24186,1639,6.3
CN0610300000000,06,103,Tehama County, CA,Sep-17,26200,24834,1366,5.2
CN0610300000000,06,103,Tehama County, CA,Oct-17,26298,25024,1274,4.8
CN0610300000000,06,103,Tehama County, CA,Nov-17,25557,24265,1292,5.1
CN0610300000000,06,103,Tehama County, CA,Dec-17,25263,23879,1384,5.5
CN0610300000000,06,103,Tehama County, CA,Jan-18,25663,24036,1627,6.3
CN0610300000000,06,103,Tehama County, CA,Feb-18,25771,24116,1655,6.4
CN0610300000000,06,103,Tehama County, CA,Mar-18,25627,24005,1622,6.3
CN0610300000000,06,103,Tehama County, CA,Apr-18(p),25514,24109,1405,5.5
CN1210700000000,12,107,Putnam County, FL,Mar-17,27338,25891,1447,5.3
CN1210700000000,12,107,Putnam County, FL,Apr-17,27175,25812,1363,5.0
CN1210700000000,12,107,Putnam County, FL,May-17,27741,26355,1386,5.0
CN1210700000000,12,107,Putnam County, FL,Jun-17,26857,25333,1524,5.7
CN1210700000000,12,107,Putnam County, FL,Jul-17,26557,25032,1525,5.7
CN1210700000000,12,107,Putnam County, FL,Aug-17,27161,25649,1512,5.6
CN1210700000000,12,107,Putnam County, FL,Sep-17,27493,26080,1413,5.1
CN1210700000000,12,107,Putnam County, FL,Oct-17,27048,25729,1319,4.9
CN1210700000000,12,107,Putnam County, FL,Nov-17,26630,25304,1326,5.0
CN1210700000000,12,107,Putnam County, FL,Dec-17,27241,25959,1282,4.7
CN1210700000000,12,107,Putnam County, FL,Jan-18,26835,25349,1486,5.5
CN1210700000000,12,107,Putnam County, FL,Feb-18,26968,25591,1377,5.1
CN1210700000000,12,107,Putnam County, FL,Mar-18,27092,25744,1348,5.0
CN1210700000000,12,107,Putnam County, FL,Apr-18(p),26968,25740,1228,4.6
CN0601300000000,06,013,Contra Costa County, CA,Mar-17,564315,541464,22851,4.0
CN0601300000000,06,013,Contra Costa County, CA,Apr-17,560678,539922,20756,3.7
CN0601300000000,06,013,Contra Costa County, CA,May-17,560119,540432,19687,3.5
CN0601300000000,06,013,Contra Costa County, CA,Jun-17,563277,540844,22433,4.0
CN0601300000000,06,013,Contra Costa County, CA,Jul-17,567113,543291,23822,4.2
CN0601300000000,06,013,Contra Costa County, CA,Aug-17,565099,542040,23059,4.1
CN0601300000000,06,013,Contra Costa County, CA,Sep-17,567425,547600,19825,3.5
CN0601300000000,06,013,Contra Costa County, CA,Oct-17,565145,545939,19206,3.4
CN0601300000000,06,013,Contra Costa County, CA,Nov-17,566472,547819,18653,3.3
CN0601300000000,06,013,Contra Costa County, CA,Dec-17,565001,547166,17835,3.2
CN0601300000000,06,013,Contra Costa County, CA,Jan-18,563976,544131,19845,3.5
CN0601300000000,06,013,Contra Costa County, CA,Feb-18,567304,548224,19080,3.4
CN0601300000000,06,013,Contra Costa County, CA,Mar-18,564441,546821,17620,3.1
CN0601300000000,06,013,Contra Costa County, CA,Apr-18(p),559638,543736,15902,2.8
CN4702100000000,47,021,Cheatham County, TN,Mar-17,20847,20132,715,3.4
CN4702100000000,47,021,Cheatham County, TN,Apr-17,20878,20282,596,2.9
CN4702100000000,47,021,Cheatham County, TN,May-17,20879,20334,545,2.6
CN4702100000000,47,021,Cheatham County, TN,Jun-17,21204,20495,709,3.3
CN4702100000000,47,021,Cheatham County, TN,Jul-17,21276,20601,675,3.2
CN4702100000000,47,021,Cheatham County, TN,Aug-17,21087,20443,644,3.1
CN4702100000000,47,021,Cheatham County, TN,Sep-17,21240,20692,548,2.6
CN4702100000000,47,021,Cheatham County, TN,Oct-17,21223,20697,526,2.5
CN4702100000000,47,021,Cheatham County, TN,Nov-17,21080,20549,531,2.5
CN4702100000000,47,021,Cheatham County, TN,Dec-17,21054,20560,494,2.3
CN4702100000000,47,021,Cheatham County, TN,Jan-18,21006,20433,573,2.7
CN4702100000000,47,021,Cheatham County, TN,Feb-18,21278,20702,576,2.7
CN4702100000000,47,021,Cheatham County, TN,Mar-18,21361,20776,585,2.7
CN4702100000000,47,021,Cheatham County, TN,Apr-18(p),21517,21031,486,2.3
CN1316300000000,13,163,Jefferson County, GA,Mar-17,6741,6308,433,6.4
CN1316300000000,13,163,Jefferson County, GA,Apr-17,6725,6344,381,5.7
CN1316300000000,13,163,Jefferson County, GA,May-17,6741,6333,408,6.1
CN1316300000000,13,163,Jefferson County, GA,Jun-17,6788,6348,440,6.5
CN1316300000000,13,163,Jefferson County, GA,Jul-17,6768,6296,472,7.0
CN1316300000000,13,163,Jefferson County, GA,Aug-17,6741,6296,445,6.6
CN1316300000000,13,163,Jefferson County, GA,Sep-17,6712,6334,378,5.6
CN1316300000000,13,163,Jefferson County, GA,Oct-17,6719,6340,379,5.6
CN1316300000000,13,163,Jefferson County, GA,Nov-17,6754,6369,385,5.7
CN1316300000000,13,163,Jefferson County, GA,Dec-17,6772,6391,381,5.6
CN1316300000000,13,163,Jefferson County, GA,Jan-18,6965,6492,473,6.8
CN1316300000000,13,163,Jefferson County, GA,Feb-18,6852,6441,411,6.0
CN1316300000000,13,163,Jefferson County, GA,Mar-18,6820,6453,367,5.4
CN1316300000000,13,163,Jefferson County, GA,Apr-18(p),6785,6450,335,4.9
CN4829100000000,48,291,Liberty County, TX,Mar-17,31838,29435,2403,7.5
CN4829100000000,48,291,Liberty County, TX,Apr-17,31773,29536,2237,7.0
CN4829100000000,48,291,Liberty County, TX,May-17,31638,29487,2151,6.8
CN4829100000000,48,291,Liberty County, TX,Jun-17,31786,29462,2324,7.3
CN4829100000000,48,291,Liberty County, TX,Jul-17,31770,29497,2273,7.2
CN4829100000000,48,291,Liberty County, TX,Aug-17,31721,29364,2357,7.4
CN4829100000000,48,291,Liberty County, TX,Sep-17,31752,29561,2191,6.9
CN4829100000000,48,291,Liberty County, TX,Oct-17,31446,29569,1877,6.0
CN4829100000000,48,291,Liberty County, TX,Nov-17,31640,29711,1929,6.1
CN4829100000000,48,291,Liberty County, TX,Dec-17,31728,29780,1948,6.1
CN4829100000000,48,291,Liberty County, TX,Jan-18,31829,29650,2179,6.8
CN4829100000000,48,291,Liberty County, TX,Feb-18,32240,30099,2141,6.6
CN4829100000000,48,291,Liberty County, TX,Mar-18,32263,30224,2039,6.3
CN4829100000000,48,291,Liberty County, TX,Apr-18(p),32284,30398,1886,5.8
CN0501700000000,05,017,Chicot County, AR,Mar-17,3525,3285,240,6.8
CN0501700000000,05,017,Chicot County, AR,Apr-17,3499,3295,204,5.8
CN0501700000000,05,017,Chicot County, AR,May-17,3530,3317,213,6.0
CN0501700000000,05,017,Chicot County, AR,Jun-17,3550,3325,225,6.3
CN0501700000000,05,017,Chicot County, AR,Jul-17,3539,3309,230,6.5
CN0501700000000,05,017,Chicot County, AR,Aug-17,3527,3313,214,6.1
CN0501700000000,05,017,Chicot County, AR,Sep-17,3466,3266,200,5.8
CN0501700000000,05,017,Chicot County, AR,Oct-17,3513,3308,205,5.8
CN0501700000000,05,017,Chicot County, AR,Nov-17,3458,3251,207,6.0
CN0501700000000,05,017,Chicot County, AR,Dec-17,3466,3226,240,6.9
CN0501700000000,05,017,Chicot County, AR,Jan-18,3386,3085,301,8.9
CN0501700000000,05,017,Chicot County, AR,Feb-18,3389,3078,311,9.2
CN0501700000000,05,017,Chicot County, AR,Mar-18,3392,3099,293,8.6
CN0501700000000,05,017,Chicot County, AR,Apr-18(p),3397,3168,229,6.7
CN4904500000000,49,045,Tooele County, UT,Mar-17,31442,30218,1224,3.9
CN4904500000000,49,045,Tooele County, UT,Apr-17,31450,30281,1169,3.7
CN4904500000000,49,045,Tooele County, UT,May-17,31811,30623,1188,3.7
CN4904500000000,49,045,Tooele County, UT,Jun-17,32040,30710,1330,4.2
CN4904500000000,49,045,Tooele County, UT,Jul-17,32155,30915,1240,3.9
CN4904500000000,49,045,Tooele County, UT,Aug-17,32065,30842,1223,3.8
CN4904500000000,49,045,Tooele County, UT,Sep-17,31877,30812,1065,3.3
CN4904500000000,49,045,Tooele County, UT,Oct-17,31904,30884,1020,3.2
CN4904500000000,49,045,Tooele County, UT,Nov-17,32156,31220,936,2.9
CN4904500000000,49,045,Tooele County, UT,Dec-17,32153,31154,999,3.1
CN4904500000000,49,045,Tooele County, UT,Jan-18,31972,30871,1101,3.4
CN4904500000000,49,045,Tooele County, UT,Feb-18,32260,31107,1153,3.6
CN4904500000000,49,045,Tooele County, UT,Mar-18,32315,31126,1189,3.7
CN4904500000000,49,045,Tooele County, UT,Apr-18(p),32242,31172,1070,3.3
CN5500100000000,55,001,Adams County, WI,Mar-17,8109,7582,527,6.5
CN5500100000000,55,001,Adams County, WI,Apr-17,8191,7822,369,4.5
CN5500100000000,55,001,Adams County, WI,May-17,8322,7985,337,4.0
CN5500100000000,55,001,Adams County, WI,Jun-17,8762,8330,432,4.9
CN5500100000000,55,001,Adams County, WI,Jul-17,8601,8200,401,4.7
CN5500100000000,55,001,Adams County, WI,Aug-17,8537,8113,424,5.0
CN5500100000000,55,001,Adams County, WI,Sep-17,8367,8027,340,4.1
CN5500100000000,55,001,Adams County, WI,Oct-17,8276,7961,315,3.8
CN5500100000000,55,001,Adams County, WI,Nov-17,8227,7879,348,4.2
CN5500100000000,55,001,Adams County, WI,Dec-17,8179,7762,417,5.1
CN5500100000000,55,001,Adams County, WI,Jan-18,8125,7672,453,5.6
CN5500100000000,55,001,Adams County, WI,Feb-18,8164,7648,516,6.3
CN5500100000000,55,001,Adams County, WI,Mar-18,8186,7736,450,5.5
CN5500100000000,55,001,Adams County, WI,Apr-18(p),8270,7921,349,4.2
CN0803700000000,08,037,Eagle County, CO,Mar-17,36546,35795,751,2.1
CN0803700000000,08,037,Eagle County, CO,Apr-17,35257,34580,677,1.9
CN0803700000000,08,037,Eagle County, CO,May-17,31564,30605,959,3.0
CN0803700000000,08,037,Eagle County, CO,Jun-17,34250,33429,821,2.4
CN0803700000000,08,037,Eagle County, CO,Jul-17,35353,34638,715,2.0
CN0803700000000,08,037,Eagle County, CO,Aug-17,35077,34383,694,2.0
CN0803700000000,08,037,Eagle County, CO,Sep-17,34361,33653,708,2.1
CN0803700000000,08,037,Eagle County, CO,Oct-17,33886,33054,832,2.5
CN0803700000000,08,037,Eagle County, CO,Nov-17,33816,32767,1049,3.1
CN0803700000000,08,037,Eagle County, CO,Dec-17,37331,36443,888,2.4
CN0803700000000,08,037,Eagle County, CO,Jan-18,37979,37078,901,2.4
CN0803700000000,08,037,Eagle County, CO,Feb-18,38192,37291,901,2.4
CN0803700000000,08,037,Eagle County, CO,Mar-18,38036,37248,788,2.1
CN0803700000000,08,037,Eagle County, CO,Apr-18(p),36681,35986,695,1.9
CN1310300000000,13,103,Effingham County, GA,Mar-17,28996,27773,1223,4.2
CN1310300000000,13,103,Effingham County, GA,Apr-17,29055,27909,1146,3.9
CN1310300000000,13,103,Effingham County, GA,May-17,29163,28014,1149,3.9
CN1310300000000,13,103,Effingham County, GA,Jun-17,29263,27964,1299,4.4
CN1310300000000,13,103,Effingham County, GA,Jul-17,29514,28229,1285,4.4
CN1310300000000,13,103,Effingham County, GA,Aug-17,29156,27920,1236,4.2
CN1310300000000,13,103,Effingham County, GA,Sep-17,28936,27837,1099,3.8
CN1310300000000,13,103,Effingham County, GA,Oct-17,29113,28000,1113,3.8
CN1310300000000,13,103,Effingham County, GA,Nov-17,28974,27925,1049,3.6
CN1310300000000,13,103,Effingham County, GA,Dec-17,28975,27908,1067,3.7
CN1310300000000,13,103,Effingham County, GA,Jan-18,29039,27916,1123,3.9
CN1310300000000,13,103,Effingham County, GA,Feb-18,29499,28358,1141,3.9
CN1310300000000,13,103,Effingham County, GA,Mar-18,29627,28574,1053,3.6
CN1310300000000,13,103,Effingham County, GA,Apr-18(p),29435,28511,924,3.1
CN1815900000000,18,159,Tipton County, IN,Mar-17,8468,8194,274,3.2
CN1815900000000,18,159,Tipton County, IN,Apr-17,8458,8252,206,2.4
CN1815900000000,18,159,Tipton County, IN,May-17,8786,8562,224,2.5
CN1815900000000,18,159,Tipton County, IN,Jun-17,8749,8425,324,3.7
CN1815900000000,18,159,Tipton County, IN,Jul-17,8578,8326,252,2.9
CN1815900000000,18,159,Tipton County, IN,Aug-17,8577,8284,293,3.4
CN1815900000000,18,159,Tipton County, IN,Sep-17,8543,8307,236,2.8
CN1815900000000,18,159,Tipton County, IN,Oct-17,8519,8295,224,2.6
CN1815900000000,18,159,Tipton County, IN,Nov-17,8555,8341,214,2.5
CN1815900000000,18,159,Tipton County, IN,Dec-17,8444,8232,212,2.5
CN1815900000000,18,159,Tipton County, IN,Jan-18,8287,8029,258,3.1
CN1815900000000,18,159,Tipton County, IN,Feb-18,8464,8174,290,3.4
CN1815900000000,18,159,Tipton County, IN,Mar-18,8559,8319,240,2.8
CN1815900000000,18,159,Tipton County, IN,Apr-18(p),8574,8354,220,2.6
CN4104700000000,41,047,Marion County, OR,Mar-17,159679,152518,7161,4.5
CN4104700000000,41,047,Marion County, OR,Apr-17,160423,154044,6379,4.0
CN4104700000000,41,047,Marion County, OR,May-17,160987,154697,6290,3.9
CN4104700000000,41,047,Marion County, OR,Jun-17,164089,156684,7405,4.5
CN4104700000000,41,047,Marion County, OR,Jul-17,166368,158544,7824,4.7
CN4104700000000,41,047,Marion County, OR,Aug-17,166616,158784,7832,4.7
CN4104700000000,41,047,Marion County, OR,Sep-17,165466,158659,6807,4.1
CN4104700000000,41,047,Marion County, OR,Oct-17,163942,157347,6595,4.0
CN4104700000000,41,047,Marion County, OR,Nov-17,164110,157470,6640,4.0
CN4104700000000,41,047,Marion County, OR,Dec-17,162439,156053,6386,3.9
CN4104700000000,41,047,Marion County, OR,Jan-18,160454,153466,6988,4.4
CN4104700000000,41,047,Marion County, OR,Feb-18,162347,155076,7271,4.5
CN4104700000000,41,047,Marion County, OR,Mar-18,160987,153796,7191,4.5
CN4104700000000,41,047,Marion County, OR,Apr-18(p),159846,153430,6416,4.0
CN1904900000000,19,049,Dallas County, IA,Mar-17,45770,44708,1062,2.3
CN1904900000000,19,049,Dallas County, IA,Apr-17,45872,44943,929,2.0
CN1904900000000,19,049,Dallas County, IA,May-17,45930,44999,931,2.0
CN1904900000000,19,049,Dallas County, IA,Jun-17,46647,45571,1076,2.3
CN1904900000000,19,049,Dallas County, IA,Jul-17,46989,45972,1017,2.2
CN1904900000000,19,049,Dallas County, IA,Aug-17,46446,45414,1032,2.2
CN1904900000000,19,049,Dallas County, IA,Sep-17,45951,45004,947,2.1
CN1904900000000,19,049,Dallas County, IA,Oct-17,45979,45214,765,1.7
CN1904900000000,19,049,Dallas County, IA,Nov-17,46038,45253,785,1.7
CN1904900000000,19,049,Dallas County, IA,Dec-17,45704,44881,823,1.8
CN1904900000000,19,049,Dallas County, IA,Jan-18,45692,44619,1073,2.3
CN1904900000000,19,049,Dallas County, IA,Feb-18,45818,44771,1047,2.3
CN1904900000000,19,049,Dallas County, IA,Mar-18,45851,44948,903,2.0
CN1904900000000,19,049,Dallas County, IA,Apr-18(p),46218,45470,748,1.6
CN3908500000000,39,085,Lake County, OH,Mar-17,123681,116531,7150,5.8
CN3908500000000,39,085,Lake County, OH,Apr-17,125142,119106,6036,4.8
CN3908500000000,39,085,Lake County, OH,May-17,123894,117805,6089,4.9
CN3908500000000,39,085,Lake County, OH,Jun-17,125675,118826,6849,5.4
CN3908500000000,39,085,Lake County, OH,Jul-17,126919,120192,6727,5.3
CN3908500000000,39,085,Lake County, OH,Aug-17,124845,118393,6452,5.2
CN3908500000000,39,085,Lake County, OH,Sep-17,124684,119135,5549,4.5
CN3908500000000,39,085,Lake County, OH,Oct-17,123054,117954,5100,4.1
CN3908500000000,39,085,Lake County, OH,Nov-17,122933,117932,5001,4.1
CN3908500000000,39,085,Lake County, OH,Dec-17,121371,115863,5508,4.5
CN3908500000000,39,085,Lake County, OH,Jan-18,122086,115377,6709,5.5
CN3908500000000,39,085,Lake County, OH,Feb-18,124062,117089,6973,5.6
CN3908500000000,39,085,Lake County, OH,Mar-18,123363,117573,5790,4.7
CN3908500000000,39,085,Lake County, OH,Apr-18(p),125010,119812,5198,4.2
CN2613900000000,26,139,Ottawa County, MI,Mar-17,156721,151907,4814,3.1
CN2613900000000,26,139,Ottawa County, MI,Apr-17,156189,152387,3802,2.4
CN2613900000000,26,139,Ottawa County, MI,May-17,157514,152954,4560,2.9
CN2613900000000,26,139,Ottawa County, MI,Jun-17,159279,153849,5430,3.4
CN2613900000000,26,139,Ottawa County, MI,Jul-17,158566,151854,6712,4.2
CN2613900000000,26,139,Ottawa County, MI,Aug-17,157606,151567,6039,3.8
CN2613900000000,26,139,Ottawa County, MI,Sep-17,156976,151689,5287,3.4
CN2613900000000,26,139,Ottawa County, MI,Oct-17,156929,152048,4881,3.1
CN2613900000000,26,139,Ottawa County, MI,Nov-17,157993,152933,5060,3.2
CN2613900000000,26,139,Ottawa County, MI,Dec-17,157629,152491,5138,3.3
CN2613900000000,26,139,Ottawa County, MI,Jan-18,156780,150981,5799,3.7
CN2613900000000,26,139,Ottawa County, MI,Feb-18,159194,153201,5993,3.8
CN2613900000000,26,139,Ottawa County, MI,Mar-18,159741,154681,5060,3.2
CN2613900000000,26,139,Ottawa County, MI,Apr-18(p),159966,155593,4373,2.7
CN4008500000000,40,085,Love County, OK,Mar-17,6662,6463,199,3.0
CN4008500000000,40,085,Love County, OK,Apr-17,6551,6361,190,2.9
CN4008500000000,40,085,Love County, OK,May-17,6529,6329,200,3.1
CN4008500000000,40,085,Love County, OK,Jun-17,6602,6382,220,3.3
CN4008500000000,40,085,Love County, OK,Jul-17,6510,6313,197,3.0
CN4008500000000,40,085,Love County, OK,Aug-17,6485,6297,188,2.9
CN4008500000000,40,085,Love County, OK,Sep-17,6584,6405,179,2.7
CN4008500000000,40,085,Love County, OK,Oct-17,6725,6529,196,2.9
CN4008500000000,40,085,Love County, OK,Nov-17,6736,6552,184,2.7
CN4008500000000,40,085,Love County, OK,Dec-17,6641,6461,180,2.7
CN4008500000000,40,085,Love County, OK,Jan-18,6681,6489,192,2.9
CN4008500000000,40,085,Love County, OK,Feb-18,6656,6478,178,2.7
CN4008500000000,40,085,Love County, OK,Mar-18,6654,6491,163,2.4
CN4008500000000,40,085,Love County, OK,Apr-18(p),6579,6426,153,2.3
CN3706100000000,37,061,Duplin County, NC,Mar-17,26881,25632,1249,4.6
CN3706100000000,37,061,Duplin County, NC,Apr-17,25857,24717,1140,4.4
CN3706100000000,37,061,Duplin County, NC,May-17,25445,24247,1198,4.7
CN3706100000000,37,061,Duplin County, NC,Jun-17,24658,23400,1258,5.1
CN3706100000000,37,061,Duplin County, NC,Jul-17,25602,24280,1322,5.2
CN3706100000000,37,061,Duplin County, NC,Aug-17,25176,23844,1332,5.3
CN3706100000000,37,061,Duplin County, NC,Sep-17,25489,24303,1186,4.7
CN3706100000000,37,061,Duplin County, NC,Oct-17,25395,24225,1170,4.6
CN3706100000000,37,061,Duplin County, NC,Nov-17,25013,23755,1258,5.0
CN3706100000000,37,061,Duplin County, NC,Dec-17,25060,23858,1202,4.8
CN3706100000000,37,061,Duplin County, NC,Jan-18,25130,23790,1340,5.3
CN3706100000000,37,061,Duplin County, NC,Feb-18,25664,24352,1312,5.1
CN3706100000000,37,061,Duplin County, NC,Mar-18,25310,24092,1218,4.8
CN3706100000000,37,061,Duplin County, NC,Apr-18(p),24921,23901,1020,4.1
CN2103700000000,21,037,Campbell County, KY,Mar-17,49412,47272,2140,4.3
CN2103700000000,21,037,Campbell County, KY,Apr-17,49440,47548,1892,3.8
CN2103700000000,21,037,Campbell County, KY,May-17,49678,47765,1913,3.9
CN2103700000000,21,037,Campbell County, KY,Jun-17,50364,48203,2161,4.3
CN2103700000000,21,037,Campbell County, KY,Jul-17,50598,48561,2037,4.0
CN2103700000000,21,037,Campbell County, KY,Aug-17,49986,48177,1809,3.6
CN2103700000000,21,037,Campbell County, KY,Sep-17,50032,48371,1661,3.3
CN2103700000000,21,037,Campbell County, KY,Oct-17,49374,47802,1572,3.2
CN2103700000000,21,037,Campbell County, KY,Nov-17,49150,47674,1476,3.0
CN2103700000000,21,037,Campbell County, KY,Dec-17,48830,47419,1411,2.9
CN2103700000000,21,037,Campbell County, KY,Jan-18,48567,46994,1573,3.2
CN2103700000000,21,037,Campbell County, KY,Feb-18,49568,47764,1804,3.6
CN2103700000000,21,037,Campbell County, KY,Mar-18,49945,48282,1663,3.3
CN2103700000000,21,037,Campbell County, KY,Apr-18(p),49994,48534,1460,2.9
CN3503900000000,35,039,Rio Arriba County, NM,Mar-17,16454,15327,1127,6.8
CN3503900000000,35,039,Rio Arriba County, NM,Apr-17,16525,15512,1013,6.1
CN3503900000000,35,039,Rio Arriba County, NM,May-17,16559,15568,991,6.0
CN3503900000000,35,039,Rio Arriba County, NM,Jun-17,16892,15733,1159,6.9
CN3503900000000,35,039,Rio Arriba County, NM,Jul-17,17048,15886,1162,6.8
CN3503900000000,35,039,Rio Arriba County, NM,Aug-17,16975,15888,1087,6.4
CN3503900000000,35,039,Rio Arriba County, NM,Sep-17,16917,15896,1021,6.0
CN3503900000000,35,039,Rio Arriba County, NM,Oct-17,16811,15819,992,5.9
CN3503900000000,35,039,Rio Arriba County, NM,Nov-17,16767,15782,985,5.9
CN3503900000000,35,039,Rio Arriba County, NM,Dec-17,16691,15723,968,5.8
CN3503900000000,35,039,Rio Arriba County, NM,Jan-18,16600,15569,1031,6.2
CN3503900000000,35,039,Rio Arriba County, NM,Feb-18,16654,15658,996,6.0
CN3503900000000,35,039,Rio Arriba County, NM,Mar-18,16616,15703,913,5.5
CN3503900000000,35,039,Rio Arriba County, NM,Apr-18(p),16755,15974,781,4.7
CN7203500000000,72,035,Cayey Municipio, PR,Mar-17,16353,14720,1633,10.0
CN7203500000000,72,035,Cayey Municipio, PR,Apr-17,16332,14603,1729,10.6
CN7203500000000,72,035,Cayey Municipio, PR,May-17,15982,14496,1486,9.3
CN7203500000000,72,035,Cayey Municipio, PR,Jun-17,15801,14411,1390,8.8
CN7203500000000,72,035,Cayey Municipio, PR,Jul-17,15964,14339,1625,10.2
CN7203500000000,72,035,Cayey Municipio, PR,Aug-17,16061,14149,1912,11.9
CN7203500000000,72,035,Cayey Municipio, PR,Sep-17(y),16142,14329,1813,11.2
CN7203500000000,72,035,Cayey Municipio, PR,Oct-17,15503,13735,1768,11.4
CN7203500000000,72,035,Cayey Municipio, PR,Nov-17,16164,14576,1588,9.8
CN7203500000000,72,035,Cayey Municipio, PR,Dec-17,16197,14705,1492,9.2
CN7203500000000,72,035,Cayey Municipio, PR,Jan-18,15933,14435,1498,9.4
CN7203500000000,72,035,Cayey Municipio, PR,Feb-18,15807,14463,1344,8.5
CN7203500000000,72,035,Cayey Municipio, PR,Mar-18,15753,14475,1278,8.1
CN7203500000000,72,035,Cayey Municipio, PR,Apr-18(p),15824,14601,1223,7.7
CN2816100000000,28,161,Yalobusha County, MS,Mar-17,5011,4740,271,5.4
CN2816100000000,28,161,Yalobusha County, MS,Apr-17,4935,4704,231,4.7
CN2816100000000,28,161,Yalobusha County, MS,May-17,5006,4714,292,5.8
CN2816100000000,28,161,Yalobusha County, MS,Jun-17,4980,4648,332,6.7
CN2816100000000,28,161,Yalobusha County, MS,Jul-17,4978,4641,337,6.8
CN2816100000000,28,161,Yalobusha County, MS,Aug-17,4953,4668,285,5.8
CN2816100000000,28,161,Yalobusha County, MS,Sep-17,5074,4810,264,5.2
CN2816100000000,28,161,Yalobusha County, MS,Oct-17,5046,4808,238,4.7
CN2816100000000,28,161,Yalobusha County, MS,Nov-17,5049,4819,230,4.6
CN2816100000000,28,161,Yalobusha County, MS,Dec-17,4988,4752,236,4.7
CN2816100000000,28,161,Yalobusha County, MS,Jan-18,4959,4707,252,5.1
CN2816100000000,28,161,Yalobusha County, MS,Feb-18,5118,4880,238,4.7
CN2816100000000,28,161,Yalobusha County, MS,Mar-18,5088,4858,230,4.5
CN2816100000000,28,161,Yalobusha County, MS,Apr-18(p),5196,4968,228,4.4
CN7212500000000,72,125,San German Municipio, PR,Mar-17,10484,8815,1669,15.9
CN7212500000000,72,125,San German Municipio, PR,Apr-17,10350,8614,1736,16.8
CN7212500000000,72,125,San German Municipio, PR,May-17,10214,8614,1600,15.7
CN7212500000000,72,125,San German Municipio, PR,Jun-17,9930,8555,1375,13.8
CN7212500000000,72,125,San German Municipio, PR,Jul-17,9889,8375,1514,15.3
CN7212500000000,72,125,San German Municipio, PR,Aug-17,9925,8253,1672,16.8
CN7212500000000,72,125,San German Municipio, PR,Sep-17(y),9962,8344,1618,16.2
CN7212500000000,72,125,San German Municipio, PR,Oct-17,9718,8098,1620,16.7
CN7212500000000,72,125,San German Municipio, PR,Nov-17,9932,8552,1380,13.9
CN7212500000000,72,125,San German Municipio, PR,Dec-17,10019,8683,1336,13.3
CN7212500000000,72,125,San German Municipio, PR,Jan-18,9782,8357,1425,14.6
CN7212500000000,72,125,San German Municipio, PR,Feb-18,9590,8318,1272,13.3
CN7212500000000,72,125,San German Municipio, PR,Mar-18,9610,8358,1252,13.0
CN7212500000000,72,125,San German Municipio, PR,Apr-18(p),9671,8448,1223,12.6
CN2914100000000,29,141,Morgan County, MO,Mar-17,7704,7267,437,5.7
CN2914100000000,29,141,Morgan County, MO,Apr-17,7914,7560,354,4.5
CN2914100000000,29,141,Morgan County, MO,May-17,7977,7625,352,4.4
CN2914100000000,29,141,Morgan County, MO,Jun-17,8167,7813,354,4.3
CN2914100000000,29,141,Morgan County, MO,Jul-17,7818,7433,385,4.9
CN2914100000000,29,141,Morgan County, MO,Aug-17,7797,7399,398,5.1
CN2914100000000,29,141,Morgan County, MO,Sep-17,7709,7407,302,3.9
CN2914100000000,29,141,Morgan County, MO,Oct-17,7661,7420,241,3.1
CN2914100000000,29,141,Morgan County, MO,Nov-17,7617,7302,315,4.1
CN2914100000000,29,141,Morgan County, MO,Dec-17,7608,7230,378,5.0
CN2914100000000,29,141,Morgan County, MO,Jan-18,7636,7160,476,6.2
CN2914100000000,29,141,Morgan County, MO,Feb-18,7669,7163,506,6.6
CN2914100000000,29,141,Morgan County, MO,Mar-18,7659,7234,425,5.5
CN2914100000000,29,141,Morgan County, MO,Apr-18(p),7793,7443,350,4.5
CN4501100000000,45,011,Barnwell County, SC,Mar-17,8086,7639,447,5.5
CN4501100000000,45,011,Barnwell County, SC,Apr-17,8025,7588,437,5.4
CN4501100000000,45,011,Barnwell County, SC,May-17,7991,7548,443,5.5
CN4501100000000,45,011,Barnwell County, SC,Jun-17,8126,7611,515,6.3
CN4501100000000,45,011,Barnwell County, SC,Jul-17,8117,7613,504,6.2
CN4501100000000,45,011,Barnwell County, SC,Aug-17,8100,7561,539,6.7
CN4501100000000,45,011,Barnwell County, SC,Sep-17,8067,7593,474,5.9
CN4501100000000,45,011,Barnwell County, SC,Oct-17,8118,7629,489,6.0
CN4501100000000,45,011,Barnwell County, SC,Nov-17,8119,7656,463,5.7
CN4501100000000,45,011,Barnwell County, SC,Dec-17,8197,7718,479,5.8
CN4501100000000,45,011,Barnwell County, SC,Jan-18,8234,7670,564,6.8
CN4501100000000,45,011,Barnwell County, SC,Feb-18,8278,7747,531,6.4
CN4501100000000,45,011,Barnwell County, SC,Mar-18,8169,7696,473,5.8
CN4501100000000,45,011,Barnwell County, SC,Apr-18(p),8050,7715,335,4.2
CN0400300000000,04,003,Cochise County, AZ,Mar-17,50374,47533,2841,5.6
CN0400300000000,04,003,Cochise County, AZ,Apr-17,49710,47021,2689,5.4
CN0400300000000,04,003,Cochise County, AZ,May-17,49655,47077,2578,5.2
CN0400300000000,04,003,Cochise County, AZ,Jun-17,49630,46855,2775,5.6
CN0400300000000,04,003,Cochise County, AZ,Jul-17,48207,45427,2780,5.8
CN0400300000000,04,003,Cochise County, AZ,Aug-17,48701,45838,2863,5.9
CN0400300000000,04,003,Cochise County, AZ,Sep-17,49340,46534,2806,5.7
CN0400300000000,04,003,Cochise County, AZ,Oct-17,49404,46731,2673,5.4
CN0400300000000,04,003,Cochise County, AZ,Nov-17,49090,46431,2659,5.4
CN0400300000000,04,003,Cochise County, AZ,Dec-17,49092,46421,2671,5.4
CN0400300000000,04,003,Cochise County, AZ,Jan-18,48574,45576,2998,6.2
CN0400300000000,04,003,Cochise County, AZ,Feb-18,49038,46102,2936,6.0
CN0400300000000,04,003,Cochise County, AZ,Mar-18,49220,46474,2746,5.6
CN0400300000000,04,003,Cochise County, AZ,Apr-18(p),48679,46116,2563,5.3
CN4828700000000,48,287,Lee County, TX,Mar-17,9319,8977,342,3.7
CN4828700000000,48,287,Lee County, TX,Apr-17,9217,8919,298,3.2
CN4828700000000,48,287,Lee County, TX,May-17,9585,9287,298,3.1
CN4828700000000,48,287,Lee County, TX,Jun-17,9918,9595,323,3.3
CN4828700000000,48,287,Lee County, TX,Jul-17,9929,9589,340,3.4
CN4828700000000,48,287,Lee County, TX,Aug-17,9891,9570,321,3.2
CN4828700000000,48,287,Lee County, TX,Sep-17,9786,9512,274,2.8
CN4828700000000,48,287,Lee County, TX,Oct-17,9733,9477,256,2.6
CN4828700000000,48,287,Lee County, TX,Nov-17,9746,9453,293,3.0
CN4828700000000,48,287,Lee County, TX,Dec-17,9766,9484,282,2.9
CN4828700000000,48,287,Lee County, TX,Jan-18,9870,9549,321,3.3
CN4828700000000,48,287,Lee County, TX,Feb-18,9973,9628,345,3.5
CN4828700000000,48,287,Lee County, TX,Mar-18,9880,9534,346,3.5
CN4828700000000,48,287,Lee County, TX,Apr-18(p),9726,9434,292,3.0
CN3504300000000,35,043,Sandoval County, NM,Mar-17,63465,59569,3896,6.1
CN3504300000000,35,043,Sandoval County, NM,Apr-17,63633,60022,3611,5.7
CN3504300000000,35,043,Sandoval County, NM,May-17,63280,59576,3704,5.9
CN3504300000000,35,043,Sandoval County, NM,Jun-17,63995,59607,4388,6.9
CN3504300000000,35,043,Sandoval County, NM,Jul-17,64050,59689,4361,6.8
CN3504300000000,35,043,Sandoval County, NM,Aug-17,63656,59551,4105,6.4
CN3504300000000,35,043,Sandoval County, NM,Sep-17,64058,60117,3941,6.2
CN3504300000000,35,043,Sandoval County, NM,Oct-17,64234,60422,3812,5.9
CN3504300000000,35,043,Sandoval County, NM,Nov-17,64845,61123,3722,5.7
CN3504300000000,35,043,Sandoval County, NM,Dec-17,64698,61106,3592,5.6
CN3504300000000,35,043,Sandoval County, NM,Jan-18,64304,60645,3659,5.7
CN3504300000000,35,043,Sandoval County, NM,Feb-18,64793,61276,3517,5.4
CN3504300000000,35,043,Sandoval County, NM,Mar-18,64611,61369,3242,5.0
CN3504300000000,35,043,Sandoval County, NM,Apr-18(p),64459,61647,2812,4.4
CN4831700000000,48,317,Martin County, TX,Mar-17,2557,2462,95,3.7
CN4831700000000,48,317,Martin County, TX,Apr-17,2565,2484,81,3.2
CN4831700000000,48,317,Martin County, TX,May-17,2588,2504,84,3.2
CN4831700000000,48,317,Martin County, TX,Jun-17,2588,2500,88,3.4
CN4831700000000,48,317,Martin County, TX,Jul-17,2576,2489,87,3.4
CN4831700000000,48,317,Martin County, TX,Aug-17,2596,2516,80,3.1
CN4831700000000,48,317,Martin County, TX,Sep-17,2591,2521,70,2.7
CN4831700000000,48,317,Martin County, TX,Oct-17,2598,2534,64,2.5
CN4831700000000,48,317,Martin County, TX,Nov-17,2601,2536,65,2.5
CN4831700000000,48,317,Martin County, TX,Dec-17,2612,2552,60,2.3
CN4831700000000,48,317,Martin County, TX,Jan-18,2610,2547,63,2.4
CN4831700000000,48,317,Martin County, TX,Feb-18,2653,2585,68,2.6
CN4831700000000,48,317,Martin County, TX,Mar-18,2732,2666,66,2.4
CN4831700000000,48,317,Martin County, TX,Apr-18(p),2764,2704,60,2.2
CN4703500000000,47,035,Cumberland County, TN,Mar-17,23414,22168,1246,5.3
CN4703500000000,47,035,Cumberland County, TN,Apr-17,23396,22440,956,4.1
CN4703500000000,47,035,Cumberland County, TN,May-17,23508,22611,897,3.8
CN4703500000000,47,035,Cumberland County, TN,Jun-17,23426,22319,1107,4.7
CN4703500000000,47,035,Cumberland County, TN,Jul-17,23734,22667,1067,4.5
CN4703500000000,47,035,Cumberland County, TN,Aug-17,24007,23007,1000,4.2
CN4703500000000,47,035,Cumberland County, TN,Sep-17,23969,23069,900,3.8
CN4703500000000,47,035,Cumberland County, TN,Oct-17,23693,22853,840,3.5
CN4703500000000,47,035,Cumberland County, TN,Nov-17,23466,22600,866,3.7
CN4703500000000,47,035,Cumberland County, TN,Dec-17,23537,22564,973,4.1
CN4703500000000,47,035,Cumberland County, TN,Jan-18,23637,22372,1265,5.4
CN4703500000000,47,035,Cumberland County, TN,Feb-18,23860,22646,1214,5.1
CN4703500000000,47,035,Cumberland County, TN,Mar-18,23812,22800,1012,4.2
CN4703500000000,47,035,Cumberland County, TN,Apr-18(p),24097,23304,793,3.3
CN0602700000000,06,027,Inyo County, CA,Mar-17,8708,8268,440,5.1
CN0602700000000,06,027,Inyo County, CA,Apr-17,8593,8197,396,4.6
CN0602700000000,06,027,Inyo County, CA,May-17,8593,8253,340,4.0
CN0602700000000,06,027,Inyo County, CA,Jun-17,8685,8325,360,4.1
CN0602700000000,06,027,Inyo County, CA,Jul-17,8846,8445,401,4.5
CN0602700000000,06,027,Inyo County, CA,Aug-17,8757,8385,372,4.2
CN0602700000000,06,027,Inyo County, CA,Sep-17,8761,8435,326,3.7
CN0602700000000,06,027,Inyo County, CA,Oct-17,8636,8307,329,3.8
CN0602700000000,06,027,Inyo County, CA,Nov-17,8569,8237,332,3.9
CN0602700000000,06,027,Inyo County, CA,Dec-17,8624,8287,337,3.9
CN0602700000000,06,027,Inyo County, CA,Jan-18,8709,8336,373,4.3
CN0602700000000,06,027,Inyo County, CA,Feb-18,8664,8274,390,4.5
CN0602700000000,06,027,Inyo County, CA,Mar-18,8704,8335,369,4.2
CN0602700000000,06,027,Inyo County, CA,Apr-18(p),8636,8322,314,3.6
CN4605500000000,46,055,Haakon County, SD,Mar-17,1092,1058,34,3.1
CN4605500000000,46,055,Haakon County, SD,Apr-17,1110,1078,32,2.9
CN4605500000000,46,055,Haakon County, SD,May-17,1094,1064,30,2.7
CN4605500000000,46,055,Haakon County, SD,Jun-17,1163,1132,31,2.7
CN4605500000000,46,055,Haakon County, SD,Jul-17,1121,1091,30,2.7
CN4605500000000,46,055,Haakon County, SD,Aug-17,1076,1044,32,3.0
CN4605500000000,46,055,Haakon County, SD,Sep-17,1051,1022,29,2.8
CN4605500000000,46,055,Haakon County, SD,Oct-17,1057,1031,26,2.5
CN4605500000000,46,055,Haakon County, SD,Nov-17,1059,1025,34,3.2
CN4605500000000,46,055,Haakon County, SD,Dec-17,1070,1040,30,2.8
CN4605500000000,46,055,Haakon County, SD,Jan-18,1087,1049,38,3.5
CN4605500000000,46,055,Haakon County, SD,Feb-18,1094,1062,32,2.9
CN4605500000000,46,055,Haakon County, SD,Mar-18,1116,1082,34,3.0
CN4605500000000,46,055,Haakon County, SD,Apr-18(p),1076,1046,30,2.8
CN0513700000000,05,137,Stone County, AR,Mar-17,4788,4550,238,5.0
CN0513700000000,05,137,Stone County, AR,Apr-17,4839,4640,199,4.1
CN0513700000000,05,137,Stone County, AR,May-17,4917,4693,224,4.6
CN0513700000000,05,137,Stone County, AR,Jun-17,5071,4834,237,4.7
CN0513700000000,05,137,Stone County, AR,Jul-17,4837,4593,244,5.0
CN0513700000000,05,137,Stone County, AR,Aug-17,4871,4649,222,4.6
CN0513700000000,05,137,Stone County, AR,Sep-17,4813,4607,206,4.3
CN0513700000000,05,137,Stone County, AR,Oct-17,4805,4613,192,4.0
CN0513700000000,05,137,Stone County, AR,Nov-17,4797,4600,197,4.1
CN0513700000000,05,137,Stone County, AR,Dec-17,4740,4520,220,4.6
CN0513700000000,05,137,Stone County, AR,Jan-18,4642,4363,279,6.0
CN0513700000000,05,137,Stone County, AR,Feb-18,4648,4387,261,5.6
CN0513700000000,05,137,Stone County, AR,Mar-18,4677,4442,235,5.0
CN0513700000000,05,137,Stone County, AR,Apr-18(p),4721,4529,192,4.1
CN4212900000000,42,129,Westmoreland County, PA,Mar-17,181827,171548,10279,5.7
CN4212900000000,42,129,Westmoreland County, PA,Apr-17,181329,172878,8451,4.7
CN4212900000000,42,129,Westmoreland County, PA,May-17,181561,172691,8870,4.9
CN4212900000000,42,129,Westmoreland County, PA,Jun-17,183331,173386,9945,5.4
CN4212900000000,42,129,Westmoreland County, PA,Jul-17,184315,174149,10166,5.5
CN4212900000000,42,129,Westmoreland County, PA,Aug-17,182406,172259,10147,5.6
CN4212900000000,42,129,Westmoreland County, PA,Sep-17,181266,173280,7986,4.4
CN4212900000000,42,129,Westmoreland County, PA,Oct-17,180374,172604,7770,4.3
CN4212900000000,42,129,Westmoreland County, PA,Nov-17,181454,173357,8097,4.5
CN4212900000000,42,129,Westmoreland County, PA,Dec-17,180886,172388,8498,4.7
CN4212900000000,42,129,Westmoreland County, PA,Jan-18,180794,170283,10511,5.8
CN4212900000000,42,129,Westmoreland County, PA,Feb-18,180539,170398,10141,5.6
CN4212900000000,42,129,Westmoreland County, PA,Mar-18,178408,169777,8631,4.8
CN4212900000000,42,129,Westmoreland County, PA,Apr-18(p),178758,171581,7177,4.0
CN0109500000000,01,095,Marshall County, AL,Mar-17,42207,40358,1849,4.4
CN0109500000000,01,095,Marshall County, AL,Apr-17,42202,40700,1502,3.6
CN0109500000000,01,095,Marshall County, AL,May-17,42099,40625,1474,3.5
CN0109500000000,01,095,Marshall County, AL,Jun-17,42287,40540,1747,4.1
CN0109500000000,01,095,Marshall County, AL,Jul-17,42150,40530,1620,3.8
CN0109500000000,01,095,Marshall County, AL,Aug-17,42055,40496,1559,3.7
CN0109500000000,01,095,Marshall County, AL,Sep-17,42469,41164,1305,3.1
CN0109500000000,01,095,Marshall County, AL,Oct-17,42386,41078,1308,3.1
CN0109500000000,01,095,Marshall County, AL,Nov-17,42098,40873,1225,2.9
CN0109500000000,01,095,Marshall County, AL,Dec-17,41770,40551,1219,2.9
CN0109500000000,01,095,Marshall County, AL,Jan-18,41341,39867,1474,3.6
CN0109500000000,01,095,Marshall County, AL,Feb-18,41903,40340,1563,3.7
CN0109500000000,01,095,Marshall County, AL,Mar-18,42128,40731,1397,3.3
CN0109500000000,01,095,Marshall County, AL,Apr-18(p),42423,41159,1264,3.0
CN0809700000000,08,097,Pitkin County, CO,Mar-17,11137,10917,220,2.0
CN0809700000000,08,097,Pitkin County, CO,Apr-17,10956,10663,293,2.7
CN0809700000000,08,097,Pitkin County, CO,May-17,10641,10052,589,5.5
CN0809700000000,08,097,Pitkin County, CO,Jun-17,11148,10827,321,2.9
CN0809700000000,08,097,Pitkin County, CO,Jul-17,11310,11056,254,2.2
CN0809700000000,08,097,Pitkin County, CO,Aug-17,11121,10879,242,2.2
CN0809700000000,08,097,Pitkin County, CO,Sep-17,10946,10663,283,2.6
CN0809700000000,08,097,Pitkin County, CO,Oct-17,10832,10431,401,3.7
CN0809700000000,08,097,Pitkin County, CO,Nov-17,10930,10294,636,5.8
CN0809700000000,08,097,Pitkin County, CO,Dec-17,11414,11045,369,3.2
CN0809700000000,08,097,Pitkin County, CO,Jan-18,11197,10899,298,2.7
CN0809700000000,08,097,Pitkin County, CO,Feb-18,11414,11123,291,2.5
CN0809700000000,08,097,Pitkin County, CO,Mar-18,11445,11195,250,2.2
CN0809700000000,08,097,Pitkin County, CO,Apr-18(p),11270,10974,296,2.6
CN1711500000000,17,115,Macon County, IL,Mar-17,49275,46487,2788,5.7
CN1711500000000,17,115,Macon County, IL,Apr-17,49002,46660,2342,4.8
CN1711500000000,17,115,Macon County, IL,May-17,48741,46433,2308,4.7
CN1711500000000,17,115,Macon County, IL,Jun-17,49258,46540,2718,5.5
CN1711500000000,17,115,Macon County, IL,Jul-17,49606,46755,2851,5.7
CN1711500000000,17,115,Macon County, IL,Aug-17,49320,46425,2895,5.9
CN1711500000000,17,115,Macon County, IL,Sep-17,49297,46819,2478,5.0
CN1711500000000,17,115,Macon County, IL,Oct-17,49097,46743,2354,4.8
CN1711500000000,17,115,Macon County, IL,Nov-17,49079,46631,2448,5.0
CN1711500000000,17,115,Macon County, IL,Dec-17,48680,46213,2467,5.1
CN1711500000000,17,115,Macon County, IL,Jan-18,48478,45892,2586,5.3
CN1711500000000,17,115,Macon County, IL,Feb-18,49010,46612,2398,4.9
CN1711500000000,17,115,Macon County, IL,Mar-18,49745,47171,2574,5.2
CN1711500000000,17,115,Macon County, IL,Apr-18(p),49642,47481,2161,4.4
CN4800100000000,48,001,Anderson County, TX,Mar-17,23020,22123,897,3.9
CN4800100000000,48,001,Anderson County, TX,Apr-17,23340,22518,822,3.5
CN4800100000000,48,001,Anderson County, TX,May-17,23247,22421,826,3.6
CN4800100000000,48,001,Anderson County, TX,Jun-17,23372,22448,924,4.0
CN4800100000000,48,001,Anderson County, TX,Jul-17,23396,22477,919,3.9
CN4800100000000,48,001,Anderson County, TX,Aug-17,23283,22427,856,3.7
CN4800100000000,48,001,Anderson County, TX,Sep-17,23494,22711,783,3.3
CN4800100000000,48,001,Anderson County, TX,Oct-17,23296,22590,706,3.0
CN4800100000000,48,001,Anderson County, TX,Nov-17,23332,22601,731,3.1
CN4800100000000,48,001,Anderson County, TX,Dec-17,23283,22612,671,2.9
CN4800100000000,48,001,Anderson County, TX,Jan-18,23564,22809,755,3.2
CN4800100000000,48,001,Anderson County, TX,Feb-18,23785,23021,764,3.2
CN4800100000000,48,001,Anderson County, TX,Mar-18,23835,23052,783,3.3
CN4800100000000,48,001,Anderson County, TX,Apr-18(p),23419,22706,713,3.0
CN0504700000000,05,047,Franklin County, AR,Mar-17,7386,7147,239,3.2
CN0504700000000,05,047,Franklin County, AR,Apr-17,7439,7218,221,3.0
CN0504700000000,05,047,Franklin County, AR,May-17,7485,7226,259,3.5
CN0504700000000,05,047,Franklin County, AR,Jun-17,7620,7342,278,3.6
CN0504700000000,05,047,Franklin County, AR,Jul-17,7408,7094,314,4.2
CN0504700000000,05,047,Franklin County, AR,Aug-17,7467,7202,265,3.5
CN0504700000000,05,047,Franklin County, AR,Sep-17,7429,7185,244,3.3
CN0504700000000,05,047,Franklin County, AR,Oct-17,7513,7292,221,2.9
CN0504700000000,05,047,Franklin County, AR,Nov-17,7489,7259,230,3.1
CN0504700000000,05,047,Franklin County, AR,Dec-17,7434,7185,249,3.3
CN0504700000000,05,047,Franklin County, AR,Jan-18,7330,7037,293,4.0
CN0504700000000,05,047,Franklin County, AR,Feb-18,7305,7003,302,4.1
CN0504700000000,05,047,Franklin County, AR,Mar-18,7347,7066,281,3.8
CN0504700000000,05,047,Franklin County, AR,Apr-18(p),7344,7104,240,3.3
CN5403500000000,54,035,Jackson County, WV,Mar-17,11781,11043,738,6.3
CN5403500000000,54,035,Jackson County, WV,Apr-17,11912,11263,649,5.4
CN5403500000000,54,035,Jackson County, WV,May-17,11891,11308,583,4.9
CN5403500000000,54,035,Jackson County, WV,Jun-17,12178,11501,677,5.6
CN5403500000000,54,035,Jackson County, WV,Jul-17,12046,11377,669,5.6
CN5403500000000,54,035,Jackson County, WV,Aug-17,11991,11290,701,5.8
CN5403500000000,54,035,Jackson County, WV,Sep-17,11979,11397,582,4.9
CN5403500000000,54,035,Jackson County, WV,Oct-17,11890,11308,582,4.9
CN5403500000000,54,035,Jackson County, WV,Nov-17,11903,11242,661,5.6
CN5403500000000,54,035,Jackson County, WV,Dec-17,11886,11199,687,5.8
CN5403500000000,54,035,Jackson County, WV,Jan-18,11965,11176,789,6.6
CN5403500000000,54,035,Jackson County, WV,Feb-18,12117,11245,872,7.2
CN5403500000000,54,035,Jackson County, WV,Mar-18,11998,11269,729,6.1
CN5403500000000,54,035,Jackson County, WV,Apr-18(p),12048,11387,661,5.5
CN4807900000000,48,079,Cochran County, TX,Mar-17,1217,1158,59,4.8
CN4807900000000,48,079,Cochran County, TX,Apr-17,1194,1149,45,3.8
CN4807900000000,48,079,Cochran County, TX,May-17,1211,1165,46,3.8
CN4807900000000,48,079,Cochran County, TX,Jun-17,1178,1130,48,4.1
CN4807900000000,48,079,Cochran County, TX,Jul-17,1102,1047,55,5.0
CN4807900000000,48,079,Cochran County, TX,Aug-17,1129,1073,56,5.0
CN4807900000000,48,079,Cochran County, TX,Sep-17,1072,1021,51,4.8
CN4807900000000,48,079,Cochran County, TX,Oct-17,1118,1068,50,4.5
CN4807900000000,48,079,Cochran County, TX,Nov-17,1069,1021,48,4.5
CN4807900000000,48,079,Cochran County, TX,Dec-17,1075,1030,45,4.2
CN4807900000000,48,079,Cochran County, TX,Jan-18,1049,1001,48,4.6
CN4807900000000,48,079,Cochran County, TX,Feb-18,1084,1032,52,4.8
CN4807900000000,48,079,Cochran County, TX,Mar-18,1171,1112,59,5.0
CN4807900000000,48,079,Cochran County, TX,Apr-18(p),1150,1101,49,4.3
CN0607300000000,06,073,San Diego County, CA,Mar-17,1582171,1514948,67223,4.2
CN0607300000000,06,073,San Diego County, CA,Apr-17,1579209,1518239,60970,3.9
CN0607300000000,06,073,San Diego County, CA,May-17,1573912,1515673,58239,3.7
CN0607300000000,06,073,San Diego County, CA,Jun-17,1584486,1518146,66340,4.2
CN0607300000000,06,073,San Diego County, CA,Jul-17,1594546,1523858,70688,4.4
CN0607300000000,06,073,San Diego County, CA,Aug-17,1588585,1520294,68291,4.3
CN0607300000000,06,073,San Diego County, CA,Sep-17,1591530,1532322,59208,3.7
CN0607300000000,06,073,San Diego County, CA,Oct-17,1586193,1528687,57506,3.6
CN0607300000000,06,073,San Diego County, CA,Nov-17,1590911,1535006,55905,3.5
CN0607300000000,06,073,San Diego County, CA,Dec-17,1583042,1530168,52874,3.3
CN0607300000000,06,073,San Diego County, CA,Jan-18,1581529,1523884,57645,3.6
CN0607300000000,06,073,San Diego County, CA,Feb-18,1592665,1537158,55507,3.5
CN0607300000000,06,073,San Diego County, CA,Mar-18,1583331,1532107,51224,3.2
CN0607300000000,06,073,San Diego County, CA,Apr-18(p),1577413,1531178,46235,2.9
CN3109100000000,31,091,Hooker County, NE,Mar-17,358,341,17,4.7
CN3109100000000,31,091,Hooker County, NE,Apr-17,370,353,17,4.6
CN3109100000000,31,091,Hooker County, NE,May-17,431,420,11,2.6
CN3109100000000,31,091,Hooker County, NE,Jun-17,466,453,13,2.8
CN3109100000000,31,091,Hooker County, NE,Jul-17,444,432,12,2.7
CN3109100000000,31,091,Hooker County, NE,Aug-17,440,428,12,2.7
CN3109100000000,31,091,Hooker County, NE,Sep-17,415,404,11,2.7
CN3109100000000,31,091,Hooker County, NE,Oct-17,387,378,9,2.3
CN3109100000000,31,091,Hooker County, NE,Nov-17,412,392,20,4.9
CN3109100000000,31,091,Hooker County, NE,Dec-17,369,350,19,5.1
CN3109100000000,31,091,Hooker County, NE,Jan-18,374,351,23,6.1
CN3109100000000,31,091,Hooker County, NE,Feb-18,362,340,22,6.1
CN3109100000000,31,091,Hooker County, NE,Mar-18,383,361,22,5.7
CN3109100000000,31,091,Hooker County, NE,Apr-18(p),367,348,19,5.2
CN4213300000000,42,133,York County, PA,Mar-17,234453,224084,10369,4.4
CN4213300000000,42,133,York County, PA,Apr-17,234244,225126,9118,3.9
CN4213300000000,42,133,York County, PA,May-17,234784,224652,10132,4.3
CN4213300000000,42,133,York County, PA,Jun-17,236106,224981,11125,4.7
CN4213300000000,42,133,York County, PA,Jul-17,237633,225706,11927,5.0
CN4213300000000,42,133,York County, PA,Aug-17,235676,224059,11617,4.9
CN4213300000000,42,133,York County, PA,Sep-17,233995,224589,9406,4.0
CN4213300000000,42,133,York County, PA,Oct-17,232241,223267,8974,3.9
CN4213300000000,42,133,York County, PA,Nov-17,232623,223613,9010,3.9
CN4213300000000,42,133,York County, PA,Dec-17,231412,222726,8686,3.8
CN4213300000000,42,133,York County, PA,Jan-18,232649,221853,10796,4.6
CN4213300000000,42,133,York County, PA,Feb-18,232087,221494,10593,4.6
CN4213300000000,42,133,York County, PA,Mar-18,230476,221396,9080,3.9
CN4213300000000,42,133,York County, PA,Apr-18(p),230065,222073,7992,3.5
CN1913900000000,19,139,Muscatine County, IA,Mar-17,21914,21080,834,3.8
CN1913900000000,19,139,Muscatine County, IA,Apr-17,21754,21015,739,3.4
CN1913900000000,19,139,Muscatine County, IA,May-17,21606,20939,667,3.1
CN1913900000000,19,139,Muscatine County, IA,Jun-17,22209,21456,753,3.4
CN1913900000000,19,139,Muscatine County, IA,Jul-17,22210,21514,696,3.1
CN1913900000000,19,139,Muscatine County, IA,Aug-17,21957,21235,722,3.3
CN1913900000000,19,139,Muscatine County, IA,Sep-17,21749,21118,631,2.9
CN1913900000000,19,139,Muscatine County, IA,Oct-17,21559,21035,524,2.4
CN1913900000000,19,139,Muscatine County, IA,Nov-17,21558,21003,555,2.6
CN1913900000000,19,139,Muscatine County, IA,Dec-17,21320,20682,638,3.0
CN1913900000000,19,139,Muscatine County, IA,Jan-18,21403,20631,772,3.6
CN1913900000000,19,139,Muscatine County, IA,Feb-18,21433,20672,761,3.6
CN1913900000000,19,139,Muscatine County, IA,Mar-18,21528,20812,716,3.3
CN1913900000000,19,139,Muscatine County, IA,Apr-18(p),21534,20934,600,2.8
CN0101900000000,01,019,Cherokee County, AL,Mar-17,11364,10863,501,4.4
CN0101900000000,01,019,Cherokee County, AL,Apr-17,11384,10973,411,3.6
CN0101900000000,01,019,Cherokee County, AL,May-17,11307,10908,399,3.5
CN0101900000000,01,019,Cherokee County, AL,Jun-17,11357,10864,493,4.3
CN0101900000000,01,019,Cherokee County, AL,Jul-17,10987,10520,467,4.3
CN0101900000000,01,019,Cherokee County, AL,Aug-17,11004,10556,448,4.1
CN0101900000000,01,019,Cherokee County, AL,Sep-17,11137,10763,374,3.4
CN0101900000000,01,019,Cherokee County, AL,Oct-17,11115,10735,380,3.4
CN0101900000000,01,019,Cherokee County, AL,Nov-17,11027,10671,356,3.2
CN0101900000000,01,019,Cherokee County, AL,Dec-17,10922,10579,343,3.1
CN0101900000000,01,019,Cherokee County, AL,Jan-18,10818,10394,424,3.9
CN0101900000000,01,019,Cherokee County, AL,Feb-18,11053,10616,437,4.0
CN0101900000000,01,019,Cherokee County, AL,Mar-18,11140,10750,390,3.5
CN0101900000000,01,019,Cherokee County, AL,Apr-18(p),11209,10861,348,3.1
CN1800500000000,18,005,Bartholomew County, IN,Mar-17,44549,43283,1266,2.8
CN1800500000000,18,005,Bartholomew County, IN,Apr-17,44383,43398,985,2.2
CN1800500000000,18,005,Bartholomew County, IN,May-17,44524,43402,1122,2.5
CN1800500000000,18,005,Bartholomew County, IN,Jun-17,45242,44012,1230,2.7
CN1800500000000,18,005,Bartholomew County, IN,Jul-17,44900,43631,1269,2.8
CN1800500000000,18,005,Bartholomew County, IN,Aug-17,44499,43116,1383,3.1
CN1800500000000,18,005,Bartholomew County, IN,Sep-17,44445,43338,1107,2.5
CN1800500000000,18,005,Bartholomew County, IN,Oct-17,44357,43296,1061,2.4
CN1800500000000,18,005,Bartholomew County, IN,Nov-17,44377,43297,1080,2.4
CN1800500000000,18,005,Bartholomew County, IN,Dec-17,44141,43120,1021,2.3
CN1800500000000,18,005,Bartholomew County, IN,Jan-18,44418,43181,1237,2.8
CN1800500000000,18,005,Bartholomew County, IN,Feb-18,44916,43623,1293,2.9
CN1800500000000,18,005,Bartholomew County, IN,Mar-18,45394,44274,1120,2.5
CN1800500000000,18,005,Bartholomew County, IN,Apr-18(p),45701,44704,997,2.2
CN2711900000000,27,119,Polk County, MN,Mar-17,17275,16411,864,5.0
CN2711900000000,27,119,Polk County, MN,Apr-17,17176,16454,722,4.2
CN2711900000000,27,119,Polk County, MN,May-17,17008,16380,628,3.7
CN2711900000000,27,119,Polk County, MN,Jun-17,16989,16217,772,4.5
CN2711900000000,27,119,Polk County, MN,Jul-17,16695,15920,775,4.6
CN2711900000000,27,119,Polk County, MN,Aug-17,16494,15726,768,4.7
CN2711900000000,27,119,Polk County, MN,Sep-17,16813,16294,519,3.1
CN2711900000000,27,119,Polk County, MN,Oct-17,17098,16673,425,2.5
CN2711900000000,27,119,Polk County, MN,Nov-17,17129,16569,560,3.3
CN2711900000000,27,119,Polk County, MN,Dec-17,17079,16360,719,4.2
CN2711900000000,27,119,Polk County, MN,Jan-18,17187,16323,864,5.0
CN2711900000000,27,119,Polk County, MN,Feb-18,17293,16438,855,4.9
CN2711900000000,27,119,Polk County, MN,Mar-18,17296,16435,861,5.0
CN2711900000000,27,119,Polk County, MN,Apr-18(p),17214,16503,711,4.1
CN5307300000000,53,073,Whatcom County, WA,Mar-17,109419,103754,5665,5.2
CN5307300000000,53,073,Whatcom County, WA,Apr-17,109016,103851,5165,4.7
CN5307300000000,53,073,Whatcom County, WA,May-17,109338,104148,5190,4.7
CN5307300000000,53,073,Whatcom County, WA,Jun-17,109489,103989,5500,5.0
CN5307300000000,53,073,Whatcom County, WA,Jul-17,110677,105156,5521,5.0
CN5307300000000,53,073,Whatcom County, WA,Aug-17,109957,104521,5436,4.9
CN5307300000000,53,073,Whatcom County, WA,Sep-17,109443,104280,5163,4.7
CN5307300000000,53,073,Whatcom County, WA,Oct-17,110998,106122,4876,4.4
CN5307300000000,53,073,Whatcom County, WA,Nov-17,112021,106892,5129,4.6
CN5307300000000,53,073,Whatcom County, WA,Dec-17,111784,106214,5570,5.0
CN5307300000000,53,073,Whatcom County, WA,Jan-18,110564,104461,6103,5.5
CN5307300000000,53,073,Whatcom County, WA,Feb-18,110220,104022,6198,5.6
CN5307300000000,53,073,Whatcom County, WA,Mar-18,110865,105096,5769,5.2
CN5307300000000,53,073,Whatcom County, WA,Apr-18(p),109766,104463,5303,4.8
CN2609700000000,26,097,Mackinac County, MI,Mar-17,4619,3595,1024,22.2
CN2609700000000,26,097,Mackinac County, MI,Apr-17,4704,4046,658,14.0
CN2609700000000,26,097,Mackinac County, MI,May-17,5509,5282,227,4.1
CN2609700000000,26,097,Mackinac County, MI,Jun-17,6158,5955,203,3.3
CN2609700000000,26,097,Mackinac County, MI,Jul-17,6381,6152,229,3.6
CN2609700000000,26,097,Mackinac County, MI,Aug-17,6282,6067,215,3.4
CN2609700000000,26,097,Mackinac County, MI,Sep-17,5869,5682,187,3.2
CN2609700000000,26,097,Mackinac County, MI,Oct-17,5442,5252,190,3.5
CN2609700000000,26,097,Mackinac County, MI,Nov-17,4494,4009,485,10.8
CN2609700000000,26,097,Mackinac County, MI,Dec-17,4578,3697,881,19.2
CN2609700000000,26,097,Mackinac County, MI,Jan-18,4702,3689,1013,21.5
CN2609700000000,26,097,Mackinac County, MI,Feb-18,4879,3701,1178,24.1
CN2609700000000,26,097,Mackinac County, MI,Mar-18,4755,3705,1050,22.1
CN2609700000000,26,097,Mackinac County, MI,Apr-18(p),4850,4111,739,15.2
CN2705900000000,27,059,Isanti County, MN,Mar-17,21108,19888,1220,5.8
CN2705900000000,27,059,Isanti County, MN,Apr-17,20935,20034,901,4.3
CN2705900000000,27,059,Isanti County, MN,May-17,20861,20113,748,3.6
CN2705900000000,27,059,Isanti County, MN,Jun-17,21007,20196,811,3.9
CN2705900000000,27,059,Isanti County, MN,Jul-17,21235,20429,806,3.8
CN2705900000000,27,059,Isanti County, MN,Aug-17,21135,20340,795,3.8
CN2705900000000,27,059,Isanti County, MN,Sep-17,21007,20350,657,3.1
CN2705900000000,27,059,Isanti County, MN,Oct-17,20882,20290,592,2.8
CN2705900000000,27,059,Isanti County, MN,Nov-17,21018,20253,765,3.6
CN2705900000000,27,059,Isanti County, MN,Dec-17,21096,20089,1007,4.8
CN2705900000000,27,059,Isanti County, MN,Jan-18,21467,20204,1263,5.9
CN2705900000000,27,059,Isanti County, MN,Feb-18,21541,20342,1199,5.6
CN2705900000000,27,059,Isanti County, MN,Mar-18,21475,20318,1157,5.4
CN2705900000000,27,059,Isanti County, MN,Apr-18(p),21338,20434,904,4.2
CN1315500000000,13,155,Irwin County, GA,Mar-17,3266,3026,240,7.3
CN1315500000000,13,155,Irwin County, GA,Apr-17,3239,3016,223,6.9
CN1315500000000,13,155,Irwin County, GA,May-17,3270,3048,222,6.8
CN1315500000000,13,155,Irwin County, GA,Jun-17,3342,3093,249,7.5
CN1315500000000,13,155,Irwin County, GA,Jul-17,3314,3035,279,8.4
CN1315500000000,13,155,Irwin County, GA,Aug-17,3254,3039,215,6.6
CN1315500000000,13,155,Irwin County, GA,Sep-17,3256,3048,208,6.4
CN1315500000000,13,155,Irwin County, GA,Oct-17,3274,3080,194,5.9
CN1315500000000,13,155,Irwin County, GA,Nov-17,3285,3086,199,6.1
CN1315500000000,13,155,Irwin County, GA,Dec-17,3298,3083,215,6.5
CN1315500000000,13,155,Irwin County, GA,Jan-18,3325,3100,225,6.8
CN1315500000000,13,155,Irwin County, GA,Feb-18,3189,2980,209,6.6
CN1315500000000,13,155,Irwin County, GA,Mar-18,3197,3004,193,6.0
CN1315500000000,13,155,Irwin County, GA,Apr-18(p),3169,2997,172,5.4
CN1710700000000,17,107,Logan County, IL,Mar-17,12847,12235,612,4.8
CN1710700000000,17,107,Logan County, IL,Apr-17,12960,12455,505,3.9
CN1710700000000,17,107,Logan County, IL,May-17,12859,12344,515,4.0
CN1710700000000,17,107,Logan County, IL,Jun-17,12858,12264,594,4.6
CN1710700000000,17,107,Logan County, IL,Jul-17,12810,12199,611,4.8
CN1710700000000,17,107,Logan County, IL,Aug-17,12803,12215,588,4.6
CN1710700000000,17,107,Logan County, IL,Sep-17,12922,12409,513,4.0
CN1710700000000,17,107,Logan County, IL,Oct-17,12759,12256,503,3.9
CN1710700000000,17,107,Logan County, IL,Nov-17,12753,12240,513,4.0
CN1710700000000,17,107,Logan County, IL,Dec-17,12601,12071,530,4.2
CN1710700000000,17,107,Logan County, IL,Jan-18,12618,12022,596,4.7
CN1710700000000,17,107,Logan County, IL,Feb-18,12716,12161,555,4.4
CN1710700000000,17,107,Logan County, IL,Mar-18,12884,12313,571,4.4
CN1710700000000,17,107,Logan County, IL,Apr-18(p),12957,12504,453,3.5
CN4710700000000,47,107,McMinn County, TN,Mar-17,23074,21904,1170,5.1
CN4710700000000,47,107,McMinn County, TN,Apr-17,23044,22143,901,3.9
CN4710700000000,47,107,McMinn County, TN,May-17,22744,21895,849,3.7
CN4710700000000,47,107,McMinn County, TN,Jun-17,22860,21777,1083,4.7
CN4710700000000,47,107,McMinn County, TN,Jul-17,22806,21793,1013,4.4
CN4710700000000,47,107,McMinn County, TN,Aug-17,22669,21696,973,4.3
CN4710700000000,47,107,McMinn County, TN,Sep-17,22850,21988,862,3.8
CN4710700000000,47,107,McMinn County, TN,Oct-17,22712,21857,855,3.8
CN4710700000000,47,107,McMinn County, TN,Nov-17,22573,21728,845,3.7
CN4710700000000,47,107,McMinn County, TN,Dec-17,22544,21687,857,3.8
CN4710700000000,47,107,McMinn County, TN,Jan-18,22621,21592,1029,4.5
CN4710700000000,47,107,McMinn County, TN,Feb-18,22852,21846,1006,4.4
CN4710700000000,47,107,McMinn County, TN,Mar-18,22814,21873,941,4.1
CN4710700000000,47,107,McMinn County, TN,Apr-18(p),23022,22198,824,3.6
CN0606500000000,06,065,Riverside County, CA,Mar-17,1072724,1013945,58779,5.5
CN0606500000000,06,065,Riverside County, CA,Apr-17,1065306,1012130,53176,5.0
CN0606500000000,06,065,Riverside County, CA,May-17,1062414,1012186,50228,4.7
CN0606500000000,06,065,Riverside County, CA,Jun-17,1068339,1010570,57769,5.4
CN0606500000000,06,065,Riverside County, CA,Jul-17,1072399,1010023,62376,5.8
CN0606500000000,06,065,Riverside County, CA,Aug-17,1072038,1009705,62333,5.8
CN0606500000000,06,065,Riverside County, CA,Sep-17,1079828,1024797,55031,5.1
CN0606500000000,06,065,Riverside County, CA,Oct-17,1080097,1027390,52707,4.9
CN0606500000000,06,065,Riverside County, CA,Nov-17,1088569,1038360,50209,4.6
CN0606500000000,06,065,Riverside County, CA,Dec-17,1087280,1039792,47488,4.4
CN0606500000000,06,065,Riverside County, CA,Jan-18,1086348,1035252,51096,4.7
CN0606500000000,06,065,Riverside County, CA,Feb-18,1088256,1038798,49458,4.5
CN0606500000000,06,065,Riverside County, CA,Mar-18,1083637,1037694,45943,4.2
CN0606500000000,06,065,Riverside County, CA,Apr-18(p),1070005,1028912,41093,3.8
CN3606500000000,36,065,Oneida County, NY,Mar-17,102469,97157,5312,5.2
CN3606500000000,36,065,Oneida County, NY,Apr-17,102222,97312,4910,4.8
CN3606500000000,36,065,Oneida County, NY,May-17,101933,97112,4821,4.7
CN3606500000000,36,065,Oneida County, NY,Jun-17,104059,99001,5058,4.9
CN3606500000000,36,065,Oneida County, NY,Jul-17,104568,99412,5156,4.9
CN3606500000000,36,065,Oneida County, NY,Aug-17,103439,98313,5126,5.0
CN3606500000000,36,065,Oneida County, NY,Sep-17,101723,96737,4986,4.9
CN3606500000000,36,065,Oneida County, NY,Oct-17,100711,95956,4755,4.7
CN3606500000000,36,065,Oneida County, NY,Nov-17,100276,95152,5124,5.1
CN3606500000000,36,065,Oneida County, NY,Dec-17,99459,94185,5274,5.3
CN3606500000000,36,065,Oneida County, NY,Jan-18,100199,94117,6082,6.1
CN3606500000000,36,065,Oneida County, NY,Feb-18,99863,93619,6244,6.3
CN3606500000000,36,065,Oneida County, NY,Mar-18,98927,93234,5693,5.8
CN3606500000000,36,065,Oneida County, NY,Apr-18(p),99240,94144,5096,5.1
CN5505300000000,55,053,Jackson County, WI,Mar-17,10242,9809,433,4.2
CN5505300000000,55,053,Jackson County, WI,Apr-17,10401,10050,351,3.4
CN5505300000000,55,053,Jackson County, WI,May-17,10540,10231,309,2.9
CN5505300000000,55,053,Jackson County, WI,Jun-17,10965,10590,375,3.4
CN5505300000000,55,053,Jackson County, WI,Jul-17,10651,10315,336,3.2
CN5505300000000,55,053,Jackson County, WI,Aug-17,10544,10241,303,2.9
CN5505300000000,55,053,Jackson County, WI,Sep-17,10504,10220,284,2.7
CN5505300000000,55,053,Jackson County, WI,Oct-17,10526,10272,254,2.4
CN5505300000000,55,053,Jackson County, WI,Nov-17,10504,10257,247,2.4
CN5505300000000,55,053,Jackson County, WI,Dec-17,10380,10077,303,2.9
CN5505300000000,55,053,Jackson County, WI,Jan-18,10468,10113,355,3.4
CN5505300000000,55,053,Jackson County, WI,Feb-18,10445,10021,424,4.1
CN5505300000000,55,053,Jackson County, WI,Mar-18,10584,10191,393,3.7
CN5505300000000,55,053,Jackson County, WI,Apr-18(p),10761,10420,341,3.2
CN4103900000000,41,039,Lane County, OR,Mar-17,181713,173515,8198,4.5
CN4103900000000,41,039,Lane County, OR,Apr-17,181524,174018,7506,4.1
CN4103900000000,41,039,Lane County, OR,May-17,181869,174598,7271,4.0
CN4103900000000,41,039,Lane County, OR,Jun-17,182534,173890,8644,4.7
CN4103900000000,41,039,Lane County, OR,Jul-17,181087,172017,9070,5.0
CN4103900000000,41,039,Lane County, OR,Aug-17,181109,172099,9010,5.0
CN4103900000000,41,039,Lane County, OR,Sep-17,183160,175140,8020,4.4
CN4103900000000,41,039,Lane County, OR,Oct-17,185148,177276,7872,4.3
CN4103900000000,41,039,Lane County, OR,Nov-17,185377,177530,7847,4.2
CN4103900000000,41,039,Lane County, OR,Dec-17,184824,177308,7516,4.1
CN4103900000000,41,039,Lane County, OR,Jan-18,184864,176702,8162,4.4
CN4103900000000,41,039,Lane County, OR,Feb-18,186517,177991,8526,4.6
CN4103900000000,41,039,Lane County, OR,Mar-18,185619,177147,8472,4.6
CN4103900000000,41,039,Lane County, OR,Apr-18(p),183638,176095,7543,4.1
CN0502100000000,05,021,Clay County, AR,Mar-17,5911,5637,274,4.6
CN0502100000000,05,021,Clay County, AR,Apr-17,5949,5727,222,3.7
CN0502100000000,05,021,Clay County, AR,May-17,6027,5785,242,4.0
CN0502100000000,05,021,Clay County, AR,Jun-17,6104,5827,277,4.5
CN0502100000000,05,021,Clay County, AR,Jul-17,5958,5653,305,5.1
CN0502100000000,05,021,Clay County, AR,Aug-17,5980,5714,266,4.4
CN0502100000000,05,021,Clay County, AR,Sep-17,5885,5638,247,4.2
CN0502100000000,05,021,Clay County, AR,Oct-17,5832,5621,211,3.6
CN0502100000000,05,021,Clay County, AR,Nov-17,5805,5581,224,3.9
CN0502100000000,05,021,Clay County, AR,Dec-17,5753,5501,252,4.4
CN0502100000000,05,021,Clay County, AR,Jan-18,5650,5320,330,5.8
CN0502100000000,05,021,Clay County, AR,Feb-18,5693,5377,316,5.6
CN0502100000000,05,021,Clay County, AR,Mar-18,5697,5416,281,4.9
CN0502100000000,05,021,Clay County, AR,Apr-18(p),5724,5496,228,4.0
CN3116300000000,31,163,Sherman County, NE,Mar-17,1678,1628,50,3.0
CN3116300000000,31,163,Sherman County, NE,Apr-17,1701,1647,54,3.2
CN3116300000000,31,163,Sherman County, NE,May-17,1712,1659,53,3.1
CN3116300000000,31,163,Sherman County, NE,Jun-17,1760,1708,52,3.0
CN3116300000000,31,163,Sherman County, NE,Jul-17,1699,1647,52,3.1
CN3116300000000,31,163,Sherman County, NE,Aug-17,1642,1601,41,2.5
CN3116300000000,31,163,Sherman County, NE,Sep-17,1604,1569,35,2.2
CN3116300000000,31,163,Sherman County, NE,Oct-17,1627,1591,36,2.2
CN3116300000000,31,163,Sherman County, NE,Nov-17,1643,1606,37,2.3
CN3116300000000,31,163,Sherman County, NE,Dec-17,1644,1598,46,2.8
CN3116300000000,31,163,Sherman County, NE,Jan-18,1689,1620,69,4.1
CN3116300000000,31,163,Sherman County, NE,Feb-18,1650,1600,50,3.0
CN3116300000000,31,163,Sherman County, NE,Mar-18,1685,1641,44,2.6
CN3116300000000,31,163,Sherman County, NE,Apr-18(p),1695,1651,44,2.6
CN4003300000000,40,033,Cotton County, OK,Mar-17,2851,2741,110,3.9
CN4003300000000,40,033,Cotton County, OK,Apr-17,2856,2748,108,3.8
CN4003300000000,40,033,Cotton County, OK,May-17,2829,2712,117,4.1
CN4003300000000,40,033,Cotton County, OK,Jun-17,2845,2722,123,4.3
CN4003300000000,40,033,Cotton County, OK,Jul-17,2850,2733,117,4.1
CN4003300000000,40,033,Cotton County, OK,Aug-17,2858,2735,123,4.3
CN4003300000000,40,033,Cotton County, OK,Sep-17,2842,2725,117,4.1
CN4003300000000,40,033,Cotton County, OK,Oct-17,2874,2764,110,3.8
CN4003300000000,40,033,Cotton County, OK,Nov-17,2905,2803,102,3.5
CN4003300000000,40,033,Cotton County, OK,Dec-17,2860,2749,111,3.9
CN4003300000000,40,033,Cotton County, OK,Jan-18,2839,2722,117,4.1
CN4003300000000,40,033,Cotton County, OK,Feb-18,2850,2748,102,3.6
CN4003300000000,40,033,Cotton County, OK,Mar-18,2846,2742,104,3.7
CN4003300000000,40,033,Cotton County, OK,Apr-18(p),2815,2718,97,3.4
CN3909300000000,39,093,Lorain County, OH,Mar-17,151155,140965,10190,6.7
CN3909300000000,39,093,Lorain County, OH,Apr-17,152796,144013,8783,5.7
CN3909300000000,39,093,Lorain County, OH,May-17,151125,142335,8790,5.8
CN3909300000000,39,093,Lorain County, OH,Jun-17,153468,143513,9955,6.5
CN3909300000000,39,093,Lorain County, OH,Jul-17,155467,145030,10437,6.7
CN3909300000000,39,093,Lorain County, OH,Aug-17,152833,143074,9759,6.4
CN3909300000000,39,093,Lorain County, OH,Sep-17,152584,143889,8695,5.7
CN3909300000000,39,093,Lorain County, OH,Oct-17,150187,142446,7741,5.2
CN3909300000000,39,093,Lorain County, OH,Nov-17,149612,142443,7169,4.8
CN3909300000000,39,093,Lorain County, OH,Dec-17,147351,139789,7562,5.1
CN3909300000000,39,093,Lorain County, OH,Jan-18,148475,139214,9261,6.2
CN3909300000000,39,093,Lorain County, OH,Feb-18,150785,141415,9370,6.2
CN3909300000000,39,093,Lorain County, OH,Mar-18,149697,142071,7626,5.1
CN3909300000000,39,093,Lorain County, OH,Apr-18(p),151783,144682,7101,4.7
CN2615100000000,26,151,Sanilac County, MI,Mar-17,19595,18293,1302,6.6
CN2615100000000,26,151,Sanilac County, MI,Apr-17,19337,18207,1130,5.8
CN2615100000000,26,151,Sanilac County, MI,May-17,19453,18412,1041,5.4
CN2615100000000,26,151,Sanilac County, MI,Jun-17,19617,18501,1116,5.7
CN2615100000000,26,151,Sanilac County, MI,Jul-17,20087,18589,1498,7.5
CN2615100000000,26,151,Sanilac County, MI,Aug-17,19532,18365,1167,6.0
CN2615100000000,26,151,Sanilac County, MI,Sep-17,19312,18383,929,4.8
CN2615100000000,26,151,Sanilac County, MI,Oct-17,19304,18429,875,4.5
CN2615100000000,26,151,Sanilac County, MI,Nov-17,19212,18313,899,4.7
CN2615100000000,26,151,Sanilac County, MI,Dec-17,19266,18164,1102,5.7
CN2615100000000,26,151,Sanilac County, MI,Jan-18,19462,17956,1506,7.7
CN2615100000000,26,151,Sanilac County, MI,Feb-18,19732,18210,1522,7.7
CN2615100000000,26,151,Sanilac County, MI,Mar-18,19780,18380,1400,7.1
CN2615100000000,26,151,Sanilac County, MI,Apr-18(p),19419,18273,1146,5.9
CN1906100000000,19,061,Dubuque County, IA,Mar-17,54923,52908,2015,3.7
CN1906100000000,19,061,Dubuque County, IA,Apr-17,54488,52975,1513,2.8
CN1906100000000,19,061,Dubuque County, IA,May-17,54546,53111,1435,2.6
CN1906100000000,19,061,Dubuque County, IA,Jun-17,54455,52871,1584,2.9
CN1906100000000,19,061,Dubuque County, IA,Jul-17,54476,52935,1541,2.8
CN1906100000000,19,061,Dubuque County, IA,Aug-17,53975,52379,1596,3.0
CN1906100000000,19,061,Dubuque County, IA,Sep-17,54274,52905,1369,2.5
CN1906100000000,19,061,Dubuque County, IA,Oct-17,54232,53128,1104,2.0
CN1906100000000,19,061,Dubuque County, IA,Nov-17,54312,53089,1223,2.3
CN1906100000000,19,061,Dubuque County, IA,Dec-17,54324,52717,1607,3.0
CN1906100000000,19,061,Dubuque County, IA,Jan-18,54116,52036,2080,3.8
CN1906100000000,19,061,Dubuque County, IA,Feb-18,54342,52376,1966,3.6
CN1906100000000,19,061,Dubuque County, IA,Mar-18,54439,52763,1676,3.1
CN1906100000000,19,061,Dubuque County, IA,Apr-18(p),54447,53094,1353,2.5
CN2202500000000,22,025,Catahoula Parish, LA,Mar-17,3435,3177,258,7.5
CN2202500000000,22,025,Catahoula Parish, LA,Apr-17,3487,3247,240,6.9
CN2202500000000,22,025,Catahoula Parish, LA,May-17,3568,3334,234,6.6
CN2202500000000,22,025,Catahoula Parish, LA,Jun-17,3704,3423,281,7.6
CN2202500000000,22,025,Catahoula Parish, LA,Jul-17,3622,3348,274,7.6
CN2202500000000,22,025,Catahoula Parish, LA,Aug-17,3479,3216,263,7.6
CN2202500000000,22,025,Catahoula Parish, LA,Sep-17,3327,3098,229,6.9
CN2202500000000,22,025,Catahoula Parish, LA,Oct-17,3362,3163,199,5.9
CN2202500000000,22,025,Catahoula Parish, LA,Nov-17,3329,3141,188,5.6
CN2202500000000,22,025,Catahoula Parish, LA,Dec-17,3335,3130,205,6.1
CN2202500000000,22,025,Catahoula Parish, LA,Jan-18,3384,3158,226,6.7
CN2202500000000,22,025,Catahoula Parish, LA,Feb-18,3313,3104,209,6.3
CN2202500000000,22,025,Catahoula Parish, LA,Mar-18,3342,3132,210,6.3
CN2202500000000,22,025,Catahoula Parish, LA,Apr-18(p),3362,3151,211,6.3
CN1714500000000,17,145,Perry County, IL,Mar-17,8462,7962,500,5.9
CN1714500000000,17,145,Perry County, IL,Apr-17,8404,7969,435,5.2
CN1714500000000,17,145,Perry County, IL,May-17,8308,7861,447,5.4
CN1714500000000,17,145,Perry County, IL,Jun-17,8189,7709,480,5.9
CN1714500000000,17,145,Perry County, IL,Jul-17,8335,7810,525,6.3
CN1714500000000,17,145,Perry County, IL,Aug-17,8241,7748,493,6.0
CN1714500000000,17,145,Perry County, IL,Sep-17,8247,7815,432,5.2
CN1714500000000,17,145,Perry County, IL,Oct-17,8182,7774,408,5.0
CN1714500000000,17,145,Perry County, IL,Nov-17,8219,7781,438,5.3
CN1714500000000,17,145,Perry County, IL,Dec-17,8145,7710,435,5.3
CN1714500000000,17,145,Perry County, IL,Jan-18,8135,7649,486,6.0
CN1714500000000,17,145,Perry County, IL,Feb-18,8163,7732,431,5.3
CN1714500000000,17,145,Perry County, IL,Mar-18,8297,7843,454,5.5
CN1714500000000,17,145,Perry County, IL,Apr-18(p),8318,7940,378,4.5
CN2008300000000,20,083,Hodgeman County, KS,Mar-17,975,952,23,2.4
CN2008300000000,20,083,Hodgeman County, KS,Apr-17,961,939,22,2.3
CN2008300000000,20,083,Hodgeman County, KS,May-17,968,943,25,2.6
CN2008300000000,20,083,Hodgeman County, KS,Jun-17,1032,1004,28,2.7
CN2008300000000,20,083,Hodgeman County, KS,Jul-17,989,962,27,2.7
CN2008300000000,20,083,Hodgeman County, KS,Aug-17,1008,983,25,2.5
CN2008300000000,20,083,Hodgeman County, KS,Sep-17,1004,980,24,2.4
CN2008300000000,20,083,Hodgeman County, KS,Oct-17,1023,1002,21,2.1
CN2008300000000,20,083,Hodgeman County, KS,Nov-17,1029,1004,25,2.4
CN2008300000000,20,083,Hodgeman County, KS,Dec-17,996,972,24,2.4
CN2008300000000,20,083,Hodgeman County, KS,Jan-18,962,940,22,2.3
CN2008300000000,20,083,Hodgeman County, KS,Feb-18,957,931,26,2.7
CN2008300000000,20,083,Hodgeman County, KS,Mar-18,962,936,26,2.7
CN2008300000000,20,083,Hodgeman County, KS,Apr-18(p),898,875,23,2.6
CN0227500000000,02,275,Wrangell Borough/city, AK,Mar-17,1038,945,93,9.0
CN0227500000000,02,275,Wrangell Borough/city, AK,Apr-17,1038,960,78,7.5
CN0227500000000,02,275,Wrangell Borough/city, AK,May-17,1045,973,72,6.9
CN0227500000000,02,275,Wrangell Borough/city, AK,Jun-17,1069,992,77,7.2
CN0227500000000,02,275,Wrangell Borough/city, AK,Jul-17,1200,1130,70,5.8
CN0227500000000,02,275,Wrangell Borough/city, AK,Aug-17,1161,1087,74,6.4
CN0227500000000,02,275,Wrangell Borough/city, AK,Sep-17,1025,956,69,6.7
CN0227500000000,02,275,Wrangell Borough/city, AK,Oct-17,1023,949,74,7.2
CN0227500000000,02,275,Wrangell Borough/city, AK,Nov-17,1017,930,87,8.6
CN0227500000000,02,275,Wrangell Borough/city, AK,Dec-17,1026,939,87,8.5
CN0227500000000,02,275,Wrangell Borough/city, AK,Jan-18,989,884,105,10.6
CN0227500000000,02,275,Wrangell Borough/city, AK,Feb-18,988,884,104,10.5
CN0227500000000,02,275,Wrangell Borough/city, AK,Mar-18,1050,953,97,9.2
CN0227500000000,02,275,Wrangell Borough/city, AK,Apr-18(p),1032,958,74,7.2
CN0901100000000,09,011,New London County, CT,Mar-17,138985,132227,6758,4.9
CN0901100000000,09,011,New London County, CT,Apr-17,138936,132710,6226,4.5
CN0901100000000,09,011,New London County, CT,May-17,140274,133878,6396,4.6
CN0901100000000,09,011,New London County, CT,Jun-17,141943,135463,6480,4.6
CN0901100000000,09,011,New London County, CT,Jul-17,143193,136678,6515,4.5
CN0901100000000,09,011,New London County, CT,Aug-17,141211,135189,6022,4.3
CN0901100000000,09,011,New London County, CT,Sep-17,138504,132958,5546,4.0
CN0901100000000,09,011,New London County, CT,Oct-17,138661,133253,5408,3.9
CN0901100000000,09,011,New London County, CT,Nov-17,137909,132540,5369,3.9
CN0901100000000,09,011,New London County, CT,Dec-17,137441,132157,5284,3.8
CN0901100000000,09,011,New London County, CT,Jan-18,137225,130116,7109,5.2
CN0901100000000,09,011,New London County, CT,Feb-18,137389,130507,6882,5.0
CN0901100000000,09,011,New London County, CT,Mar-18,136979,130874,6105,4.5
CN0901100000000,09,011,New London County, CT,Apr-18(p),136511,131057,5454,4.0
CN4500300000000,45,003,Aiken County, SC,Mar-17,74133,71278,2855,3.9
CN4500300000000,45,003,Aiken County, SC,Apr-17,74677,72082,2595,3.5
CN4500300000000,45,003,Aiken County, SC,May-17,73758,71082,2676,3.6
CN4500300000000,45,003,Aiken County, SC,Jun-17,74558,71336,3222,4.3
CN4500300000000,45,003,Aiken County, SC,Jul-17,74463,71308,3155,4.2
CN4500300000000,45,003,Aiken County, SC,Aug-17,74786,71335,3451,4.6
CN4500300000000,45,003,Aiken County, SC,Sep-17,74470,71429,3041,4.1
CN4500300000000,45,003,Aiken County, SC,Oct-17,74683,71673,3010,4.0
CN4500300000000,45,003,Aiken County, SC,Nov-17,74641,71753,2888,3.9
CN4500300000000,45,003,Aiken County, SC,Dec-17,75156,72180,2976,4.0
CN4500300000000,45,003,Aiken County, SC,Jan-18,75987,72381,3606,4.7
CN4500300000000,45,003,Aiken County, SC,Feb-18,75985,72693,3292,4.3
CN4500300000000,45,003,Aiken County, SC,Mar-18,75694,72732,2962,3.9
CN4500300000000,45,003,Aiken County, SC,Apr-18(p),75441,73466,1975,2.6
CN4844900000000,48,449,Titus County, TX,Mar-17,13091,12301,790,6.0
CN4844900000000,48,449,Titus County, TX,Apr-17,12964,12285,679,5.2
CN4844900000000,48,449,Titus County, TX,May-17,12864,12205,659,5.1
CN4844900000000,48,449,Titus County, TX,Jun-17,12939,12200,739,5.7
CN4844900000000,48,449,Titus County, TX,Jul-17,12968,12241,727,5.6
CN4844900000000,48,449,Titus County, TX,Aug-17,12979,12271,708,5.5
CN4844900000000,48,449,Titus County, TX,Sep-17,12938,12337,601,4.6
CN4844900000000,48,449,Titus County, TX,Oct-17,12810,12262,548,4.3
CN4844900000000,48,449,Titus County, TX,Nov-17,12881,12295,586,4.5
CN4844900000000,48,449,Titus County, TX,Dec-17,12907,12331,576,4.5
CN4844900000000,48,449,Titus County, TX,Jan-18,13002,12358,644,5.0
CN4844900000000,48,449,Titus County, TX,Feb-18,13233,12528,705,5.3
CN4844900000000,48,449,Titus County, TX,Mar-18,13295,12581,714,5.4
CN4844900000000,48,449,Titus County, TX,Apr-18(p),13111,12467,644,4.9
CN2601500000000,26,015,Barry County, MI,Mar-17,31076,29798,1278,4.1
CN2601500000000,26,015,Barry County, MI,Apr-17,30944,29909,1035,3.3
CN2601500000000,26,015,Barry County, MI,May-17,31129,30047,1082,3.5
CN2601500000000,26,015,Barry County, MI,Jun-17,31501,30252,1249,4.0
CN2601500000000,26,015,Barry County, MI,Jul-17,31364,29831,1533,4.9
CN2601500000000,26,015,Barry County, MI,Aug-17,31135,29734,1401,4.5
CN2601500000000,26,015,Barry County, MI,Sep-17,30953,29793,1160,3.7
CN2601500000000,26,015,Barry County, MI,Oct-17,30931,29887,1044,3.4
CN2601500000000,26,015,Barry County, MI,Nov-17,31194,30087,1107,3.5
CN2601500000000,26,015,Barry County, MI,Dec-17,31266,29984,1282,4.1
CN2601500000000,26,015,Barry County, MI,Jan-18,31199,29688,1511,4.8
CN2601500000000,26,015,Barry County, MI,Feb-18,31616,30106,1510,4.8
CN2601500000000,26,015,Barry County, MI,Mar-18,31696,30357,1339,4.2
CN2601500000000,26,015,Barry County, MI,Apr-18(p),31687,30560,1127,3.6
CN5115700000000,51,157,Rappahannock County, VA,Mar-17,3732,3588,144,3.9
CN5115700000000,51,157,Rappahannock County, VA,Apr-17,3742,3620,122,3.3
CN5115700000000,51,157,Rappahannock County, VA,May-17,3757,3623,134,3.6
CN5115700000000,51,157,Rappahannock County, VA,Jun-17,3829,3692,137,3.6
CN5115700000000,51,157,Rappahannock County, VA,Jul-17,3808,3681,127,3.3
CN5115700000000,51,157,Rappahannock County, VA,Aug-17,3729,3596,133,3.6
CN5115700000000,51,157,Rappahannock County, VA,Sep-17,3744,3619,125,3.3
CN5115700000000,51,157,Rappahannock County, VA,Oct-17,3708,3587,121,3.3
CN5115700000000,51,157,Rappahannock County, VA,Nov-17,3734,3615,119,3.2
CN5115700000000,51,157,Rappahannock County, VA,Dec-17,3766,3654,112,3.0
CN5115700000000,51,157,Rappahannock County, VA,Jan-18,3725,3604,121,3.2
CN5115700000000,51,157,Rappahannock County, VA,Feb-18,3784,3672,112,3.0
CN5115700000000,51,157,Rappahannock County, VA,Mar-18,3782,3670,112,3.0
CN5115700000000,51,157,Rappahannock County, VA,Apr-18(p),3806,3713,93,2.4
CN1902300000000,19,023,Butler County, IA,Mar-17,7805,7421,384,4.9
CN1902300000000,19,023,Butler County, IA,Apr-17,7914,7621,293,3.7
CN1902300000000,19,023,Butler County, IA,May-17,7917,7667,250,3.2
CN1902300000000,19,023,Butler County, IA,Jun-17,7954,7692,262,3.3
CN1902300000000,19,023,Butler County, IA,Jul-17,7969,7731,238,3.0
CN1902300000000,19,023,Butler County, IA,Aug-17,7793,7551,242,3.1
CN1902300000000,19,023,Butler County, IA,Sep-17,7863,7645,218,2.8
CN1902300000000,19,023,Butler County, IA,Oct-17,7881,7703,178,2.3
CN1902300000000,19,023,Butler County, IA,Nov-17,7777,7580,197,2.5
CN1902300000000,19,023,Butler County, IA,Dec-17,7770,7503,267,3.4
CN1902300000000,19,023,Butler County, IA,Jan-18,7641,7288,353,4.6
CN1902300000000,19,023,Butler County, IA,Feb-18,7725,7388,337,4.4
CN1902300000000,19,023,Butler County, IA,Mar-18,7664,7357,307,4.0
CN1902300000000,19,023,Butler County, IA,Apr-18(p),7707,7469,238,3.1
CN4209500000000,42,095,Northampton County, PA,Mar-17,159057,150736,8321,5.2
CN4209500000000,42,095,Northampton County, PA,Apr-17,158441,151208,7233,4.6
CN4209500000000,42,095,Northampton County, PA,May-17,159304,151453,7851,4.9
CN4209500000000,42,095,Northampton County, PA,Jun-17,160392,152346,8046,5.0
CN4209500000000,42,095,Northampton County, PA,Jul-17,160141,151670,8471,5.3
CN4209500000000,42,095,Northampton County, PA,Aug-17,158485,150043,8442,5.3
CN4209500000000,42,095,Northampton County, PA,Sep-17,158714,151686,7028,4.4
CN4209500000000,42,095,Northampton County, PA,Oct-17,157832,151041,6791,4.3
CN4209500000000,42,095,Northampton County, PA,Nov-17,158156,151293,6863,4.3
CN4209500000000,42,095,Northampton County, PA,Dec-17,156529,149923,6606,4.2
CN4209500000000,42,095,Northampton County, PA,Jan-18,157484,149060,8424,5.3
CN4209500000000,42,095,Northampton County, PA,Feb-18,157849,149463,8386,5.3
CN4209500000000,42,095,Northampton County, PA,Mar-18,156244,148779,7465,4.8
CN4209500000000,42,095,Northampton County, PA,Apr-18(p),156762,150290,6472,4.1
CN4819300000000,48,193,Hamilton County, TX,Mar-17,3673,3521,152,4.1
CN4819300000000,48,193,Hamilton County, TX,Apr-17,3649,3520,129,3.5
CN4819300000000,48,193,Hamilton County, TX,May-17,3667,3530,137,3.7
CN4819300000000,48,193,Hamilton County, TX,Jun-17,3659,3504,155,4.2
CN4819300000000,48,193,Hamilton County, TX,Jul-17,3633,3484,149,4.1
CN4819300000000,48,193,Hamilton County, TX,Aug-17,3584,3440,144,4.0
CN4819300000000,48,193,Hamilton County, TX,Sep-17,3564,3438,126,3.5
CN4819300000000,48,193,Hamilton County, TX,Oct-17,3505,3388,117,3.3
CN4819300000000,48,193,Hamilton County, TX,Nov-17,3524,3399,125,3.5
CN4819300000000,48,193,Hamilton County, TX,Dec-17,3533,3412,121,3.4
CN4819300000000,48,193,Hamilton County, TX,Jan-18,3576,3442,134,3.7
CN4819300000000,48,193,Hamilton County, TX,Feb-18,3615,3481,134,3.7
CN4819300000000,48,193,Hamilton County, TX,Mar-18,3650,3518,132,3.6
CN4819300000000,48,193,Hamilton County, TX,Apr-18(p),3637,3521,116,3.2
CN1329100000000,13,291,Union County, GA,Mar-17,10118,9622,496,4.9
CN1329100000000,13,291,Union County, GA,Apr-17,10073,9628,445,4.4
CN1329100000000,13,291,Union County, GA,May-17,10132,9683,449,4.4
CN1329100000000,13,291,Union County, GA,Jun-17,10219,9751,468,4.6
CN1329100000000,13,291,Union County, GA,Jul-17,10208,9733,475,4.7
CN1329100000000,13,291,Union County, GA,Aug-17,10154,9687,467,4.6
CN1329100000000,13,291,Union County, GA,Sep-17,10307,9900,407,3.9
CN1329100000000,13,291,Union County, GA,Oct-17,10334,9913,421,4.1
CN1329100000000,13,291,Union County, GA,Nov-17,10324,9922,402,3.9
CN1329100000000,13,291,Union County, GA,Dec-17,10357,9941,416,4.0
CN1329100000000,13,291,Union County, GA,Jan-18,10209,9770,439,4.3
CN1329100000000,13,291,Union County, GA,Feb-18,10105,9655,450,4.5
CN1329100000000,13,291,Union County, GA,Mar-18,10098,9701,397,3.9
CN1329100000000,13,291,Union County, GA,Apr-18(p),10117,9776,341,3.4
CN7209500000000,72,095,Maunabo Municipio, PR,Mar-17,3124,2500,624,20.0
CN7209500000000,72,095,Maunabo Municipio, PR,Apr-17,3074,2467,607,19.7
CN7209500000000,72,095,Maunabo Municipio, PR,May-17,2998,2459,539,18.0
CN7209500000000,72,095,Maunabo Municipio, PR,Jun-17,2861,2449,412,14.4
CN7209500000000,72,095,Maunabo Municipio, PR,Jul-17,2893,2442,451,15.6
CN7209500000000,72,095,Maunabo Municipio, PR,Aug-17,2903,2410,493,17.0
CN7209500000000,72,095,Maunabo Municipio, PR,Sep-17(y),2852,2433,419,14.7
CN7209500000000,72,095,Maunabo Municipio, PR,Oct-17,2705,2325,380,14.0
CN7209500000000,72,095,Maunabo Municipio, PR,Nov-17,2869,2463,406,14.2
CN7209500000000,72,095,Maunabo Municipio, PR,Dec-17,2934,2481,453,15.4
CN7209500000000,72,095,Maunabo Municipio, PR,Jan-18,2978,2436,542,18.2
CN7209500000000,72,095,Maunabo Municipio, PR,Feb-18,2975,2441,534,17.9
CN7209500000000,72,095,Maunabo Municipio, PR,Mar-18,2982,2445,537,18.0
CN7209500000000,72,095,Maunabo Municipio, PR,Apr-18(p),2948,2460,488,16.6
CN1816300000000,18,163,Vanderburgh County, IN,Mar-17,92225,89117,3108,3.4
CN1816300000000,18,163,Vanderburgh County, IN,Apr-17,92115,89542,2573,2.8
CN1816300000000,18,163,Vanderburgh County, IN,May-17,91924,89079,2845,3.1
CN1816300000000,18,163,Vanderburgh County, IN,Jun-17,93555,90434,3121,3.3
CN1816300000000,18,163,Vanderburgh County, IN,Jul-17,94761,91620,3141,3.3
CN1816300000000,18,163,Vanderburgh County, IN,Aug-17,93450,90041,3409,3.6
CN1816300000000,18,163,Vanderburgh County, IN,Sep-17,94270,91435,2835,3.0
CN1816300000000,18,163,Vanderburgh County, IN,Oct-17,93976,91312,2664,2.8
CN1816300000000,18,163,Vanderburgh County, IN,Nov-17,93785,91070,2715,2.9
CN1816300000000,18,163,Vanderburgh County, IN,Dec-17,92946,90438,2508,2.7
CN1816300000000,18,163,Vanderburgh County, IN,Jan-18,92167,89283,2884,3.1
CN1816300000000,18,163,Vanderburgh County, IN,Feb-18,93626,90493,3133,3.3
CN1816300000000,18,163,Vanderburgh County, IN,Mar-18,94633,91888,2745,2.9
CN1816300000000,18,163,Vanderburgh County, IN,Apr-18(p),95317,92750,2567,2.7
CN4200500000000,42,005,Armstrong County, PA,Mar-17,32861,30520,2341,7.1
CN4200500000000,42,005,Armstrong County, PA,Apr-17,32609,30777,1832,5.6
CN4200500000000,42,005,Armstrong County, PA,May-17,32545,30762,1783,5.5
CN4200500000000,42,005,Armstrong County, PA,Jun-17,32947,30944,2003,6.1
CN4200500000000,42,005,Armstrong County, PA,Jul-17,33119,31084,2035,6.1
CN4200500000000,42,005,Armstrong County, PA,Aug-17,32785,30716,2069,6.3
CN4200500000000,42,005,Armstrong County, PA,Sep-17,32390,30813,1577,4.9
CN4200500000000,42,005,Armstrong County, PA,Oct-17,32153,30648,1505,4.7
CN4200500000000,42,005,Armstrong County, PA,Nov-17,32377,30729,1648,5.1
CN4200500000000,42,005,Armstrong County, PA,Dec-17,32442,30599,1843,5.7
CN4200500000000,42,005,Armstrong County, PA,Jan-18,32587,30215,2372,7.3
CN4200500000000,42,005,Armstrong County, PA,Feb-18,32584,30279,2305,7.1
CN4200500000000,42,005,Armstrong County, PA,Mar-18,32067,30147,1920,6.0
CN4200500000000,42,005,Armstrong County, PA,Apr-18(p),31909,30435,1474,4.6
CN2611300000000,26,113,Missaukee County, MI,Mar-17,7135,6617,518,7.3
CN2611300000000,26,113,Missaukee County, MI,Apr-17,6964,6595,369,5.3
CN2611300000000,26,113,Missaukee County, MI,May-17,6982,6632,350,5.0
CN2611300000000,26,113,Missaukee County, MI,Jun-17,7094,6703,391,5.5
CN2611300000000,26,113,Missaukee County, MI,Jul-17,7207,6749,458,6.4
CN2611300000000,26,113,Missaukee County, MI,Aug-17,7020,6615,405,5.8
CN2611300000000,26,113,Missaukee County, MI,Sep-17,6962,6621,341,4.9
CN2611300000000,26,113,Missaukee County, MI,Oct-17,6980,6658,322,4.6
CN2611300000000,26,113,Missaukee County, MI,Nov-17,6883,6550,333,4.8
CN2611300000000,26,113,Missaukee County, MI,Dec-17,7024,6598,426,6.1
CN2611300000000,26,113,Missaukee County, MI,Jan-18,7087,6534,553,7.8
CN2611300000000,26,113,Missaukee County, MI,Feb-18,7253,6671,582,8.0
CN2611300000000,26,113,Missaukee County, MI,Mar-18,7168,6679,489,6.8
CN2611300000000,26,113,Missaukee County, MI,Apr-18(p),7059,6650,409,5.8
CN2703300000000,27,033,Cottonwood County, MN,Mar-17,5600,5334,266,4.8
CN2703300000000,27,033,Cottonwood County, MN,Apr-17,5632,5399,233,4.1
CN2703300000000,27,033,Cottonwood County, MN,May-17,5817,5609,208,3.6
CN2703300000000,27,033,Cottonwood County, MN,Jun-17,5910,5667,243,4.1
CN2703300000000,27,033,Cottonwood County, MN,Jul-17,5756,5476,280,4.9
CN2703300000000,27,033,Cottonwood County, MN,Aug-17,5635,4993,642,11.4
CN2703300000000,27,033,Cottonwood County, MN,Sep-17,5662,5124,538,9.5
CN2703300000000,27,033,Cottonwood County, MN,Oct-17,5558,5349,209,3.8
CN2703300000000,27,033,Cottonwood County, MN,Nov-17,5476,5286,190,3.5
CN2703300000000,27,033,Cottonwood County, MN,Dec-17,5455,5248,207,3.8
CN2703300000000,27,033,Cottonwood County, MN,Jan-18,5395,5138,257,4.8
CN2703300000000,27,033,Cottonwood County, MN,Feb-18,5413,5162,251,4.6
CN2703300000000,27,033,Cottonwood County, MN,Mar-18,5463,5228,235,4.3
CN2703300000000,27,033,Cottonwood County, MN,Apr-18(p),5492,5291,201,3.7
CN4504100000000,45,041,Florence County, SC,Mar-17,65681,62909,2772,4.2
CN4504100000000,45,041,Florence County, SC,Apr-17,65283,62595,2688,4.1
CN4504100000000,45,041,Florence County, SC,May-17,65448,62727,2721,4.2
CN4504100000000,45,041,Florence County, SC,Jun-17,65899,62756,3143,4.8
CN4504100000000,45,041,Florence County, SC,Jul-17,65525,62407,3118,4.8
CN4504100000000,45,041,Florence County, SC,Aug-17,65506,62189,3317,5.1
CN4504100000000,45,041,Florence County, SC,Sep-17,65507,62559,2948,4.5
CN4504100000000,45,041,Florence County, SC,Oct-17,65111,62133,2978,4.6
CN4504100000000,45,041,Florence County, SC,Nov-17,64872,62084,2788,4.3
CN4504100000000,45,041,Florence County, SC,Dec-17,65009,62080,2929,4.5
CN4504100000000,45,041,Florence County, SC,Jan-18,65382,61876,3506,5.4
CN4504100000000,45,041,Florence County, SC,Feb-18,65765,62579,3186,4.8
CN4504100000000,45,041,Florence County, SC,Mar-18,65823,62968,2855,4.3
CN4504100000000,45,041,Florence County, SC,Apr-18(p),64749,62730,2019,3.1
CN2209300000000,22,093,St. James Parish, LA,Mar-17,9510,8872,638,6.7
CN2209300000000,22,093,St. James Parish, LA,Apr-17,9521,8919,602,6.3
CN2209300000000,22,093,St. James Parish, LA,May-17,9522,8908,614,6.4
CN2209300000000,22,093,St. James Parish, LA,Jun-17,9672,8929,743,7.7
CN2209300000000,22,093,St. James Parish, LA,Jul-17,9677,8945,732,7.6
CN2209300000000,22,093,St. James Parish, LA,Aug-17,9585,8885,700,7.3
CN2209300000000,22,093,St. James Parish, LA,Sep-17,9566,8957,609,6.4
CN2209300000000,22,093,St. James Parish, LA,Oct-17,9528,9000,528,5.5
CN2209300000000,22,093,St. James Parish, LA,Nov-17,9527,9014,513,5.4
CN2209300000000,22,093,St. James Parish, LA,Dec-17,9478,8998,480,5.1
CN2209300000000,22,093,St. James Parish, LA,Jan-18,9560,9004,556,5.8
CN2209300000000,22,093,St. James Parish, LA,Feb-18,9623,9096,527,5.5
CN2209300000000,22,093,St. James Parish, LA,Mar-18,9636,9110,526,5.5
CN2209300000000,22,093,St. James Parish, LA,Apr-18(p),9662,9132,530,5.5
CN1319300000000,13,193,Macon County, GA,Mar-17,4683,4367,316,6.7
CN1319300000000,13,193,Macon County, GA,Apr-17,4680,4372,308,6.6
CN1319300000000,13,193,Macon County, GA,May-17,4725,4415,310,6.6
CN1319300000000,13,193,Macon County, GA,Jun-17,4784,4463,321,6.7
CN1319300000000,13,193,Macon County, GA,Jul-17,4786,4453,333,7.0
CN1319300000000,13,193,Macon County, GA,Aug-17,4773,4435,338,7.1
CN1319300000000,13,193,Macon County, GA,Sep-17,4722,4424,298,6.3
CN1319300000000,13,193,Macon County, GA,Oct-17,4867,4468,399,8.2
CN1319300000000,13,193,Macon County, GA,Nov-17,4783,4492,291,6.1
CN1319300000000,13,193,Macon County, GA,Dec-17,4773,4492,281,5.9
CN1319300000000,13,193,Macon County, GA,Jan-18,4936,4576,360,7.3
CN1319300000000,13,193,Macon County, GA,Feb-18,4666,4377,289,6.2
CN1319300000000,13,193,Macon County, GA,Mar-18,4647,4387,260,5.6
CN1319300000000,13,193,Macon County, GA,Apr-18(p),4631,4378,253,5.5
CN5509100000000,55,091,Pepin County, WI,Mar-17,4122,3938,184,4.5
CN5509100000000,55,091,Pepin County, WI,Apr-17,4301,4170,131,3.0
CN5509100000000,55,091,Pepin County, WI,May-17,4343,4217,126,2.9
CN5509100000000,55,091,Pepin County, WI,Jun-17,4510,4350,160,3.5
CN5509100000000,55,091,Pepin County, WI,Jul-17,4330,4177,153,3.5
CN5509100000000,55,091,Pepin County, WI,Aug-17,4256,4123,133,3.1
CN5509100000000,55,091,Pepin County, WI,Sep-17,4226,4118,108,2.6
CN5509100000000,55,091,Pepin County, WI,Oct-17,4303,4193,110,2.6
CN5509100000000,55,091,Pepin County, WI,Nov-17,4302,4178,124,2.9
CN5509100000000,55,091,Pepin County, WI,Dec-17,4199,4058,141,3.4
CN5509100000000,55,091,Pepin County, WI,Jan-18,4223,4039,184,4.4
CN5509100000000,55,091,Pepin County, WI,Feb-18,4204,3998,206,4.9
CN5509100000000,55,091,Pepin County, WI,Mar-18,4278,4093,185,4.3
CN5509100000000,55,091,Pepin County, WI,Apr-18(p),4413,4274,139,3.1
CN1201300000000,12,013,Calhoun County, FL,Mar-17,4943,4703,240,4.9
CN1201300000000,12,013,Calhoun County, FL,Apr-17,4935,4703,232,4.7
CN1201300000000,12,013,Calhoun County, FL,May-17,4978,4744,234,4.7
CN1201300000000,12,013,Calhoun County, FL,Jun-17,4923,4655,268,5.4
CN1201300000000,12,013,Calhoun County, FL,Jul-17,4904,4640,264,5.4
CN1201300000000,12,013,Calhoun County, FL,Aug-17,4902,4641,261,5.3
CN1201300000000,12,013,Calhoun County, FL,Sep-17,5063,4826,237,4.7
CN1201300000000,12,013,Calhoun County, FL,Oct-17,4967,4753,214,4.3
CN1201300000000,12,013,Calhoun County, FL,Nov-17,4911,4699,212,4.3
CN1201300000000,12,013,Calhoun County, FL,Dec-17,4861,4654,207,4.3
CN1201300000000,12,013,Calhoun County, FL,Jan-18,4927,4682,245,5.0
CN1201300000000,12,013,Calhoun County, FL,Feb-18,4937,4721,216,4.4
CN1201300000000,12,013,Calhoun County, FL,Mar-18,4965,4747,218,4.4
CN1201300000000,12,013,Calhoun County, FL,Apr-18(p),4980,4785,195,3.9
CN3100100000000,31,001,Adams County, NE,Mar-17,16412,15894,518,3.2
CN3100100000000,31,001,Adams County, NE,Apr-17,16618,16143,475,2.9
CN3100100000000,31,001,Adams County, NE,May-17,16743,16265,478,2.9
CN3100100000000,31,001,Adams County, NE,Jun-17,16947,16376,571,3.4
CN3100100000000,31,001,Adams County, NE,Jul-17,16936,16351,585,3.5
CN3100100000000,31,001,Adams County, NE,Aug-17,16620,16103,517,3.1
CN3100100000000,31,001,Adams County, NE,Sep-17,16423,15985,438,2.7
CN3100100000000,31,001,Adams County, NE,Oct-17,16472,16057,415,2.5
CN3100100000000,31,001,Adams County, NE,Nov-17,16418,15996,422,2.6
CN3100100000000,31,001,Adams County, NE,Dec-17,16322,15807,515,3.2
CN3100100000000,31,001,Adams County, NE,Jan-18,16409,15859,550,3.4
CN3100100000000,31,001,Adams County, NE,Feb-18,16503,16017,486,2.9
CN3100100000000,31,001,Adams County, NE,Mar-18,16521,16022,499,3.0
CN3100100000000,31,001,Adams County, NE,Apr-18(p),16145,15678,467,2.9
CN0800700000000,08,007,Archuleta County, CO,Mar-17,6372,6155,217,3.4
CN0800700000000,08,007,Archuleta County, CO,Apr-17,6504,6308,196,3.0
CN0800700000000,08,007,Archuleta County, CO,May-17,6642,6472,170,2.6
CN0800700000000,08,007,Archuleta County, CO,Jun-17,6834,6640,194,2.8
CN0800700000000,08,007,Archuleta County, CO,Jul-17,6818,6642,176,2.6
CN0800700000000,08,007,Archuleta County, CO,Aug-17,6810,6626,184,2.7
CN0800700000000,08,007,Archuleta County, CO,Sep-17,6729,6545,184,2.7
CN0800700000000,08,007,Archuleta County, CO,Oct-17,6734,6536,198,2.9
CN0800700000000,08,007,Archuleta County, CO,Nov-17,6578,6377,201,3.1
CN0800700000000,08,007,Archuleta County, CO,Dec-17,6479,6273,206,3.2
CN0800700000000,08,007,Archuleta County, CO,Jan-18,6397,6160,237,3.7
CN0800700000000,08,007,Archuleta County, CO,Feb-18,6413,6163,250,3.9
CN0800700000000,08,007,Archuleta County, CO,Mar-18,6445,6222,223,3.5
CN0800700000000,08,007,Archuleta County, CO,Apr-18(p),6584,6400,184,2.8
CN2913700000000,29,137,Monroe County, MO,Mar-17,4085,3895,190,4.7
CN2913700000000,29,137,Monroe County, MO,Apr-17,4160,4011,149,3.6
CN2913700000000,29,137,Monroe County, MO,May-17,4107,3955,152,3.7
CN2913700000000,29,137,Monroe County, MO,Jun-17,4058,3844,214,5.3
CN2913700000000,29,137,Monroe County, MO,Jul-17,3778,3589,189,5.0
CN2913700000000,29,137,Monroe County, MO,Aug-17,3824,3619,205,5.4
CN2913700000000,29,137,Monroe County, MO,Sep-17,3941,3770,171,4.3
CN2913700000000,29,137,Monroe County, MO,Oct-17,3907,3798,109,2.8
CN2913700000000,29,137,Monroe County, MO,Nov-17,3909,3774,135,3.5
CN2913700000000,29,137,Monroe County, MO,Dec-17,3883,3726,157,4.0
CN2913700000000,29,137,Monroe County, MO,Jan-18,3864,3664,200,5.2
CN2913700000000,29,137,Monroe County, MO,Feb-18,3915,3719,196,5.0
CN2913700000000,29,137,Monroe County, MO,Mar-18,3907,3726,181,4.6
CN2913700000000,29,137,Monroe County, MO,Apr-18(p),3957,3811,146,3.7
CN4812500000000,48,125,Dickens County, TX,Mar-17,697,662,35,5.0
CN4812500000000,48,125,Dickens County, TX,Apr-17,699,666,33,4.7
CN4812500000000,48,125,Dickens County, TX,May-17,711,677,34,4.8
CN4812500000000,48,125,Dickens County, TX,Jun-17,700,667,33,4.7
CN4812500000000,48,125,Dickens County, TX,Jul-17,667,629,38,5.7
CN4812500000000,48,125,Dickens County, TX,Aug-17,690,653,37,5.4
CN4812500000000,48,125,Dickens County, TX,Sep-17,668,638,30,4.5
CN4812500000000,48,125,Dickens County, TX,Oct-17,679,655,24,3.5
CN4812500000000,48,125,Dickens County, TX,Nov-17,661,635,26,3.9
CN4812500000000,48,125,Dickens County, TX,Dec-17,671,645,26,3.9
CN4812500000000,48,125,Dickens County, TX,Jan-18,673,646,27,4.0
CN4812500000000,48,125,Dickens County, TX,Feb-18,680,650,30,4.4
CN4812500000000,48,125,Dickens County, TX,Mar-18,706,675,31,4.4
CN4812500000000,48,125,Dickens County, TX,Apr-18(p),694,666,28,4.0
CN7208700000000,72,087,Loiza Municipio, PR,Mar-17,8680,7812,868,10.0
CN7208700000000,72,087,Loiza Municipio, PR,Apr-17,8643,7730,913,10.6
CN7208700000000,72,087,Loiza Municipio, PR,May-17,8457,7688,769,9.1
CN7208700000000,72,087,Loiza Municipio, PR,Jun-17,8309,7643,666,8.0
CN7208700000000,72,087,Loiza Municipio, PR,Jul-17,8370,7613,757,9.0
CN7208700000000,72,087,Loiza Municipio, PR,Aug-17,8384,7507,877,10.5
CN7208700000000,72,087,Loiza Municipio, PR,Sep-17(y),8420,7594,826,9.8
CN7208700000000,72,087,Loiza Municipio, PR,Oct-17,8040,7297,743,9.2
CN7208700000000,72,087,Loiza Municipio, PR,Nov-17,8423,7704,719,8.5
CN7208700000000,72,087,Loiza Municipio, PR,Dec-17,8460,7761,699,8.3
CN7208700000000,72,087,Loiza Municipio, PR,Jan-18,8419,7617,802,9.5
CN7208700000000,72,087,Loiza Municipio, PR,Feb-18,8403,7651,752,8.9
CN7208700000000,72,087,Loiza Municipio, PR,Mar-18,8419,7663,756,9.0
CN7208700000000,72,087,Loiza Municipio, PR,Apr-18(p),8427,7703,724,8.6
CN2206300000000,22,063,Livingston Parish, LA,Mar-17,68734,65784,2950,4.3
CN2206300000000,22,063,Livingston Parish, LA,Apr-17,68679,65871,2808,4.1
CN2206300000000,22,063,Livingston Parish, LA,May-17,68361,65518,2843,4.2
CN2206300000000,22,063,Livingston Parish, LA,Jun-17,69050,65698,3352,4.9
CN2206300000000,22,063,Livingston Parish, LA,Jul-17,69273,66056,3217,4.6
CN2206300000000,22,063,Livingston Parish, LA,Aug-17,69044,65888,3156,4.6
CN2206300000000,22,063,Livingston Parish, LA,Sep-17,69279,66463,2816,4.1
CN2206300000000,22,063,Livingston Parish, LA,Oct-17,69034,66651,2383,3.5
CN2206300000000,22,063,Livingston Parish, LA,Nov-17,69374,66984,2390,3.4
CN2206300000000,22,063,Livingston Parish, LA,Dec-17,68697,66435,2262,3.3
CN2206300000000,22,063,Livingston Parish, LA,Jan-18,68749,66224,2525,3.7
CN2206300000000,22,063,Livingston Parish, LA,Feb-18,69600,67339,2261,3.2
CN2206300000000,22,063,Livingston Parish, LA,Mar-18,69985,67497,2488,3.6
CN2206300000000,22,063,Livingston Parish, LA,Apr-18(p),70233,67762,2471,3.5
CN4105100000000,41,051,Multnomah County, OR,Mar-17,452283,435615,16668,3.7
CN4105100000000,41,051,Multnomah County, OR,Apr-17,454206,438905,15301,3.4
CN4105100000000,41,051,Multnomah County, OR,May-17,453905,438835,15070,3.3
CN4105100000000,41,051,Multnomah County, OR,Jun-17,457189,439667,17522,3.8
CN4105100000000,41,051,Multnomah County, OR,Jul-17,460985,442616,18369,4.0
CN4105100000000,41,051,Multnomah County, OR,Aug-17,461988,443624,18364,4.0
CN4105100000000,41,051,Multnomah County, OR,Sep-17,462751,445975,16776,3.6
CN4105100000000,41,051,Multnomah County, OR,Oct-17,463124,446406,16718,3.6
CN4105100000000,41,051,Multnomah County, OR,Nov-17,462941,446810,16131,3.5
CN4105100000000,41,051,Multnomah County, OR,Dec-17,460950,445709,15241,3.3
CN4105100000000,41,051,Multnomah County, OR,Jan-18,460627,443960,16667,3.6
CN4105100000000,41,051,Multnomah County, OR,Feb-18,462762,445470,17292,3.7
CN4105100000000,41,051,Multnomah County, OR,Mar-18,461432,444047,17385,3.8
CN4105100000000,41,051,Multnomah County, OR,Apr-18(p),458021,442190,15831,3.5
CN0804500000000,08,045,Garfield County, CO,Mar-17,32336,31383,953,2.9
CN0804500000000,08,045,Garfield County, CO,Apr-17,31552,30715,837,2.7
CN0804500000000,08,045,Garfield County, CO,May-17,29861,29006,855,2.9
CN0804500000000,08,045,Garfield County, CO,Jun-17,32106,31218,888,2.8
CN0804500000000,08,045,Garfield County, CO,Jul-17,32753,31916,837,2.6
CN0804500000000,08,045,Garfield County, CO,Aug-17,32220,31405,815,2.5
CN0804500000000,08,045,Garfield County, CO,Sep-17,31561,30770,791,2.5
CN0804500000000,08,045,Garfield County, CO,Oct-17,31047,30208,839,2.7
CN0804500000000,08,045,Garfield County, CO,Nov-17,30651,29751,900,2.9
CN0804500000000,08,045,Garfield County, CO,Dec-17,32975,31993,982,3.0
CN0804500000000,08,045,Garfield County, CO,Jan-18,32669,31497,1172,3.6
CN0804500000000,08,045,Garfield County, CO,Feb-18,33265,32075,1190,3.6
CN0804500000000,08,045,Garfield County, CO,Mar-18,33227,32213,1014,3.1
CN0804500000000,08,045,Garfield County, CO,Apr-18(p),32382,31552,830,2.6
CN5112700000000,51,127,New Kent County, VA,Mar-17,11855,11457,398,3.4
CN5112700000000,51,127,New Kent County, VA,Apr-17,11858,11502,356,3.0
CN5112700000000,51,127,New Kent County, VA,May-17,11884,11508,376,3.2
CN5112700000000,51,127,New Kent County, VA,Jun-17,11963,11573,390,3.3
CN5112700000000,51,127,New Kent County, VA,Jul-17,12039,11639,400,3.3
CN5112700000000,51,127,New Kent County, VA,Aug-17,11893,11501,392,3.3
CN5112700000000,51,127,New Kent County, VA,Sep-17,11928,11564,364,3.1
CN5112700000000,51,127,New Kent County, VA,Oct-17,11865,11513,352,3.0
CN5112700000000,51,127,New Kent County, VA,Nov-17,11789,11435,354,3.0
CN5112700000000,51,127,New Kent County, VA,Dec-17,11771,11415,356,3.0
CN5112700000000,51,127,New Kent County, VA,Jan-18,11756,11378,378,3.2
CN5112700000000,51,127,New Kent County, VA,Feb-18,11925,11549,376,3.2
CN5112700000000,51,127,New Kent County, VA,Mar-18,11996,11617,379,3.2
CN5112700000000,51,127,New Kent County, VA,Apr-18(p),12017,11690,327,2.7
CN0509900000000,05,099,Nevada County, AR,Mar-17,3592,3471,121,3.4
CN0509900000000,05,099,Nevada County, AR,Apr-17,3631,3508,123,3.4
CN0509900000000,05,099,Nevada County, AR,May-17,3633,3502,131,3.6
CN0509900000000,05,099,Nevada County, AR,Jun-17,3707,3560,147,4.0
CN0509900000000,05,099,Nevada County, AR,Jul-17,3563,3414,149,4.2
CN0509900000000,05,099,Nevada County, AR,Aug-17,3562,3425,137,3.8
CN0509900000000,05,099,Nevada County, AR,Sep-17,3652,3532,120,3.3
CN0509900000000,05,099,Nevada County, AR,Oct-17,3637,3525,112,3.1
CN0509900000000,05,099,Nevada County, AR,Nov-17,3621,3507,114,3.1
CN0509900000000,05,099,Nevada County, AR,Dec-17,3598,3475,123,3.4
CN0509900000000,05,099,Nevada County, AR,Jan-18,3550,3412,138,3.9
CN0509900000000,05,099,Nevada County, AR,Feb-18,3591,3442,149,4.1
CN0509900000000,05,099,Nevada County, AR,Mar-18,3596,3464,132,3.7
CN0509900000000,05,099,Nevada County, AR,Apr-18(p),3597,3485,112,3.1
CN4816300000000,48,163,Frio County, TX,Mar-17,9465,9063,402,4.2
CN4816300000000,48,163,Frio County, TX,Apr-17,9488,9119,369,3.9
CN4816300000000,48,163,Frio County, TX,May-17,9541,9186,355,3.7
CN4816300000000,48,163,Frio County, TX,Jun-17,9406,9013,393,4.2
CN4816300000000,48,163,Frio County, TX,Jul-17,9239,8854,385,4.2
CN4816300000000,48,163,Frio County, TX,Aug-17,9332,8965,367,3.9
CN4816300000000,48,163,Frio County, TX,Sep-17,9335,9038,297,3.2
CN4816300000000,48,163,Frio County, TX,Oct-17,9283,8999,284,3.1
CN4816300000000,48,163,Frio County, TX,Nov-17,9220,8926,294,3.2
CN4816300000000,48,163,Frio County, TX,Dec-17,9198,8914,284,3.1
CN4816300000000,48,163,Frio County, TX,Jan-18,9429,9113,316,3.4
CN4816300000000,48,163,Frio County, TX,Feb-18,9582,9268,314,3.3
CN4816300000000,48,163,Frio County, TX,Mar-18,9741,9444,297,3.0
CN4816300000000,48,163,Frio County, TX,Apr-18(p),10042,9782,260,2.6
CN1331700000000,13,317,Wilkes County, GA,Mar-17,3804,3577,227,6.0
CN1331700000000,13,317,Wilkes County, GA,Apr-17,3810,3615,195,5.1
CN1331700000000,13,317,Wilkes County, GA,May-17,3856,3651,205,5.3
CN1331700000000,13,317,Wilkes County, GA,Jun-17,3904,3675,229,5.9
CN1331700000000,13,317,Wilkes County, GA,Jul-17,3898,3656,242,6.2
CN1331700000000,13,317,Wilkes County, GA,Aug-17,3852,3629,223,5.8
CN1331700000000,13,317,Wilkes County, GA,Sep-17,3854,3649,205,5.3
CN1331700000000,13,317,Wilkes County, GA,Oct-17,3833,3636,197,5.1
CN1331700000000,13,317,Wilkes County, GA,Nov-17,3826,3626,200,5.2
CN1331700000000,13,317,Wilkes County, GA,Dec-17,3833,3628,205,5.3
CN1331700000000,13,317,Wilkes County, GA,Jan-18,3900,3662,238,6.1
CN1331700000000,13,317,Wilkes County, GA,Feb-18,3812,3613,199,5.2
CN1331700000000,13,317,Wilkes County, GA,Mar-18,3816,3637,179,4.7
CN1331700000000,13,317,Wilkes County, GA,Apr-18(p),3822,3660,162,4.2
CN1211100000000,12,111,St. Lucie County, FL,Mar-17,138705,131816,6889,5.0
CN1211100000000,12,111,St. Lucie County, FL,Apr-17,137878,131344,6534,4.7
CN1211100000000,12,111,St. Lucie County, FL,May-17,138732,131948,6784,4.9
CN1211100000000,12,111,St. Lucie County, FL,Jun-17,138585,131250,7335,5.3
CN1211100000000,12,111,St. Lucie County, FL,Jul-17,138497,131019,7478,5.4
CN1211100000000,12,111,St. Lucie County, FL,Aug-17,138366,130989,7377,5.3
CN1211100000000,12,111,St. Lucie County, FL,Sep-17,138745,131817,6928,5.0
CN1211100000000,12,111,St. Lucie County, FL,Oct-17,138598,132123,6475,4.7
CN1211100000000,12,111,St. Lucie County, FL,Nov-17,137671,131144,6527,4.7
CN1211100000000,12,111,St. Lucie County, FL,Dec-17,136933,130680,6253,4.6
CN1211100000000,12,111,St. Lucie County, FL,Jan-18,137926,130904,7022,5.1
CN1211100000000,12,111,St. Lucie County, FL,Feb-18,139376,132861,6515,4.7
CN1211100000000,12,111,St. Lucie County, FL,Mar-18,139838,133440,6398,4.6
CN1211100000000,12,111,St. Lucie County, FL,Apr-18(p),139001,133248,5753,4.1
CN3609500000000,36,095,Schoharie County, NY,Mar-17,14952,14024,928,6.2
CN3609500000000,36,095,Schoharie County, NY,Apr-17,14934,14118,816,5.5
CN3609500000000,36,095,Schoharie County, NY,May-17,14648,13916,732,5.0
CN3609500000000,36,095,Schoharie County, NY,Jun-17,14954,14149,805,5.4
CN3609500000000,36,095,Schoharie County, NY,Jul-17,14896,14098,798,5.4
CN3609500000000,36,095,Schoharie County, NY,Aug-17,14724,13990,734,5.0
CN3609500000000,36,095,Schoharie County, NY,Sep-17,14730,14016,714,4.8
CN3609500000000,36,095,Schoharie County, NY,Oct-17,14671,14004,667,4.5
CN3609500000000,36,095,Schoharie County, NY,Nov-17,14798,14097,701,4.7
CN3609500000000,36,095,Schoharie County, NY,Dec-17,14710,13929,781,5.3
CN3609500000000,36,095,Schoharie County, NY,Jan-18,15229,14063,1166,7.7
CN3609500000000,36,095,Schoharie County, NY,Feb-18,15019,13901,1118,7.4
CN3609500000000,36,095,Schoharie County, NY,Mar-18,14800,13796,1004,6.8
CN3609500000000,36,095,Schoharie County, NY,Apr-18(p),14711,13882,829,5.6
CN0113300000000,01,133,Winston County, AL,Mar-17,9668,9141,527,5.5
CN0113300000000,01,133,Winston County, AL,Apr-17,9628,9179,449,4.7
CN0113300000000,01,133,Winston County, AL,May-17,9609,9174,435,4.5
CN0113300000000,01,133,Winston County, AL,Jun-17,9736,9232,504,5.2
CN0113300000000,01,133,Winston County, AL,Jul-17,9648,9154,494,5.1
CN0113300000000,01,133,Winston County, AL,Aug-17,9653,9158,495,5.1
CN0113300000000,01,133,Winston County, AL,Sep-17,9770,9355,415,4.2
CN0113300000000,01,133,Winston County, AL,Oct-17,9754,9334,420,4.3
CN0113300000000,01,133,Winston County, AL,Nov-17,9617,9242,375,3.9
CN0113300000000,01,133,Winston County, AL,Dec-17,9492,9121,371,3.9
CN0113300000000,01,133,Winston County, AL,Jan-18,9413,8977,436,4.6
CN0113300000000,01,133,Winston County, AL,Feb-18,9521,9064,457,4.8
CN0113300000000,01,133,Winston County, AL,Mar-18,9577,9173,404,4.2
CN0113300000000,01,133,Winston County, AL,Apr-18(p),9638,9277,361,3.7
CN3505100000000,35,051,Sierra County, NM,Mar-17,3823,3474,349,9.1
CN3505100000000,35,051,Sierra County, NM,Apr-17,4100,3748,352,8.6
CN3505100000000,35,051,Sierra County, NM,May-17,4111,3783,328,8.0
CN3505100000000,35,051,Sierra County, NM,Jun-17,4236,3919,317,7.5
CN3505100000000,35,051,Sierra County, NM,Jul-17,4372,4059,313,7.2
CN3505100000000,35,051,Sierra County, NM,Aug-17,4269,3975,294,6.9
CN3505100000000,35,051,Sierra County, NM,Sep-17,4220,3933,287,6.8
CN3505100000000,35,051,Sierra County, NM,Oct-17,4158,3866,292,7.0
CN3505100000000,35,051,Sierra County, NM,Nov-17,4081,3784,297,7.3
CN3505100000000,35,051,Sierra County, NM,Dec-17,4042,3715,327,8.1
CN3505100000000,35,051,Sierra County, NM,Jan-18,3893,3532,361,9.3
CN3505100000000,35,051,Sierra County, NM,Feb-18,3922,3567,355,9.1
CN3505100000000,35,051,Sierra County, NM,Mar-18,3923,3578,345,8.8
CN3505100000000,35,051,Sierra County, NM,Apr-18(p),4066,3751,315,7.7
CN1327900000000,13,279,Toombs County, GA,Mar-17,11837,11069,768,6.5
CN1327900000000,13,279,Toombs County, GA,Apr-17,12003,11201,802,6.7
CN1327900000000,13,279,Toombs County, GA,May-17,12058,11345,713,5.9
CN1327900000000,13,279,Toombs County, GA,Jun-17,12178,11384,794,6.5
CN1327900000000,13,279,Toombs County, GA,Jul-17,12107,11300,807,6.7
CN1327900000000,13,279,Toombs County, GA,Aug-17,12052,11253,799,6.6
CN1327900000000,13,279,Toombs County, GA,Sep-17,12132,11387,745,6.1
CN1327900000000,13,279,Toombs County, GA,Oct-17,12017,11317,700,5.8
CN1327900000000,13,279,Toombs County, GA,Nov-17,12034,11317,717,6.0
CN1327900000000,13,279,Toombs County, GA,Dec-17,12041,11312,729,6.1
CN1327900000000,13,279,Toombs County, GA,Jan-18,12319,11456,863,7.0
CN1327900000000,13,279,Toombs County, GA,Feb-18,11703,10967,736,6.3
CN1327900000000,13,279,Toombs County, GA,Mar-18,11736,11036,700,6.0
CN1327900000000,13,279,Toombs County, GA,Apr-18(p),11736,11090,646,5.5
CN2707100000000,27,071,Koochiching County, MN,Mar-17,6019,5484,535,8.9
CN2707100000000,27,071,Koochiching County, MN,Apr-17,5913,5367,546,9.2
CN2707100000000,27,071,Koochiching County, MN,May-17,5972,5536,436,7.3
CN2707100000000,27,071,Koochiching County, MN,Jun-17,6189,5770,419,6.8
CN2707100000000,27,071,Koochiching County, MN,Jul-17,6125,5752,373,6.1
CN2707100000000,27,071,Koochiching County, MN,Aug-17,5992,5603,389,6.5
CN2707100000000,27,071,Koochiching County, MN,Sep-17,5957,5666,291,4.9
CN2707100000000,27,071,Koochiching County, MN,Oct-17,5980,5705,275,4.6
CN2707100000000,27,071,Koochiching County, MN,Nov-17,6119,5687,432,7.1
CN2707100000000,27,071,Koochiching County, MN,Dec-17,6044,5673,371,6.1
CN2707100000000,27,071,Koochiching County, MN,Jan-18,6043,5630,413,6.8
CN2707100000000,27,071,Koochiching County, MN,Feb-18,6066,5662,404,6.7
CN2707100000000,27,071,Koochiching County, MN,Mar-18,6099,5657,442,7.2
CN2707100000000,27,071,Koochiching County, MN,Apr-18(p),6043,5584,459,7.6
CN4011900000000,40,119,Payne County, OK,Mar-17,38951,37581,1370,3.5
CN4011900000000,40,119,Payne County, OK,Apr-17,38987,37773,1214,3.1
CN4011900000000,40,119,Payne County, OK,May-17,38895,37468,1427,3.7
CN4011900000000,40,119,Payne County, OK,Jun-17,37931,36189,1742,4.6
CN4011900000000,40,119,Payne County, OK,Jul-17,38054,36569,1485,3.9
CN4011900000000,40,119,Payne County, OK,Aug-17,38267,36817,1450,3.8
CN4011900000000,40,119,Payne County, OK,Sep-17,38346,36929,1417,3.7
CN4011900000000,40,119,Payne County, OK,Oct-17,38443,37253,1190,3.1
CN4011900000000,40,119,Payne County, OK,Nov-17,38599,37332,1267,3.3
CN4011900000000,40,119,Payne County, OK,Dec-17,37878,36659,1219,3.2
CN4011900000000,40,119,Payne County, OK,Jan-18,38020,36597,1423,3.7
CN4011900000000,40,119,Payne County, OK,Feb-18,37662,36315,1347,3.6
CN4011900000000,40,119,Payne County, OK,Mar-18,37724,36434,1290,3.4
CN4011900000000,40,119,Payne County, OK,Apr-18(p),37663,36394,1269,3.4
CN5101100000000,51,011,Appomattox County, VA,Mar-17,7013,6686,327,4.7
CN5101100000000,51,011,Appomattox County, VA,Apr-17,7028,6756,272,3.9
CN5101100000000,51,011,Appomattox County, VA,May-17,6984,6687,297,4.3
CN5101100000000,51,011,Appomattox County, VA,Jun-17,7047,6713,334,4.7
CN5101100000000,51,011,Appomattox County, VA,Jul-17,7124,6794,330,4.6
CN5101100000000,51,011,Appomattox County, VA,Aug-17,7057,6727,330,4.7
CN5101100000000,51,011,Appomattox County, VA,Sep-17,7083,6786,297,4.2
CN5101100000000,51,011,Appomattox County, VA,Oct-17,7005,6725,280,4.0
CN5101100000000,51,011,Appomattox County, VA,Nov-17,6995,6712,283,4.0
CN5101100000000,51,011,Appomattox County, VA,Dec-17,7004,6717,287,4.1
CN5101100000000,51,011,Appomattox County, VA,Jan-18,6958,6625,333,4.8
CN5101100000000,51,011,Appomattox County, VA,Feb-18,7067,6774,293,4.1
CN5101100000000,51,011,Appomattox County, VA,Mar-18,7099,6786,313,4.4
CN5101100000000,51,011,Appomattox County, VA,Apr-18(p),7139,6891,248,3.5
CN1000300000000,10,003,New Castle County, DE,Mar-17,297878,284372,13506,4.5
CN1000300000000,10,003,New Castle County, DE,Apr-17,297230,284135,13095,4.4
CN1000300000000,10,003,New Castle County, DE,May-17,294181,281516,12665,4.3
CN1000300000000,10,003,New Castle County, DE,Jun-17,294112,279306,14806,5.0
CN1000300000000,10,003,New Castle County, DE,Jul-17,295809,281238,14571,4.9
CN1000300000000,10,003,New Castle County, DE,Aug-17,294612,280284,14328,4.9
CN1000300000000,10,003,New Castle County, DE,Sep-17,292878,279697,13181,4.5
CN1000300000000,10,003,New Castle County, DE,Oct-17,296686,283857,12829,4.3
CN1000300000000,10,003,New Castle County, DE,Nov-17,298492,286855,11637,3.9
CN1000300000000,10,003,New Castle County, DE,Dec-17,298647,287206,11441,3.8
CN1000300000000,10,003,New Castle County, DE,Jan-18,299504,286261,13243,4.4
CN1000300000000,10,003,New Castle County, DE,Feb-18,300367,287836,12531,4.2
CN1000300000000,10,003,New Castle County, DE,Mar-18,302537,290772,11765,3.9
CN1000300000000,10,003,New Castle County, DE,Apr-18(p),301929,291146,10783,3.6
CN2812300000000,28,123,Scott County, MS,Mar-17,13413,12891,522,3.9
CN2812300000000,28,123,Scott County, MS,Apr-17,13384,12898,486,3.6
CN2812300000000,28,123,Scott County, MS,May-17,13452,12871,581,4.3
CN2812300000000,28,123,Scott County, MS,Jun-17,13691,13040,651,4.8
CN2812300000000,28,123,Scott County, MS,Jul-17,13701,13081,620,4.5
CN2812300000000,28,123,Scott County, MS,Aug-17,13353,12807,546,4.1
CN2812300000000,28,123,Scott County, MS,Sep-17,13420,12928,492,3.7
CN2812300000000,28,123,Scott County, MS,Oct-17,13312,12844,468,3.5
CN2812300000000,28,123,Scott County, MS,Nov-17,13255,12794,461,3.5
CN2812300000000,28,123,Scott County, MS,Dec-17,13442,12974,468,3.5
CN2812300000000,28,123,Scott County, MS,Jan-18,13259,12794,465,3.5
CN2812300000000,28,123,Scott County, MS,Feb-18,13361,12904,457,3.4
CN2812300000000,28,123,Scott County, MS,Mar-18,13491,13040,451,3.3
CN2812300000000,28,123,Scott County, MS,Apr-18(p),13480,13007,473,3.5
CN2901300000000,29,013,Bates County, MO,Mar-17,8087,7708,379,4.7
CN2901300000000,29,013,Bates County, MO,Apr-17,8263,7916,347,4.2
CN2901300000000,29,013,Bates County, MO,May-17,8135,7780,355,4.4
CN2901300000000,29,013,Bates County, MO,Jun-17,8226,7851,375,4.6
CN2901300000000,29,013,Bates County, MO,Jul-17,8233,7845,388,4.7
CN2901300000000,29,013,Bates County, MO,Aug-17,8127,7743,384,4.7
CN2901300000000,29,013,Bates County, MO,Sep-17,8017,7739,278,3.5
CN2901300000000,29,013,Bates County, MO,Oct-17,8083,7840,243,3.0
CN2901300000000,29,013,Bates County, MO,Nov-17,8056,7770,286,3.6
CN2901300000000,29,013,Bates County, MO,Dec-17,7992,7683,309,3.9
CN2901300000000,29,013,Bates County, MO,Jan-18,8080,7659,421,5.2
CN2901300000000,29,013,Bates County, MO,Feb-18,8167,7746,421,5.2
CN2901300000000,29,013,Bates County, MO,Mar-18,8110,7758,352,4.3
CN2901300000000,29,013,Bates County, MO,Apr-18(p),8175,7848,327,4.0
CN5116500000000,51,165,Rockingham County, VA,Mar-17,40982,39617,1365,3.3
CN5116500000000,51,165,Rockingham County, VA,Apr-17,41607,40411,1196,2.9
CN5116500000000,51,165,Rockingham County, VA,May-17,40462,39077,1385,3.4
CN5116500000000,51,165,Rockingham County, VA,Jun-17,40537,39063,1474,3.6
CN5116500000000,51,165,Rockingham County, VA,Jul-17,40722,39285,1437,3.5
CN5116500000000,51,165,Rockingham County, VA,Aug-17,39688,38301,1387,3.5
CN5116500000000,51,165,Rockingham County, VA,Sep-17,41403,40120,1283,3.1
CN5116500000000,51,165,Rockingham County, VA,Oct-17,41160,39954,1206,2.9
CN5116500000000,51,165,Rockingham County, VA,Nov-17,40959,39741,1218,3.0
CN5116500000000,51,165,Rockingham County, VA,Dec-17,41116,39954,1162,2.8
CN5116500000000,51,165,Rockingham County, VA,Jan-18,40612,39319,1293,3.2
CN5116500000000,51,165,Rockingham County, VA,Feb-18,41434,40256,1178,2.8
CN5116500000000,51,165,Rockingham County, VA,Mar-18,41231,40004,1227,3.0
CN5116500000000,51,165,Rockingham County, VA,Apr-18(p),41902,40870,1032,2.5
CN2916700000000,29,167,Polk County, MO,Mar-17,14101,13480,621,4.4
CN2916700000000,29,167,Polk County, MO,Apr-17,14277,13725,552,3.9
CN2916700000000,29,167,Polk County, MO,May-17,14108,13536,572,4.1
CN2916700000000,29,167,Polk County, MO,Jun-17,14262,13647,615,4.3
CN2916700000000,29,167,Polk County, MO,Jul-17,14327,13656,671,4.7
CN2916700000000,29,167,Polk County, MO,Aug-17,14055,13406,649,4.6
CN2916700000000,29,167,Polk County, MO,Sep-17,14129,13629,500,3.5
CN2916700000000,29,167,Polk County, MO,Oct-17,14022,13667,355,2.5
CN2916700000000,29,167,Polk County, MO,Nov-17,14043,13556,487,3.5
CN2916700000000,29,167,Polk County, MO,Dec-17,14039,13557,482,3.4
CN2916700000000,29,167,Polk County, MO,Jan-18,14034,13450,584,4.2
CN2916700000000,29,167,Polk County, MO,Feb-18,14252,13578,674,4.7
CN2916700000000,29,167,Polk County, MO,Mar-18,14184,13554,630,4.4
CN2916700000000,29,167,Polk County, MO,Apr-18(p),14227,13680,547,3.8
CN2500100000000,25,001,Barnstable County, MA,Mar-17,106188,99071,7117,6.7
CN2500100000000,25,001,Barnstable County, MA,Apr-17,107514,102239,5275,4.9
CN2500100000000,25,001,Barnstable County, MA,May-17,110992,106293,4699,4.2
CN2500100000000,25,001,Barnstable County, MA,Jun-17,120469,115937,4532,3.8
CN2500100000000,25,001,Barnstable County, MA,Jul-17,126272,121981,4291,3.4
CN2500100000000,25,001,Barnstable County, MA,Aug-17,125602,121616,3986,3.2
CN2500100000000,25,001,Barnstable County, MA,Sep-17,114309,110471,3838,3.4
CN2500100000000,25,001,Barnstable County, MA,Oct-17,111049,107483,3566,3.2
CN2500100000000,25,001,Barnstable County, MA,Nov-17,108557,104167,4390,4.0
CN2500100000000,25,001,Barnstable County, MA,Dec-17,107563,102507,5056,4.7
CN2500100000000,25,001,Barnstable County, MA,Jan-18,107698,100330,7368,6.8
CN2500100000000,25,001,Barnstable County, MA,Feb-18,107573,99898,7675,7.1
CN2500100000000,25,001,Barnstable County, MA,Mar-18,108760,101781,6979,6.4
CN2500100000000,25,001,Barnstable County, MA,Apr-18(p),110889,105739,5150,4.6
CN2807700000000,28,077,Lawrence County, MS,Mar-17,4594,4299,295,6.4
CN2807700000000,28,077,Lawrence County, MS,Apr-17,4620,4345,275,6.0
CN2807700000000,28,077,Lawrence County, MS,May-17,4687,4357,330,7.0
CN2807700000000,28,077,Lawrence County, MS,Jun-17,4730,4365,365,7.7
CN2807700000000,28,077,Lawrence County, MS,Jul-17,4725,4360,365,7.7
CN2807700000000,28,077,Lawrence County, MS,Aug-17,4615,4287,328,7.1
CN2807700000000,28,077,Lawrence County, MS,Sep-17,4662,4387,275,5.9
CN2807700000000,28,077,Lawrence County, MS,Oct-17,4599,4366,233,5.1
CN2807700000000,28,077,Lawrence County, MS,Nov-17,4589,4347,242,5.3
CN2807700000000,28,077,Lawrence County, MS,Dec-17,4616,4347,269,5.8
CN2807700000000,28,077,Lawrence County, MS,Jan-18,4548,4293,255,5.6
CN2807700000000,28,077,Lawrence County, MS,Feb-18,4563,4321,242,5.3
CN2807700000000,28,077,Lawrence County, MS,Mar-18,4556,4335,221,4.9
CN2807700000000,28,077,Lawrence County, MS,Apr-18(p),4566,4341,225,4.9
CN3911900000000,39,119,Muskingum County, OH,Mar-17,39550,36980,2570,6.5
CN3911900000000,39,119,Muskingum County, OH,Apr-17,39570,37373,2197,5.6
CN3911900000000,39,119,Muskingum County, OH,May-17,39749,37755,1994,5.0
CN3911900000000,39,119,Muskingum County, OH,Jun-17,40004,37773,2231,5.6
CN3911900000000,39,119,Muskingum County, OH,Jul-17,40028,37808,2220,5.5
CN3911900000000,39,119,Muskingum County, OH,Aug-17,39915,37752,2163,5.4
CN3911900000000,39,119,Muskingum County, OH,Sep-17,39632,37686,1946,4.9
CN3911900000000,39,119,Muskingum County, OH,Oct-17,39621,37774,1847,4.7
CN3911900000000,39,119,Muskingum County, OH,Nov-17,39671,37694,1977,5.0
CN3911900000000,39,119,Muskingum County, OH,Dec-17,39543,37366,2177,5.5
CN3911900000000,39,119,Muskingum County, OH,Jan-18,38679,36079,2600,6.7
CN3911900000000,39,119,Muskingum County, OH,Feb-18,39594,37194,2400,6.1
CN3911900000000,39,119,Muskingum County, OH,Mar-18,40013,37747,2266,5.7
CN3911900000000,39,119,Muskingum County, OH,Apr-18(p),40078,38086,1992,5.0
CN2109700000000,21,097,Harrison County, KY,Mar-17,8868,8404,464,5.2
CN2109700000000,21,097,Harrison County, KY,Apr-17,8888,8482,406,4.6
CN2109700000000,21,097,Harrison County, KY,May-17,8853,8437,416,4.7
CN2109700000000,21,097,Harrison County, KY,Jun-17,8933,8481,452,5.1
CN2109700000000,21,097,Harrison County, KY,Jul-17,8684,8268,416,4.8
CN2109700000000,21,097,Harrison County, KY,Aug-17,8733,8370,363,4.2
CN2109700000000,21,097,Harrison County, KY,Sep-17,8783,8435,348,4.0
CN2109700000000,21,097,Harrison County, KY,Oct-17,8774,8452,322,3.7
CN2109700000000,21,097,Harrison County, KY,Nov-17,8748,8451,297,3.4
CN2109700000000,21,097,Harrison County, KY,Dec-17,8773,8469,304,3.5
CN2109700000000,21,097,Harrison County, KY,Jan-18,8690,8362,328,3.8
CN2109700000000,21,097,Harrison County, KY,Feb-18,8707,8321,386,4.4
CN2109700000000,21,097,Harrison County, KY,Mar-18,8767,8398,369,4.2
CN2109700000000,21,097,Harrison County, KY,Apr-18(p),8801,8482,319,3.6
CN2400500000000,24,005,Baltimore County, MD,Mar-17,449700,429880,19820,4.4
CN2400500000000,24,005,Baltimore County, MD,Apr-17,449879,431474,18405,4.1
CN2400500000000,24,005,Baltimore County, MD,May-17,452111,433427,18684,4.1
CN2400500000000,24,005,Baltimore County, MD,Jun-17,456722,436236,20486,4.5
CN2400500000000,24,005,Baltimore County, MD,Jul-17,460852,440406,20446,4.4
CN2400500000000,24,005,Baltimore County, MD,Aug-17,456896,436750,20146,4.4
CN2400500000000,24,005,Baltimore County, MD,Sep-17,455549,437019,18530,4.1
CN2400500000000,24,005,Baltimore County, MD,Oct-17,454667,435883,18784,4.1
CN2400500000000,24,005,Baltimore County, MD,Nov-17,454426,435823,18603,4.1
CN2400500000000,24,005,Baltimore County, MD,Dec-17,450492,432711,17781,3.9
CN2400500000000,24,005,Baltimore County, MD,Jan-18,450976,429770,21206,4.7
CN2400500000000,24,005,Baltimore County, MD,Feb-18,452723,431541,21182,4.7
CN2400500000000,24,005,Baltimore County, MD,Mar-18,454903,434015,20888,4.6
CN2400500000000,24,005,Baltimore County, MD,Apr-18(p),452612,434477,18135,4.0
CN3803700000000,38,037,Grant County, ND,Mar-17,1267,1209,58,4.6
CN3803700000000,38,037,Grant County, ND,Apr-17,1301,1254,47,3.6
CN3803700000000,38,037,Grant County, ND,May-17,1286,1255,31,2.4
CN3803700000000,38,037,Grant County, ND,Jun-17,1318,1287,31,2.4
CN3803700000000,38,037,Grant County, ND,Jul-17,1296,1270,26,2.0
CN3803700000000,38,037,Grant County, ND,Aug-17,1309,1284,25,1.9
CN3803700000000,38,037,Grant County, ND,Sep-17,1303,1280,23,1.8
CN3803700000000,38,037,Grant County, ND,Oct-17,1356,1331,25,1.8
CN3803700000000,38,037,Grant County, ND,Nov-17,1266,1236,30,2.4
CN3803700000000,38,037,Grant County, ND,Dec-17,1263,1225,38,3.0
CN3803700000000,38,037,Grant County, ND,Jan-18,1241,1195,46,3.7
CN3803700000000,38,037,Grant County, ND,Feb-18,1213,1169,44,3.6
CN3803700000000,38,037,Grant County, ND,Mar-18,1208,1169,39,3.2
CN3803700000000,38,037,Grant County, ND,Apr-18(p),1221,1187,34,2.8
CN3714700000000,37,147,Pitt County, NC,Mar-17,89589,85338,4251,4.7
CN3714700000000,37,147,Pitt County, NC,Apr-17,89202,85266,3936,4.4
CN3714700000000,37,147,Pitt County, NC,May-17,89189,84823,4366,4.9
CN3714700000000,37,147,Pitt County, NC,Jun-17,88981,84328,4653,5.2
CN3714700000000,37,147,Pitt County, NC,Jul-17,89322,84444,4878,5.5
CN3714700000000,37,147,Pitt County, NC,Aug-17,88722,83894,4828,5.4
CN3714700000000,37,147,Pitt County, NC,Sep-17,90489,86376,4113,4.5
CN3714700000000,37,147,Pitt County, NC,Oct-17,89484,85427,4057,4.5
CN3714700000000,37,147,Pitt County, NC,Nov-17,89728,85443,4285,4.8
CN3714700000000,37,147,Pitt County, NC,Dec-17,89043,84971,4072,4.6
CN3714700000000,37,147,Pitt County, NC,Jan-18,89202,84844,4358,4.9
CN3714700000000,37,147,Pitt County, NC,Feb-18,89936,85584,4352,4.8
CN3714700000000,37,147,Pitt County, NC,Mar-18,90260,86147,4113,4.6
CN3714700000000,37,147,Pitt County, NC,Apr-18(p),89781,86143,3638,4.1
CN4002500000000,40,025,Cimarron County, OK,Mar-17,1375,1341,34,2.5
CN4002500000000,40,025,Cimarron County, OK,Apr-17,1398,1371,27,1.9
CN4002500000000,40,025,Cimarron County, OK,May-17,1383,1349,34,2.5
CN4002500000000,40,025,Cimarron County, OK,Jun-17,1343,1303,40,3.0
CN4002500000000,40,025,Cimarron County, OK,Jul-17,1347,1308,39,2.9
CN4002500000000,40,025,Cimarron County, OK,Aug-17,1461,1425,36,2.5
CN4002500000000,40,025,Cimarron County, OK,Sep-17,1416,1381,35,2.5
CN4002500000000,40,025,Cimarron County, OK,Oct-17,1467,1433,34,2.3
CN4002500000000,40,025,Cimarron County, OK,Nov-17,1498,1467,31,2.1
CN4002500000000,40,025,Cimarron County, OK,Dec-17,1436,1403,33,2.3
CN4002500000000,40,025,Cimarron County, OK,Jan-18,1392,1357,35,2.5
CN4002500000000,40,025,Cimarron County, OK,Feb-18,1427,1397,30,2.1
CN4002500000000,40,025,Cimarron County, OK,Mar-18,1379,1349,30,2.2
CN4002500000000,40,025,Cimarron County, OK,Apr-18(p),1339,1311,28,2.1
CN4832500000000,48,325,Medina County, TX,Mar-17,21317,20453,864,4.1
CN4832500000000,48,325,Medina County, TX,Apr-17,21298,20514,784,3.7
CN4832500000000,48,325,Medina County, TX,May-17,21270,20469,801,3.8
CN4832500000000,48,325,Medina County, TX,Jun-17,21328,20478,850,4.0
CN4832500000000,48,325,Medina County, TX,Jul-17,21338,20463,875,4.1
CN4832500000000,48,325,Medina County, TX,Aug-17,21279,20436,843,4.0
CN4832500000000,48,325,Medina County, TX,Sep-17,21413,20646,767,3.6
CN4832500000000,48,325,Medina County, TX,Oct-17,21297,20597,700,3.3
CN4832500000000,48,325,Medina County, TX,Nov-17,21267,20543,724,3.4
CN4832500000000,48,325,Medina County, TX,Dec-17,21301,20619,682,3.2
CN4832500000000,48,325,Medina County, TX,Jan-18,21273,20485,788,3.7
CN4832500000000,48,325,Medina County, TX,Feb-18,21613,20824,789,3.7
CN4832500000000,48,325,Medina County, TX,Mar-18,21720,20933,787,3.6
CN4832500000000,48,325,Medina County, TX,Apr-18(p),21640,20930,710,3.3
CN3007300000000,30,073,Pondera County, MT,Mar-17,2783,2658,125,4.5
CN3007300000000,30,073,Pondera County, MT,Apr-17,2842,2743,99,3.5
CN3007300000000,30,073,Pondera County, MT,May-17,2856,2764,92,3.2
CN3007300000000,30,073,Pondera County, MT,Jun-17,2810,2695,115,4.1
CN3007300000000,30,073,Pondera County, MT,Jul-17,2779,2670,109,3.9
CN3007300000000,30,073,Pondera County, MT,Aug-17,2747,2639,108,3.9
CN3007300000000,30,073,Pondera County, MT,Sep-17,2684,2593,91,3.4
CN3007300000000,30,073,Pondera County, MT,Oct-17,2694,2603,91,3.4
CN3007300000000,30,073,Pondera County, MT,Nov-17,2678,2591,87,3.2
CN3007300000000,30,073,Pondera County, MT,Dec-17,2697,2590,107,4.0
CN3007300000000,30,073,Pondera County, MT,Jan-18,2702,2565,137,5.1
CN3007300000000,30,073,Pondera County, MT,Feb-18,2704,2572,132,4.9
CN3007300000000,30,073,Pondera County, MT,Mar-18,2677,2548,129,4.8
CN3007300000000,30,073,Pondera County, MT,Apr-18(p),2701,2606,95,3.5
CN5402700000000,54,027,Hampshire County, WV,Mar-17,9963,9523,440,4.4
CN5402700000000,54,027,Hampshire County, WV,Apr-17,10159,9803,356,3.5
CN5402700000000,54,027,Hampshire County, WV,May-17,10106,9763,343,3.4
CN5402700000000,54,027,Hampshire County, WV,Jun-17,10295,9882,413,4.0
CN5402700000000,54,027,Hampshire County, WV,Jul-17,10274,9880,394,3.8
CN5402700000000,54,027,Hampshire County, WV,Aug-17,10235,9823,412,4.0
CN5402700000000,54,027,Hampshire County, WV,Sep-17,10260,9907,353,3.4
CN5402700000000,54,027,Hampshire County, WV,Oct-17,10292,9950,342,3.3
CN5402700000000,54,027,Hampshire County, WV,Nov-17,10179,9804,375,3.7
CN5402700000000,54,027,Hampshire County, WV,Dec-17,9949,9549,400,4.0
CN5402700000000,54,027,Hampshire County, WV,Jan-18,10237,9775,462,4.5
CN5402700000000,54,027,Hampshire County, WV,Feb-18,10540,9976,564,5.4
CN5402700000000,54,027,Hampshire County, WV,Mar-18,10359,9869,490,4.7
CN5402700000000,54,027,Hampshire County, WV,Apr-18(p),10464,10019,445,4.3
CN0105700000000,01,057,Fayette County, AL,Mar-17,6648,6294,354,5.3
CN0105700000000,01,057,Fayette County, AL,Apr-17,6485,6207,278,4.3
CN0105700000000,01,057,Fayette County, AL,May-17,6510,6237,273,4.2
CN0105700000000,01,057,Fayette County, AL,Jun-17,6543,6205,338,5.2
CN0105700000000,01,057,Fayette County, AL,Jul-17,6463,6158,305,4.7
CN0105700000000,01,057,Fayette County, AL,Aug-17,6437,6152,285,4.4
CN0105700000000,01,057,Fayette County, AL,Sep-17,6542,6289,253,3.9
CN0105700000000,01,057,Fayette County, AL,Oct-17,6488,6237,251,3.9
CN0105700000000,01,057,Fayette County, AL,Nov-17,6475,6219,256,4.0
CN0105700000000,01,057,Fayette County, AL,Dec-17,6457,6200,257,4.0
CN0105700000000,01,057,Fayette County, AL,Jan-18,6406,6110,296,4.6
CN0105700000000,01,057,Fayette County, AL,Feb-18,6401,6099,302,4.7
CN0105700000000,01,057,Fayette County, AL,Mar-18,6410,6136,274,4.3
CN0105700000000,01,057,Fayette County, AL,Apr-18(p),6441,6195,246,3.8
CN2010900000000,20,109,Logan County, KS,Mar-17,1683,1651,32,1.9
CN2010900000000,20,109,Logan County, KS,Apr-17,1633,1600,33,2.0
CN2010900000000,20,109,Logan County, KS,May-17,1624,1587,37,2.3
CN2010900000000,20,109,Logan County, KS,Jun-17,1779,1736,43,2.4
CN2010900000000,20,109,Logan County, KS,Jul-17,1595,1553,42,2.6
CN2010900000000,20,109,Logan County, KS,Aug-17,1570,1526,44,2.8
CN2010900000000,20,109,Logan County, KS,Sep-17,1771,1737,34,1.9
CN2010900000000,20,109,Logan County, KS,Oct-17,1777,1747,30,1.7
CN2010900000000,20,109,Logan County, KS,Nov-17,1746,1713,33,1.9
CN2010900000000,20,109,Logan County, KS,Dec-17,1761,1728,33,1.9
CN2010900000000,20,109,Logan County, KS,Jan-18,1709,1672,37,2.2
CN2010900000000,20,109,Logan County, KS,Feb-18,1714,1678,36,2.1
CN2010900000000,20,109,Logan County, KS,Mar-18,1711,1673,38,2.2
CN2010900000000,20,109,Logan County, KS,Apr-18(p),1616,1578,38,2.4
CN1323100000000,13,231,Pike County, GA,Mar-17,8622,8226,396,4.6
CN1323100000000,13,231,Pike County, GA,Apr-17,8617,8254,363,4.2
CN1323100000000,13,231,Pike County, GA,May-17,8641,8272,369,4.3
CN1323100000000,13,231,Pike County, GA,Jun-17,8698,8274,424,4.9
CN1323100000000,13,231,Pike County, GA,Jul-17,8732,8317,415,4.8
CN1323100000000,13,231,Pike County, GA,Aug-17,8660,8269,391,4.5
CN1323100000000,13,231,Pike County, GA,Sep-17,8773,8378,395,4.5
CN1323100000000,13,231,Pike County, GA,Oct-17,8711,8354,357,4.1
CN1323100000000,13,231,Pike County, GA,Nov-17,8724,8376,348,4.0
CN1323100000000,13,231,Pike County, GA,Dec-17,8710,8377,333,3.8
CN1323100000000,13,231,Pike County, GA,Jan-18,8734,8378,356,4.1
CN1323100000000,13,231,Pike County, GA,Feb-18,8844,8480,364,4.1
CN1323100000000,13,231,Pike County, GA,Mar-18,8852,8504,348,3.9
CN1323100000000,13,231,Pike County, GA,Apr-18(p),8792,8499,293,3.3
CN1301900000000,13,019,Berrien County, GA,Mar-17,7383,6991,392,5.3
CN1301900000000,13,019,Berrien County, GA,Apr-17,7382,7034,348,4.7
CN1301900000000,13,019,Berrien County, GA,May-17,7458,7098,360,4.8
CN1301900000000,13,019,Berrien County, GA,Jun-17,7494,7094,400,5.3
CN1301900000000,13,019,Berrien County, GA,Jul-17,7387,6980,407,5.5
CN1301900000000,13,019,Berrien County, GA,Aug-17,7349,6961,388,5.3
CN1301900000000,13,019,Berrien County, GA,Sep-17,7385,7034,351,4.8
CN1301900000000,13,019,Berrien County, GA,Oct-17,7478,7127,351,4.7
CN1301900000000,13,019,Berrien County, GA,Nov-17,7471,7132,339,4.5
CN1301900000000,13,019,Berrien County, GA,Dec-17,7474,7135,339,4.5
CN1301900000000,13,019,Berrien County, GA,Jan-18,7552,7180,372,4.9
CN1301900000000,13,019,Berrien County, GA,Feb-18,7391,7034,357,4.8
CN1301900000000,13,019,Berrien County, GA,Mar-18,7392,7070,322,4.4
CN1301900000000,13,019,Berrien County, GA,Apr-18(p),7362,7084,278,3.8
CN4601700000000,46,017,Buffalo County, SD,Mar-17,695,643,52,7.5
CN4601700000000,46,017,Buffalo County, SD,Apr-17,696,648,48,6.9
CN4601700000000,46,017,Buffalo County, SD,May-17,705,659,46,6.5
CN4601700000000,46,017,Buffalo County, SD,Jun-17,737,682,55,7.5
CN4601700000000,46,017,Buffalo County, SD,Jul-17,735,678,57,7.8
CN4601700000000,46,017,Buffalo County, SD,Aug-17,729,678,51,7.0
CN4601700000000,46,017,Buffalo County, SD,Sep-17,714,664,50,7.0
CN4601700000000,46,017,Buffalo County, SD,Oct-17,723,668,55,7.6
CN4601700000000,46,017,Buffalo County, SD,Nov-17,725,667,58,8.0
CN4601700000000,46,017,Buffalo County, SD,Dec-17,725,674,51,7.0
CN4601700000000,46,017,Buffalo County, SD,Jan-18,723,665,58,8.0
CN4601700000000,46,017,Buffalo County, SD,Feb-18,704,649,55,7.8
CN4601700000000,46,017,Buffalo County, SD,Mar-18,690,649,41,5.9
CN4601700000000,46,017,Buffalo County, SD,Apr-18(p),680,639,41,6.0
CN0500900000000,05,009,Boone County, AR,Mar-17,15846,15331,515,3.3
CN0500900000000,05,009,Boone County, AR,Apr-17,15855,15386,469,3.0
CN0500900000000,05,009,Boone County, AR,May-17,15956,15431,525,3.3
CN0500900000000,05,009,Boone County, AR,Jun-17,16306,15766,540,3.3
CN0500900000000,05,009,Boone County, AR,Jul-17,15628,15045,583,3.7
CN0500900000000,05,009,Boone County, AR,Aug-17,15573,15052,521,3.3
CN0500900000000,05,009,Boone County, AR,Sep-17,15928,15388,540,3.4
CN0500900000000,05,009,Boone County, AR,Oct-17,15816,15331,485,3.1
CN0500900000000,05,009,Boone County, AR,Nov-17,15819,15314,505,3.2
CN0500900000000,05,009,Boone County, AR,Dec-17,15722,15152,570,3.6
CN0500900000000,05,009,Boone County, AR,Jan-18,15603,14898,705,4.5
CN0500900000000,05,009,Boone County, AR,Feb-18,15721,15032,689,4.4
CN0500900000000,05,009,Boone County, AR,Mar-18,15841,15198,643,4.1
CN0500900000000,05,009,Boone County, AR,Apr-18(p),15830,15283,547,3.5
CN1320100000000,13,201,Miller County, GA,Mar-17,2807,2676,131,4.7
CN1320100000000,13,201,Miller County, GA,Apr-17,2784,2662,122,4.4
CN1320100000000,13,201,Miller County, GA,May-17,2842,2716,126,4.4
CN1320100000000,13,201,Miller County, GA,Jun-17,2876,2742,134,4.7
CN1320100000000,13,201,Miller County, GA,Jul-17,2828,2690,138,4.9
CN1320100000000,13,201,Miller County, GA,Aug-17,2825,2689,136,4.8
CN1320100000000,13,201,Miller County, GA,Sep-17,2846,2723,123,4.3
CN1320100000000,13,201,Miller County, GA,Oct-17,2902,2783,119,4.1
CN1320100000000,13,201,Miller County, GA,Nov-17,2870,2756,114,4.0
CN1320100000000,13,201,Miller County, GA,Dec-17,2878,2760,118,4.1
CN1320100000000,13,201,Miller County, GA,Jan-18,2937,2807,130,4.4
CN1320100000000,13,201,Miller County, GA,Feb-18,2823,2698,125,4.4
CN1320100000000,13,201,Miller County, GA,Mar-18,2820,2707,113,4.0
CN1320100000000,13,201,Miller County, GA,Apr-18(p),2801,2706,95,3.4
CN2210100000000,22,101,St. Mary Parish, LA,Mar-17,20517,18719,1798,8.8
CN2210100000000,22,101,St. Mary Parish, LA,Apr-17,20582,18896,1686,8.2
CN2210100000000,22,101,St. Mary Parish, LA,May-17,20506,18809,1697,8.3
CN2210100000000,22,101,St. Mary Parish, LA,Jun-17,20870,19043,1827,8.8
CN2210100000000,22,101,St. Mary Parish, LA,Jul-17,20651,18960,1691,8.2
CN2210100000000,22,101,St. Mary Parish, LA,Aug-17,20399,18724,1675,8.2
CN2210100000000,22,101,St. Mary Parish, LA,Sep-17,20308,18814,1494,7.4
CN2210100000000,22,101,St. Mary Parish, LA,Oct-17,20147,18807,1340,6.7
CN2210100000000,22,101,St. Mary Parish, LA,Nov-17,19962,18732,1230,6.2
CN2210100000000,22,101,St. Mary Parish, LA,Dec-17,19824,18642,1182,6.0
CN2210100000000,22,101,St. Mary Parish, LA,Jan-18,19776,18500,1276,6.5
CN2210100000000,22,101,St. Mary Parish, LA,Feb-18,19704,18469,1235,6.3
CN2210100000000,22,101,St. Mary Parish, LA,Mar-18,19748,18442,1306,6.6
CN2210100000000,22,101,St. Mary Parish, LA,Apr-18(p),19646,18366,1280,6.5
CN0224000000000,02,240,Southeast Fairbanks Census Area, AK,Mar-17,2951,2606,345,11.7
CN0224000000000,02,240,Southeast Fairbanks Census Area, AK,Apr-17,2913,2601,312,10.7
CN0224000000000,02,240,Southeast Fairbanks Census Area, AK,May-17,3013,2728,285,9.5
CN0224000000000,02,240,Southeast Fairbanks Census Area, AK,Jun-17,2969,2679,290,9.8
CN0224000000000,02,240,Southeast Fairbanks Census Area, AK,Jul-17,2929,2659,270,9.2
CN0224000000000,02,240,Southeast Fairbanks Census Area, AK,Aug-17,2947,2687,260,8.8
CN0224000000000,02,240,Southeast Fairbanks Census Area, AK,Sep-17,2896,2649,247,8.5
CN0224000000000,02,240,Southeast Fairbanks Census Area, AK,Oct-17,2965,2683,282,9.5
CN0224000000000,02,240,Southeast Fairbanks Census Area, AK,Nov-17,3047,2711,336,11.0
CN0224000000000,02,240,Southeast Fairbanks Census Area, AK,Dec-17,2993,2667,326,10.9
CN0224000000000,02,240,Southeast Fairbanks Census Area, AK,Jan-18,2985,2618,367,12.3
CN0224000000000,02,240,Southeast Fairbanks Census Area, AK,Feb-18,2967,2585,382,12.9
CN0224000000000,02,240,Southeast Fairbanks Census Area, AK,Mar-18,2980,2612,368,12.3
CN0224000000000,02,240,Southeast Fairbanks Census Area, AK,Apr-18(p),2900,2583,317,10.9
CN2715700000000,27,157,Wabasha County, MN,Mar-17,12029,11515,514,4.3
CN2715700000000,27,157,Wabasha County, MN,Apr-17,12030,11637,393,3.3
CN2715700000000,27,157,Wabasha County, MN,May-17,12029,11677,352,2.9
CN2715700000000,27,157,Wabasha County, MN,Jun-17,12170,11780,390,3.2
CN2715700000000,27,157,Wabasha County, MN,Jul-17,12263,11890,373,3.0
CN2715700000000,27,157,Wabasha County, MN,Aug-17,12103,11729,374,3.1
CN2715700000000,27,157,Wabasha County, MN,Sep-17,11851,11541,310,2.6
CN2715700000000,27,157,Wabasha County, MN,Oct-17,12136,11876,260,2.1
CN2715700000000,27,157,Wabasha County, MN,Nov-17,12069,11747,322,2.7
CN2715700000000,27,157,Wabasha County, MN,Dec-17,12105,11678,427,3.5
CN2715700000000,27,157,Wabasha County, MN,Jan-18,12118,11571,547,4.5
CN2715700000000,27,157,Wabasha County, MN,Feb-18,12148,11615,533,4.4
CN2715700000000,27,157,Wabasha County, MN,Mar-18,12142,11631,511,4.2
CN2715700000000,27,157,Wabasha County, MN,Apr-18(p),12074,11672,402,3.3
CN1605500000000,16,055,Kootenai County, ID,Mar-17,73788,70166,3622,4.9
CN1605500000000,16,055,Kootenai County, ID,Apr-17,74381,71493,2888,3.9
CN1605500000000,16,055,Kootenai County, ID,May-17,75309,72939,2370,3.1
CN1605500000000,16,055,Kootenai County, ID,Jun-17,77160,74687,2473,3.2
CN1605500000000,16,055,Kootenai County, ID,Jul-17,77480,74965,2515,3.2
CN1605500000000,16,055,Kootenai County, ID,Aug-17,77050,74511,2539,3.3
CN1605500000000,16,055,Kootenai County, ID,Sep-17,75666,73259,2407,3.2
CN1605500000000,16,055,Kootenai County, ID,Oct-17,75301,72924,2377,3.2
CN1605500000000,16,055,Kootenai County, ID,Nov-17,75957,73145,2812,3.7
CN1605500000000,16,055,Kootenai County, ID,Dec-17,75749,72806,2943,3.9
CN1605500000000,16,055,Kootenai County, ID,Jan-18,76125,72274,3851,5.1
CN1605500000000,16,055,Kootenai County, ID,Feb-18,76051,72625,3426,4.5
CN1605500000000,16,055,Kootenai County, ID,Mar-18,75716,72527,3189,4.2
CN1605500000000,16,055,Kootenai County, ID,Apr-18(p),76185,73552,2633,3.5
CN4849100000000,48,491,Williamson County, TX,Mar-17,285626,275796,9830,3.4
CN4849100000000,48,491,Williamson County, TX,Apr-17,286599,277833,8766,3.1
CN4849100000000,48,491,Williamson County, TX,May-17,286512,277562,8950,3.1
CN4849100000000,48,491,Williamson County, TX,Jun-17,287243,277524,9719,3.4
CN4849100000000,48,491,Williamson County, TX,Jul-17,288827,279040,9787,3.4
CN4849100000000,48,491,Williamson County, TX,Aug-17,287077,277329,9748,3.4
CN4849100000000,48,491,Williamson County, TX,Sep-17,289638,280892,8746,3.0
CN4849100000000,48,491,Williamson County, TX,Oct-17,288039,279822,8217,2.9
CN4849100000000,48,491,Williamson County, TX,Nov-17,290680,282255,8425,2.9
CN4849100000000,48,491,Williamson County, TX,Dec-17,289913,281851,8062,2.8
CN4849100000000,48,491,Williamson County, TX,Jan-18,291411,282345,9066,3.1
CN4849100000000,48,491,Williamson County, TX,Feb-18,296364,286972,9392,3.2
CN4849100000000,48,491,Williamson County, TX,Mar-18,296304,286825,9479,3.2
CN4849100000000,48,491,Williamson County, TX,Apr-18(p),296667,288093,8574,2.9
CN1207300000000,12,073,Leon County, FL,Mar-17,152430,146526,5904,3.9
CN1207300000000,12,073,Leon County, FL,Apr-17,153364,147781,5583,3.6
CN1207300000000,12,073,Leon County, FL,May-17,152140,146535,5605,3.7
CN1207300000000,12,073,Leon County, FL,Jun-17,151305,144867,6438,4.3
CN1207300000000,12,073,Leon County, FL,Jul-17,152051,145690,6361,4.2
CN1207300000000,12,073,Leon County, FL,Aug-17,150027,143970,6057,4.0
CN1207300000000,12,073,Leon County, FL,Sep-17,156687,151058,5629,3.6
CN1207300000000,12,073,Leon County, FL,Oct-17,154355,149011,5344,3.5
CN1207300000000,12,073,Leon County, FL,Nov-17,153271,147785,5486,3.6
CN1207300000000,12,073,Leon County, FL,Dec-17,152175,147176,4999,3.3
CN1207300000000,12,073,Leon County, FL,Jan-18,153735,147771,5964,3.9
CN1207300000000,12,073,Leon County, FL,Feb-18,155062,149708,5354,3.5
CN1207300000000,12,073,Leon County, FL,Mar-18,154869,149541,5328,3.4
CN1207300000000,12,073,Leon County, FL,Apr-18(p),154742,149865,4877,3.2
CN2804700000000,28,047,Harrison County, MS,Mar-17,86642,82454,4188,4.8
CN2804700000000,28,047,Harrison County, MS,Apr-17,86628,82842,3786,4.4
CN2804700000000,28,047,Harrison County, MS,May-17,87055,82614,4441,5.1
CN2804700000000,28,047,Harrison County, MS,Jun-17,88349,83476,4873,5.5
CN2804700000000,28,047,Harrison County, MS,Jul-17,88761,84085,4676,5.3
CN2804700000000,28,047,Harrison County, MS,Aug-17,86403,82450,3953,4.6
CN2804700000000,28,047,Harrison County, MS,Sep-17,85922,82092,3830,4.5
CN2804700000000,28,047,Harrison County, MS,Oct-17,85938,82261,3677,4.3
CN2804700000000,28,047,Harrison County, MS,Nov-17,86336,82765,3571,4.1
CN2804700000000,28,047,Harrison County, MS,Dec-17,86277,82642,3635,4.2
CN2804700000000,28,047,Harrison County, MS,Jan-18,85384,81797,3587,4.2
CN2804700000000,28,047,Harrison County, MS,Feb-18,85814,82132,3682,4.3
CN2804700000000,28,047,Harrison County, MS,Mar-18,85665,82159,3506,4.1
CN2804700000000,28,047,Harrison County, MS,Apr-18(p),86238,82742,3496,4.1
CN2121100000000,21,211,Shelby County, KY,Mar-17,24057,23136,921,3.8
CN2121100000000,21,211,Shelby County, KY,Apr-17,24211,23377,834,3.4
CN2121100000000,21,211,Shelby County, KY,May-17,24282,23396,886,3.6
CN2121100000000,21,211,Shelby County, KY,Jun-17,24645,23644,1001,4.1
CN2121100000000,21,211,Shelby County, KY,Jul-17,24629,23583,1046,4.2
CN2121100000000,21,211,Shelby County, KY,Aug-17,24197,23330,867,3.6
CN2121100000000,21,211,Shelby County, KY,Sep-17,24209,23440,769,3.2
CN2121100000000,21,211,Shelby County, KY,Oct-17,24137,23373,764,3.2
CN2121100000000,21,211,Shelby County, KY,Nov-17,24324,23586,738,3.0
CN2121100000000,21,211,Shelby County, KY,Dec-17,24239,23528,711,2.9
CN2121100000000,21,211,Shelby County, KY,Jan-18,23949,23166,783,3.3
CN2121100000000,21,211,Shelby County, KY,Feb-18,24154,23243,911,3.8
CN2121100000000,21,211,Shelby County, KY,Mar-18,24366,23518,848,3.5
CN2121100000000,21,211,Shelby County, KY,Apr-18(p),24417,23702,715,2.9
CN5108900000000,51,089,Henry County, VA,Mar-17,22564,21351,1213,5.4
CN5108900000000,51,089,Henry County, VA,Apr-17,22540,21430,1110,4.9
CN5108900000000,51,089,Henry County, VA,May-17,22449,21357,1092,4.9
CN5108900000000,51,089,Henry County, VA,Jun-17,22536,21387,1149,5.1
CN5108900000000,51,089,Henry County, VA,Jul-17,22656,21512,1144,5.0
CN5108900000000,51,089,Henry County, VA,Aug-17,22598,21469,1129,5.0
CN5108900000000,51,089,Henry County, VA,Sep-17,22443,21404,1039,4.6
CN5108900000000,51,089,Henry County, VA,Oct-17,22528,21537,991,4.4
CN5108900000000,51,089,Henry County, VA,Nov-17,22409,21425,984,4.4
CN5108900000000,51,089,Henry County, VA,Dec-17,22376,21394,982,4.4
CN5108900000000,51,089,Henry County, VA,Jan-18,22890,21734,1156,5.1
CN5108900000000,51,089,Henry County, VA,Feb-18,22904,21881,1023,4.5
CN5108900000000,51,089,Henry County, VA,Mar-18,22807,21815,992,4.3
CN5108900000000,51,089,Henry County, VA,Apr-18(p),22727,21873,854,3.8
CN5162000000000,51,620,Franklin city, VA,Mar-17,3505,3291,214,6.1
CN5162000000000,51,620,Franklin city, VA,Apr-17,3494,3295,199,5.7
CN5162000000000,51,620,Franklin city, VA,May-17,3492,3293,199,5.7
CN5162000000000,51,620,Franklin city, VA,Jun-17,3548,3351,197,5.6
CN5162000000000,51,620,Franklin city, VA,Jul-17,3552,3354,198,5.6
CN5162000000000,51,620,Franklin city, VA,Aug-17,3522,3321,201,5.7
CN5162000000000,51,620,Franklin city, VA,Sep-17,3478,3299,179,5.1
CN5162000000000,51,620,Franklin city, VA,Oct-17,3439,3268,171,5.0
CN5162000000000,51,620,Franklin city, VA,Nov-17,3433,3270,163,4.7
CN5162000000000,51,620,Franklin city, VA,Dec-17,3428,3260,168,4.9
CN5162000000000,51,620,Franklin city, VA,Jan-18,3413,3232,181,5.3
CN5162000000000,51,620,Franklin city, VA,Feb-18,3462,3290,172,5.0
CN5162000000000,51,620,Franklin city, VA,Mar-18,3492,3321,171,4.9
CN5162000000000,51,620,Franklin city, VA,Apr-18(p),3493,3339,154,4.4
CN3112500000000,31,125,Nance County, NE,Mar-17,1992,1936,56,2.8
CN3112500000000,31,125,Nance County, NE,Apr-17,2033,1985,48,2.4
CN3112500000000,31,125,Nance County, NE,May-17,2083,2035,48,2.3
CN3112500000000,31,125,Nance County, NE,Jun-17,2122,2070,52,2.5
CN3112500000000,31,125,Nance County, NE,Jul-17,2073,2026,47,2.3
CN3112500000000,31,125,Nance County, NE,Aug-17,2035,1990,45,2.2
CN3112500000000,31,125,Nance County, NE,Sep-17,1974,1928,46,2.3
CN3112500000000,31,125,Nance County, NE,Oct-17,1976,1930,46,2.3
CN3112500000000,31,125,Nance County, NE,Nov-17,1983,1937,46,2.3
CN3112500000000,31,125,Nance County, NE,Dec-17,1974,1930,44,2.2
CN3112500000000,31,125,Nance County, NE,Jan-18,2015,1959,56,2.8
CN3112500000000,31,125,Nance County, NE,Feb-18,1975,1927,48,2.4
CN3112500000000,31,125,Nance County, NE,Mar-18,2002,1954,48,2.4
CN3112500000000,31,125,Nance County, NE,Apr-18(p),2001,1959,42,2.1
CN7213300000000,72,133,Santa Isabel Municipio, PR,Mar-17,10640,9467,1173,11.0
CN7213300000000,72,133,Santa Isabel Municipio, PR,Apr-17,9186,7902,1284,14.0
CN7213300000000,72,133,Santa Isabel Municipio, PR,May-17,10601,9231,1370,12.9
CN7213300000000,72,133,Santa Isabel Municipio, PR,Jun-17,11018,9850,1168,10.6
CN7213300000000,72,133,Santa Isabel Municipio, PR,Jul-17,8849,7571,1278,14.4
CN7213300000000,72,133,Santa Isabel Municipio, PR,Aug-17,9014,7428,1586,17.6
CN7213300000000,72,133,Santa Isabel Municipio, PR,Sep-17(y),8392,6766,1626,19.4
CN7213300000000,72,133,Santa Isabel Municipio, PR,Oct-17,8977,7593,1384,15.4
CN7213300000000,72,133,Santa Isabel Municipio, PR,Nov-17,10003,8723,1280,12.8
CN7213300000000,72,133,Santa Isabel Municipio, PR,Dec-17,10205,8886,1319,12.9
CN7213300000000,72,133,Santa Isabel Municipio, PR,Jan-18,10466,9163,1303,12.4
CN7213300000000,72,133,Santa Isabel Municipio, PR,Feb-18,9287,8178,1109,11.9
CN7213300000000,72,133,Santa Isabel Municipio, PR,Mar-18,9470,8343,1127,11.9
CN7213300000000,72,133,Santa Isabel Municipio, PR,Apr-18(p),9053,7977,1076,11.9
CN3201500000000,32,015,Lander County, NV,Mar-17,3331,3162,169,5.1
CN3201500000000,32,015,Lander County, NV,Apr-17,3183,3035,148,4.6
CN3201500000000,32,015,Lander County, NV,May-17,3190,3051,139,4.4
CN3201500000000,32,015,Lander County, NV,Jun-17,3291,3149,142,4.3
CN3201500000000,32,015,Lander County, NV,Jul-17,3214,3076,138,4.3
CN3201500000000,32,015,Lander County, NV,Aug-17,3196,3066,130,4.1
CN3201500000000,32,015,Lander County, NV,Sep-17,3143,3023,120,3.8
CN3201500000000,32,015,Lander County, NV,Oct-17,3067,2951,116,3.8
CN3201500000000,32,015,Lander County, NV,Nov-17,3084,2966,118,3.8
CN3201500000000,32,015,Lander County, NV,Dec-17,3134,3004,130,4.1
CN3201500000000,32,015,Lander County, NV,Jan-18,3131,2964,167,5.3
CN3201500000000,32,015,Lander County, NV,Feb-18,3203,3048,155,4.8
CN3201500000000,32,015,Lander County, NV,Mar-18,3288,3143,145,4.4
CN3201500000000,32,015,Lander County, NV,Apr-18(p),3129,2996,133,4.3
CN2904300000000,29,043,Christian County, MO,Mar-17,43103,41626,1477,3.4
CN2904300000000,29,043,Christian County, MO,Apr-17,43061,41818,1243,2.9
CN2904300000000,29,043,Christian County, MO,May-17,43018,41738,1280,3.0
CN2904300000000,29,043,Christian County, MO,Jun-17,43306,41928,1378,3.2
CN2904300000000,29,043,Christian County, MO,Jul-17,43706,42224,1482,3.4
CN2904300000000,29,043,Christian County, MO,Aug-17,42717,41299,1418,3.3
CN2904300000000,29,043,Christian County, MO,Sep-17,43463,42309,1154,2.7
CN2904300000000,29,043,Christian County, MO,Oct-17,42780,41960,820,1.9
CN2904300000000,29,043,Christian County, MO,Nov-17,42881,41789,1092,2.5
CN2904300000000,29,043,Christian County, MO,Dec-17,43175,42002,1173,2.7
CN2904300000000,29,043,Christian County, MO,Jan-18,42899,41442,1457,3.4
CN2904300000000,29,043,Christian County, MO,Feb-18,43293,41831,1462,3.4
CN2904300000000,29,043,Christian County, MO,Mar-18,43096,41722,1374,3.2
CN2904300000000,29,043,Christian County, MO,Apr-18(p),43056,41941,1115,2.6
CN2403500000000,24,035,Queen Anne's County, MD,Mar-17,27286,26274,1012,3.7
CN2403500000000,24,035,Queen Anne's County, MD,Apr-17,27323,26431,892,3.3
CN2403500000000,24,035,Queen Anne's County, MD,May-17,26942,26033,909,3.4
CN2403500000000,24,035,Queen Anne's County, MD,Jun-17,27315,26252,1063,3.9
CN2403500000000,24,035,Queen Anne's County, MD,Jul-17,27461,26417,1044,3.8
CN2403500000000,24,035,Queen Anne's County, MD,Aug-17,26753,25769,984,3.7
CN2403500000000,24,035,Queen Anne's County, MD,Sep-17,26944,26037,907,3.4
CN2403500000000,24,035,Queen Anne's County, MD,Oct-17,27315,26401,914,3.3
CN2403500000000,24,035,Queen Anne's County, MD,Nov-17,27057,26102,955,3.5
CN2403500000000,24,035,Queen Anne's County, MD,Dec-17,27134,26249,885,3.3
CN2403500000000,24,035,Queen Anne's County, MD,Jan-18,27508,26333,1175,4.3
CN2403500000000,24,035,Queen Anne's County, MD,Feb-18,27688,26512,1176,4.2
CN2403500000000,24,035,Queen Anne's County, MD,Mar-18,27753,26645,1108,4.0
CN2403500000000,24,035,Queen Anne's County, MD,Apr-18(p),27514,26610,904,3.3
CN1708100000000,17,081,Jefferson County, IL,Mar-17,17292,16370,922,5.3
CN1708100000000,17,081,Jefferson County, IL,Apr-17,17259,16441,818,4.7
CN1708100000000,17,081,Jefferson County, IL,May-17,17174,16353,821,4.8
CN1708100000000,17,081,Jefferson County, IL,Jun-17,17530,16577,953,5.4
CN1708100000000,17,081,Jefferson County, IL,Jul-17,17631,16628,1003,5.7
CN1708100000000,17,081,Jefferson County, IL,Aug-17,17416,16420,996,5.7
CN1708100000000,17,081,Jefferson County, IL,Sep-17,17355,16480,875,5.0
CN1708100000000,17,081,Jefferson County, IL,Oct-17,17193,16381,812,4.7
CN1708100000000,17,081,Jefferson County, IL,Nov-17,17279,16416,863,5.0
CN1708100000000,17,081,Jefferson County, IL,Dec-17,17183,16330,853,5.0
CN1708100000000,17,081,Jefferson County, IL,Jan-18,17238,16352,886,5.1
CN1708100000000,17,081,Jefferson County, IL,Feb-18,17338,16519,819,4.7
CN1708100000000,17,081,Jefferson County, IL,Mar-18,17598,16747,851,4.8
CN1708100000000,17,081,Jefferson County, IL,Apr-18(p),17719,16998,721,4.1
CN4846100000000,48,461,Upton County, TX,Mar-17,1576,1510,66,4.2
CN4846100000000,48,461,Upton County, TX,Apr-17,1545,1491,54,3.5
CN4846100000000,48,461,Upton County, TX,May-17,1528,1468,60,3.9
CN4846100000000,48,461,Upton County, TX,Jun-17,1579,1520,59,3.7
CN4846100000000,48,461,Upton County, TX,Jul-17,1584,1522,62,3.9
CN4846100000000,48,461,Upton County, TX,Aug-17,1549,1495,54,3.5
CN4846100000000,48,461,Upton County, TX,Sep-17,1530,1478,52,3.4
CN4846100000000,48,461,Upton County, TX,Oct-17,1513,1465,48,3.2
CN4846100000000,48,461,Upton County, TX,Nov-17,1519,1465,54,3.6
CN4846100000000,48,461,Upton County, TX,Dec-17,1518,1469,49,3.2
CN4846100000000,48,461,Upton County, TX,Jan-18,1516,1458,58,3.8
CN4846100000000,48,461,Upton County, TX,Feb-18,1529,1470,59,3.9
CN4846100000000,48,461,Upton County, TX,Mar-18,1540,1486,54,3.5
CN4846100000000,48,461,Upton County, TX,Apr-18(p),1589,1532,57,3.6
CN3610300000000,36,103,Suffolk County, NY,Mar-17,778950,743708,35242,4.5
CN3610300000000,36,103,Suffolk County, NY,Apr-17,779060,746962,32098,4.1
CN3610300000000,36,103,Suffolk County, NY,May-17,783916,751218,32698,4.2
CN3610300000000,36,103,Suffolk County, NY,Jun-17,799422,764794,34628,4.3
CN3610300000000,36,103,Suffolk County, NY,Jul-17,805029,766931,38098,4.7
CN3610300000000,36,103,Suffolk County, NY,Aug-17,794212,756408,37804,4.8
CN3610300000000,36,103,Suffolk County, NY,Sep-17,786123,751537,34586,4.4
CN3610300000000,36,103,Suffolk County, NY,Oct-17,778613,745250,33363,4.3
CN3610300000000,36,103,Suffolk County, NY,Nov-17,773725,738976,34749,4.5
CN3610300000000,36,103,Suffolk County, NY,Dec-17,770631,736056,34575,4.5
CN3610300000000,36,103,Suffolk County, NY,Jan-18,772976,732307,40669,5.3
CN3610300000000,36,103,Suffolk County, NY,Feb-18,767850,726280,41570,5.4
CN3610300000000,36,103,Suffolk County, NY,Mar-18,769693,732368,37325,4.8
CN3610300000000,36,103,Suffolk County, NY,Apr-18(p),773847,741754,32093,4.1
CN1917700000000,19,177,Van Buren County, IA,Mar-17,3707,3592,115,3.1
CN1917700000000,19,177,Van Buren County, IA,Apr-17,3703,3596,107,2.9
CN1917700000000,19,177,Van Buren County, IA,May-17,3750,3654,96,2.6
CN1917700000000,19,177,Van Buren County, IA,Jun-17,3836,3725,111,2.9
CN1917700000000,19,177,Van Buren County, IA,Jul-17,3787,3663,124,3.3
CN1917700000000,19,177,Van Buren County, IA,Aug-17,3752,3626,126,3.4
CN1917700000000,19,177,Van Buren County, IA,Sep-17,3689,3571,118,3.2
CN1917700000000,19,177,Van Buren County, IA,Oct-17,3676,3579,97,2.6
CN1917700000000,19,177,Van Buren County, IA,Nov-17,3642,3552,90,2.5
CN1917700000000,19,177,Van Buren County, IA,Dec-17,3646,3557,89,2.4
CN1917700000000,19,177,Van Buren County, IA,Jan-18,3606,3476,130,3.6
CN1917700000000,19,177,Van Buren County, IA,Feb-18,3622,3499,123,3.4
CN1917700000000,19,177,Van Buren County, IA,Mar-18,3549,3442,107,3.0
CN1917700000000,19,177,Van Buren County, IA,Apr-18(p),3536,3442,94,2.7
CN0514500000000,05,145,White County, AR,Mar-17,33841,32285,1556,4.6
CN0514500000000,05,145,White County, AR,Apr-17,33855,32413,1442,4.3
CN0514500000000,05,145,White County, AR,May-17,33845,32219,1626,4.8
CN0514500000000,05,145,White County, AR,Jun-17,34172,32555,1617,4.7
CN0514500000000,05,145,White County, AR,Jul-17,33405,31789,1616,4.8
CN0514500000000,05,145,White County, AR,Aug-17,33928,32453,1475,4.3
CN0514500000000,05,145,White County, AR,Sep-17,34177,32793,1384,4.0
CN0514500000000,05,145,White County, AR,Oct-17,33845,32586,1259,3.7
CN0514500000000,05,145,White County, AR,Nov-17,33778,32470,1308,3.9
CN0514500000000,05,145,White County, AR,Dec-17,33693,32204,1489,4.4
CN0514500000000,05,145,White County, AR,Jan-18,33230,31417,1813,5.5
CN0514500000000,05,145,White County, AR,Feb-18,33699,31938,1761,5.2
CN0514500000000,05,145,White County, AR,Mar-18,33885,32198,1687,5.0
CN0514500000000,05,145,White County, AR,Apr-18(p),33669,32255,1414,4.2
CN4604700000000,46,047,Fall River County, SD,Mar-17,2893,2754,139,4.8
CN4604700000000,46,047,Fall River County, SD,Apr-17,2976,2852,124,4.2
CN4604700000000,46,047,Fall River County, SD,May-17,3064,2938,126,4.1
CN4604700000000,46,047,Fall River County, SD,Jun-17,3167,3053,114,3.6
CN4604700000000,46,047,Fall River County, SD,Jul-17,3136,3028,108,3.4
CN4604700000000,46,047,Fall River County, SD,Aug-17,3063,2943,120,3.9
CN4604700000000,46,047,Fall River County, SD,Sep-17,2985,2872,113,3.8
CN4604700000000,46,047,Fall River County, SD,Oct-17,2939,2832,107,3.6
CN4604700000000,46,047,Fall River County, SD,Nov-17,2918,2788,130,4.5
CN4604700000000,46,047,Fall River County, SD,Dec-17,2898,2764,134,4.6
CN4604700000000,46,047,Fall River County, SD,Jan-18,2905,2746,159,5.5
CN4604700000000,46,047,Fall River County, SD,Feb-18,2954,2799,155,5.2
CN4604700000000,46,047,Fall River County, SD,Mar-18,2974,2832,142,4.8
CN4604700000000,46,047,Fall River County, SD,Apr-18(p),3013,2876,137,4.5
CN4824900000000,48,249,Jim Wells County, TX,Mar-17,16981,15544,1437,8.5
CN4824900000000,48,249,Jim Wells County, TX,Apr-17,16860,15533,1327,7.9
CN4824900000000,48,249,Jim Wells County, TX,May-17,16820,15597,1223,7.3
CN4824900000000,48,249,Jim Wells County, TX,Jun-17,17003,15714,1289,7.6
CN4824900000000,48,249,Jim Wells County, TX,Jul-17,16578,15333,1245,7.5
CN4824900000000,48,249,Jim Wells County, TX,Aug-17,16411,15174,1237,7.5
CN4824900000000,48,249,Jim Wells County, TX,Sep-17,16499,15428,1071,6.5
CN4824900000000,48,249,Jim Wells County, TX,Oct-17,16552,15561,991,6.0
CN4824900000000,48,249,Jim Wells County, TX,Nov-17,16577,15575,1002,6.0
CN4824900000000,48,249,Jim Wells County, TX,Dec-17,16427,15449,978,6.0
CN4824900000000,48,249,Jim Wells County, TX,Jan-18,16343,15266,1077,6.6
CN4824900000000,48,249,Jim Wells County, TX,Feb-18,16614,15549,1065,6.4
CN4824900000000,48,249,Jim Wells County, TX,Mar-18,16746,15704,1042,6.2
CN4824900000000,48,249,Jim Wells County, TX,Apr-18(p),16599,15648,951,5.7
CN5508100000000,55,081,Monroe County, WI,Mar-17,23331,22537,794,3.4
CN5508100000000,55,081,Monroe County, WI,Apr-17,23562,22948,614,2.6
CN5508100000000,55,081,Monroe County, WI,May-17,23668,23040,628,2.7
CN5508100000000,55,081,Monroe County, WI,Jun-17,24348,23592,756,3.1
CN5508100000000,55,081,Monroe County, WI,Jul-17,24077,23338,739,3.1
CN5508100000000,55,081,Monroe County, WI,Aug-17,23739,23079,660,2.8
CN5508100000000,55,081,Monroe County, WI,Sep-17,23622,23000,622,2.6
CN5508100000000,55,081,Monroe County, WI,Oct-17,23722,23166,556,2.3
CN5508100000000,55,081,Monroe County, WI,Nov-17,23659,23082,577,2.4
CN5508100000000,55,081,Monroe County, WI,Dec-17,23582,23001,581,2.5
CN5508100000000,55,081,Monroe County, WI,Jan-18,23713,22997,716,3.0
CN5508100000000,55,081,Monroe County, WI,Feb-18,23720,22962,758,3.2
CN5508100000000,55,081,Monroe County, WI,Mar-18,23885,23201,684,2.9
CN5508100000000,55,081,Monroe County, WI,Apr-18(p),23942,23394,548,2.3
CN4811500000000,48,115,Dawson County, TX,Mar-17,4785,4542,243,5.1
CN4811500000000,48,115,Dawson County, TX,Apr-17,4784,4529,255,5.3
CN4811500000000,48,115,Dawson County, TX,May-17,4767,4530,237,5.0
CN4811500000000,48,115,Dawson County, TX,Jun-17,4749,4494,255,5.4
CN4811500000000,48,115,Dawson County, TX,Jul-17,4622,4376,246,5.3
CN4811500000000,48,115,Dawson County, TX,Aug-17,4578,4344,234,5.1
CN4811500000000,48,115,Dawson County, TX,Sep-17,4501,4300,201,4.5
CN4811500000000,48,115,Dawson County, TX,Oct-17,4565,4383,182,4.0
CN4811500000000,48,115,Dawson County, TX,Nov-17,4573,4382,191,4.2
CN4811500000000,48,115,Dawson County, TX,Dec-17,4595,4410,185,4.0
CN4811500000000,48,115,Dawson County, TX,Jan-18,4529,4329,200,4.4
CN4811500000000,48,115,Dawson County, TX,Feb-18,4565,4353,212,4.6
CN4811500000000,48,115,Dawson County, TX,Mar-18,4645,4437,208,4.5
CN4811500000000,48,115,Dawson County, TX,Apr-18(p),4637,4435,202,4.4
CN3716700000000,37,167,Stanly County, NC,Mar-17,29811,28590,1221,4.1
CN3716700000000,37,167,Stanly County, NC,Apr-17,29670,28570,1100,3.7
CN3716700000000,37,167,Stanly County, NC,May-17,29752,28606,1146,3.9
CN3716700000000,37,167,Stanly County, NC,Jun-17,29896,28675,1221,4.1
CN3716700000000,37,167,Stanly County, NC,Jul-17,29921,28602,1319,4.4
CN3716700000000,37,167,Stanly County, NC,Aug-17,29738,28444,1294,4.4
CN3716700000000,37,167,Stanly County, NC,Sep-17,30096,28929,1167,3.9
CN3716700000000,37,167,Stanly County, NC,Oct-17,30143,28957,1186,3.9
CN3716700000000,37,167,Stanly County, NC,Nov-17,30128,28863,1265,4.2
CN3716700000000,37,167,Stanly County, NC,Dec-17,29903,28682,1221,4.1
CN3716700000000,37,167,Stanly County, NC,Jan-18,29908,28645,1263,4.2
CN3716700000000,37,167,Stanly County, NC,Feb-18,29949,28717,1232,4.1
CN3716700000000,37,167,Stanly County, NC,Mar-18,30142,28944,1198,4.0
CN3716700000000,37,167,Stanly County, NC,Apr-18(p),30010,28999,1011,3.4
CN7207900000000,72,079,Lajas Municipio, PR,Mar-17,5576,4566,1010,18.1
CN7207900000000,72,079,Lajas Municipio, PR,Apr-17,5542,4423,1119,20.2
CN7207900000000,72,079,Lajas Municipio, PR,May-17,5532,4501,1031,18.6
CN7207900000000,72,079,Lajas Municipio, PR,Jun-17,5488,4491,997,18.2
CN7207900000000,72,079,Lajas Municipio, PR,Jul-17,5503,4460,1043,19.0
CN7207900000000,72,079,Lajas Municipio, PR,Aug-17,5575,4390,1185,21.3
CN7207900000000,72,079,Lajas Municipio, PR,Sep-17(y),5536,4369,1167,21.1
CN7207900000000,72,079,Lajas Municipio, PR,Oct-17,5465,4211,1254,22.9
CN7207900000000,72,079,Lajas Municipio, PR,Nov-17,5492,4482,1010,18.4
CN7207900000000,72,079,Lajas Municipio, PR,Dec-17,5456,4533,923,16.9
CN7207900000000,72,079,Lajas Municipio, PR,Jan-18,5319,4344,975,18.3
CN7207900000000,72,079,Lajas Municipio, PR,Feb-18,5159,4280,879,17.0
CN7207900000000,72,079,Lajas Municipio, PR,Mar-18,5214,4312,902,17.3
CN7207900000000,72,079,Lajas Municipio, PR,Apr-18(p),5197,4363,834,16.0
CN2906500000000,29,065,Dent County, MO,Mar-17,6095,5819,276,4.5
CN2906500000000,29,065,Dent County, MO,Apr-17,6132,5882,250,4.1
CN2906500000000,29,065,Dent County, MO,May-17,6077,5833,244,4.0
CN2906500000000,29,065,Dent County, MO,Jun-17,6184,5910,274,4.4
CN2906500000000,29,065,Dent County, MO,Jul-17,5948,5672,276,4.6
CN2906500000000,29,065,Dent County, MO,Aug-17,5913,5623,290,4.9
CN2906500000000,29,065,Dent County, MO,Sep-17,6115,5886,229,3.7
CN2906500000000,29,065,Dent County, MO,Oct-17,5999,5835,164,2.7
CN2906500000000,29,065,Dent County, MO,Nov-17,5971,5757,214,3.6
CN2906500000000,29,065,Dent County, MO,Dec-17,5923,5699,224,3.8
CN2906500000000,29,065,Dent County, MO,Jan-18,5836,5581,255,4.4
CN2906500000000,29,065,Dent County, MO,Feb-18,5921,5684,237,4.0
CN2906500000000,29,065,Dent County, MO,Mar-18,5973,5746,227,3.8
CN2906500000000,29,065,Dent County, MO,Apr-18(p),6055,5832,223,3.7
CN2805300000000,28,053,Humphreys County, MS,Mar-17,2374,2148,226,9.5
CN2805300000000,28,053,Humphreys County, MS,Apr-17,2348,2166,182,7.8
CN2805300000000,28,053,Humphreys County, MS,May-17,2338,2136,202,8.6
CN2805300000000,28,053,Humphreys County, MS,Jun-17,2389,2138,251,10.5
CN2805300000000,28,053,Humphreys County, MS,Jul-17,2346,2098,248,10.6
CN2805300000000,28,053,Humphreys County, MS,Aug-17,2311,2117,194,8.4
CN2805300000000,28,053,Humphreys County, MS,Sep-17,2328,2156,172,7.4
CN2805300000000,28,053,Humphreys County, MS,Oct-17,2280,2108,172,7.5
CN2805300000000,28,053,Humphreys County, MS,Nov-17,2202,2042,160,7.3
CN2805300000000,28,053,Humphreys County, MS,Dec-17,2201,2028,173,7.9
CN2805300000000,28,053,Humphreys County, MS,Jan-18,2181,1970,211,9.7
CN2805300000000,28,053,Humphreys County, MS,Feb-18,2234,2024,210,9.4
CN2805300000000,28,053,Humphreys County, MS,Mar-18,2299,2108,191,8.3
CN2805300000000,28,053,Humphreys County, MS,Apr-18(p),2275,2106,169,7.4
CN2704100000000,27,041,Douglas County, MN,Mar-17,20236,19367,869,4.3
CN2704100000000,27,041,Douglas County, MN,Apr-17,20399,19732,667,3.3
CN2704100000000,27,041,Douglas County, MN,May-17,20700,20161,539,2.6
CN2704100000000,27,041,Douglas County, MN,Jun-17,21180,20606,574,2.7
CN2704100000000,27,041,Douglas County, MN,Jul-17,21346,20807,539,2.5
CN2704100000000,27,041,Douglas County, MN,Aug-17,21138,20603,535,2.5
CN2704100000000,27,041,Douglas County, MN,Sep-17,20523,20054,469,2.3
CN2704100000000,27,041,Douglas County, MN,Oct-17,20472,20056,416,2.0
CN2704100000000,27,041,Douglas County, MN,Nov-17,20614,20024,590,2.9
CN2704100000000,27,041,Douglas County, MN,Dec-17,20739,19980,759,3.7
CN2704100000000,27,041,Douglas County, MN,Jan-18,20855,19996,859,4.1
CN2704100000000,27,041,Douglas County, MN,Feb-18,20849,20037,812,3.9
CN2704100000000,27,041,Douglas County, MN,Mar-18,20831,20026,805,3.9
CN2704100000000,27,041,Douglas County, MN,Apr-18(p),21060,20405,655,3.1
CN0800300000000,08,003,Alamosa County, CO,Mar-17,7947,7663,284,3.6
CN0800300000000,08,003,Alamosa County, CO,Apr-17,8150,7900,250,3.1
CN0800300000000,08,003,Alamosa County, CO,May-17,8281,8039,242,2.9
CN0800300000000,08,003,Alamosa County, CO,Jun-17,8191,7912,279,3.4
CN0800300000000,08,003,Alamosa County, CO,Jul-17,8230,7951,279,3.4
CN0800300000000,08,003,Alamosa County, CO,Aug-17,8123,7854,269,3.3
CN0800300000000,08,003,Alamosa County, CO,Sep-17,8195,7949,246,3.0
CN0800300000000,08,003,Alamosa County, CO,Oct-17,8687,8421,266,3.1
CN0800300000000,08,003,Alamosa County, CO,Nov-17,8574,8292,282,3.3
CN0800300000000,08,003,Alamosa County, CO,Dec-17,8384,8068,316,3.8
CN0800300000000,08,003,Alamosa County, CO,Jan-18,8219,7876,343,4.2
CN0800300000000,08,003,Alamosa County, CO,Feb-18,8250,7889,361,4.4
CN0800300000000,08,003,Alamosa County, CO,Mar-18,8212,7901,311,3.8
CN0800300000000,08,003,Alamosa County, CO,Apr-18(p),8380,8099,281,3.4
CN0223000000000,02,230,Skagway Municipality, AK,Mar-17,594,469,125,21.0
CN0223000000000,02,230,Skagway Municipality, AK,Apr-17,663,583,80,12.1
CN0223000000000,02,230,Skagway Municipality, AK,May-17,1003,962,41,4.1
CN0223000000000,02,230,Skagway Municipality, AK,Jun-17,1094,1056,38,3.5
CN0223000000000,02,230,Skagway Municipality, AK,Jul-17,1115,1081,34,3.0
CN0223000000000,02,230,Skagway Municipality, AK,Aug-17,1097,1067,30,2.7
CN0223000000000,02,230,Skagway Municipality, AK,Sep-17,1014,976,38,3.7
CN0223000000000,02,230,Skagway Municipality, AK,Oct-17,804,689,115,14.3
CN0223000000000,02,230,Skagway Municipality, AK,Nov-17,634,500,134,21.1
CN0223000000000,02,230,Skagway Municipality, AK,Dec-17,642,509,133,20.7
CN0223000000000,02,230,Skagway Municipality, AK,Jan-18,622,476,146,23.5
CN0223000000000,02,230,Skagway Municipality, AK,Feb-18,628,469,159,25.3
CN0223000000000,02,230,Skagway Municipality, AK,Mar-18,600,474,126,21.0
CN0223000000000,02,230,Skagway Municipality, AK,Apr-18(p),683,591,92,13.5
CN4850700000000,48,507,Zavala County, TX,Mar-17,3973,3538,435,10.9
CN4850700000000,48,507,Zavala County, TX,Apr-17,3865,3472,393,10.2
CN4850700000000,48,507,Zavala County, TX,May-17,3846,3472,374,9.7
CN4850700000000,48,507,Zavala County, TX,Jun-17,3747,3290,457,12.2
CN4850700000000,48,507,Zavala County, TX,Jul-17,3640,3184,456,12.5
CN4850700000000,48,507,Zavala County, TX,Aug-17,3631,3181,450,12.4
CN4850700000000,48,507,Zavala County, TX,Sep-17,3481,3102,379,10.9
CN4850700000000,48,507,Zavala County, TX,Oct-17,3506,3150,356,10.2
CN4850700000000,48,507,Zavala County, TX,Nov-17,3520,3175,345,9.8
CN4850700000000,48,507,Zavala County, TX,Dec-17,3563,3231,332,9.3
CN4850700000000,48,507,Zavala County, TX,Jan-18,3551,3185,366,10.3
CN4850700000000,48,507,Zavala County, TX,Feb-18,3667,3294,373,10.2
CN4850700000000,48,507,Zavala County, TX,Mar-18,3712,3346,366,9.9
CN4850700000000,48,507,Zavala County, TX,Apr-18(p),3673,3336,337,9.2
CN3810100000000,38,101,Ward County, ND,Mar-17,32967,31564,1403,4.3
CN3810100000000,38,101,Ward County, ND,Apr-17,32960,31804,1156,3.5
CN3810100000000,38,101,Ward County, ND,May-17,33183,32281,902,2.7
CN3810100000000,38,101,Ward County, ND,Jun-17,33546,32415,1131,3.4
CN3810100000000,38,101,Ward County, ND,Jul-17,33805,32895,910,2.7
CN3810100000000,38,101,Ward County, ND,Aug-17,33348,32442,906,2.7
CN3810100000000,38,101,Ward County, ND,Sep-17,32672,31878,794,2.4
CN3810100000000,38,101,Ward County, ND,Oct-17,32652,31904,748,2.3
CN3810100000000,38,101,Ward County, ND,Nov-17,32276,31368,908,2.8
CN3810100000000,38,101,Ward County, ND,Dec-17,32055,31110,945,2.9
CN3810100000000,38,101,Ward County, ND,Jan-18,32014,30754,1260,3.9
CN3810100000000,38,101,Ward County, ND,Feb-18,32110,30851,1259,3.9
CN3810100000000,38,101,Ward County, ND,Mar-18,32019,30834,1185,3.7
CN3810100000000,38,101,Ward County, ND,Apr-18(p),31841,30764,1077,3.4
CN4212700000000,42,127,Wayne County, PA,Mar-17,22197,20758,1439,6.5
CN4212700000000,42,127,Wayne County, PA,Apr-17,22143,21059,1084,4.9
CN4212700000000,42,127,Wayne County, PA,May-17,22334,21276,1058,4.7
CN4212700000000,42,127,Wayne County, PA,Jun-17,22854,21875,979,4.3
CN4212700000000,42,127,Wayne County, PA,Jul-17,23952,22863,1089,4.5
CN4212700000000,42,127,Wayne County, PA,Aug-17,23951,22878,1073,4.5
CN4212700000000,42,127,Wayne County, PA,Sep-17,22303,21380,923,4.1
CN4212700000000,42,127,Wayne County, PA,Oct-17,21988,21089,899,4.1
CN4212700000000,42,127,Wayne County, PA,Nov-17,21970,20982,988,4.5
CN4212700000000,42,127,Wayne County, PA,Dec-17,22062,20925,1137,5.2
CN4212700000000,42,127,Wayne County, PA,Jan-18,22309,20805,1504,6.7
CN4212700000000,42,127,Wayne County, PA,Feb-18,22191,20723,1468,6.6
CN4212700000000,42,127,Wayne County, PA,Mar-18,21897,20577,1320,6.0
CN4212700000000,42,127,Wayne County, PA,Apr-18(p),21971,20958,1013,4.6
CN2709100000000,27,091,Martin County, MN,Mar-17,10453,10028,425,4.1
CN2709100000000,27,091,Martin County, MN,Apr-17,10533,10189,344,3.3
CN2709100000000,27,091,Martin County, MN,May-17,10515,10195,320,3.0
CN2709100000000,27,091,Martin County, MN,Jun-17,10640,10271,369,3.5
CN2709100000000,27,091,Martin County, MN,Jul-17,10486,10127,359,3.4
CN2709100000000,27,091,Martin County, MN,Aug-17,10450,10064,386,3.7
CN2709100000000,27,091,Martin County, MN,Sep-17,10119,9791,328,3.2
CN2709100000000,27,091,Martin County, MN,Oct-17,10381,10104,277,2.7
CN2709100000000,27,091,Martin County, MN,Nov-17,10294,10002,292,2.8
CN2709100000000,27,091,Martin County, MN,Dec-17,10332,9956,376,3.6
CN2709100000000,27,091,Martin County, MN,Jan-18,10309,9884,425,4.1
CN2709100000000,27,091,Martin County, MN,Feb-18,10355,9936,419,4.0
CN2709100000000,27,091,Martin County, MN,Mar-18,10354,9948,406,3.9
CN2709100000000,27,091,Martin County, MN,Apr-18(p),10439,10102,337,3.2
CN5402500000000,54,025,Greenbrier County, WV,Mar-17,15407,14560,847,5.5
CN5402500000000,54,025,Greenbrier County, WV,Apr-17,15698,15006,692,4.4
CN5402500000000,54,025,Greenbrier County, WV,May-17,15696,15054,642,4.1
CN5402500000000,54,025,Greenbrier County, WV,Jun-17,16319,15603,716,4.4
CN5402500000000,54,025,Greenbrier County, WV,Jul-17,16171,15488,683,4.2
CN5402500000000,54,025,Greenbrier County, WV,Aug-17,16186,15453,733,4.5
CN5402500000000,54,025,Greenbrier County, WV,Sep-17,15825,15159,666,4.2
CN5402500000000,54,025,Greenbrier County, WV,Oct-17,15799,15130,669,4.2
CN5402500000000,54,025,Greenbrier County, WV,Nov-17,15413,14656,757,4.9
CN5402500000000,54,025,Greenbrier County, WV,Dec-17,15061,14258,803,5.3
CN5402500000000,54,025,Greenbrier County, WV,Jan-18,15338,14409,929,6.1
CN5402500000000,54,025,Greenbrier County, WV,Feb-18,15609,14544,1065,6.8
CN5402500000000,54,025,Greenbrier County, WV,Mar-18,15502,14505,997,6.4
CN5402500000000,54,025,Greenbrier County, WV,Apr-18(p),15720,14910,810,5.2
CN2917100000000,29,171,Putnam County, MO,Mar-17,2471,2375,96,3.9
CN2917100000000,29,171,Putnam County, MO,Apr-17,2546,2466,80,3.1
CN2917100000000,29,171,Putnam County, MO,May-17,2445,2360,85,3.5
CN2917100000000,29,171,Putnam County, MO,Jun-17,2452,2371,81,3.3
CN2917100000000,29,171,Putnam County, MO,Jul-17,2367,2269,98,4.1
CN2917100000000,29,171,Putnam County, MO,Aug-17,2350,2254,96,4.1
CN2917100000000,29,171,Putnam County, MO,Sep-17,2325,2244,81,3.5
CN2917100000000,29,171,Putnam County, MO,Oct-17,2368,2302,66,2.8
CN2917100000000,29,171,Putnam County, MO,Nov-17,2354,2283,71,3.0
CN2917100000000,29,171,Putnam County, MO,Dec-17,2291,2210,81,3.5
CN2917100000000,29,171,Putnam County, MO,Jan-18,2359,2246,113,4.8
CN2917100000000,29,171,Putnam County, MO,Feb-18,2435,2321,114,4.7
CN2917100000000,29,171,Putnam County, MO,Mar-18,2433,2325,108,4.4
CN2917100000000,29,171,Putnam County, MO,Apr-18(p),2475,2380,95,3.8
CN7200100000000,72,001,Adjuntas Municipio, PR,Mar-17,4488,3706,782,17.4
CN7200100000000,72,001,Adjuntas Municipio, PR,Apr-17,4383,3623,760,17.3
CN7200100000000,72,001,Adjuntas Municipio, PR,May-17,4308,3762,546,12.7
CN7200100000000,72,001,Adjuntas Municipio, PR,Jun-17,4329,3787,542,12.5
CN7200100000000,72,001,Adjuntas Municipio, PR,Jul-17,4397,3837,560,12.7
CN7200100000000,72,001,Adjuntas Municipio, PR,Aug-17,4432,3821,611,13.8
CN7200100000000,72,001,Adjuntas Municipio, PR,Sep-17(y),4342,3739,603,13.9
CN7200100000000,72,001,Adjuntas Municipio, PR,Oct-17,4173,3562,611,14.6
CN7200100000000,72,001,Adjuntas Municipio, PR,Nov-17,4492,3844,648,14.4
CN7200100000000,72,001,Adjuntas Municipio, PR,Dec-17,4536,3875,661,14.6
CN7200100000000,72,001,Adjuntas Municipio, PR,Jan-18,4465,3748,717,16.1
CN7200100000000,72,001,Adjuntas Municipio, PR,Feb-18,4299,3625,674,15.7
CN7200100000000,72,001,Adjuntas Municipio, PR,Mar-18,4331,3663,668,15.4
CN7200100000000,72,001,Adjuntas Municipio, PR,Apr-18(p),4301,3734,567,13.2
CN5503700000000,55,037,Florence County, WI,Mar-17,2249,2116,133,5.9
CN5503700000000,55,037,Florence County, WI,Apr-17,2275,2158,117,5.1
CN5503700000000,55,037,Florence County, WI,May-17,2306,2214,92,4.0
CN5503700000000,55,037,Florence County, WI,Jun-17,2423,2306,117,4.8
CN5503700000000,55,037,Florence County, WI,Jul-17,2340,2246,94,4.0
CN5503700000000,55,037,Florence County, WI,Aug-17,2334,2231,103,4.4
CN5503700000000,55,037,Florence County, WI,Sep-17,2311,2225,86,3.7
CN5503700000000,55,037,Florence County, WI,Oct-17,2309,2229,80,3.5
CN5503700000000,55,037,Florence County, WI,Nov-17,2300,2209,91,4.0
CN5503700000000,55,037,Florence County, WI,Dec-17,2315,2208,107,4.6
CN5503700000000,55,037,Florence County, WI,Jan-18,2323,2222,101,4.3
CN5503700000000,55,037,Florence County, WI,Feb-18,2314,2201,113,4.9
CN5503700000000,55,037,Florence County, WI,Mar-18,2328,2224,104,4.5
CN5503700000000,55,037,Florence County, WI,Apr-18(p),2335,2242,93,4.0
CN3011100000000,30,111,Yellowstone County, MT,Mar-17,81112,78053,3059,3.8
CN3011100000000,30,111,Yellowstone County, MT,Apr-17,81458,78908,2550,3.1
CN3011100000000,30,111,Yellowstone County, MT,May-17,81823,79486,2337,2.9
CN3011100000000,30,111,Yellowstone County, MT,Jun-17,82165,79071,3094,3.8
CN3011100000000,30,111,Yellowstone County, MT,Jul-17,81980,79125,2855,3.5
CN3011100000000,30,111,Yellowstone County, MT,Aug-17,82170,79359,2811,3.4
CN3011100000000,30,111,Yellowstone County, MT,Sep-17,81566,78938,2628,3.2
CN3011100000000,30,111,Yellowstone County, MT,Oct-17,81279,78632,2647,3.3
CN3011100000000,30,111,Yellowstone County, MT,Nov-17,81491,78672,2819,3.5
CN3011100000000,30,111,Yellowstone County, MT,Dec-17,81186,78297,2889,3.6
CN3011100000000,30,111,Yellowstone County, MT,Jan-18,80352,76856,3496,4.4
CN3011100000000,30,111,Yellowstone County, MT,Feb-18,80723,77228,3495,4.3
CN3011100000000,30,111,Yellowstone County, MT,Mar-18,81029,77749,3280,4.0
CN3011100000000,30,111,Yellowstone County, MT,Apr-18(p),81099,78643,2456,3.0
CN2403300000000,24,033,Prince George's County, MD,Mar-17,512085,491203,20882,4.1
CN2403300000000,24,033,Prince George's County, MD,Apr-17,511144,491575,19569,3.8
CN2403300000000,24,033,Prince George's County, MD,May-17,512578,492302,20276,4.0
CN2403300000000,24,033,Prince George's County, MD,Jun-17,513228,490955,22273,4.3
CN2403300000000,24,033,Prince George's County, MD,Jul-17,518926,496449,22477,4.3
CN2403300000000,24,033,Prince George's County, MD,Aug-17,512618,490502,22116,4.3
CN2403300000000,24,033,Prince George's County, MD,Sep-17,513060,492379,20681,4.0
CN2403300000000,24,033,Prince George's County, MD,Oct-17,512313,491438,20875,4.1
CN2403300000000,24,033,Prince George's County, MD,Nov-17,510643,489773,20870,4.1
CN2403300000000,24,033,Prince George's County, MD,Dec-17,508221,488005,20216,4.0
CN2403300000000,24,033,Prince George's County, MD,Jan-18,506009,482615,23394,4.6
CN2403300000000,24,033,Prince George's County, MD,Feb-18,510010,486305,23705,4.6
CN2403300000000,24,033,Prince George's County, MD,Mar-18,510318,486906,23412,4.6
CN2403300000000,24,033,Prince George's County, MD,Apr-18(p),507246,486681,20565,4.1
CN2800300000000,28,003,Alcorn County, MS,Mar-17,16370,15657,713,4.4
CN2800300000000,28,003,Alcorn County, MS,Apr-17,16304,15677,627,3.8
CN2800300000000,28,003,Alcorn County, MS,May-17,16228,15471,757,4.7
CN2800300000000,28,003,Alcorn County, MS,Jun-17,16070,15231,839,5.2
CN2800300000000,28,003,Alcorn County, MS,Jul-17,15812,15017,795,5.0
CN2800300000000,28,003,Alcorn County, MS,Aug-17,15597,14897,700,4.5
CN2800300000000,28,003,Alcorn County, MS,Sep-17,15756,15103,653,4.1
CN2800300000000,28,003,Alcorn County, MS,Oct-17,15855,15238,617,3.9
CN2800300000000,28,003,Alcorn County, MS,Nov-17,15956,15357,599,3.8
CN2800300000000,28,003,Alcorn County, MS,Dec-17,16584,15968,616,3.7
CN2800300000000,28,003,Alcorn County, MS,Jan-18,16255,15624,631,3.9
CN2800300000000,28,003,Alcorn County, MS,Feb-18,16383,15756,627,3.8
CN2800300000000,28,003,Alcorn County, MS,Mar-18,16395,15794,601,3.7
CN2800300000000,28,003,Alcorn County, MS,Apr-18(p),16454,15853,601,3.7
CN4605700000000,46,057,Hamlin County, SD,Mar-17,3158,2998,160,5.1
CN4605700000000,46,057,Hamlin County, SD,Apr-17,3160,3059,101,3.2
CN4605700000000,46,057,Hamlin County, SD,May-17,3176,3077,99,3.1
CN4605700000000,46,057,Hamlin County, SD,Jun-17,3300,3200,100,3.0
CN4605700000000,46,057,Hamlin County, SD,Jul-17,3252,3151,101,3.1
CN4605700000000,46,057,Hamlin County, SD,Aug-17,3183,3079,104,3.3
CN4605700000000,46,057,Hamlin County, SD,Sep-17,3138,3036,102,3.3
CN4605700000000,46,057,Hamlin County, SD,Oct-17,3117,3036,81,2.6
CN4605700000000,46,057,Hamlin County, SD,Nov-17,3109,3022,87,2.8
CN4605700000000,46,057,Hamlin County, SD,Dec-17,3147,3020,127,4.0
CN4605700000000,46,057,Hamlin County, SD,Jan-18,3147,2984,163,5.2
CN4605700000000,46,057,Hamlin County, SD,Feb-18,3135,2986,149,4.8
CN4605700000000,46,057,Hamlin County, SD,Mar-18,3164,3035,129,4.1
CN4605700000000,46,057,Hamlin County, SD,Apr-18(p),3133,3019,114,3.6
CN1314700000000,13,147,Hart County, GA,Mar-17,11293,10780,513,4.5
CN1314700000000,13,147,Hart County, GA,Apr-17,11237,10750,487,4.3
CN1314700000000,13,147,Hart County, GA,May-17,11278,10794,484,4.3
CN1314700000000,13,147,Hart County, GA,Jun-17,11313,10792,521,4.6
CN1314700000000,13,147,Hart County, GA,Jul-17,11315,10731,584,5.2
CN1314700000000,13,147,Hart County, GA,Aug-17,11178,10668,510,4.6
CN1314700000000,13,147,Hart County, GA,Sep-17,11285,10826,459,4.1
CN1314700000000,13,147,Hart County, GA,Oct-17,11223,10761,462,4.1
CN1314700000000,13,147,Hart County, GA,Nov-17,11193,10753,440,3.9
CN1314700000000,13,147,Hart County, GA,Dec-17,11221,10782,439,3.9
CN1314700000000,13,147,Hart County, GA,Jan-18,11412,10926,486,4.3
CN1314700000000,13,147,Hart County, GA,Feb-18,11306,10836,470,4.2
CN1314700000000,13,147,Hart County, GA,Mar-18,11331,10895,436,3.8
CN1314700000000,13,147,Hart County, GA,Apr-18(p),11282,10906,376,3.3
CN5101700000000,51,017,Bath County, VA,Mar-17,2380,2301,79,3.3
CN5101700000000,51,017,Bath County, VA,Apr-17,2381,2312,69,2.9
CN5101700000000,51,017,Bath County, VA,May-17,2432,2358,74,3.0
CN5101700000000,51,017,Bath County, VA,Jun-17,2547,2473,74,2.9
CN5101700000000,51,017,Bath County, VA,Jul-17,2516,2435,81,3.2
CN5101700000000,51,017,Bath County, VA,Aug-17,2511,2432,79,3.1
CN5101700000000,51,017,Bath County, VA,Sep-17,2516,2441,75,3.0
CN5101700000000,51,017,Bath County, VA,Oct-17,2409,2337,72,3.0
CN5101700000000,51,017,Bath County, VA,Nov-17,2389,2309,80,3.3
CN5101700000000,51,017,Bath County, VA,Dec-17,2393,2307,86,3.6
CN5101700000000,51,017,Bath County, VA,Jan-18,2381,2289,92,3.9
CN5101700000000,51,017,Bath County, VA,Feb-18,2394,2315,79,3.3
CN5101700000000,51,017,Bath County, VA,Mar-18,2396,2312,84,3.5
CN5101700000000,51,017,Bath County, VA,Apr-18(p),2416,2349,67,2.8
CN2901500000000,29,015,Benton County, MO,Mar-17,7125,6730,395,5.5
CN2901500000000,29,015,Benton County, MO,Apr-17,7290,6964,326,4.5
CN2901500000000,29,015,Benton County, MO,May-17,7163,6826,337,4.7
CN2901500000000,29,015,Benton County, MO,Jun-17,7303,6952,351,4.8
CN2901500000000,29,015,Benton County, MO,Jul-17,6911,6519,392,5.7
CN2901500000000,29,015,Benton County, MO,Aug-17,6980,6574,406,5.8
CN2901500000000,29,015,Benton County, MO,Sep-17,7170,6862,308,4.3
CN2901500000000,29,015,Benton County, MO,Oct-17,7072,6818,254,3.6
CN2901500000000,29,015,Benton County, MO,Nov-17,7052,6736,316,4.5
CN2901500000000,29,015,Benton County, MO,Dec-17,7046,6690,356,5.1
CN2901500000000,29,015,Benton County, MO,Jan-18,7012,6594,418,6.0
CN2901500000000,29,015,Benton County, MO,Feb-18,7087,6689,398,5.6
CN2901500000000,29,015,Benton County, MO,Mar-18,7151,6745,406,5.7
CN2901500000000,29,015,Benton County, MO,Apr-18(p),7294,6918,376,5.2
CN4504500000000,45,045,Greenville County, SC,Mar-17,246949,238459,8490,3.4
CN4504500000000,45,045,Greenville County, SC,Apr-17,246456,238678,7778,3.2
CN4504500000000,45,045,Greenville County, SC,May-17,247222,238943,8279,3.3
CN4504500000000,45,045,Greenville County, SC,Jun-17,248840,239206,9634,3.9
CN4504500000000,45,045,Greenville County, SC,Jul-17,248795,238745,10050,4.0
CN4504500000000,45,045,Greenville County, SC,Aug-17,248201,238207,9994,4.0
CN4504500000000,45,045,Greenville County, SC,Sep-17,248542,239607,8935,3.6
CN4504500000000,45,045,Greenville County, SC,Oct-17,248751,239986,8765,3.5
CN4504500000000,45,045,Greenville County, SC,Nov-17,247695,239336,8359,3.4
CN4504500000000,45,045,Greenville County, SC,Dec-17,247354,238809,8545,3.5
CN4504500000000,45,045,Greenville County, SC,Jan-18,248589,237981,10608,4.3
CN4504500000000,45,045,Greenville County, SC,Feb-18,249175,239463,9712,3.9
CN4504500000000,45,045,Greenville County, SC,Mar-18,250017,241358,8659,3.5
CN4504500000000,45,045,Greenville County, SC,Apr-18(p),246193,240413,5780,2.3
CN5000500000000,50,005,Caledonia County, VT,Mar-17,14621,13913,708,4.8
CN5000500000000,50,005,Caledonia County, VT,Apr-17,14532,13885,647,4.5
CN5000500000000,50,005,Caledonia County, VT,May-17,14729,14254,475,3.2
CN5000500000000,50,005,Caledonia County, VT,Jun-17,15051,14509,542,3.6
CN5000500000000,50,005,Caledonia County, VT,Jul-17,15170,14660,510,3.4
CN5000500000000,50,005,Caledonia County, VT,Aug-17,15083,14565,518,3.4
CN5000500000000,50,005,Caledonia County, VT,Sep-17,14843,14376,467,3.1
CN5000500000000,50,005,Caledonia County, VT,Oct-17,14579,14215,364,2.5
CN5000500000000,50,005,Caledonia County, VT,Nov-17,14459,14040,419,2.9
CN5000500000000,50,005,Caledonia County, VT,Dec-17,14360,13920,440,3.1
CN5000500000000,50,005,Caledonia County, VT,Jan-18,14573,13908,665,4.6
CN5000500000000,50,005,Caledonia County, VT,Feb-18,14701,14077,624,4.2
CN5000500000000,50,005,Caledonia County, VT,Mar-18,14771,14164,607,4.1
CN5000500000000,50,005,Caledonia County, VT,Apr-18(p),14771,14189,582,3.9
CN7202900000000,72,029,Canovanas Municipio, PR,Mar-17,16262,14650,1612,9.9
CN7202900000000,72,029,Canovanas Municipio, PR,Apr-17,16212,14515,1697,10.5
CN7202900000000,72,029,Canovanas Municipio, PR,May-17,15914,14426,1488,9.4
CN7202900000000,72,029,Canovanas Municipio, PR,Jun-17,15686,14336,1350,8.6
CN7202900000000,72,029,Canovanas Municipio, PR,Jul-17,15759,14284,1475,9.4
CN7202900000000,72,029,Canovanas Municipio, PR,Aug-17,15750,14092,1658,10.5
CN7202900000000,72,029,Canovanas Municipio, PR,Sep-17(y),15880,14258,1622,10.2
CN7202900000000,72,029,Canovanas Municipio, PR,Oct-17,15249,13686,1563,10.2
CN7202900000000,72,029,Canovanas Municipio, PR,Nov-17,15939,14479,1460,9.2
CN7202900000000,72,029,Canovanas Municipio, PR,Dec-17,16008,14591,1417,8.9
CN7202900000000,72,029,Canovanas Municipio, PR,Jan-18,15790,14322,1468,9.3
CN7202900000000,72,029,Canovanas Municipio, PR,Feb-18,15761,14371,1390,8.8
CN7202900000000,72,029,Canovanas Municipio, PR,Mar-18,15768,14390,1378,8.7
CN7202900000000,72,029,Canovanas Municipio, PR,Apr-18(p),15760,14483,1277,8.1
CN1200100000000,12,001,Alachua County, FL,Mar-17,136679,131691,4988,3.6
CN1200100000000,12,001,Alachua County, FL,Apr-17,137178,132463,4715,3.4
CN1200100000000,12,001,Alachua County, FL,May-17,134716,129975,4741,3.5
CN1200100000000,12,001,Alachua County, FL,Jun-17,133946,128508,5438,4.1
CN1200100000000,12,001,Alachua County, FL,Jul-17,135134,129751,5383,4.0
CN1200100000000,12,001,Alachua County, FL,Aug-17,133339,128182,5157,3.9
CN1200100000000,12,001,Alachua County, FL,Sep-17,139668,134786,4882,3.5
CN1200100000000,12,001,Alachua County, FL,Oct-17,138066,133429,4637,3.4
CN1200100000000,12,001,Alachua County, FL,Nov-17,136684,131837,4847,3.5
CN1200100000000,12,001,Alachua County, FL,Dec-17,135316,130902,4414,3.3
CN1200100000000,12,001,Alachua County, FL,Jan-18,136544,131289,5255,3.8
CN1200100000000,12,001,Alachua County, FL,Feb-18,138041,133356,4685,3.4
CN1200100000000,12,001,Alachua County, FL,Mar-18,137626,133013,4613,3.4
CN1200100000000,12,001,Alachua County, FL,Apr-18(p),138499,134288,4211,3.0
CN1711700000000,17,117,Macoupin County, IL,Mar-17,23050,21912,1138,4.9
CN1711700000000,17,117,Macoupin County, IL,Apr-17,23140,22186,954,4.1
CN1711700000000,17,117,Macoupin County, IL,May-17,23006,22070,936,4.1
CN1711700000000,17,117,Macoupin County, IL,Jun-17,23299,22255,1044,4.5
CN1711700000000,17,117,Macoupin County, IL,Jul-17,23249,22129,1120,4.8
CN1711700000000,17,117,Macoupin County, IL,Aug-17,23042,21939,1103,4.8
CN1711700000000,17,117,Macoupin County, IL,Sep-17,23007,21990,1017,4.4
CN1711700000000,17,117,Macoupin County, IL,Oct-17,22970,22014,956,4.2
CN1711700000000,17,117,Macoupin County, IL,Nov-17,23033,21999,1034,4.5
CN1711700000000,17,117,Macoupin County, IL,Dec-17,22797,21761,1036,4.5
CN1711700000000,17,117,Macoupin County, IL,Jan-18,22825,21649,1176,5.2
CN1711700000000,17,117,Macoupin County, IL,Feb-18,22999,21940,1059,4.6
CN1711700000000,17,117,Macoupin County, IL,Mar-18,23412,22348,1064,4.5
CN1711700000000,17,117,Macoupin County, IL,Apr-18(p),23453,22601,852,3.6
CN1202900000000,12,029,Dixie County, FL,Mar-17,5848,5578,270,4.6
CN1202900000000,12,029,Dixie County, FL,Apr-17,5831,5581,250,4.3
CN1202900000000,12,029,Dixie County, FL,May-17,5854,5613,241,4.1
CN1202900000000,12,029,Dixie County, FL,Jun-17,5700,5432,268,4.7
CN1202900000000,12,029,Dixie County, FL,Jul-17,5672,5400,272,4.8
CN1202900000000,12,029,Dixie County, FL,Aug-17,5785,5514,271,4.7
CN1202900000000,12,029,Dixie County, FL,Sep-17,6030,5784,246,4.1
CN1202900000000,12,029,Dixie County, FL,Oct-17,5851,5599,252,4.3
CN1202900000000,12,029,Dixie County, FL,Nov-17,5759,5511,248,4.3
CN1202900000000,12,029,Dixie County, FL,Dec-17,5741,5503,238,4.1
CN1202900000000,12,029,Dixie County, FL,Jan-18,5747,5464,283,4.9
CN1202900000000,12,029,Dixie County, FL,Feb-18,5776,5522,254,4.4
CN1202900000000,12,029,Dixie County, FL,Mar-18,5781,5536,245,4.2
CN1202900000000,12,029,Dixie County, FL,Apr-18(p),5772,5552,220,3.8
CN3000500000000,30,005,Blaine County, MT,Mar-17,2341,2222,119,5.1
CN3000500000000,30,005,Blaine County, MT,Apr-17,2432,2343,89,3.7
CN3000500000000,30,005,Blaine County, MT,May-17,2442,2364,78,3.2
CN3000500000000,30,005,Blaine County, MT,Jun-17,2346,2257,89,3.8
CN3000500000000,30,005,Blaine County, MT,Jul-17,2311,2226,85,3.7
CN3000500000000,30,005,Blaine County, MT,Aug-17,2283,2203,80,3.5
CN3000500000000,30,005,Blaine County, MT,Sep-17,2331,2252,79,3.4
CN3000500000000,30,005,Blaine County, MT,Oct-17,2341,2256,85,3.6
CN3000500000000,30,005,Blaine County, MT,Nov-17,2343,2249,94,4.0
CN3000500000000,30,005,Blaine County, MT,Dec-17,2327,2218,109,4.7
CN3000500000000,30,005,Blaine County, MT,Jan-18,2336,2200,136,5.8
CN3000500000000,30,005,Blaine County, MT,Feb-18,2360,2228,132,5.6
CN3000500000000,30,005,Blaine County, MT,Mar-18,2323,2198,125,5.4
CN3000500000000,30,005,Blaine County, MT,Apr-18(p),2326,2225,101,4.3
CN2010300000000,20,103,Leavenworth County, KS,Mar-17,35707,34205,1502,4.2
CN2010300000000,20,103,Leavenworth County, KS,Apr-17,35752,34473,1279,3.6
CN2010300000000,20,103,Leavenworth County, KS,May-17,35795,34465,1330,3.7
CN2010300000000,20,103,Leavenworth County, KS,Jun-17,36549,35087,1462,4.0
CN2010300000000,20,103,Leavenworth County, KS,Jul-17,37167,35618,1549,4.2
CN2010300000000,20,103,Leavenworth County, KS,Aug-17,36516,34950,1566,4.3
CN2010300000000,20,103,Leavenworth County, KS,Sep-17,36005,34732,1273,3.5
CN2010300000000,20,103,Leavenworth County, KS,Oct-17,35985,34732,1253,3.5
CN2010300000000,20,103,Leavenworth County, KS,Nov-17,36218,34996,1222,3.4
CN2010300000000,20,103,Leavenworth County, KS,Dec-17,36029,34850,1179,3.3
CN2010300000000,20,103,Leavenworth County, KS,Jan-18,36238,34687,1551,4.3
CN2010300000000,20,103,Leavenworth County, KS,Feb-18,36112,34644,1468,4.1
CN2010300000000,20,103,Leavenworth County, KS,Mar-18,35871,34516,1355,3.8
CN2010300000000,20,103,Leavenworth County, KS,Apr-18(p),36129,34882,1247,3.5
CN3301300000000,33,013,Merrimack County, NH,Mar-17,81414,79156,2258,2.8
CN3301300000000,33,013,Merrimack County, NH,Apr-17,80475,78707,1768,2.2
CN3301300000000,33,013,Merrimack County, NH,May-17,80396,78585,1811,2.3
CN3301300000000,33,013,Merrimack County, NH,Jun-17,81641,79766,1875,2.3
CN3301300000000,33,013,Merrimack County, NH,Jul-17,82244,80333,1911,2.3
CN3301300000000,33,013,Merrimack County, NH,Aug-17,81560,79678,1882,2.3
CN3301300000000,33,013,Merrimack County, NH,Sep-17,80537,78748,1789,2.2
CN3301300000000,33,013,Merrimack County, NH,Oct-17,80736,79121,1615,2.0
CN3301300000000,33,013,Merrimack County, NH,Nov-17,81060,79362,1698,2.1
CN3301300000000,33,013,Merrimack County, NH,Dec-17,80518,78982,1536,1.9
CN3301300000000,33,013,Merrimack County, NH,Jan-18,81176,78971,2205,2.7
CN3301300000000,33,013,Merrimack County, NH,Feb-18,81576,79407,2169,2.7
CN3301300000000,33,013,Merrimack County, NH,Mar-18,81890,79745,2145,2.6
CN3301300000000,33,013,Merrimack County, NH,Apr-18(p),81552,79672,1880,2.3
CN1916300000000,19,163,Scott County, IA,Mar-17,85761,82248,3513,4.1
CN1916300000000,19,163,Scott County, IA,Apr-17,85295,82148,3147,3.7
CN1916300000000,19,163,Scott County, IA,May-17,85379,82425,2954,3.5
CN1916300000000,19,163,Scott County, IA,Jun-17,86949,83619,3330,3.8
CN1916300000000,19,163,Scott County, IA,Jul-17,87644,84552,3092,3.5
CN1916300000000,19,163,Scott County, IA,Aug-17,86924,83722,3202,3.7
CN1916300000000,19,163,Scott County, IA,Sep-17,86095,83173,2922,3.4
CN1916300000000,19,163,Scott County, IA,Oct-17,85647,83103,2544,3.0
CN1916300000000,19,163,Scott County, IA,Nov-17,86280,83688,2592,3.0
CN1916300000000,19,163,Scott County, IA,Dec-17,85824,82871,2953,3.4
CN1916300000000,19,163,Scott County, IA,Jan-18,86131,82634,3497,4.1
CN1916300000000,19,163,Scott County, IA,Feb-18,86113,82846,3267,3.8
CN1916300000000,19,163,Scott County, IA,Mar-18,86666,83804,2862,3.3
CN1916300000000,19,163,Scott County, IA,Apr-18(p),86392,83884,2508,2.9
CN2111500000000,21,115,Johnson County, KY,Mar-17,7510,6782,728,9.7
CN2111500000000,21,115,Johnson County, KY,Apr-17,7463,6836,627,8.4
CN2111500000000,21,115,Johnson County, KY,May-17,7430,6829,601,8.1
CN2111500000000,21,115,Johnson County, KY,Jun-17,7584,6935,649,8.6
CN2111500000000,21,115,Johnson County, KY,Jul-17,7442,6837,605,8.1
CN2111500000000,21,115,Johnson County, KY,Aug-17,7354,6803,551,7.5
CN2111500000000,21,115,Johnson County, KY,Sep-17,7347,6825,522,7.1
CN2111500000000,21,115,Johnson County, KY,Oct-17,7251,6768,483,6.7
CN2111500000000,21,115,Johnson County, KY,Nov-17,7224,6765,459,6.4
CN2111500000000,21,115,Johnson County, KY,Dec-17,7193,6721,472,6.6
CN2111500000000,21,115,Johnson County, KY,Jan-18,7164,6649,515,7.2
CN2111500000000,21,115,Johnson County, KY,Feb-18,7264,6697,567,7.8
CN2111500000000,21,115,Johnson County, KY,Mar-18,7277,6778,499,6.9
CN2111500000000,21,115,Johnson County, KY,Apr-18(p),7272,6837,435,6.0
CN3200100000000,32,001,Churchill County, NV,Mar-17,11659,11144,515,4.4
CN3200100000000,32,001,Churchill County, NV,Apr-17,11013,10554,459,4.2
CN3200100000000,32,001,Churchill County, NV,May-17,11163,10700,463,4.1
CN3200100000000,32,001,Churchill County, NV,Jun-17,11303,10816,487,4.3
CN3200100000000,32,001,Churchill County, NV,Jul-17,10705,10244,461,4.3
CN3200100000000,32,001,Churchill County, NV,Aug-17,10597,10151,446,4.2
CN3200100000000,32,001,Churchill County, NV,Sep-17,10519,10082,437,4.2
CN3200100000000,32,001,Churchill County, NV,Oct-17,10338,9905,433,4.2
CN3200100000000,32,001,Churchill County, NV,Nov-17,10448,10000,448,4.3
CN3200100000000,32,001,Churchill County, NV,Dec-17,10546,10109,437,4.1
CN3200100000000,32,001,Churchill County, NV,Jan-18,10492,9955,537,5.1
CN3200100000000,32,001,Churchill County, NV,Feb-18,10817,10321,496,4.6
CN3200100000000,32,001,Churchill County, NV,Mar-18,11223,10741,482,4.3
CN3200100000000,32,001,Churchill County, NV,Apr-18(p),10573,10131,442,4.2
CN1207900000000,12,079,Madison County, FL,Mar-17,7432,7103,329,4.4
CN1207900000000,12,079,Madison County, FL,Apr-17,7407,7106,301,4.1
CN1207900000000,12,079,Madison County, FL,May-17,7481,7171,310,4.1
CN1207900000000,12,079,Madison County, FL,Jun-17,7466,7130,336,4.5
CN1207900000000,12,079,Madison County, FL,Jul-17,7350,6995,355,4.8
CN1207900000000,12,079,Madison County, FL,Aug-17,7473,7139,334,4.5
CN1207900000000,12,079,Madison County, FL,Sep-17,7546,7239,307,4.1
CN1207900000000,12,079,Madison County, FL,Oct-17,7458,7171,287,3.8
CN1207900000000,12,079,Madison County, FL,Nov-17,7360,7067,293,4.0
CN1207900000000,12,079,Madison County, FL,Dec-17,7248,6968,280,3.9
CN1207900000000,12,079,Madison County, FL,Jan-18,7290,6966,324,4.4
CN1207900000000,12,079,Madison County, FL,Feb-18,7300,6999,301,4.1
CN1207900000000,12,079,Madison County, FL,Mar-18,7303,7012,291,4.0
CN1207900000000,12,079,Madison County, FL,Apr-18(p),7281,7013,268,3.7
CN1604900000000,16,049,Idaho County, ID,Mar-17,6137,5727,410,6.7
CN1604900000000,16,049,Idaho County, ID,Apr-17,6229,5871,358,5.7
CN1604900000000,16,049,Idaho County, ID,May-17,6292,6011,281,4.5
CN1604900000000,16,049,Idaho County, ID,Jun-17,6451,6183,268,4.2
CN1604900000000,16,049,Idaho County, ID,Jul-17,6480,6210,270,4.2
CN1604900000000,16,049,Idaho County, ID,Aug-17,6462,6192,270,4.2
CN1604900000000,16,049,Idaho County, ID,Sep-17,6304,6064,240,3.8
CN1604900000000,16,049,Idaho County, ID,Oct-17,6185,5941,244,3.9
CN1604900000000,16,049,Idaho County, ID,Nov-17,6116,5836,280,4.6
CN1604900000000,16,049,Idaho County, ID,Dec-17,6055,5772,283,4.7
CN1604900000000,16,049,Idaho County, ID,Jan-18,6188,5806,382,6.2
CN1604900000000,16,049,Idaho County, ID,Feb-18,6227,5848,379,6.1
CN1604900000000,16,049,Idaho County, ID,Mar-18,6265,5886,379,6.0
CN1604900000000,16,049,Idaho County, ID,Apr-18(p),6352,5997,355,5.6
CN2122100000000,21,221,Trigg County, KY,Mar-17,5923,5537,386,6.5
CN2122100000000,21,221,Trigg County, KY,Apr-17,5975,5640,335,5.6
CN2122100000000,21,221,Trigg County, KY,May-17,5931,5592,339,5.7
CN2122100000000,21,221,Trigg County, KY,Jun-17,5907,5544,363,6.1
CN2122100000000,21,221,Trigg County, KY,Jul-17,5832,5464,368,6.3
CN2122100000000,21,221,Trigg County, KY,Aug-17,5809,5483,326,5.6
CN2122100000000,21,221,Trigg County, KY,Sep-17,5795,5500,295,5.1
CN2122100000000,21,221,Trigg County, KY,Oct-17,5786,5513,273,4.7
CN2122100000000,21,221,Trigg County, KY,Nov-17,5841,5578,263,4.5
CN2122100000000,21,221,Trigg County, KY,Dec-17,5779,5507,272,4.7
CN2122100000000,21,221,Trigg County, KY,Jan-18,5804,5500,304,5.2
CN2122100000000,21,221,Trigg County, KY,Feb-18,5850,5519,331,5.7
CN2122100000000,21,221,Trigg County, KY,Mar-18,5866,5550,316,5.4
CN2122100000000,21,221,Trigg County, KY,Apr-18(p),5885,5617,268,4.6
CN3711700000000,37,117,Martin County, NC,Mar-17,9979,9418,561,5.6
CN3711700000000,37,117,Martin County, NC,Apr-17,9801,9266,535,5.5
CN3711700000000,37,117,Martin County, NC,May-17,9660,9131,529,5.5
CN3711700000000,37,117,Martin County, NC,Jun-17,9458,8897,561,5.9
CN3711700000000,37,117,Martin County, NC,Jul-17,9424,8856,568,6.0
CN3711700000000,37,117,Martin County, NC,Aug-17,9376,8822,554,5.9
CN3711700000000,37,117,Martin County, NC,Sep-17,9607,9110,497,5.2
CN3711700000000,37,117,Martin County, NC,Oct-17,9577,9090,487,5.1
CN3711700000000,37,117,Martin County, NC,Nov-17,9567,9032,535,5.6
CN3711700000000,37,117,Martin County, NC,Dec-17,9530,9000,530,5.6
CN3711700000000,37,117,Martin County, NC,Jan-18,9538,8961,577,6.0
CN3711700000000,37,117,Martin County, NC,Feb-18,9637,9080,557,5.8
CN3711700000000,37,117,Martin County, NC,Mar-18,9630,9097,533,5.5
CN3711700000000,37,117,Martin County, NC,Apr-18(p),9551,9090,461,4.8
CN1716700000000,17,167,Sangamon County, IL,Mar-17,104430,99738,4692,4.5
CN1716700000000,17,167,Sangamon County, IL,Apr-17,103608,99661,3947,3.8
CN1716700000000,17,167,Sangamon County, IL,May-17,102573,98811,3762,3.7
CN1716700000000,17,167,Sangamon County, IL,Jun-17,104137,99860,4277,4.1
CN1716700000000,17,167,Sangamon County, IL,Jul-17,104054,99542,4512,4.3
CN1716700000000,17,167,Sangamon County, IL,Aug-17,105358,100823,4535,4.3
CN1716700000000,17,167,Sangamon County, IL,Sep-17,102883,98842,4041,3.9
CN1716700000000,17,167,Sangamon County, IL,Oct-17,101725,97856,3869,3.8
CN1716700000000,17,167,Sangamon County, IL,Nov-17,102188,98236,3952,3.9
CN1716700000000,17,167,Sangamon County, IL,Dec-17,101776,97830,3946,3.9
CN1716700000000,17,167,Sangamon County, IL,Jan-18,100789,96411,4378,4.3
CN1716700000000,17,167,Sangamon County, IL,Feb-18,101571,97559,4012,3.9
CN1716700000000,17,167,Sangamon County, IL,Mar-18,102911,98735,4176,4.1
CN1716700000000,17,167,Sangamon County, IL,Apr-18(p),103523,100146,3377,3.3
CN7213500000000,72,135,Toa Alta Municipio, PR,Mar-17,26857,24766,2091,7.8
CN7213500000000,72,135,Toa Alta Municipio, PR,Apr-17,26799,24534,2265,8.5
CN7213500000000,72,135,Toa Alta Municipio, PR,May-17,26370,24375,1995,7.6
CN7213500000000,72,135,Toa Alta Municipio, PR,Jun-17,26066,24224,1842,7.1
CN7213500000000,72,135,Toa Alta Municipio, PR,Jul-17,26180,24121,2059,7.9
CN7213500000000,72,135,Toa Alta Municipio, PR,Aug-17,26134,23795,2339,9.0
CN7213500000000,72,135,Toa Alta Municipio, PR,Sep-17(y),26355,24084,2271,8.6
CN7213500000000,72,135,Toa Alta Municipio, PR,Oct-17,25145,23130,2015,8.0
CN7213500000000,72,135,Toa Alta Municipio, PR,Nov-17,26409,24456,1953,7.4
CN7213500000000,72,135,Toa Alta Municipio, PR,Dec-17,26480,24646,1834,6.9
CN7213500000000,72,135,Toa Alta Municipio, PR,Jan-18,26143,24191,1952,7.5
CN7213500000000,72,135,Toa Alta Municipio, PR,Feb-18,26075,24288,1787,6.9
CN7213500000000,72,135,Toa Alta Municipio, PR,Mar-18,26027,24319,1708,6.6
CN7213500000000,72,135,Toa Alta Municipio, PR,Apr-18(p),26186,24472,1714,6.5
CN4829900000000,48,299,Llano County, TX,Mar-17,8282,7953,329,4.0
CN4829900000000,48,299,Llano County, TX,Apr-17,8309,8032,277,3.3
CN4829900000000,48,299,Llano County, TX,May-17,8372,8080,292,3.5
CN4829900000000,48,299,Llano County, TX,Jun-17,8493,8184,309,3.6
CN4829900000000,48,299,Llano County, TX,Jul-17,8468,8131,337,4.0
CN4829900000000,48,299,Llano County, TX,Aug-17,8414,8097,317,3.8
CN4829900000000,48,299,Llano County, TX,Sep-17,8318,8023,295,3.5
CN4829900000000,48,299,Llano County, TX,Oct-17,8270,7993,277,3.3
CN4829900000000,48,299,Llano County, TX,Nov-17,8263,7973,290,3.5
CN4829900000000,48,299,Llano County, TX,Dec-17,8242,7965,277,3.4
CN4829900000000,48,299,Llano County, TX,Jan-18,8271,7961,310,3.7
CN4829900000000,48,299,Llano County, TX,Feb-18,8355,8033,322,3.9
CN4829900000000,48,299,Llano County, TX,Mar-18,8516,8184,332,3.9
CN4829900000000,48,299,Llano County, TX,Apr-18(p),8413,8116,297,3.5
CN2116500000000,21,165,Menifee County, KY,Mar-17,2443,2172,271,11.1
CN2116500000000,21,165,Menifee County, KY,Apr-17,2392,2184,208,8.7
CN2116500000000,21,165,Menifee County, KY,May-17,2378,2193,185,7.8
CN2116500000000,21,165,Menifee County, KY,Jun-17,2412,2201,211,8.7
CN2116500000000,21,165,Menifee County, KY,Jul-17,2391,2184,207,8.7
CN2116500000000,21,165,Menifee County, KY,Aug-17,2353,2172,181,7.7
CN2116500000000,21,165,Menifee County, KY,Sep-17,2371,2212,159,6.7
CN2116500000000,21,165,Menifee County, KY,Oct-17,2339,2190,149,6.4
CN2116500000000,21,165,Menifee County, KY,Nov-17,2335,2190,145,6.2
CN2116500000000,21,165,Menifee County, KY,Dec-17,2352,2164,188,8.0
CN2116500000000,21,165,Menifee County, KY,Jan-18,2352,2118,234,9.9
CN2116500000000,21,165,Menifee County, KY,Feb-18,2372,2117,255,10.8
CN2116500000000,21,165,Menifee County, KY,Mar-18,2357,2143,214,9.1
CN2116500000000,21,165,Menifee County, KY,Apr-18(p),2346,2171,175,7.5
CN2704700000000,27,047,Freeborn County, MN,Mar-17,16339,15652,687,4.2
CN2704700000000,27,047,Freeborn County, MN,Apr-17,16211,15650,561,3.5
CN2704700000000,27,047,Freeborn County, MN,May-17,16241,15758,483,3.0
CN2704700000000,27,047,Freeborn County, MN,Jun-17,16377,15796,581,3.5
CN2704700000000,27,047,Freeborn County, MN,Jul-17,16140,15605,535,3.3
CN2704700000000,27,047,Freeborn County, MN,Aug-17,15831,15287,544,3.4
CN2704700000000,27,047,Freeborn County, MN,Sep-17,15834,15360,474,3.0
CN2704700000000,27,047,Freeborn County, MN,Oct-17,16127,15646,481,3.0
CN2704700000000,27,047,Freeborn County, MN,Nov-17,16149,15555,594,3.7
CN2704700000000,27,047,Freeborn County, MN,Dec-17,16132,15478,654,4.1
CN2704700000000,27,047,Freeborn County, MN,Jan-18,16220,15485,735,4.5
CN2704700000000,27,047,Freeborn County, MN,Feb-18,16208,15511,697,4.3
CN2704700000000,27,047,Freeborn County, MN,Mar-18,16238,15566,672,4.1
CN2704700000000,27,047,Freeborn County, MN,Apr-18(p),16236,15704,532,3.3
CN4704700000000,47,047,Fayette County, TN,Mar-17,18433,17613,820,4.4
CN4704700000000,47,047,Fayette County, TN,Apr-17,18341,17688,653,3.6
CN4704700000000,47,047,Fayette County, TN,May-17,18224,17611,613,3.4
CN4704700000000,47,047,Fayette County, TN,Jun-17,18534,17787,747,4.0
CN4704700000000,47,047,Fayette County, TN,Jul-17,18603,17886,717,3.9
CN4704700000000,47,047,Fayette County, TN,Aug-17,18544,17846,698,3.8
CN4704700000000,47,047,Fayette County, TN,Sep-17,18650,17980,670,3.6
CN4704700000000,47,047,Fayette County, TN,Oct-17,18617,17941,676,3.6
CN4704700000000,47,047,Fayette County, TN,Nov-17,18755,18077,678,3.6
CN4704700000000,47,047,Fayette County, TN,Dec-17,18728,18057,671,3.6
CN4704700000000,47,047,Fayette County, TN,Jan-18,18501,17742,759,4.1
CN4704700000000,47,047,Fayette County, TN,Feb-18,18758,18043,715,3.8
CN4704700000000,47,047,Fayette County, TN,Mar-18,18729,18038,691,3.7
CN4704700000000,47,047,Fayette County, TN,Apr-18(p),18710,18148,562,3.0
CN2006300000000,20,063,Gove County, KS,Mar-17,1382,1350,32,2.3
CN2006300000000,20,063,Gove County, KS,Apr-17,1370,1340,30,2.2
CN2006300000000,20,063,Gove County, KS,May-17,1364,1329,35,2.6
CN2006300000000,20,063,Gove County, KS,Jun-17,1439,1405,34,2.4
CN2006300000000,20,063,Gove County, KS,Jul-17,1409,1374,35,2.5
CN2006300000000,20,063,Gove County, KS,Aug-17,1424,1387,37,2.6
CN2006300000000,20,063,Gove County, KS,Sep-17,1440,1412,28,1.9
CN2006300000000,20,063,Gove County, KS,Oct-17,1475,1445,30,2.0
CN2006300000000,20,063,Gove County, KS,Nov-17,1445,1413,32,2.2
CN2006300000000,20,063,Gove County, KS,Dec-17,1458,1427,31,2.1
CN2006300000000,20,063,Gove County, KS,Jan-18,1435,1404,31,2.2
CN2006300000000,20,063,Gove County, KS,Feb-18,1429,1399,30,2.1
CN2006300000000,20,063,Gove County, KS,Mar-18,1404,1373,31,2.2
CN2006300000000,20,063,Gove County, KS,Apr-18(p),1313,1284,29,2.2
CN5154000000000,51,540,Charlottesville city, VA,Mar-17,25599,24820,779,3.0
CN5154000000000,51,540,Charlottesville city, VA,Apr-17,25712,25013,699,2.7
CN5154000000000,51,540,Charlottesville city, VA,May-17,25654,24867,787,3.1
CN5154000000000,51,540,Charlottesville city, VA,Jun-17,25666,24762,904,3.5
CN5154000000000,51,540,Charlottesville city, VA,Jul-17,25459,24534,925,3.6
CN5154000000000,51,540,Charlottesville city, VA,Aug-17,25179,24268,911,3.6
CN5154000000000,51,540,Charlottesville city, VA,Sep-17,26043,25308,735,2.8
CN5154000000000,51,540,Charlottesville city, VA,Oct-17,25734,25045,689,2.7
CN5154000000000,51,540,Charlottesville city, VA,Nov-17,25825,25134,691,2.7
CN5154000000000,51,540,Charlottesville city, VA,Dec-17,25575,24935,640,2.5
CN5154000000000,51,540,Charlottesville city, VA,Jan-18,25515,24680,835,3.3
CN5154000000000,51,540,Charlottesville city, VA,Feb-18,26170,25499,671,2.6
CN5154000000000,51,540,Charlottesville city, VA,Mar-18,26389,25699,690,2.6
CN5154000000000,51,540,Charlottesville city, VA,Apr-18(p),26588,26002,586,2.2
CN3609900000000,36,099,Seneca County, NY,Mar-17,16126,15300,826,5.1
CN3609900000000,36,099,Seneca County, NY,Apr-17,16254,15531,723,4.4
CN3609900000000,36,099,Seneca County, NY,May-17,16178,15501,677,4.2
CN3609900000000,36,099,Seneca County, NY,Jun-17,16562,15858,704,4.3
CN3609900000000,36,099,Seneca County, NY,Jul-17,16641,15947,694,4.2
CN3609900000000,36,099,Seneca County, NY,Aug-17,16547,15843,704,4.3
CN3609900000000,36,099,Seneca County, NY,Sep-17,16382,15692,690,4.2
CN3609900000000,36,099,Seneca County, NY,Oct-17,16292,15642,650,4.0
CN3609900000000,36,099,Seneca County, NY,Nov-17,16252,15542,710,4.4
CN3609900000000,36,099,Seneca County, NY,Dec-17,16091,15338,753,4.7
CN3609900000000,36,099,Seneca County, NY,Jan-18,16313,15418,895,5.5
CN3609900000000,36,099,Seneca County, NY,Feb-18,16246,15303,943,5.8
CN3609900000000,36,099,Seneca County, NY,Mar-18,16058,15228,830,5.2
CN3609900000000,36,099,Seneca County, NY,Apr-18(p),16141,15453,688,4.3
CN4006300000000,40,063,Hughes County, OK,Mar-17,5537,5222,315,5.7
CN4006300000000,40,063,Hughes County, OK,Apr-17,5401,5130,271,5.0
CN4006300000000,40,063,Hughes County, OK,May-17,5399,5107,292,5.4
CN4006300000000,40,063,Hughes County, OK,Jun-17,5229,4914,315,6.0
CN4006300000000,40,063,Hughes County, OK,Jul-17,5135,4821,314,6.1
CN4006300000000,40,063,Hughes County, OK,Aug-17,5337,5036,301,5.6
CN4006300000000,40,063,Hughes County, OK,Sep-17,5490,5206,284,5.2
CN4006300000000,40,063,Hughes County, OK,Oct-17,5567,5259,308,5.5
CN4006300000000,40,063,Hughes County, OK,Nov-17,5589,5297,292,5.2
CN4006300000000,40,063,Hughes County, OK,Dec-17,5529,5250,279,5.0
CN4006300000000,40,063,Hughes County, OK,Jan-18,5388,5083,305,5.7
CN4006300000000,40,063,Hughes County, OK,Feb-18,5453,5179,274,5.0
CN4006300000000,40,063,Hughes County, OK,Mar-18,5420,5158,262,4.8
CN4006300000000,40,063,Hughes County, OK,Apr-18(p),5294,5037,257,4.9
CN5182000000000,51,820,Waynesboro city, VA,Mar-17,10337,9902,435,4.2
CN5182000000000,51,820,Waynesboro city, VA,Apr-17,10336,9958,378,3.7
CN5182000000000,51,820,Waynesboro city, VA,May-17,10292,9889,403,3.9
CN5182000000000,51,820,Waynesboro city, VA,Jun-17,10289,9852,437,4.2
CN5182000000000,51,820,Waynesboro city, VA,Jul-17,10304,9873,431,4.2
CN5182000000000,51,820,Waynesboro city, VA,Aug-17,10194,9767,427,4.2
CN5182000000000,51,820,Waynesboro city, VA,Sep-17,10295,9888,407,4.0
CN5182000000000,51,820,Waynesboro city, VA,Oct-17,10290,9876,414,4.0
CN5182000000000,51,820,Waynesboro city, VA,Nov-17,10259,9874,385,3.8
CN5182000000000,51,820,Waynesboro city, VA,Dec-17,10211,9824,387,3.8
CN5182000000000,51,820,Waynesboro city, VA,Jan-18,10273,9829,444,4.3
CN5182000000000,51,820,Waynesboro city, VA,Feb-18,10393,10014,379,3.6
CN5182000000000,51,820,Waynesboro city, VA,Mar-18,10475,10093,382,3.6
CN5182000000000,51,820,Waynesboro city, VA,Apr-18(p),10449,10128,321,3.1
CN5407500000000,54,075,Pocahontas County, WV,Mar-17,3891,3675,216,5.6
CN5407500000000,54,075,Pocahontas County, WV,Apr-17,3577,3260,317,8.9
CN5407500000000,54,075,Pocahontas County, WV,May-17,3497,3249,248,7.1
CN5407500000000,54,075,Pocahontas County, WV,Jun-17,3752,3559,193,5.1
CN5407500000000,54,075,Pocahontas County, WV,Jul-17,3734,3552,182,4.9
CN5407500000000,54,075,Pocahontas County, WV,Aug-17,3715,3519,196,5.3
CN5407500000000,54,075,Pocahontas County, WV,Sep-17,3657,3479,178,4.9
CN5407500000000,54,075,Pocahontas County, WV,Oct-17,3602,3411,191,5.3
CN5407500000000,54,075,Pocahontas County, WV,Nov-17,3550,3289,261,7.4
CN5407500000000,54,075,Pocahontas County, WV,Dec-17,3814,3594,220,5.8
CN5407500000000,54,075,Pocahontas County, WV,Jan-18,4001,3760,241,6.0
CN5407500000000,54,075,Pocahontas County, WV,Feb-18,4029,3776,253,6.3
CN5407500000000,54,075,Pocahontas County, WV,Mar-18,3983,3713,270,6.8
CN5407500000000,54,075,Pocahontas County, WV,Apr-18(p),3703,3362,341,9.2
CN4701900000000,47,019,Carter County, TN,Mar-17,24129,22942,1187,4.9
CN4701900000000,47,019,Carter County, TN,Apr-17,24140,23179,961,4.0
CN4701900000000,47,019,Carter County, TN,May-17,23913,22967,946,4.0
CN4701900000000,47,019,Carter County, TN,Jun-17,23719,22565,1154,4.9
CN4701900000000,47,019,Carter County, TN,Jul-17,23845,22745,1100,4.6
CN4701900000000,47,019,Carter County, TN,Aug-17,23700,22631,1069,4.5
CN4701900000000,47,019,Carter County, TN,Sep-17,24001,23067,934,3.9
CN4701900000000,47,019,Carter County, TN,Oct-17,23983,23084,899,3.7
CN4701900000000,47,019,Carter County, TN,Nov-17,23781,22883,898,3.8
CN4701900000000,47,019,Carter County, TN,Dec-17,23787,22876,911,3.8
CN4701900000000,47,019,Carter County, TN,Jan-18,23651,22525,1126,4.8
CN4701900000000,47,019,Carter County, TN,Feb-18,24033,22946,1087,4.5
CN4701900000000,47,019,Carter County, TN,Mar-18,24007,23020,987,4.1
CN4701900000000,47,019,Carter County, TN,Apr-18(p),24131,23321,810,3.4
CN1716100000000,17,161,Rock Island County, IL,Mar-17,70382,66528,3854,5.5
CN1716100000000,17,161,Rock Island County, IL,Apr-17,70043,66972,3071,4.4
CN1716100000000,17,161,Rock Island County, IL,May-17,69936,66815,3121,4.5
CN1716100000000,17,161,Rock Island County, IL,Jun-17,70807,67455,3352,4.7
CN1716100000000,17,161,Rock Island County, IL,Jul-17,71720,68270,3450,4.8
CN1716100000000,17,161,Rock Island County, IL,Aug-17,70983,67496,3487,4.9
CN1716100000000,17,161,Rock Island County, IL,Sep-17,70659,67255,3404,4.8
CN1716100000000,17,161,Rock Island County, IL,Oct-17,70491,67219,3272,4.6
CN1716100000000,17,161,Rock Island County, IL,Nov-17,70994,67928,3066,4.3
CN1716100000000,17,161,Rock Island County, IL,Dec-17,70785,67594,3191,4.5
CN1716100000000,17,161,Rock Island County, IL,Jan-18,70880,67216,3664,5.2
CN1716100000000,17,161,Rock Island County, IL,Feb-18,70969,67510,3459,4.9
CN1716100000000,17,161,Rock Island County, IL,Mar-18,72247,68670,3577,5.0
CN1716100000000,17,161,Rock Island County, IL,Apr-18(p),71926,69048,2878,4.0
CN1812300000000,18,123,Perry County, IN,Mar-17,9189,8853,336,3.7
CN1812300000000,18,123,Perry County, IN,Apr-17,9187,8912,275,3.0
CN1812300000000,18,123,Perry County, IN,May-17,9282,8989,293,3.2
CN1812300000000,18,123,Perry County, IN,Jun-17,9406,9067,339,3.6
CN1812300000000,18,123,Perry County, IN,Jul-17,9384,8996,388,4.1
CN1812300000000,18,123,Perry County, IN,Aug-17,9342,8936,406,4.3
CN1812300000000,18,123,Perry County, IN,Sep-17,9193,8861,332,3.6
CN1812300000000,18,123,Perry County, IN,Oct-17,9140,8816,324,3.5
CN1812300000000,18,123,Perry County, IN,Nov-17,9121,8791,330,3.6
CN1812300000000,18,123,Perry County, IN,Dec-17,9092,8757,335,3.7
CN1812300000000,18,123,Perry County, IN,Jan-18,9022,8653,369,4.1
CN1812300000000,18,123,Perry County, IN,Feb-18,9125,8742,383,4.2
CN1812300000000,18,123,Perry County, IN,Mar-18,9202,8861,341,3.7
CN1812300000000,18,123,Perry County, IN,Apr-18(p),9200,8906,294,3.2
CN4208700000000,42,087,Mifflin County, PA,Mar-17,20739,19480,1259,6.1
CN4208700000000,42,087,Mifflin County, PA,Apr-17,20666,19670,996,4.8
CN4208700000000,42,087,Mifflin County, PA,May-17,20553,19523,1030,5.0
CN4208700000000,42,087,Mifflin County, PA,Jun-17,21023,19886,1137,5.4
CN4208700000000,42,087,Mifflin County, PA,Jul-17,21157,20012,1145,5.4
CN4208700000000,42,087,Mifflin County, PA,Aug-17,20853,19704,1149,5.5
CN4208700000000,42,087,Mifflin County, PA,Sep-17,20532,19617,915,4.5
CN4208700000000,42,087,Mifflin County, PA,Oct-17,20327,19426,901,4.4
CN4208700000000,42,087,Mifflin County, PA,Nov-17,20276,19310,966,4.8
CN4208700000000,42,087,Mifflin County, PA,Dec-17,20292,19235,1057,5.2
CN4208700000000,42,087,Mifflin County, PA,Jan-18,20410,19148,1262,6.2
CN4208700000000,42,087,Mifflin County, PA,Feb-18,20457,19203,1254,6.1
CN4208700000000,42,087,Mifflin County, PA,Mar-18,20137,19043,1094,5.4
CN4208700000000,42,087,Mifflin County, PA,Apr-18(p),20058,19152,906,4.5
CN4715900000000,47,159,Smith County, TN,Mar-17,8937,8573,364,4.1
CN4715900000000,47,159,Smith County, TN,Apr-17,8901,8627,274,3.1
CN4715900000000,47,159,Smith County, TN,May-17,8899,8629,270,3.0
CN4715900000000,47,159,Smith County, TN,Jun-17,9058,8713,345,3.8
CN4715900000000,47,159,Smith County, TN,Jul-17,9099,8768,331,3.6
CN4715900000000,47,159,Smith County, TN,Aug-17,9035,8726,309,3.4
CN4715900000000,47,159,Smith County, TN,Sep-17,9098,8831,267,2.9
CN4715900000000,47,159,Smith County, TN,Oct-17,9056,8807,249,2.7
CN4715900000000,47,159,Smith County, TN,Nov-17,9035,8773,262,2.9
CN4715900000000,47,159,Smith County, TN,Dec-17,9021,8766,255,2.8
CN4715900000000,47,159,Smith County, TN,Jan-18,9003,8690,313,3.5
CN4715900000000,47,159,Smith County, TN,Feb-18,9126,8813,313,3.4
CN4715900000000,47,159,Smith County, TN,Mar-18,9111,8824,287,3.2
CN4715900000000,47,159,Smith County, TN,Apr-18(p),9142,8928,214,2.3
CN1319100000000,13,191,McIntosh County, GA,Mar-17,6118,5788,330,5.4
CN1319100000000,13,191,McIntosh County, GA,Apr-17,6111,5825,286,4.7
CN1319100000000,13,191,McIntosh County, GA,May-17,6158,5867,291,4.7
CN1319100000000,13,191,McIntosh County, GA,Jun-17,6229,5929,300,4.8
CN1319100000000,13,191,McIntosh County, GA,Jul-17,6243,5928,315,5.0
CN1319100000000,13,191,McIntosh County, GA,Aug-17,6163,5844,319,5.2
CN1319100000000,13,191,McIntosh County, GA,Sep-17,6030,5680,350,5.8
CN1319100000000,13,191,McIntosh County, GA,Oct-17,6077,5784,293,4.8
CN1319100000000,13,191,McIntosh County, GA,Nov-17,6041,5783,258,4.3
CN1319100000000,13,191,McIntosh County, GA,Dec-17,6087,5813,274,4.5
CN1319100000000,13,191,McIntosh County, GA,Jan-18,6134,5845,289,4.7
CN1319100000000,13,191,McIntosh County, GA,Feb-18,6089,5802,287,4.7
CN1319100000000,13,191,McIntosh County, GA,Mar-18,6127,5856,271,4.4
CN1319100000000,13,191,McIntosh County, GA,Apr-18(p),6133,5905,228,3.7
CN1907300000000,19,073,Greene County, IA,Mar-17,5405,5248,157,2.9
CN1907300000000,19,073,Greene County, IA,Apr-17,5431,5270,161,3.0
CN1907300000000,19,073,Greene County, IA,May-17,5455,5284,171,3.1
CN1907300000000,19,073,Greene County, IA,Jun-17,5522,5342,180,3.3
CN1907300000000,19,073,Greene County, IA,Jul-17,5515,5328,187,3.4
CN1907300000000,19,073,Greene County, IA,Aug-17,5377,5211,166,3.1
CN1907300000000,19,073,Greene County, IA,Sep-17,5351,5229,122,2.3
CN1907300000000,19,073,Greene County, IA,Oct-17,5421,5318,103,1.9
CN1907300000000,19,073,Greene County, IA,Nov-17,5325,5217,108,2.0
CN1907300000000,19,073,Greene County, IA,Dec-17,5310,5197,113,2.1
CN1907300000000,19,073,Greene County, IA,Jan-18,5246,5095,151,2.9
CN1907300000000,19,073,Greene County, IA,Feb-18,5316,5161,155,2.9
CN1907300000000,19,073,Greene County, IA,Mar-18,5267,5137,130,2.5
CN1907300000000,19,073,Greene County, IA,Apr-18(p),5261,5133,128,2.4
CN4838900000000,48,389,Reeves County, TX,Mar-17,6403,6153,250,3.9
CN4838900000000,48,389,Reeves County, TX,Apr-17,6529,6297,232,3.6
CN4838900000000,48,389,Reeves County, TX,May-17,6688,6453,235,3.5
CN4838900000000,48,389,Reeves County, TX,Jun-17,6923,6692,231,3.3
CN4838900000000,48,389,Reeves County, TX,Jul-17,7061,6831,230,3.3
CN4838900000000,48,389,Reeves County, TX,Aug-17,7191,6890,301,4.2
CN4838900000000,48,389,Reeves County, TX,Sep-17,7449,7203,246,3.3
CN4838900000000,48,389,Reeves County, TX,Oct-17,7441,7226,215,2.9
CN4838900000000,48,389,Reeves County, TX,Nov-17,7382,7171,211,2.9
CN4838900000000,48,389,Reeves County, TX,Dec-17,7479,7277,202,2.7
CN4838900000000,48,389,Reeves County, TX,Jan-18,7737,7519,218,2.8
CN4838900000000,48,389,Reeves County, TX,Feb-18,7717,7502,215,2.8
CN4838900000000,48,389,Reeves County, TX,Mar-18,7723,7508,215,2.8
CN4838900000000,48,389,Reeves County, TX,Apr-18(p),7765,7573,192,2.5
CN4849500000000,48,495,Winkler County, TX,Mar-17,3187,2983,204,6.4
CN4849500000000,48,495,Winkler County, TX,Apr-17,3173,3005,168,5.3
CN4849500000000,48,495,Winkler County, TX,May-17,3255,3073,182,5.6
CN4849500000000,48,495,Winkler County, TX,Jun-17,3243,3071,172,5.3
CN4849500000000,48,495,Winkler County, TX,Jul-17,3261,3098,163,5.0
CN4849500000000,48,495,Winkler County, TX,Aug-17,3256,3090,166,5.1
CN4849500000000,48,495,Winkler County, TX,Sep-17,3283,3139,144,4.4
CN4849500000000,48,495,Winkler County, TX,Oct-17,3295,3167,128,3.9
CN4849500000000,48,495,Winkler County, TX,Nov-17,3300,3170,130,3.9
CN4849500000000,48,495,Winkler County, TX,Dec-17,3303,3179,124,3.8
CN4849500000000,48,495,Winkler County, TX,Jan-18,3346,3218,128,3.8
CN4849500000000,48,495,Winkler County, TX,Feb-18,3381,3257,124,3.7
CN4849500000000,48,495,Winkler County, TX,Mar-18,3396,3266,130,3.8
CN4849500000000,48,495,Winkler County, TX,Apr-18(p),3502,3386,116,3.3
CN3500900000000,35,009,Curry County, NM,Mar-17,22016,20959,1057,4.8
CN3500900000000,35,009,Curry County, NM,Apr-17,22086,21112,974,4.4
CN3500900000000,35,009,Curry County, NM,May-17,21919,20906,1013,4.6
CN3500900000000,35,009,Curry County, NM,Jun-17,21947,20726,1221,5.6
CN3500900000000,35,009,Curry County, NM,Jul-17,22111,20890,1221,5.5
CN3500900000000,35,009,Curry County, NM,Aug-17,21726,20596,1130,5.2
CN3500900000000,35,009,Curry County, NM,Sep-17,22042,20951,1091,4.9
CN3500900000000,35,009,Curry County, NM,Oct-17,21990,20948,1042,4.7
CN3500900000000,35,009,Curry County, NM,Nov-17,22096,21122,974,4.4
CN3500900000000,35,009,Curry County, NM,Dec-17,22139,21225,914,4.1
CN3500900000000,35,009,Curry County, NM,Jan-18,22230,21277,953,4.3
CN3500900000000,35,009,Curry County, NM,Feb-18,22567,21673,894,4.0
CN3500900000000,35,009,Curry County, NM,Mar-18,22517,21672,845,3.8
CN3500900000000,35,009,Curry County, NM,Apr-18(p),22417,21668,749,3.3
CN3200700000000,32,007,Elko County, NV,Mar-17,27800,26701,1099,4.0
CN3200700000000,32,007,Elko County, NV,Apr-17,27318,26306,1012,3.7
CN3200700000000,32,007,Elko County, NV,May-17,27436,26449,987,3.6
CN3200700000000,32,007,Elko County, NV,Jun-17,28002,26948,1054,3.8
CN3200700000000,32,007,Elko County, NV,Jul-17,27785,26725,1060,3.8
CN3200700000000,32,007,Elko County, NV,Aug-17,27612,26674,938,3.4
CN3200700000000,32,007,Elko County, NV,Sep-17,27251,26357,894,3.3
CN3200700000000,32,007,Elko County, NV,Oct-17,26924,26048,876,3.3
CN3200700000000,32,007,Elko County, NV,Nov-17,26968,26081,887,3.3
CN3200700000000,32,007,Elko County, NV,Dec-17,26967,26071,896,3.3
CN3200700000000,32,007,Elko County, NV,Jan-18,26810,25694,1116,4.2
CN3200700000000,32,007,Elko County, NV,Feb-18,26856,25831,1025,3.8
CN3200700000000,32,007,Elko County, NV,Mar-18,27326,26334,992,3.6
CN3200700000000,32,007,Elko County, NV,Apr-18(p),26692,25788,904,3.4
CN3007700000000,30,077,Powell County, MT,Mar-17,2839,2676,163,5.7
CN3007700000000,30,077,Powell County, MT,Apr-17,2888,2755,133,4.6
CN3007700000000,30,077,Powell County, MT,May-17,2937,2820,117,4.0
CN3007700000000,30,077,Powell County, MT,Jun-17,2976,2861,115,3.9
CN3007700000000,30,077,Powell County, MT,Jul-17,2973,2876,97,3.3
CN3007700000000,30,077,Powell County, MT,Aug-17,2954,2858,96,3.2
CN3007700000000,30,077,Powell County, MT,Sep-17,2879,2787,92,3.2
CN3007700000000,30,077,Powell County, MT,Oct-17,2886,2777,109,3.8
CN3007700000000,30,077,Powell County, MT,Nov-17,2864,2737,127,4.4
CN3007700000000,30,077,Powell County, MT,Dec-17,2835,2701,134,4.7
CN3007700000000,30,077,Powell County, MT,Jan-18,2775,2611,164,5.9
CN3007700000000,30,077,Powell County, MT,Feb-18,2805,2629,176,6.3
CN3007700000000,30,077,Powell County, MT,Mar-18,2790,2625,165,5.9
CN3007700000000,30,077,Powell County, MT,Apr-18(p),2785,2661,124,4.5
CN4715300000000,47,153,Sequatchie County, TN,Mar-17,6036,5730,306,5.1
CN4715300000000,47,153,Sequatchie County, TN,Apr-17,6019,5764,255,4.2
CN4715300000000,47,153,Sequatchie County, TN,May-17,6015,5767,248,4.1
CN4715300000000,47,153,Sequatchie County, TN,Jun-17,6180,5857,323,5.2
CN4715300000000,47,153,Sequatchie County, TN,Jul-17,6213,5841,372,6.0
CN4715300000000,47,153,Sequatchie County, TN,Aug-17,6099,5785,314,5.1
CN4715300000000,47,153,Sequatchie County, TN,Sep-17,6126,5852,274,4.5
CN4715300000000,47,153,Sequatchie County, TN,Oct-17,6137,5866,271,4.4
CN4715300000000,47,153,Sequatchie County, TN,Nov-17,6109,5853,256,4.2
CN4715300000000,47,153,Sequatchie County, TN,Dec-17,6107,5839,268,4.4
CN4715300000000,47,153,Sequatchie County, TN,Jan-18,6097,5805,292,4.8
CN4715300000000,47,153,Sequatchie County, TN,Feb-18,6161,5887,274,4.4
CN4715300000000,47,153,Sequatchie County, TN,Mar-18,6175,5904,271,4.4
CN4715300000000,47,153,Sequatchie County, TN,Apr-18(p),6226,6006,220,3.5
CN1500900000000,15,009,Maui County, HI,Mar-17,86871,84506,2365,2.7
CN1500900000000,15,009,Maui County, HI,Apr-17,86597,84184,2413,2.8
CN1500900000000,15,009,Maui County, HI,May-17,86401,84182,2219,2.6
CN1500900000000,15,009,Maui County, HI,Jun-17,87832,85126,2706,3.1
CN1500900000000,15,009,Maui County, HI,Jul-17,87817,85603,2214,2.5
CN1500900000000,15,009,Maui County, HI,Aug-17,87384,85420,1964,2.2
CN1500900000000,15,009,Maui County, HI,Sep-17,85406,83394,2012,2.4
CN1500900000000,15,009,Maui County, HI,Oct-17,85372,83522,1850,2.2
CN1500900000000,15,009,Maui County, HI,Nov-17,85323,83423,1900,2.2
CN1500900000000,15,009,Maui County, HI,Dec-17,85513,83991,1522,1.8
CN1500900000000,15,009,Maui County, HI,Jan-18,86209,84392,1817,2.1
CN1500900000000,15,009,Maui County, HI,Feb-18,85682,83950,1732,2.0
CN1500900000000,15,009,Maui County, HI,Mar-18,86429,84727,1702,2.0
CN1500900000000,15,009,Maui County, HI,Apr-18(p),86536,84842,1694,2.0
CN4800900000000,48,009,Archer County, TX,Mar-17,4144,3992,152,3.7
CN4800900000000,48,009,Archer County, TX,Apr-17,4140,4005,135,3.3
CN4800900000000,48,009,Archer County, TX,May-17,4133,3994,139,3.4
CN4800900000000,48,009,Archer County, TX,Jun-17,4125,3974,151,3.7
CN4800900000000,48,009,Archer County, TX,Jul-17,4078,3937,141,3.5
CN4800900000000,48,009,Archer County, TX,Aug-17,4065,3925,140,3.4
CN4800900000000,48,009,Archer County, TX,Sep-17,4066,3936,130,3.2
CN4800900000000,48,009,Archer County, TX,Oct-17,4077,3956,121,3.0
CN4800900000000,48,009,Archer County, TX,Nov-17,4063,3939,124,3.1
CN4800900000000,48,009,Archer County, TX,Dec-17,4065,3949,116,2.9
CN4800900000000,48,009,Archer County, TX,Jan-18,4065,3931,134,3.3
CN4800900000000,48,009,Archer County, TX,Feb-18,4124,3990,134,3.2
CN4800900000000,48,009,Archer County, TX,Mar-18,4163,4024,139,3.3
CN4800900000000,48,009,Archer County, TX,Apr-18(p),4135,4016,119,2.9
CN1810700000000,18,107,Montgomery County, IN,Mar-17,19023,18436,587,3.1
CN1810700000000,18,107,Montgomery County, IN,Apr-17,18971,18493,478,2.5
CN1810700000000,18,107,Montgomery County, IN,May-17,19217,18698,519,2.7
CN1810700000000,18,107,Montgomery County, IN,Jun-17,19174,18579,595,3.1
CN1810700000000,18,107,Montgomery County, IN,Jul-17,19135,18536,599,3.1
CN1810700000000,18,107,Montgomery County, IN,Aug-17,18894,18220,674,3.6
CN1810700000000,18,107,Montgomery County, IN,Sep-17,18851,18313,538,2.9
CN1810700000000,18,107,Montgomery County, IN,Oct-17,18855,18337,518,2.7
CN1810700000000,18,107,Montgomery County, IN,Nov-17,18796,18265,531,2.8
CN1810700000000,18,107,Montgomery County, IN,Dec-17,18581,18098,483,2.6
CN1810700000000,18,107,Montgomery County, IN,Jan-18,18458,17885,573,3.1
CN1810700000000,18,107,Montgomery County, IN,Feb-18,18835,18239,596,3.2
CN1810700000000,18,107,Montgomery County, IN,Mar-18,19101,18561,540,2.8
CN1810700000000,18,107,Montgomery County, IN,Apr-18(p),19126,18645,481,2.5
CN3115100000000,31,151,Saline County, NE,Mar-17,7355,7102,253,3.4
CN3115100000000,31,151,Saline County, NE,Apr-17,7374,7167,207,2.8
CN3115100000000,31,151,Saline County, NE,May-17,7360,7167,193,2.6
CN3115100000000,31,151,Saline County, NE,Jun-17,7538,7300,238,3.2
CN3115100000000,31,151,Saline County, NE,Jul-17,7431,7200,231,3.1
CN3115100000000,31,151,Saline County, NE,Aug-17,7291,7083,208,2.9
CN3115100000000,31,151,Saline County, NE,Sep-17,7217,7011,206,2.9
CN3115100000000,31,151,Saline County, NE,Oct-17,7243,7064,179,2.5
CN3115100000000,31,151,Saline County, NE,Nov-17,7238,7069,169,2.3
CN3115100000000,31,151,Saline County, NE,Dec-17,7261,7035,226,3.1
CN3115100000000,31,151,Saline County, NE,Jan-18,7357,7086,271,3.7
CN3115100000000,31,151,Saline County, NE,Feb-18,7385,7128,257,3.5
CN3115100000000,31,151,Saline County, NE,Mar-18,7356,7117,239,3.2
CN3115100000000,31,151,Saline County, NE,Apr-18(p),7308,7111,197,2.7
CN1705500000000,17,055,Franklin County, IL,Mar-17,16481,15400,1081,6.6
CN1705500000000,17,055,Franklin County, IL,Apr-17,16496,15547,949,5.8
CN1705500000000,17,055,Franklin County, IL,May-17,16370,15415,955,5.8
CN1705500000000,17,055,Franklin County, IL,Jun-17,16331,15309,1022,6.3
CN1705500000000,17,055,Franklin County, IL,Jul-17,16458,15388,1070,6.5
CN1705500000000,17,055,Franklin County, IL,Aug-17,16468,15414,1054,6.4
CN1705500000000,17,055,Franklin County, IL,Sep-17,16534,15581,953,5.8
CN1705500000000,17,055,Franklin County, IL,Oct-17,16444,15545,899,5.5
CN1705500000000,17,055,Franklin County, IL,Nov-17,16446,15490,956,5.8
CN1705500000000,17,055,Franklin County, IL,Dec-17,16267,15325,942,5.8
CN1705500000000,17,055,Franklin County, IL,Jan-18,16041,15047,994,6.2
CN1705500000000,17,055,Franklin County, IL,Feb-18,16153,15231,922,5.7
CN1705500000000,17,055,Franklin County, IL,Mar-18,16556,15598,958,5.8
CN1705500000000,17,055,Franklin County, IL,Apr-18(p),16698,15884,814,4.9
CN3106100000000,31,061,Franklin County, NE,Mar-17,1467,1417,50,3.4
CN3106100000000,31,061,Franklin County, NE,Apr-17,1496,1454,42,2.8
CN3106100000000,31,061,Franklin County, NE,May-17,1523,1472,51,3.3
CN3106100000000,31,061,Franklin County, NE,Jun-17,1578,1527,51,3.2
CN3106100000000,31,061,Franklin County, NE,Jul-17,1544,1493,51,3.3
CN3106100000000,31,061,Franklin County, NE,Aug-17,1477,1433,44,3.0
CN3106100000000,31,061,Franklin County, NE,Sep-17,1417,1383,34,2.4
CN3106100000000,31,061,Franklin County, NE,Oct-17,1439,1404,35,2.4
CN3106100000000,31,061,Franklin County, NE,Nov-17,1441,1410,31,2.2
CN3106100000000,31,061,Franklin County, NE,Dec-17,1441,1400,41,2.8
CN3106100000000,31,061,Franklin County, NE,Jan-18,1471,1426,45,3.1
CN3106100000000,31,061,Franklin County, NE,Feb-18,1443,1397,46,3.2
CN3106100000000,31,061,Franklin County, NE,Mar-18,1467,1422,45,3.1
CN3106100000000,31,061,Franklin County, NE,Apr-18(p),1476,1431,45,3.0
CN1317500000000,13,175,Laurens County, GA,Mar-17,19390,18252,1138,5.9
CN1317500000000,13,175,Laurens County, GA,Apr-17,19307,18228,1079,5.6
CN1317500000000,13,175,Laurens County, GA,May-17,19432,18358,1074,5.5
CN1317500000000,13,175,Laurens County, GA,Jun-17,19451,18290,1161,6.0
CN1317500000000,13,175,Laurens County, GA,Jul-17,19424,18235,1189,6.1
CN1317500000000,13,175,Laurens County, GA,Aug-17,19314,18167,1147,5.9
CN1317500000000,13,175,Laurens County, GA,Sep-17,19554,18458,1096,5.6
CN1317500000000,13,175,Laurens County, GA,Oct-17,19553,18373,1180,6.0
CN1317500000000,13,175,Laurens County, GA,Nov-17,19444,18430,1014,5.2
CN1317500000000,13,175,Laurens County, GA,Dec-17,19537,18488,1049,5.4
CN1317500000000,13,175,Laurens County, GA,Jan-18,19625,18492,1133,5.8
CN1317500000000,13,175,Laurens County, GA,Feb-18,19728,18639,1089,5.5
CN1317500000000,13,175,Laurens County, GA,Mar-18,19709,18726,983,5.0
CN1317500000000,13,175,Laurens County, GA,Apr-18(p),19509,18628,881,4.5
CN4608500000000,46,085,Lyman County, SD,Mar-17,1682,1608,74,4.4
CN4608500000000,46,085,Lyman County, SD,Apr-17,1717,1644,73,4.3
CN4608500000000,46,085,Lyman County, SD,May-17,1765,1691,74,4.2
CN4608500000000,46,085,Lyman County, SD,Jun-17,1842,1744,98,5.3
CN4608500000000,46,085,Lyman County, SD,Jul-17,1859,1758,101,5.4
CN4608500000000,46,085,Lyman County, SD,Aug-17,1811,1713,98,5.4
CN4608500000000,46,085,Lyman County, SD,Sep-17,1767,1672,95,5.4
CN4608500000000,46,085,Lyman County, SD,Oct-17,1754,1656,98,5.6
CN4608500000000,46,085,Lyman County, SD,Nov-17,1713,1621,92,5.4
CN4608500000000,46,085,Lyman County, SD,Dec-17,1716,1626,90,5.2
CN4608500000000,46,085,Lyman County, SD,Jan-18,1674,1590,84,5.0
CN4608500000000,46,085,Lyman County, SD,Feb-18,1671,1580,91,5.4
CN4608500000000,46,085,Lyman County, SD,Mar-18,1681,1605,76,4.5
CN4608500000000,46,085,Lyman County, SD,Apr-18(p),1657,1584,73,4.4
CN1308500000000,13,085,Dawson County, GA,Mar-17,11621,11157,464,4.0
CN1308500000000,13,085,Dawson County, GA,Apr-17,11640,11207,433,3.7
CN1308500000000,13,085,Dawson County, GA,May-17,11670,11227,443,3.8
CN1308500000000,13,085,Dawson County, GA,Jun-17,11700,11228,472,4.0
CN1308500000000,13,085,Dawson County, GA,Jul-17,11776,11288,488,4.1
CN1308500000000,13,085,Dawson County, GA,Aug-17,11689,11216,473,4.0
CN1308500000000,13,085,Dawson County, GA,Sep-17,11803,11367,436,3.7
CN1308500000000,13,085,Dawson County, GA,Oct-17,11757,11329,428,3.6
CN1308500000000,13,085,Dawson County, GA,Nov-17,11768,11353,415,3.5
CN1308500000000,13,085,Dawson County, GA,Dec-17,11770,11354,416,3.5
CN1308500000000,13,085,Dawson County, GA,Jan-18,11795,11363,432,3.7
CN1308500000000,13,085,Dawson County, GA,Feb-18,11944,11501,443,3.7
CN1308500000000,13,085,Dawson County, GA,Mar-18,11945,11528,417,3.5
CN1308500000000,13,085,Dawson County, GA,Apr-18(p),11903,11537,366,3.1
CN1801700000000,18,017,Cass County, IN,Mar-17,18016,17274,742,4.1
CN1801700000000,18,017,Cass County, IN,Apr-17,17808,17224,584,3.3
CN1801700000000,18,017,Cass County, IN,May-17,18044,17453,591,3.3
CN1801700000000,18,017,Cass County, IN,Jun-17,18299,17578,721,3.9
CN1801700000000,18,017,Cass County, IN,Jul-17,17890,17236,654,3.7
CN1801700000000,18,017,Cass County, IN,Aug-17,17834,17117,717,4.0
CN1801700000000,18,017,Cass County, IN,Sep-17,17760,17111,649,3.7
CN1801700000000,18,017,Cass County, IN,Oct-17,17509,16927,582,3.3
CN1801700000000,18,017,Cass County, IN,Nov-17,17468,16887,581,3.3
CN1801700000000,18,017,Cass County, IN,Dec-17,17337,16752,585,3.4
CN1801700000000,18,017,Cass County, IN,Jan-18,17221,16509,712,4.1
CN1801700000000,18,017,Cass County, IN,Feb-18,17745,16970,775,4.4
CN1801700000000,18,017,Cass County, IN,Mar-18,17888,17192,696,3.9
CN1801700000000,18,017,Cass County, IN,Apr-18(p),17863,17257,606,3.4
CN4803100000000,48,031,Blanco County, TX,Mar-17,6282,6095,187,3.0
CN4803100000000,48,031,Blanco County, TX,Apr-17,6192,6035,157,2.5
CN4803100000000,48,031,Blanco County, TX,May-17,6215,6048,167,2.7
CN4803100000000,48,031,Blanco County, TX,Jun-17,6258,6087,171,2.7
CN4803100000000,48,031,Blanco County, TX,Jul-17,6182,6001,181,2.9
CN4803100000000,48,031,Blanco County, TX,Aug-17,6164,5993,171,2.8
CN4803100000000,48,031,Blanco County, TX,Sep-17,6161,6005,156,2.5
CN4803100000000,48,031,Blanco County, TX,Oct-17,6224,6072,152,2.4
CN4803100000000,48,031,Blanco County, TX,Nov-17,6220,6062,158,2.5
CN4803100000000,48,031,Blanco County, TX,Dec-17,6264,6117,147,2.3
CN4803100000000,48,031,Blanco County, TX,Jan-18,6374,6200,174,2.7
CN4803100000000,48,031,Blanco County, TX,Feb-18,6458,6283,175,2.7
CN4803100000000,48,031,Blanco County, TX,Mar-18,6511,6336,175,2.7
CN4803100000000,48,031,Blanco County, TX,Apr-18(p),6413,6262,151,2.4
CN4006900000000,40,069,Johnston County, OK,Mar-17,4819,4608,211,4.4
CN4006900000000,40,069,Johnston County, OK,Apr-17,4998,4814,184,3.7
CN4006900000000,40,069,Johnston County, OK,May-17,4973,4765,208,4.2
CN4006900000000,40,069,Johnston County, OK,Jun-17,5029,4804,225,4.5
CN4006900000000,40,069,Johnston County, OK,Jul-17,4950,4748,202,4.1
CN4006900000000,40,069,Johnston County, OK,Aug-17,5016,4814,202,4.0
CN4006900000000,40,069,Johnston County, OK,Sep-17,5128,4936,192,3.7
CN4006900000000,40,069,Johnston County, OK,Oct-17,5148,4972,176,3.4
CN4006900000000,40,069,Johnston County, OK,Nov-17,5184,5009,175,3.4
CN4006900000000,40,069,Johnston County, OK,Dec-17,5129,4963,166,3.2
CN4006900000000,40,069,Johnston County, OK,Jan-18,5191,5012,179,3.4
CN4006900000000,40,069,Johnston County, OK,Feb-18,5310,5123,187,3.5
CN4006900000000,40,069,Johnston County, OK,Mar-18,5322,5146,176,3.3
CN4006900000000,40,069,Johnston County, OK,Apr-18(p),5349,5179,170,3.2
CN3503100000000,35,031,McKinley County, NM,Mar-17,24208,22115,2093,8.6
CN3503100000000,35,031,McKinley County, NM,Apr-17,24036,22150,1886,7.8
CN3503100000000,35,031,McKinley County, NM,May-17,23795,21911,1884,7.9
CN3503100000000,35,031,McKinley County, NM,Jun-17,24346,21957,2389,9.8
CN3503100000000,35,031,McKinley County, NM,Jul-17,24074,21707,2367,9.8
CN3503100000000,35,031,McKinley County, NM,Aug-17,24195,21984,2211,9.1
CN3503100000000,35,031,McKinley County, NM,Sep-17,24197,22090,2107,8.7
CN3503100000000,35,031,McKinley County, NM,Oct-17,24315,22321,1994,8.2
CN3503100000000,35,031,McKinley County, NM,Nov-17,24473,22497,1976,8.1
CN3503100000000,35,031,McKinley County, NM,Dec-17,24508,22576,1932,7.9
CN3503100000000,35,031,McKinley County, NM,Jan-18,24537,22559,1978,8.1
CN3503100000000,35,031,McKinley County, NM,Feb-18,24304,22441,1863,7.7
CN3503100000000,35,031,McKinley County, NM,Mar-18,24156,22429,1727,7.1
CN3503100000000,35,031,McKinley County, NM,Apr-18(p),24108,22647,1461,6.1
CN5106100000000,51,061,Fauquier County, VA,Mar-17,36106,34878,1228,3.4
CN5106100000000,51,061,Fauquier County, VA,Apr-17,36411,35320,1091,3.0
CN5106100000000,51,061,Fauquier County, VA,May-17,36495,35319,1176,3.2
CN5106100000000,51,061,Fauquier County, VA,Jun-17,36989,35726,1263,3.4
CN5106100000000,51,061,Fauquier County, VA,Jul-17,37179,35902,1277,3.4
CN5106100000000,51,061,Fauquier County, VA,Aug-17,36417,35156,1261,3.5
CN5106100000000,51,061,Fauquier County, VA,Sep-17,36566,35400,1166,3.2
CN5106100000000,51,061,Fauquier County, VA,Oct-17,36281,35211,1070,2.9
CN5106100000000,51,061,Fauquier County, VA,Nov-17,36261,35180,1081,3.0
CN5106100000000,51,061,Fauquier County, VA,Dec-17,36354,35337,1017,2.8
CN5106100000000,51,061,Fauquier County, VA,Jan-18,36258,35100,1158,3.2
CN5106100000000,51,061,Fauquier County, VA,Feb-18,36645,35600,1045,2.9
CN5106100000000,51,061,Fauquier County, VA,Mar-18,36564,35512,1052,2.9
CN5106100000000,51,061,Fauquier County, VA,Apr-18(p),36800,35916,884,2.4
CN2201500000000,22,015,Bossier Parish, LA,Mar-17,56847,54215,2632,4.6
CN2201500000000,22,015,Bossier Parish, LA,Apr-17,56685,54198,2487,4.4
CN2201500000000,22,015,Bossier Parish, LA,May-17,56349,53803,2546,4.5
CN2201500000000,22,015,Bossier Parish, LA,Jun-17,57322,54423,2899,5.1
CN2201500000000,22,015,Bossier Parish, LA,Jul-17,57640,54825,2815,4.9
CN2201500000000,22,015,Bossier Parish, LA,Aug-17,57119,54323,2796,4.9
CN2201500000000,22,015,Bossier Parish, LA,Sep-17,57186,54697,2489,4.4
CN2201500000000,22,015,Bossier Parish, LA,Oct-17,56898,54709,2189,3.8
CN2201500000000,22,015,Bossier Parish, LA,Nov-17,56884,54705,2179,3.8
CN2201500000000,22,015,Bossier Parish, LA,Dec-17,56639,54600,2039,3.6
CN2201500000000,22,015,Bossier Parish, LA,Jan-18,56818,54642,2176,3.8
CN2201500000000,22,015,Bossier Parish, LA,Feb-18,57506,55525,1981,3.4
CN2201500000000,22,015,Bossier Parish, LA,Mar-18,57440,55245,2195,3.8
CN2201500000000,22,015,Bossier Parish, LA,Apr-18(p),57397,55163,2234,3.9
CN5503100000000,55,031,Douglas County, WI,Mar-17,23777,22505,1272,5.3
CN5503100000000,55,031,Douglas County, WI,Apr-17,23733,22645,1088,4.6
CN5503100000000,55,031,Douglas County, WI,May-17,23646,22684,962,4.1
CN5503100000000,55,031,Douglas County, WI,Jun-17,23856,22666,1190,5.0
CN5503100000000,55,031,Douglas County, WI,Jul-17,23829,22813,1016,4.3
CN5503100000000,55,031,Douglas County, WI,Aug-17,23716,22642,1074,4.5
CN5503100000000,55,031,Douglas County, WI,Sep-17,23976,23106,870,3.6
CN5503100000000,55,031,Douglas County, WI,Oct-17,23793,23005,788,3.3
CN5503100000000,55,031,Douglas County, WI,Nov-17,23771,22878,893,3.8
CN5503100000000,55,031,Douglas County, WI,Dec-17,23579,22710,869,3.7
CN5503100000000,55,031,Douglas County, WI,Jan-18,23655,22681,974,4.1
CN5503100000000,55,031,Douglas County, WI,Feb-18,24198,23060,1138,4.7
CN5503100000000,55,031,Douglas County, WI,Mar-18,24062,22990,1072,4.5
CN5503100000000,55,031,Douglas County, WI,Apr-18(p),23872,22895,977,4.1
CN0803100000000,08,031,Denver County/city, CO,Mar-17,391395,380621,10774,2.8
CN0803100000000,08,031,Denver County/city, CO,Apr-17,391658,381828,9830,2.5
CN0803100000000,08,031,Denver County/city, CO,May-17,394029,384411,9618,2.4
CN0803100000000,08,031,Denver County/city, CO,Jun-17,399429,388252,11177,2.8
CN0803100000000,08,031,Denver County/city, CO,Jul-17,400947,390204,10743,2.7
CN0803100000000,08,031,Denver County/city, CO,Aug-17,401082,390166,10916,2.7
CN0803100000000,08,031,Denver County/city, CO,Sep-17,403089,392337,10752,2.7
CN0803100000000,08,031,Denver County/city, CO,Oct-17,401937,391091,10846,2.7
CN0803100000000,08,031,Denver County/city, CO,Nov-17,402581,391348,11233,2.8
CN0803100000000,08,031,Denver County/city, CO,Dec-17,401313,389719,11594,2.9
CN0803100000000,08,031,Denver County/city, CO,Jan-18,400173,387070,13103,3.3
CN0803100000000,08,031,Denver County/city, CO,Feb-18,406227,393087,13140,3.2
CN0803100000000,08,031,Denver County/city, CO,Mar-18,406002,394589,11413,2.8
CN0803100000000,08,031,Denver County/city, CO,Apr-18(p),405326,395173,10153,2.5
CN1328100000000,13,281,Towns County, GA,Mar-17,3777,3528,249,6.6
CN1328100000000,13,281,Towns County, GA,Apr-17,3816,3582,234,6.1
CN1328100000000,13,281,Towns County, GA,May-17,3758,3528,230,6.1
CN1328100000000,13,281,Towns County, GA,Jun-17,3846,3566,280,7.3
CN1328100000000,13,281,Towns County, GA,Jul-17,3846,3575,271,7.0
CN1328100000000,13,281,Towns County, GA,Aug-17,4039,3782,257,6.4
CN1328100000000,13,281,Towns County, GA,Sep-17,4117,3879,238,5.8
CN1328100000000,13,281,Towns County, GA,Oct-17,4061,3824,237,5.8
CN1328100000000,13,281,Towns County, GA,Nov-17,3891,3661,230,5.9
CN1328100000000,13,281,Towns County, GA,Dec-17,3721,3491,230,6.2
CN1328100000000,13,281,Towns County, GA,Jan-18,3799,3559,240,6.3
CN1328100000000,13,281,Towns County, GA,Feb-18,3710,3450,260,7.0
CN1328100000000,13,281,Towns County, GA,Mar-18,3737,3509,228,6.1
CN1328100000000,13,281,Towns County, GA,Apr-18(p),3800,3595,205,5.4
CN2608500000000,26,085,Lake County, MI,Mar-17,3677,3352,325,8.8
CN2608500000000,26,085,Lake County, MI,Apr-17,3708,3450,258,7.0
CN2608500000000,26,085,Lake County, MI,May-17,3810,3545,265,7.0
CN2608500000000,26,085,Lake County, MI,Jun-17,3825,3541,284,7.4
CN2608500000000,26,085,Lake County, MI,Jul-17,3929,3562,367,9.3
CN2608500000000,26,085,Lake County, MI,Aug-17,3870,3550,320,8.3
CN2608500000000,26,085,Lake County, MI,Sep-17,3818,3546,272,7.1
CN2608500000000,26,085,Lake County, MI,Oct-17,3753,3491,262,7.0
CN2608500000000,26,085,Lake County, MI,Nov-17,3714,3450,264,7.1
CN2608500000000,26,085,Lake County, MI,Dec-17,3719,3393,326,8.8
CN2608500000000,26,085,Lake County, MI,Jan-18,3725,3374,351,9.4
CN2608500000000,26,085,Lake County, MI,Feb-18,3780,3400,380,10.1
CN2608500000000,26,085,Lake County, MI,Mar-18,3742,3398,344,9.2
CN2608500000000,26,085,Lake County, MI,Apr-18(p),3756,3473,283,7.5
CN5173000000000,51,730,Petersburg city, VA,Mar-17,13426,12407,1019,7.6
CN5173000000000,51,730,Petersburg city, VA,Apr-17,13404,12439,965,7.2
CN5173000000000,51,730,Petersburg city, VA,May-17,13351,12452,899,6.7
CN5173000000000,51,730,Petersburg city, VA,Jun-17,13432,12487,945,7.0
CN5173000000000,51,730,Petersburg city, VA,Jul-17,13573,12580,993,7.3
CN5173000000000,51,730,Petersburg city, VA,Aug-17,13472,12453,1019,7.6
CN5173000000000,51,730,Petersburg city, VA,Sep-17,13434,12514,920,6.8
CN5173000000000,51,730,Petersburg city, VA,Oct-17,13385,12481,904,6.8
CN5173000000000,51,730,Petersburg city, VA,Nov-17,13285,12377,908,6.8
CN5173000000000,51,730,Petersburg city, VA,Dec-17,13311,12323,988,7.4
CN5173000000000,51,730,Petersburg city, VA,Jan-18,13284,12329,955,7.2
CN5173000000000,51,730,Petersburg city, VA,Feb-18,13418,12500,918,6.8
CN5173000000000,51,730,Petersburg city, VA,Mar-18,13497,12584,913,6.8
CN5173000000000,51,730,Petersburg city, VA,Apr-18(p),13445,12635,810,6.0
CN2212100000000,22,121,West Baton Rouge Parish, LA,Mar-17,13254,12654,600,4.5
CN2212100000000,22,121,West Baton Rouge Parish, LA,Apr-17,13221,12650,571,4.3
CN2212100000000,22,121,West Baton Rouge Parish, LA,May-17,13129,12541,588,4.5
CN2212100000000,22,121,West Baton Rouge Parish, LA,Jun-17,13284,12554,730,5.5
CN2212100000000,22,121,West Baton Rouge Parish, LA,Jul-17,13359,12654,705,5.3
CN2212100000000,22,121,West Baton Rouge Parish, LA,Aug-17,13367,12663,704,5.3
CN2212100000000,22,121,West Baton Rouge Parish, LA,Sep-17,13436,12812,624,4.6
CN2212100000000,22,121,West Baton Rouge Parish, LA,Oct-17,13387,12842,545,4.1
CN2212100000000,22,121,West Baton Rouge Parish, LA,Nov-17,13428,12909,519,3.9
CN2212100000000,22,121,West Baton Rouge Parish, LA,Dec-17,13294,12800,494,3.7
CN2212100000000,22,121,West Baton Rouge Parish, LA,Jan-18,13301,12738,563,4.2
CN2212100000000,22,121,West Baton Rouge Parish, LA,Feb-18,13472,12958,514,3.8
CN2212100000000,22,121,West Baton Rouge Parish, LA,Mar-18,13532,12981,551,4.1
CN2212100000000,22,121,West Baton Rouge Parish, LA,Apr-18(p),13557,13029,528,3.9
CN3900100000000,39,001,Adams County, OH,Mar-17,11257,10309,948,8.4
CN3900100000000,39,001,Adams County, OH,Apr-17,10928,10202,726,6.6
CN3900100000000,39,001,Adams County, OH,May-17,10975,10327,648,5.9
CN3900100000000,39,001,Adams County, OH,Jun-17,10987,10249,738,6.7
CN3900100000000,39,001,Adams County, OH,Jul-17,10951,10182,769,7.0
CN3900100000000,39,001,Adams County, OH,Aug-17,11055,10295,760,6.9
CN3900100000000,39,001,Adams County, OH,Sep-17,10980,10350,630,5.7
CN3900100000000,39,001,Adams County, OH,Oct-17,10910,10291,619,5.7
CN3900100000000,39,001,Adams County, OH,Nov-17,10898,10228,670,6.1
CN3900100000000,39,001,Adams County, OH,Dec-17,10819,10072,747,6.9
CN3900100000000,39,001,Adams County, OH,Jan-18,10739,9755,984,9.2
CN3900100000000,39,001,Adams County, OH,Feb-18,10947,10086,861,7.9
CN3900100000000,39,001,Adams County, OH,Mar-18,11081,10297,784,7.1
CN3900100000000,39,001,Adams County, OH,Apr-18(p),10933,10276,657,6.0
CN3112900000000,31,129,Nuckolls County, NE,Mar-17,2338,2270,68,2.9
CN3112900000000,31,129,Nuckolls County, NE,Apr-17,2369,2314,55,2.3
CN3112900000000,31,129,Nuckolls County, NE,May-17,2380,2329,51,2.1
CN3112900000000,31,129,Nuckolls County, NE,Jun-17,2468,2409,59,2.4
CN3112900000000,31,129,Nuckolls County, NE,Jul-17,2442,2379,63,2.6
CN3112900000000,31,129,Nuckolls County, NE,Aug-17,2366,2307,59,2.5
CN3112900000000,31,129,Nuckolls County, NE,Sep-17,2293,2242,51,2.2
CN3112900000000,31,129,Nuckolls County, NE,Oct-17,2294,2239,55,2.4
CN3112900000000,31,129,Nuckolls County, NE,Nov-17,2315,2262,53,2.3
CN3112900000000,31,129,Nuckolls County, NE,Dec-17,2330,2256,74,3.2
CN3112900000000,31,129,Nuckolls County, NE,Jan-18,2385,2303,82,3.4
CN3112900000000,31,129,Nuckolls County, NE,Feb-18,2332,2260,72,3.1
CN3112900000000,31,129,Nuckolls County, NE,Mar-18,2360,2287,73,3.1
CN3112900000000,31,129,Nuckolls County, NE,Apr-18(p),2360,2299,61,2.6
CN0105300000000,01,053,Escambia County, AL,Mar-17,14374,13565,809,5.6
CN0105300000000,01,053,Escambia County, AL,Apr-17,14372,13680,692,4.8
CN0105300000000,01,053,Escambia County, AL,May-17,14376,13726,650,4.5
CN0105300000000,01,053,Escambia County, AL,Jun-17,14521,13734,787,5.4
CN0105300000000,01,053,Escambia County, AL,Jul-17,14343,13600,743,5.2
CN0105300000000,01,053,Escambia County, AL,Aug-17,14272,13537,735,5.1
CN0105300000000,01,053,Escambia County, AL,Sep-17,14365,13764,601,4.2
CN0105300000000,01,053,Escambia County, AL,Oct-17,14339,13760,579,4.0
CN0105300000000,01,053,Escambia County, AL,Nov-17,14237,13680,557,3.9
CN0105300000000,01,053,Escambia County, AL,Dec-17,14175,13603,572,4.0
CN0105300000000,01,053,Escambia County, AL,Jan-18,14100,13434,666,4.7
CN0105300000000,01,053,Escambia County, AL,Feb-18,14386,13676,710,4.9
CN0105300000000,01,053,Escambia County, AL,Mar-18,14445,13808,637,4.4
CN0105300000000,01,053,Escambia County, AL,Apr-18(p),14557,13970,587,4.0
CN2105300000000,21,053,Clinton County, KY,Mar-17,3949,3647,302,7.6
CN2105300000000,21,053,Clinton County, KY,Apr-17,3999,3754,245,6.1
CN2105300000000,21,053,Clinton County, KY,May-17,4027,3717,310,7.7
CN2105300000000,21,053,Clinton County, KY,Jun-17,3987,3676,311,7.8
CN2105300000000,21,053,Clinton County, KY,Jul-17,3864,3607,257,6.7
CN2105300000000,21,053,Clinton County, KY,Aug-17,3797,3574,223,5.9
CN2105300000000,21,053,Clinton County, KY,Sep-17,3780,3574,206,5.4
CN2105300000000,21,053,Clinton County, KY,Oct-17,3807,3620,187,4.9
CN2105300000000,21,053,Clinton County, KY,Nov-17,3787,3593,194,5.1
CN2105300000000,21,053,Clinton County, KY,Dec-17,3777,3585,192,5.1
CN2105300000000,21,053,Clinton County, KY,Jan-18,3772,3570,202,5.4
CN2105300000000,21,053,Clinton County, KY,Feb-18,3765,3533,232,6.2
CN2105300000000,21,053,Clinton County, KY,Mar-18,3825,3610,215,5.6
CN2105300000000,21,053,Clinton County, KY,Apr-18(p),3858,3673,185,4.8
CN3907900000000,39,079,Jackson County, OH,Mar-17,13210,11980,1230,9.3
CN3907900000000,39,079,Jackson County, OH,Apr-17,13008,12104,904,6.9
CN3907900000000,39,079,Jackson County, OH,May-17,12936,12140,796,6.2
CN3907900000000,39,079,Jackson County, OH,Jun-17,13061,12171,890,6.8
CN3907900000000,39,079,Jackson County, OH,Jul-17,13007,12129,878,6.8
CN3907900000000,39,079,Jackson County, OH,Aug-17,13071,12225,846,6.5
CN3907900000000,39,079,Jackson County, OH,Sep-17,12943,12189,754,5.8
CN3907900000000,39,079,Jackson County, OH,Oct-17,12870,12145,725,5.6
CN3907900000000,39,079,Jackson County, OH,Nov-17,12868,12085,783,6.1
CN3907900000000,39,079,Jackson County, OH,Dec-17,12778,11918,860,6.7
CN3907900000000,39,079,Jackson County, OH,Jan-18,12662,11625,1037,8.2
CN3907900000000,39,079,Jackson County, OH,Feb-18,12746,11757,989,7.8
CN3907900000000,39,079,Jackson County, OH,Mar-18,12919,12041,878,6.8
CN3907900000000,39,079,Jackson County, OH,Apr-18(p),12737,11961,776,6.1
CN2800900000000,28,009,Benton County, MS,Mar-17,3019,2861,158,5.2
CN2800900000000,28,009,Benton County, MS,Apr-17,3016,2873,143,4.7
CN2800900000000,28,009,Benton County, MS,May-17,3055,2866,189,6.2
CN2800900000000,28,009,Benton County, MS,Jun-17,3100,2880,220,7.1
CN2800900000000,28,009,Benton County, MS,Jul-17,3106,2903,203,6.5
CN2800900000000,28,009,Benton County, MS,Aug-17,3023,2870,153,5.1
CN2800900000000,28,009,Benton County, MS,Sep-17,3036,2884,152,5.0
CN2800900000000,28,009,Benton County, MS,Oct-17,3043,2892,151,5.0
CN2800900000000,28,009,Benton County, MS,Nov-17,3103,2946,157,5.1
CN2800900000000,28,009,Benton County, MS,Dec-17,3090,2937,153,5.0
CN2800900000000,28,009,Benton County, MS,Jan-18,3030,2875,155,5.1
CN2800900000000,28,009,Benton County, MS,Feb-18,3056,2896,160,5.2
CN2800900000000,28,009,Benton County, MS,Mar-18,3049,2901,148,4.9
CN2800900000000,28,009,Benton County, MS,Apr-18(p),3042,2903,139,4.6
CN3500600000000,35,006,Cibola County, NM,Mar-17,8995,8296,699,7.8
CN3500600000000,35,006,Cibola County, NM,Apr-17,9047,8402,645,7.1
CN3500600000000,35,006,Cibola County, NM,May-17,8993,8352,641,7.1
CN3500600000000,35,006,Cibola County, NM,Jun-17,9197,8380,817,8.9
CN3500600000000,35,006,Cibola County, NM,Jul-17,9111,8306,805,8.8
CN3500600000000,35,006,Cibola County, NM,Aug-17,9157,8413,744,8.1
CN3500600000000,35,006,Cibola County, NM,Sep-17,9049,8378,671,7.4
CN3500600000000,35,006,Cibola County, NM,Oct-17,9092,8407,685,7.5
CN3500600000000,35,006,Cibola County, NM,Nov-17,9143,8467,676,7.4
CN3500600000000,35,006,Cibola County, NM,Dec-17,9124,8477,647,7.1
CN3500600000000,35,006,Cibola County, NM,Jan-18,9084,8441,643,7.1
CN3500600000000,35,006,Cibola County, NM,Feb-18,9008,8398,610,6.8
CN3500600000000,35,006,Cibola County, NM,Mar-18,8967,8402,565,6.3
CN3500600000000,35,006,Cibola County, NM,Apr-18(p),8922,8439,483,5.4
CN0502300000000,05,023,Cleburne County, AR,Mar-17,9332,8877,455,4.9
CN0502300000000,05,023,Cleburne County, AR,Apr-17,9321,8916,405,4.3
CN0502300000000,05,023,Cleburne County, AR,May-17,9400,8966,434,4.6
CN0502300000000,05,023,Cleburne County, AR,Jun-17,9677,9227,450,4.7
CN0502300000000,05,023,Cleburne County, AR,Jul-17,9402,8907,495,5.3
CN0502300000000,05,023,Cleburne County, AR,Aug-17,9394,8947,447,4.8
CN0502300000000,05,023,Cleburne County, AR,Sep-17,9424,8994,430,4.6
CN0502300000000,05,023,Cleburne County, AR,Oct-17,9308,8909,399,4.3
CN0502300000000,05,023,Cleburne County, AR,Nov-17,9282,8891,391,4.2
CN0502300000000,05,023,Cleburne County, AR,Dec-17,9195,8762,433,4.7
CN0502300000000,05,023,Cleburne County, AR,Jan-18,9064,8522,542,6.0
CN0502300000000,05,023,Cleburne County, AR,Feb-18,9114,8617,497,5.5
CN0502300000000,05,023,Cleburne County, AR,Mar-18,9156,8715,441,4.8
CN0502300000000,05,023,Cleburne County, AR,Apr-18(p),9144,8748,396,4.3
CN2715300000000,27,153,Todd County, MN,Mar-17,13597,12877,720,5.3
CN2715300000000,27,153,Todd County, MN,Apr-17,13600,13072,528,3.9
CN2715300000000,27,153,Todd County, MN,May-17,13476,13091,385,2.9
CN2715300000000,27,153,Todd County, MN,Jun-17,13419,13003,416,3.1
CN2715300000000,27,153,Todd County, MN,Jul-17,13309,12905,404,3.0
CN2715300000000,27,153,Todd County, MN,Aug-17,13165,12741,424,3.2
CN2715300000000,27,153,Todd County, MN,Sep-17,13106,12765,341,2.6
CN2715300000000,27,153,Todd County, MN,Oct-17,13478,13167,311,2.3
CN2715300000000,27,153,Todd County, MN,Nov-17,13600,13050,550,4.0
CN2715300000000,27,153,Todd County, MN,Dec-17,13650,12979,671,4.9
CN2715300000000,27,153,Todd County, MN,Jan-18,13829,13017,812,5.9
CN2715300000000,27,153,Todd County, MN,Feb-18,13855,13097,758,5.5
CN2715300000000,27,153,Todd County, MN,Mar-18,13869,13141,728,5.2
CN2715300000000,27,153,Todd County, MN,Apr-18(p),13894,13293,601,4.3
CN2009100000000,20,091,Johnson County, KS,Mar-17,328064,317885,10179,3.1
CN2009100000000,20,091,Johnson County, KS,Apr-17,329198,319992,9206,2.8
CN2009100000000,20,091,Johnson County, KS,May-17,329446,319720,9726,3.0
CN2009100000000,20,091,Johnson County, KS,Jun-17,336302,325466,10836,3.2
CN2009100000000,20,091,Johnson County, KS,Jul-17,342297,330727,11570,3.4
CN2009100000000,20,091,Johnson County, KS,Aug-17,335926,324501,11425,3.4
CN2009100000000,20,091,Johnson County, KS,Sep-17,332081,322741,9340,2.8
CN2009100000000,20,091,Johnson County, KS,Oct-17,331182,322342,8840,2.7
CN2009100000000,20,091,Johnson County, KS,Nov-17,333707,324679,9028,2.7
CN2009100000000,20,091,Johnson County, KS,Dec-17,332158,323585,8573,2.6
CN2009100000000,20,091,Johnson County, KS,Jan-18,331623,322065,9558,2.9
CN2009100000000,20,091,Johnson County, KS,Feb-18,331631,321751,9880,3.0
CN2009100000000,20,091,Johnson County, KS,Mar-18,330609,321009,9600,2.9
CN2009100000000,20,091,Johnson County, KS,Apr-18(p),333656,324487,9169,2.7
CN2811500000000,28,115,Pontotoc County, MS,Mar-17,14361,13804,557,3.9
CN2811500000000,28,115,Pontotoc County, MS,Apr-17,14364,13862,502,3.5
CN2811500000000,28,115,Pontotoc County, MS,May-17,14468,13832,636,4.4
CN2811500000000,28,115,Pontotoc County, MS,Jun-17,14670,13994,676,4.6
CN2811500000000,28,115,Pontotoc County, MS,Jul-17,14588,13948,640,4.4
CN2811500000000,28,115,Pontotoc County, MS,Aug-17,14336,13798,538,3.8
CN2811500000000,28,115,Pontotoc County, MS,Sep-17,14430,13899,531,3.7
CN2811500000000,28,115,Pontotoc County, MS,Oct-17,14356,13855,501,3.5
CN2811500000000,28,115,Pontotoc County, MS,Nov-17,14409,13918,491,3.4
CN2811500000000,28,115,Pontotoc County, MS,Dec-17,14456,13968,488,3.4
CN2811500000000,28,115,Pontotoc County, MS,Jan-18,14284,13768,516,3.6
CN2811500000000,28,115,Pontotoc County, MS,Feb-18,14383,13871,512,3.6
CN2811500000000,28,115,Pontotoc County, MS,Mar-18,14374,13884,490,3.4
CN2811500000000,28,115,Pontotoc County, MS,Apr-18(p),14470,13968,502,3.5
CN4822100000000,48,221,Hood County, TX,Mar-17,25609,24473,1136,4.4
CN4822100000000,48,221,Hood County, TX,Apr-17,25618,24579,1039,4.1
CN4822100000000,48,221,Hood County, TX,May-17,25615,24550,1065,4.2
CN4822100000000,48,221,Hood County, TX,Jun-17,25722,24602,1120,4.4
CN4822100000000,48,221,Hood County, TX,Jul-17,25786,24629,1157,4.5
CN4822100000000,48,221,Hood County, TX,Aug-17,25720,24622,1098,4.3
CN4822100000000,48,221,Hood County, TX,Sep-17,25869,24870,999,3.9
CN4822100000000,48,221,Hood County, TX,Oct-17,25708,24814,894,3.5
CN4822100000000,48,221,Hood County, TX,Nov-17,25832,24879,953,3.7
CN4822100000000,48,221,Hood County, TX,Dec-17,25850,24934,916,3.5
CN4822100000000,48,221,Hood County, TX,Jan-18,25821,24779,1042,4.0
CN4822100000000,48,221,Hood County, TX,Feb-18,26161,25089,1072,4.1
CN4822100000000,48,221,Hood County, TX,Mar-18,26299,25237,1062,4.0
CN4822100000000,48,221,Hood County, TX,Apr-18(p),26352,25396,956,3.6
CN1606500000000,16,065,Madison County, ID,Mar-17,21369,20936,433,2.0
CN1606500000000,16,065,Madison County, ID,Apr-17,20770,20399,371,1.8
CN1606500000000,16,065,Madison County, ID,May-17,21594,21214,380,1.8
CN1606500000000,16,065,Madison County, ID,Jun-17,22004,21572,432,2.0
CN1606500000000,16,065,Madison County, ID,Jul-17,21805,21404,401,1.8
CN1606500000000,16,065,Madison County, ID,Aug-17,19738,19347,391,2.0
CN1606500000000,16,065,Madison County, ID,Sep-17,21407,21028,379,1.8
CN1606500000000,16,065,Madison County, ID,Oct-17,22530,22182,348,1.5
CN1606500000000,16,065,Madison County, ID,Nov-17,21791,21392,399,1.8
CN1606500000000,16,065,Madison County, ID,Dec-17,21336,21025,311,1.5
CN1606500000000,16,065,Madison County, ID,Jan-18,20628,20145,483,2.3
CN1606500000000,16,065,Madison County, ID,Feb-18,21363,20939,424,2.0
CN1606500000000,16,065,Madison County, ID,Mar-18,21449,21052,397,1.9
CN1606500000000,16,065,Madison County, ID,Apr-18(p),21753,21376,377,1.7
CN4208100000000,42,081,Lycoming County, PA,Mar-17,58071,54335,3736,6.4
CN4208100000000,42,081,Lycoming County, PA,Apr-17,57720,54669,3051,5.3
CN4208100000000,42,081,Lycoming County, PA,May-17,57545,54360,3185,5.5
CN4208100000000,42,081,Lycoming County, PA,Jun-17,57937,54744,3193,5.5
CN4208100000000,42,081,Lycoming County, PA,Jul-17,58018,54717,3301,5.7
CN4208100000000,42,081,Lycoming County, PA,Aug-17,57647,54441,3206,5.6
CN4208100000000,42,081,Lycoming County, PA,Sep-17,57533,54715,2818,4.9
CN4208100000000,42,081,Lycoming County, PA,Oct-17,56757,54081,2676,4.7
CN4208100000000,42,081,Lycoming County, PA,Nov-17,57004,54179,2825,5.0
CN4208100000000,42,081,Lycoming County, PA,Dec-17,56590,53540,3050,5.4
CN4208100000000,42,081,Lycoming County, PA,Jan-18,56914,53342,3572,6.3
CN4208100000000,42,081,Lycoming County, PA,Feb-18,57010,53476,3534,6.2
CN4208100000000,42,081,Lycoming County, PA,Mar-18,56191,53001,3190,5.7
CN4208100000000,42,081,Lycoming County, PA,Apr-18(p),55553,52956,2597,4.7
CN1719500000000,17,195,Whiteside County, IL,Mar-17,27944,26541,1403,5.0
CN1719500000000,17,195,Whiteside County, IL,Apr-17,28264,27085,1179,4.2
CN1719500000000,17,195,Whiteside County, IL,May-17,28126,26986,1140,4.1
CN1719500000000,17,195,Whiteside County, IL,Jun-17,28441,27102,1339,4.7
CN1719500000000,17,195,Whiteside County, IL,Jul-17,28065,26689,1376,4.9
CN1719500000000,17,195,Whiteside County, IL,Aug-17,27897,26531,1366,4.9
CN1719500000000,17,195,Whiteside County, IL,Sep-17,27893,26695,1198,4.3
CN1719500000000,17,195,Whiteside County, IL,Oct-17,28000,26871,1129,4.0
CN1719500000000,17,195,Whiteside County, IL,Nov-17,27854,26694,1160,4.2
CN1719500000000,17,195,Whiteside County, IL,Dec-17,27694,26516,1178,4.3
CN1719500000000,17,195,Whiteside County, IL,Jan-18,27352,26036,1316,4.8
CN1719500000000,17,195,Whiteside County, IL,Feb-18,27356,26158,1198,4.4
CN1719500000000,17,195,Whiteside County, IL,Mar-18,27771,26586,1185,4.3
CN1719500000000,17,195,Whiteside County, IL,Apr-18(p),28273,27295,978,3.5
CN3808900000000,38,089,Stark County, ND,Mar-17,17885,17286,599,3.3
CN3808900000000,38,089,Stark County, ND,Apr-17,18010,17496,514,2.9
CN3808900000000,38,089,Stark County, ND,May-17,18394,17983,411,2.2
CN3808900000000,38,089,Stark County, ND,Jun-17,19011,18519,492,2.6
CN3808900000000,38,089,Stark County, ND,Jul-17,19133,18741,392,2.0
CN3808900000000,38,089,Stark County, ND,Aug-17,18811,18381,430,2.3
CN3808900000000,38,089,Stark County, ND,Sep-17,18279,17884,395,2.2
CN3808900000000,38,089,Stark County, ND,Oct-17,18351,17965,386,2.1
CN3808900000000,38,089,Stark County, ND,Nov-17,18119,17690,429,2.4
CN3808900000000,38,089,Stark County, ND,Dec-17,17874,17374,500,2.8
CN3808900000000,38,089,Stark County, ND,Jan-18,18026,17436,590,3.3
CN3808900000000,38,089,Stark County, ND,Feb-18,18097,17509,588,3.2
CN3808900000000,38,089,Stark County, ND,Mar-18,17970,17435,535,3.0
CN3808900000000,38,089,Stark County, ND,Apr-18(p),17789,17305,484,2.7
CN4903700000000,49,037,San Juan County, UT,Mar-17,5756,5283,473,8.2
CN4903700000000,49,037,San Juan County, UT,Apr-17,5846,5440,406,6.9
CN4903700000000,49,037,San Juan County, UT,May-17,5961,5557,404,6.8
CN4903700000000,49,037,San Juan County, UT,Jun-17,6045,5609,436,7.2
CN4903700000000,49,037,San Juan County, UT,Jul-17,5795,5401,394,6.8
CN4903700000000,49,037,San Juan County, UT,Aug-17,6056,5664,392,6.5
CN4903700000000,49,037,San Juan County, UT,Sep-17,5947,5609,338,5.7
CN4903700000000,49,037,San Juan County, UT,Oct-17,5898,5578,320,5.4
CN4903700000000,49,037,San Juan County, UT,Nov-17,5666,5340,326,5.8
CN4903700000000,49,037,San Juan County, UT,Dec-17,5630,5204,426,7.6
CN4903700000000,49,037,San Juan County, UT,Jan-18,5575,5072,503,9.0
CN4903700000000,49,037,San Juan County, UT,Feb-18,5682,5207,475,8.4
CN4903700000000,49,037,San Juan County, UT,Mar-18,5805,5383,422,7.3
CN4903700000000,49,037,San Juan County, UT,Apr-18(p),5866,5522,344,5.9
CN3103900000000,31,039,Cuming County, NE,Mar-17,4600,4474,126,2.7
CN3103900000000,31,039,Cuming County, NE,Apr-17,4744,4635,109,2.3
CN3103900000000,31,039,Cuming County, NE,May-17,4843,4710,133,2.7
CN3103900000000,31,039,Cuming County, NE,Jun-17,4981,4832,149,3.0
CN3103900000000,31,039,Cuming County, NE,Jul-17,4907,4764,143,2.9
CN3103900000000,31,039,Cuming County, NE,Aug-17,4774,4639,135,2.8
CN3103900000000,31,039,Cuming County, NE,Sep-17,4599,4487,112,2.4
CN3103900000000,31,039,Cuming County, NE,Oct-17,4632,4524,108,2.3
CN3103900000000,31,039,Cuming County, NE,Nov-17,4637,4538,99,2.1
CN3103900000000,31,039,Cuming County, NE,Dec-17,4652,4537,115,2.5
CN3103900000000,31,039,Cuming County, NE,Jan-18,4733,4615,118,2.5
CN3103900000000,31,039,Cuming County, NE,Feb-18,4681,4553,128,2.7
CN3103900000000,31,039,Cuming County, NE,Mar-18,4732,4610,122,2.6
CN3103900000000,31,039,Cuming County, NE,Apr-18(p),4738,4623,115,2.4
CN2814300000000,28,143,Tunica County, MS,Mar-17,4608,4323,285,6.2
CN2814300000000,28,143,Tunica County, MS,Apr-17,4572,4347,225,4.9
CN2814300000000,28,143,Tunica County, MS,May-17,4596,4333,263,5.7
CN2814300000000,28,143,Tunica County, MS,Jun-17,4648,4348,300,6.5
CN2814300000000,28,143,Tunica County, MS,Jul-17,4650,4369,281,6.0
CN2814300000000,28,143,Tunica County, MS,Aug-17,4559,4319,240,5.3
CN2814300000000,28,143,Tunica County, MS,Sep-17,4591,4344,247,5.4
CN2814300000000,28,143,Tunica County, MS,Oct-17,4528,4315,213,4.7
CN2814300000000,28,143,Tunica County, MS,Nov-17,4588,4378,210,4.6
CN2814300000000,28,143,Tunica County, MS,Dec-17,4597,4362,235,5.1
CN2814300000000,28,143,Tunica County, MS,Jan-18,4554,4276,278,6.1
CN2814300000000,28,143,Tunica County, MS,Feb-18,4593,4324,269,5.9
CN2814300000000,28,143,Tunica County, MS,Mar-18,4599,4367,232,5.0
CN2814300000000,28,143,Tunica County, MS,Apr-18(p),4554,4350,204,4.5
CN1211900000000,12,119,Sumter County, FL,Mar-17,30338,28476,1862,6.1
CN1211900000000,12,119,Sumter County, FL,Apr-17,30253,28487,1766,5.8
CN1211900000000,12,119,Sumter County, FL,May-17,30489,28623,1866,6.1
CN1211900000000,12,119,Sumter County, FL,Jun-17,30281,28443,1838,6.1
CN1211900000000,12,119,Sumter County, FL,Jul-17,30256,28356,1900,6.3
CN1211900000000,12,119,Sumter County, FL,Aug-17,30497,28571,1926,6.3
CN1211900000000,12,119,Sumter County, FL,Sep-17,30692,28995,1697,5.5
CN1211900000000,12,119,Sumter County, FL,Oct-17,30281,28653,1628,5.4
CN1211900000000,12,119,Sumter County, FL,Nov-17,30154,28513,1641,5.4
CN1211900000000,12,119,Sumter County, FL,Dec-17,30085,28498,1587,5.3
CN1211900000000,12,119,Sumter County, FL,Jan-18,30471,28659,1812,5.9
CN1211900000000,12,119,Sumter County, FL,Feb-18,30720,29035,1685,5.5
CN1211900000000,12,119,Sumter County, FL,Mar-18,30733,29076,1657,5.4
CN1211900000000,12,119,Sumter County, FL,Apr-18(p),30522,29024,1498,4.9
CN0401700000000,04,017,Navajo County, AZ,Mar-17,41038,37733,3305,8.1
CN0401700000000,04,017,Navajo County, AZ,Apr-17,40892,37902,2990,7.3
CN0401700000000,04,017,Navajo County, AZ,May-17,41230,38373,2857,6.9
CN0401700000000,04,017,Navajo County, AZ,Jun-17,42216,38999,3217,7.6
CN0401700000000,04,017,Navajo County, AZ,Jul-17,40202,36971,3231,8.0
CN0401700000000,04,017,Navajo County, AZ,Aug-17,42063,38972,3091,7.3
CN0401700000000,04,017,Navajo County, AZ,Sep-17,42325,39386,2939,6.9
CN0401700000000,04,017,Navajo County, AZ,Oct-17,42034,39130,2904,6.9
CN0401700000000,04,017,Navajo County, AZ,Nov-17,41592,38725,2867,6.9
CN0401700000000,04,017,Navajo County, AZ,Dec-17,41680,38544,3136,7.5
CN0401700000000,04,017,Navajo County, AZ,Jan-18,41432,37846,3586,8.7
CN0401700000000,04,017,Navajo County, AZ,Feb-18,41510,38089,3421,8.2
CN0401700000000,04,017,Navajo County, AZ,Mar-18,41890,38710,3180,7.6
CN0401700000000,04,017,Navajo County, AZ,Apr-18(p),41560,38709,2851,6.9
CN5104500000000,51,045,Craig County, VA,Mar-17,2347,2242,105,4.5
CN5104500000000,51,045,Craig County, VA,Apr-17,2338,2247,91,3.9
CN5104500000000,51,045,Craig County, VA,May-17,2343,2246,97,4.1
CN5104500000000,51,045,Craig County, VA,Jun-17,2346,2243,103,4.4
CN5104500000000,51,045,Craig County, VA,Jul-17,2355,2247,108,4.6
CN5104500000000,51,045,Craig County, VA,Aug-17,2329,2225,104,4.5
CN5104500000000,51,045,Craig County, VA,Sep-17,2351,2247,104,4.4
CN5104500000000,51,045,Craig County, VA,Oct-17,2322,2232,90,3.9
CN5104500000000,51,045,Craig County, VA,Nov-17,2322,2226,96,4.1
CN5104500000000,51,045,Craig County, VA,Dec-17,2309,2223,86,3.7
CN5104500000000,51,045,Craig County, VA,Jan-18,2309,2208,101,4.4
CN5104500000000,51,045,Craig County, VA,Feb-18,2348,2241,107,4.6
CN5104500000000,51,045,Craig County, VA,Mar-18,2354,2254,100,4.2
CN5104500000000,51,045,Craig County, VA,Apr-18(p),2364,2273,91,3.8
CN2009700000000,20,097,Kiowa County, KS,Mar-17,1332,1294,38,2.9
CN2009700000000,20,097,Kiowa County, KS,Apr-17,1326,1291,35,2.6
CN2009700000000,20,097,Kiowa County, KS,May-17,1329,1294,35,2.6
CN2009700000000,20,097,Kiowa County, KS,Jun-17,1303,1268,35,2.7
CN2009700000000,20,097,Kiowa County, KS,Jul-17,1262,1225,37,2.9
CN2009700000000,20,097,Kiowa County, KS,Aug-17,1321,1289,32,2.4
CN2009700000000,20,097,Kiowa County, KS,Sep-17,1382,1354,28,2.0
CN2009700000000,20,097,Kiowa County, KS,Oct-17,1402,1375,27,1.9
CN2009700000000,20,097,Kiowa County, KS,Nov-17,1386,1356,30,2.2
CN2009700000000,20,097,Kiowa County, KS,Dec-17,1374,1349,25,1.8
CN2009700000000,20,097,Kiowa County, KS,Jan-18,1357,1329,28,2.1
CN2009700000000,20,097,Kiowa County, KS,Feb-18,1350,1315,35,2.6
CN2009700000000,20,097,Kiowa County, KS,Mar-18,1339,1307,32,2.4
CN2009700000000,20,097,Kiowa County, KS,Apr-18(p),1289,1258,31,2.4
CN3003300000000,30,033,Garfield County, MT,Mar-17,744,716,28,3.8
CN3003300000000,30,033,Garfield County, MT,Apr-17,780,759,21,2.7
CN3003300000000,30,033,Garfield County, MT,May-17,793,775,18,2.3
CN3003300000000,30,033,Garfield County, MT,Jun-17,776,754,22,2.8
CN3003300000000,30,033,Garfield County, MT,Jul-17,810,786,24,3.0
CN3003300000000,30,033,Garfield County, MT,Aug-17,784,762,22,2.8
CN3003300000000,30,033,Garfield County, MT,Sep-17,763,747,16,2.1
CN3003300000000,30,033,Garfield County, MT,Oct-17,767,746,21,2.7
CN3003300000000,30,033,Garfield County, MT,Nov-17,750,729,21,2.8
CN3003300000000,30,033,Garfield County, MT,Dec-17,752,731,21,2.8
CN3003300000000,30,033,Garfield County, MT,Jan-18,767,742,25,3.3
CN3003300000000,30,033,Garfield County, MT,Feb-18,767,742,25,3.3
CN3003300000000,30,033,Garfield County, MT,Mar-18,736,713,23,3.1
CN3003300000000,30,033,Garfield County, MT,Apr-18(p),739,726,13,1.8
CN3008300000000,30,083,Richland County, MT,Mar-17,5999,5741,258,4.3
CN3008300000000,30,083,Richland County, MT,Apr-17,6068,5813,255,4.2
CN3008300000000,30,083,Richland County, MT,May-17,6113,5873,240,3.9
CN3008300000000,30,083,Richland County, MT,Jun-17,6092,5844,248,4.1
CN3008300000000,30,083,Richland County, MT,Jul-17,6141,5919,222,3.6
CN3008300000000,30,083,Richland County, MT,Aug-17,6047,5849,198,3.3
CN3008300000000,30,083,Richland County, MT,Sep-17,5935,5718,217,3.7
CN3008300000000,30,083,Richland County, MT,Oct-17,6114,5908,206,3.4
CN3008300000000,30,083,Richland County, MT,Nov-17,6092,5901,191,3.1
CN3008300000000,30,083,Richland County, MT,Dec-17,6036,5845,191,3.2
CN3008300000000,30,083,Richland County, MT,Jan-18,5966,5752,214,3.6
CN3008300000000,30,083,Richland County, MT,Feb-18,5900,5670,230,3.9
CN3008300000000,30,083,Richland County, MT,Mar-18,5774,5529,245,4.2
CN3008300000000,30,083,Richland County, MT,Apr-18(p),5670,5469,201,3.5
CN3400300000000,34,003,Bergen County, NJ,Mar-17,485207,467124,18083,3.7
CN3400300000000,34,003,Bergen County, NJ,Apr-17,484328,466975,17353,3.6
CN3400300000000,34,003,Bergen County, NJ,May-17,483928,465549,18379,3.8
CN3400300000000,34,003,Bergen County, NJ,Jun-17,486353,467198,19155,3.9
CN3400300000000,34,003,Bergen County, NJ,Jul-17,487164,465343,21821,4.5
CN3400300000000,34,003,Bergen County, NJ,Aug-17,482248,461264,20984,4.4
CN3400300000000,34,003,Bergen County, NJ,Sep-17,480060,460666,19394,4.0
CN3400300000000,34,003,Bergen County, NJ,Oct-17,481757,463691,18066,3.8
CN3400300000000,34,003,Bergen County, NJ,Nov-17,481917,464901,17016,3.5
CN3400300000000,34,003,Bergen County, NJ,Dec-17,480691,464898,15793,3.3
CN3400300000000,34,003,Bergen County, NJ,Jan-18,476337,458252,18085,3.8
CN3400300000000,34,003,Bergen County, NJ,Feb-18,481084,462370,18714,3.9
CN3400300000000,34,003,Bergen County, NJ,Mar-18,477336,459466,17870,3.7
CN3400300000000,34,003,Bergen County, NJ,Apr-18(p),473267,457550,15717,3.3
CN4103100000000,41,031,Jefferson County, OR,Mar-17,9768,9161,607,6.2
CN4103100000000,41,031,Jefferson County, OR,Apr-17,10019,9493,526,5.3
CN4103100000000,41,031,Jefferson County, OR,May-17,10137,9661,476,4.7
CN4103100000000,41,031,Jefferson County, OR,Jun-17,10263,9740,523,5.1
CN4103100000000,41,031,Jefferson County, OR,Jul-17,10382,9829,553,5.3
CN4103100000000,41,031,Jefferson County, OR,Aug-17,10358,9809,549,5.3
CN4103100000000,41,031,Jefferson County, OR,Sep-17,10292,9805,487,4.7
CN4103100000000,41,031,Jefferson County, OR,Oct-17,10094,9613,481,4.8
CN4103100000000,41,031,Jefferson County, OR,Nov-17,10005,9479,526,5.3
CN4103100000000,41,031,Jefferson County, OR,Dec-17,9966,9366,600,6.0
CN4103100000000,41,031,Jefferson County, OR,Jan-18,9980,9246,734,7.4
CN4103100000000,41,031,Jefferson County, OR,Feb-18,9996,9319,677,6.8
CN4103100000000,41,031,Jefferson County, OR,Mar-18,9941,9332,609,6.1
CN4103100000000,41,031,Jefferson County, OR,Apr-18(p),9990,9484,506,5.1
CN5602700000000,56,027,Niobrara County, WY,Mar-17,1256,1210,46,3.7
CN5602700000000,56,027,Niobrara County, WY,Apr-17,1262,1228,34,2.7
CN5602700000000,56,027,Niobrara County, WY,May-17,1307,1274,33,2.5
CN5602700000000,56,027,Niobrara County, WY,Jun-17,1411,1366,45,3.2
CN5602700000000,56,027,Niobrara County, WY,Jul-17,1393,1352,41,2.9
CN5602700000000,56,027,Niobrara County, WY,Aug-17,1377,1344,33,2.4
CN5602700000000,56,027,Niobrara County, WY,Sep-17,1349,1319,30,2.2
CN5602700000000,56,027,Niobrara County, WY,Oct-17,1343,1312,31,2.3
CN5602700000000,56,027,Niobrara County, WY,Nov-17,1324,1296,28,2.1
CN5602700000000,56,027,Niobrara County, WY,Dec-17,1282,1253,29,2.3
CN5602700000000,56,027,Niobrara County, WY,Jan-18,1285,1256,29,2.3
CN5602700000000,56,027,Niobrara County, WY,Feb-18,1283,1249,34,2.7
CN5602700000000,56,027,Niobrara County, WY,Mar-18,1259,1228,31,2.5
CN5602700000000,56,027,Niobrara County, WY,Apr-18(p),1241,1212,29,2.3
CN4502900000000,45,029,Colleton County, SC,Mar-17,16491,15773,718,4.4
CN4502900000000,45,029,Colleton County, SC,Apr-17,16592,15927,665,4.0
CN4502900000000,45,029,Colleton County, SC,May-17,16707,16012,695,4.2
CN4502900000000,45,029,Colleton County, SC,Jun-17,17121,16252,869,5.1
CN4502900000000,45,029,Colleton County, SC,Jul-17,17084,16245,839,4.9
CN4502900000000,45,029,Colleton County, SC,Aug-17,16981,16103,878,5.2
CN4502900000000,45,029,Colleton County, SC,Sep-17,16981,16152,829,4.9
CN4502900000000,45,029,Colleton County, SC,Oct-17,17009,16200,809,4.8
CN4502900000000,45,029,Colleton County, SC,Nov-17,17024,16235,789,4.6
CN4502900000000,45,029,Colleton County, SC,Dec-17,17134,16293,841,4.9
CN4502900000000,45,029,Colleton County, SC,Jan-18,17135,16136,999,5.8
CN4502900000000,45,029,Colleton County, SC,Feb-18,17313,16370,943,5.4
CN4502900000000,45,029,Colleton County, SC,Mar-18,17128,16292,836,4.9
CN4502900000000,45,029,Colleton County, SC,Apr-18(p),16864,16274,590,3.5
CN1601500000000,16,015,Boise County, ID,Mar-17,3211,3001,210,6.5
CN1601500000000,16,015,Boise County, ID,Apr-17,3178,3003,175,5.5
CN1601500000000,16,015,Boise County, ID,May-17,3163,3028,135,4.3
CN1601500000000,16,015,Boise County, ID,Jun-17,3189,3061,128,4.0
CN1601500000000,16,015,Boise County, ID,Jul-17,3199,3071,128,4.0
CN1601500000000,16,015,Boise County, ID,Aug-17,3197,3069,128,4.0
CN1601500000000,16,015,Boise County, ID,Sep-17,3176,3063,113,3.6
CN1601500000000,16,015,Boise County, ID,Oct-17,3198,3080,118,3.7
CN1601500000000,16,015,Boise County, ID,Nov-17,3246,3116,130,4.0
CN1601500000000,16,015,Boise County, ID,Dec-17,3283,3122,161,4.9
CN1601500000000,16,015,Boise County, ID,Jan-18,3332,3129,203,6.1
CN1601500000000,16,015,Boise County, ID,Feb-18,3329,3136,193,5.8
CN1601500000000,16,015,Boise County, ID,Mar-18,3311,3141,170,5.1
CN1601500000000,16,015,Boise County, ID,Apr-18(p),3278,3132,146,4.5
CN1916900000000,19,169,Story County, IA,Mar-17,57823,56586,1237,2.1
CN1916900000000,19,169,Story County, IA,Apr-17,58242,57235,1007,1.7
CN1916900000000,19,169,Story County, IA,May-17,56619,55545,1074,1.9
CN1916900000000,19,169,Story County, IA,Jun-17,54197,52776,1421,2.6
CN1916900000000,19,169,Story County, IA,Jul-17,54620,53362,1258,2.3
CN1916900000000,19,169,Story County, IA,Aug-17,55564,54255,1309,2.4
CN1916900000000,19,169,Story County, IA,Sep-17,59039,57932,1107,1.9
CN1916900000000,19,169,Story County, IA,Oct-17,59237,58425,812,1.4
CN1916900000000,19,169,Story County, IA,Nov-17,59090,58240,850,1.4
CN1916900000000,19,169,Story County, IA,Dec-17,58060,57157,903,1.6
CN1916900000000,19,169,Story County, IA,Jan-18,57171,56108,1063,1.9
CN1916900000000,19,169,Story County, IA,Feb-18,59053,57911,1142,1.9
CN1916900000000,19,169,Story County, IA,Mar-18,58651,57656,995,1.7
CN1916900000000,19,169,Story County, IA,Apr-18(p),59255,58368,887,1.5
CN2210500000000,22,105,Tangipahoa Parish, LA,Mar-17,54619,51475,3144,5.8
CN2210500000000,22,105,Tangipahoa Parish, LA,Apr-17,54665,51647,3018,5.5
CN2210500000000,22,105,Tangipahoa Parish, LA,May-17,54826,51712,3114,5.7
CN2210500000000,22,105,Tangipahoa Parish, LA,Jun-17,55706,51956,3750,6.7
CN2210500000000,22,105,Tangipahoa Parish, LA,Jul-17,55598,52002,3596,6.5
CN2210500000000,22,105,Tangipahoa Parish, LA,Aug-17,55545,52079,3466,6.2
CN2210500000000,22,105,Tangipahoa Parish, LA,Sep-17,55663,52631,3032,5.4
CN2210500000000,22,105,Tangipahoa Parish, LA,Oct-17,55550,53043,2507,4.5
CN2210500000000,22,105,Tangipahoa Parish, LA,Nov-17,55601,53096,2505,4.5
CN2210500000000,22,105,Tangipahoa Parish, LA,Dec-17,55365,52916,2449,4.4
CN2210500000000,22,105,Tangipahoa Parish, LA,Jan-18,55555,52840,2715,4.9
CN2210500000000,22,105,Tangipahoa Parish, LA,Feb-18,55874,53471,2403,4.3
CN2210500000000,22,105,Tangipahoa Parish, LA,Mar-18,56136,53533,2603,4.6
CN2210500000000,22,105,Tangipahoa Parish, LA,Apr-18(p),56085,53462,2623,4.7
CN5409100000000,54,091,Taylor County, WV,Mar-17,7750,7319,431,5.6
CN5409100000000,54,091,Taylor County, WV,Apr-17,7803,7424,379,4.9
CN5409100000000,54,091,Taylor County, WV,May-17,7810,7490,320,4.1
CN5409100000000,54,091,Taylor County, WV,Jun-17,7876,7503,373,4.7
CN5409100000000,54,091,Taylor County, WV,Jul-17,7812,7438,374,4.8
CN5409100000000,54,091,Taylor County, WV,Aug-17,7836,7464,372,4.7
CN5409100000000,54,091,Taylor County, WV,Sep-17,7940,7615,325,4.1
CN5409100000000,54,091,Taylor County, WV,Oct-17,7927,7598,329,4.2
CN5409100000000,54,091,Taylor County, WV,Nov-17,7907,7566,341,4.3
CN5409100000000,54,091,Taylor County, WV,Dec-17,7882,7518,364,4.6
CN5409100000000,54,091,Taylor County, WV,Jan-18,7879,7436,443,5.6
CN5409100000000,54,091,Taylor County, WV,Feb-18,7946,7474,472,5.9
CN5409100000000,54,091,Taylor County, WV,Mar-18,7883,7452,431,5.5
CN5409100000000,54,091,Taylor County, WV,Apr-18(p),7950,7571,379,4.8
CN4706300000000,47,063,Hamblen County, TN,Mar-17,27369,26204,1165,4.3
CN4706300000000,47,063,Hamblen County, TN,Apr-17,27296,26306,990,3.6
CN4706300000000,47,063,Hamblen County, TN,May-17,27242,26295,947,3.5
CN4706300000000,47,063,Hamblen County, TN,Jun-17,27242,26053,1189,4.4
CN4706300000000,47,063,Hamblen County, TN,Jul-17,27321,26162,1159,4.2
CN4706300000000,47,063,Hamblen County, TN,Aug-17,27104,25980,1124,4.1
CN4706300000000,47,063,Hamblen County, TN,Sep-17,27412,26406,1006,3.7
CN4706300000000,47,063,Hamblen County, TN,Oct-17,27473,26514,959,3.5
CN4706300000000,47,063,Hamblen County, TN,Nov-17,27422,26452,970,3.5
CN4706300000000,47,063,Hamblen County, TN,Dec-17,27261,26334,927,3.4
CN4706300000000,47,063,Hamblen County, TN,Jan-18,27198,26034,1164,4.3
CN4706300000000,47,063,Hamblen County, TN,Feb-18,27563,26430,1133,4.1
CN4706300000000,47,063,Hamblen County, TN,Mar-18,27641,26584,1057,3.8
CN4706300000000,47,063,Hamblen County, TN,Apr-18(p),27569,26713,856,3.1
CN0600100000000,06,001,Alameda County, CA,Mar-17,848633,816034,32599,3.8
CN0600100000000,06,001,Alameda County, CA,Apr-17,843597,813800,29797,3.5
CN0600100000000,06,001,Alameda County, CA,May-17,843060,814540,28520,3.4
CN0600100000000,06,001,Alameda County, CA,Jun-17,847693,815214,32479,3.8
CN0600100000000,06,001,Alameda County, CA,Jul-17,853464,818776,34688,4.1
CN0600100000000,06,001,Alameda County, CA,Aug-17,850429,816633,33796,4.0
CN0600100000000,06,001,Alameda County, CA,Sep-17,853651,824864,28787,3.4
CN0600100000000,06,001,Alameda County, CA,Oct-17,850027,822095,27932,3.3
CN0600100000000,06,001,Alameda County, CA,Nov-17,852157,825327,26830,3.1
CN0600100000000,06,001,Alameda County, CA,Dec-17,850370,824769,25601,3.0
CN0600100000000,06,001,Alameda County, CA,Jan-18,847928,819743,28185,3.3
CN0600100000000,06,001,Alameda County, CA,Feb-18,853080,825916,27164,3.2
CN0600100000000,06,001,Alameda County, CA,Mar-18,848764,823799,24965,2.9
CN0600100000000,06,001,Alameda County, CA,Apr-18(p),841714,819259,22455,2.7
CN0506700000000,05,067,Jackson County, AR,Mar-17,5980,5622,358,6.0
CN0506700000000,05,067,Jackson County, AR,Apr-17,5956,5656,300,5.0
CN0506700000000,05,067,Jackson County, AR,May-17,6010,5691,319,5.3
CN0506700000000,05,067,Jackson County, AR,Jun-17,6075,5719,356,5.9
CN0506700000000,05,067,Jackson County, AR,Jul-17,5863,5489,374,6.4
CN0506700000000,05,067,Jackson County, AR,Aug-17,5941,5593,348,5.9
CN0506700000000,05,067,Jackson County, AR,Sep-17,5847,5541,306,5.2
CN0506700000000,05,067,Jackson County, AR,Oct-17,5870,5586,284,4.8
CN0506700000000,05,067,Jackson County, AR,Nov-17,5792,5507,285,4.9
CN0506700000000,05,067,Jackson County, AR,Dec-17,5808,5446,362,6.2
CN0506700000000,05,067,Jackson County, AR,Jan-18,5718,5279,439,7.7
CN0506700000000,05,067,Jackson County, AR,Feb-18,5736,5337,399,7.0
CN0506700000000,05,067,Jackson County, AR,Mar-18,5774,5409,365,6.3
CN0506700000000,05,067,Jackson County, AR,Apr-18(p),5767,5459,308,5.3
CN0512900000000,05,129,Searcy County, AR,Mar-17,2901,2784,117,4.0
CN0512900000000,05,129,Searcy County, AR,Apr-17,2939,2833,106,3.6
CN0512900000000,05,129,Searcy County, AR,May-17,3007,2886,121,4.0
CN0512900000000,05,129,Searcy County, AR,Jun-17,3110,2970,140,4.5
CN0512900000000,05,129,Searcy County, AR,Jul-17,2943,2787,156,5.3
CN0512900000000,05,129,Searcy County, AR,Aug-17,3140,2995,145,4.6
CN0512900000000,05,129,Searcy County, AR,Sep-17,3064,2926,138,4.5
CN0512900000000,05,129,Searcy County, AR,Oct-17,2869,2747,122,4.3
CN0512900000000,05,129,Searcy County, AR,Nov-17,2873,2750,123,4.3
CN0512900000000,05,129,Searcy County, AR,Dec-17,2833,2706,127,4.5
CN0512900000000,05,129,Searcy County, AR,Jan-18,2800,2633,167,6.0
CN0512900000000,05,129,Searcy County, AR,Feb-18,2918,2759,159,5.4
CN0512900000000,05,129,Searcy County, AR,Mar-18,2947,2816,131,4.4
CN0512900000000,05,129,Searcy County, AR,Apr-18(p),2954,2839,115,3.9
CN4820500000000,48,205,Hartley County, TX,Mar-17,3010,2950,60,2.0
CN4820500000000,48,205,Hartley County, TX,Apr-17,3008,2956,52,1.7
CN4820500000000,48,205,Hartley County, TX,May-17,3007,2951,56,1.9
CN4820500000000,48,205,Hartley County, TX,Jun-17,3021,2958,63,2.1
CN4820500000000,48,205,Hartley County, TX,Jul-17,2920,2857,63,2.2
CN4820500000000,48,205,Hartley County, TX,Aug-17,2930,2867,63,2.2
CN4820500000000,48,205,Hartley County, TX,Sep-17,2903,2849,54,1.9
CN4820500000000,48,205,Hartley County, TX,Oct-17,2953,2902,51,1.7
CN4820500000000,48,205,Hartley County, TX,Nov-17,2915,2857,58,2.0
CN4820500000000,48,205,Hartley County, TX,Dec-17,2911,2860,51,1.8
CN4820500000000,48,205,Hartley County, TX,Jan-18,2904,2848,56,1.9
CN4820500000000,48,205,Hartley County, TX,Feb-18,2969,2914,55,1.9
CN4820500000000,48,205,Hartley County, TX,Mar-18,3054,2995,59,1.9
CN4820500000000,48,205,Hartley County, TX,Apr-18(p),3026,2978,48,1.6
CN1209500000000,12,095,Orange County, FL,Mar-17,726012,699573,26439,3.6
CN1209500000000,12,095,Orange County, FL,Apr-17,724728,699565,25163,3.5
CN1209500000000,12,095,Orange County, FL,May-17,729416,703688,25728,3.5
CN1209500000000,12,095,Orange County, FL,Jun-17,734479,706178,28301,3.9
CN1209500000000,12,095,Orange County, FL,Jul-17,737793,709314,28479,3.9
CN1209500000000,12,095,Orange County, FL,Aug-17,734298,706368,27930,3.8
CN1209500000000,12,095,Orange County, FL,Sep-17,746245,720111,26134,3.5
CN1209500000000,12,095,Orange County, FL,Oct-17,737036,712501,24535,3.3
CN1209500000000,12,095,Orange County, FL,Nov-17,735547,710552,24995,3.4
CN1209500000000,12,095,Orange County, FL,Dec-17,736987,713643,23344,3.2
CN1209500000000,12,095,Orange County, FL,Jan-18,741088,714256,26832,3.6
CN1209500000000,12,095,Orange County, FL,Feb-18,749059,724337,24722,3.3
CN1209500000000,12,095,Orange County, FL,Mar-18,748051,723740,24311,3.2
CN1209500000000,12,095,Orange County, FL,Apr-18(p),742920,720817,22103,3.0
CN5110700000000,51,107,Loudoun County, VA,Mar-17,210887,204316,6571,3.1
CN5110700000000,51,107,Loudoun County, VA,Apr-17,211254,205283,5971,2.8
CN5110700000000,51,107,Loudoun County, VA,May-17,212383,205894,6489,3.1
CN5110700000000,51,107,Loudoun County, VA,Jun-17,213624,206835,6789,3.2
CN5110700000000,51,107,Loudoun County, VA,Jul-17,215071,208269,6802,3.2
CN5110700000000,51,107,Loudoun County, VA,Aug-17,211883,205053,6830,3.2
CN5110700000000,51,107,Loudoun County, VA,Sep-17,212232,205916,6316,3.0
CN5110700000000,51,107,Loudoun County, VA,Oct-17,211802,205843,5959,2.8
CN5110700000000,51,107,Loudoun County, VA,Nov-17,211607,205683,5924,2.8
CN5110700000000,51,107,Loudoun County, VA,Dec-17,210899,205260,5639,2.7
CN5110700000000,51,107,Loudoun County, VA,Jan-18,212317,206186,6131,2.9
CN5110700000000,51,107,Loudoun County, VA,Feb-18,214098,208473,5625,2.6
CN5110700000000,51,107,Loudoun County, VA,Mar-18,214663,208881,5782,2.7
CN5110700000000,51,107,Loudoun County, VA,Apr-18(p),214437,209498,4939,2.3
CN0607900000000,06,079,San Luis Obispo County, CA,Mar-17,143099,137616,5483,3.8
CN0607900000000,06,079,San Luis Obispo County, CA,Apr-17,143377,138561,4816,3.4
CN0607900000000,06,079,San Luis Obispo County, CA,May-17,143146,138700,4446,3.1
CN0607900000000,06,079,San Luis Obispo County, CA,Jun-17,144581,139353,5228,3.6
CN0607900000000,06,079,San Luis Obispo County, CA,Jul-17,142365,136651,5714,4.0
CN0607900000000,06,079,San Luis Obispo County, CA,Aug-17,138914,133420,5494,4.0
CN0607900000000,06,079,San Luis Obispo County, CA,Sep-17,142279,137615,4664,3.3
CN0607900000000,06,079,San Luis Obispo County, CA,Oct-17,142747,138253,4494,3.1
CN0607900000000,06,079,San Luis Obispo County, CA,Nov-17,142972,138558,4414,3.1
CN0607900000000,06,079,San Luis Obispo County, CA,Dec-17,139923,135682,4241,3.0
CN0607900000000,06,079,San Luis Obispo County, CA,Jan-18,141693,136938,4755,3.4
CN0607900000000,06,079,San Luis Obispo County, CA,Feb-18,143830,139294,4536,3.2
CN0607900000000,06,079,San Luis Obispo County, CA,Mar-18,143110,138951,4159,2.9
CN0607900000000,06,079,San Luis Obispo County, CA,Apr-18(p),142466,138714,3752,2.6
CN3114500000000,31,145,Red Willow County, NE,Mar-17,5813,5672,141,2.4
CN3114500000000,31,145,Red Willow County, NE,Apr-17,5814,5674,140,2.4
CN3114500000000,31,145,Red Willow County, NE,May-17,5864,5713,151,2.6
CN3114500000000,31,145,Red Willow County, NE,Jun-17,5951,5776,175,2.9
CN3114500000000,31,145,Red Willow County, NE,Jul-17,5960,5784,176,3.0
CN3114500000000,31,145,Red Willow County, NE,Aug-17,5827,5670,157,2.7
CN3114500000000,31,145,Red Willow County, NE,Sep-17,5740,5605,135,2.4
CN3114500000000,31,145,Red Willow County, NE,Oct-17,5755,5629,126,2.2
CN3114500000000,31,145,Red Willow County, NE,Nov-17,5747,5626,121,2.1
CN3114500000000,31,145,Red Willow County, NE,Dec-17,5734,5605,129,2.2
CN3114500000000,31,145,Red Willow County, NE,Jan-18,5818,5695,123,2.1
CN3114500000000,31,145,Red Willow County, NE,Feb-18,5872,5749,123,2.1
CN3114500000000,31,145,Red Willow County, NE,Mar-18,5849,5730,119,2.0
CN3114500000000,31,145,Red Willow County, NE,Apr-18(p),5874,5743,131,2.2
CN4507900000000,45,079,Richland County, SC,Mar-17,200600,192892,7708,3.8
CN4507900000000,45,079,Richland County, SC,Apr-17,200322,193125,7197,3.6
CN4507900000000,45,079,Richland County, SC,May-17,200336,192710,7626,3.8
CN4507900000000,45,079,Richland County, SC,Jun-17,201755,192682,9073,4.5
CN4507900000000,45,079,Richland County, SC,Jul-17,202037,193220,8817,4.4
CN4507900000000,45,079,Richland County, SC,Aug-17,199708,189809,9899,5.0
CN4507900000000,45,079,Richland County, SC,Sep-17,199366,190646,8720,4.4
CN4507900000000,45,079,Richland County, SC,Oct-17,199525,190953,8572,4.3
CN4507900000000,45,079,Richland County, SC,Nov-17,198016,189841,8175,4.1
CN4507900000000,45,079,Richland County, SC,Dec-17,197291,188965,8326,4.2
CN4507900000000,45,079,Richland County, SC,Jan-18,197761,187890,9871,5.0
CN4507900000000,45,079,Richland County, SC,Feb-18,199215,190332,8883,4.5
CN4507900000000,45,079,Richland County, SC,Mar-18,199278,191222,8056,4.0
CN4507900000000,45,079,Richland County, SC,Apr-18(p),196559,191035,5524,2.8
CN2701300000000,27,013,Blue Earth County, MN,Mar-17,40327,38961,1366,3.4
CN2701300000000,27,013,Blue Earth County, MN,Apr-17,40443,39319,1124,2.8
CN2701300000000,27,013,Blue Earth County, MN,May-17,40056,38950,1106,2.8
CN2701300000000,27,013,Blue Earth County, MN,Jun-17,39545,38251,1294,3.3
CN2701300000000,27,013,Blue Earth County, MN,Jul-17,39001,37822,1179,3.0
CN2701300000000,27,013,Blue Earth County, MN,Aug-17,39319,38163,1156,2.9
CN2701300000000,27,013,Blue Earth County, MN,Sep-17,40409,39431,978,2.4
CN2701300000000,27,013,Blue Earth County, MN,Oct-17,41379,40577,802,1.9
CN2701300000000,27,013,Blue Earth County, MN,Nov-17,41001,40133,868,2.1
CN2701300000000,27,013,Blue Earth County, MN,Dec-17,40618,39540,1078,2.7
CN2701300000000,27,013,Blue Earth County, MN,Jan-18,41265,39885,1380,3.3
CN2701300000000,27,013,Blue Earth County, MN,Feb-18,41779,40434,1345,3.2
CN2701300000000,27,013,Blue Earth County, MN,Mar-18,41592,40285,1307,3.1
CN2701300000000,27,013,Blue Earth County, MN,Apr-18(p),41384,40336,1048,2.5
CN3803900000000,38,039,Griggs County, ND,Mar-17,1129,1086,43,3.8
CN3803900000000,38,039,Griggs County, ND,Apr-17,1142,1104,38,3.3
CN3803900000000,38,039,Griggs County, ND,May-17,1157,1129,28,2.4
CN3803900000000,38,039,Griggs County, ND,Jun-17,1176,1142,34,2.9
CN3803900000000,38,039,Griggs County, ND,Jul-17,1158,1132,26,2.2
CN3803900000000,38,039,Griggs County, ND,Aug-17,1171,1143,28,2.4
CN3803900000000,38,039,Griggs County, ND,Sep-17,1169,1141,28,2.4
CN3803900000000,38,039,Griggs County, ND,Oct-17,1159,1130,29,2.5
CN3803900000000,38,039,Griggs County, ND,Nov-17,1094,1065,29,2.7
CN3803900000000,38,039,Griggs County, ND,Dec-17,1073,1048,25,2.3
CN3803900000000,38,039,Griggs County, ND,Jan-18,1071,1039,32,3.0
CN3803900000000,38,039,Griggs County, ND,Feb-18,1050,1022,28,2.7
CN3803900000000,38,039,Griggs County, ND,Mar-18,1062,1034,28,2.6
CN3803900000000,38,039,Griggs County, ND,Apr-18(p),1068,1042,26,2.4
CN4831100000000,48,311,McMullen County, TX,Mar-17,772,758,14,1.8
CN4831100000000,48,311,McMullen County, TX,Apr-17,754,742,12,1.6
CN4831100000000,48,311,McMullen County, TX,May-17,767,755,12,1.6
CN4831100000000,48,311,McMullen County, TX,Jun-17,756,741,15,2.0
CN4831100000000,48,311,McMullen County, TX,Jul-17,711,697,14,2.0
CN4831100000000,48,311,McMullen County, TX,Aug-17,732,719,13,1.8
CN4831100000000,48,311,McMullen County, TX,Sep-17,717,706,11,1.5
CN4831100000000,48,311,McMullen County, TX,Oct-17,729,718,11,1.5
CN4831100000000,48,311,McMullen County, TX,Nov-17,706,692,14,2.0
CN4831100000000,48,311,McMullen County, TX,Dec-17,713,701,12,1.7
CN4831100000000,48,311,McMullen County, TX,Jan-18,691,678,13,1.9
CN4831100000000,48,311,McMullen County, TX,Feb-18,690,677,13,1.9
CN4831100000000,48,311,McMullen County, TX,Mar-18,698,684,14,2.0
CN4831100000000,48,311,McMullen County, TX,Apr-18(p),756,741,15,2.0
CN3702700000000,37,027,Caldwell County, NC,Mar-17,36660,35067,1593,4.3
CN3702700000000,37,027,Caldwell County, NC,Apr-17,36580,35168,1412,3.9
CN3702700000000,37,027,Caldwell County, NC,May-17,36561,35026,1535,4.2
CN3702700000000,37,027,Caldwell County, NC,Jun-17,36604,34975,1629,4.5
CN3702700000000,37,027,Caldwell County, NC,Jul-17,36602,34866,1736,4.7
CN3702700000000,37,027,Caldwell County, NC,Aug-17,36284,34538,1746,4.8
CN3702700000000,37,027,Caldwell County, NC,Sep-17,36749,35211,1538,4.2
CN3702700000000,37,027,Caldwell County, NC,Oct-17,36654,34939,1715,4.7
CN3702700000000,37,027,Caldwell County, NC,Nov-17,36571,34947,1624,4.4
CN3702700000000,37,027,Caldwell County, NC,Dec-17,36295,34700,1595,4.4
CN3702700000000,37,027,Caldwell County, NC,Jan-18,36622,34961,1661,4.5
CN3702700000000,37,027,Caldwell County, NC,Feb-18,36907,35294,1613,4.4
CN3702700000000,37,027,Caldwell County, NC,Mar-18,36903,35364,1539,4.2
CN3702700000000,37,027,Caldwell County, NC,Apr-18(p),36743,35435,1308,3.6
CN5500300000000,55,003,Ashland County, WI,Mar-17,7665,7230,435,5.7
CN5500300000000,55,003,Ashland County, WI,Apr-17,7804,7422,382,4.9
CN5500300000000,55,003,Ashland County, WI,May-17,8041,7714,327,4.1
CN5500300000000,55,003,Ashland County, WI,Jun-17,8422,8019,403,4.8
CN5500300000000,55,003,Ashland County, WI,Jul-17,8478,8094,384,4.5
CN5500300000000,55,003,Ashland County, WI,Aug-17,8385,8003,382,4.6
CN5500300000000,55,003,Ashland County, WI,Sep-17,8188,7894,294,3.6
CN5500300000000,55,003,Ashland County, WI,Oct-17,8176,7894,282,3.4
CN5500300000000,55,003,Ashland County, WI,Nov-17,7916,7611,305,3.9
CN5500300000000,55,003,Ashland County, WI,Dec-17,7807,7505,302,3.9
CN5500300000000,55,003,Ashland County, WI,Jan-18,7684,7360,324,4.2
CN5500300000000,55,003,Ashland County, WI,Feb-18,7725,7336,389,5.0
CN5500300000000,55,003,Ashland County, WI,Mar-18,7746,7355,391,5.0
CN5500300000000,55,003,Ashland County, WI,Apr-18(p),7917,7520,397,5.0
CN4102500000000,41,025,Harney County, OR,Mar-17,3378,3124,254,7.5
CN4102500000000,41,025,Harney County, OR,Apr-17,3396,3185,211,6.2
CN4102500000000,41,025,Harney County, OR,May-17,3406,3223,183,5.4
CN4102500000000,41,025,Harney County, OR,Jun-17,3494,3312,182,5.2
CN4102500000000,41,025,Harney County, OR,Jul-17,3574,3389,185,5.2
CN4102500000000,41,025,Harney County, OR,Aug-17,3571,3381,190,5.3
CN4102500000000,41,025,Harney County, OR,Sep-17,3511,3343,168,4.8
CN4102500000000,41,025,Harney County, OR,Oct-17,3495,3302,193,5.5
CN4102500000000,41,025,Harney County, OR,Nov-17,3406,3194,212,6.2
CN4102500000000,41,025,Harney County, OR,Dec-17,3369,3131,238,7.1
CN4102500000000,41,025,Harney County, OR,Jan-18,3373,3089,284,8.4
CN4102500000000,41,025,Harney County, OR,Feb-18,3383,3112,271,8.0
CN4102500000000,41,025,Harney County, OR,Mar-18,3425,3161,264,7.7
CN4102500000000,41,025,Harney County, OR,Apr-18(p),3435,3210,225,6.6
CN4203700000000,42,037,Columbia County, PA,Mar-17,34247,32240,2007,5.9
CN4203700000000,42,037,Columbia County, PA,Apr-17,34208,32560,1648,4.8
CN4203700000000,42,037,Columbia County, PA,May-17,34198,32520,1678,4.9
CN4203700000000,42,037,Columbia County, PA,Jun-17,33784,32043,1741,5.2
CN4203700000000,42,037,Columbia County, PA,Jul-17,33968,32084,1884,5.5
CN4203700000000,42,037,Columbia County, PA,Aug-17,33630,31811,1819,5.4
CN4203700000000,42,037,Columbia County, PA,Sep-17,33815,32319,1496,4.4
CN4203700000000,42,037,Columbia County, PA,Oct-17,33576,32138,1438,4.3
CN4203700000000,42,037,Columbia County, PA,Nov-17,33410,31916,1494,4.5
CN4203700000000,42,037,Columbia County, PA,Dec-17,33178,31536,1642,4.9
CN4203700000000,42,037,Columbia County, PA,Jan-18,33216,31069,2147,6.5
CN4203700000000,42,037,Columbia County, PA,Feb-18,33992,31913,2079,6.1
CN4203700000000,42,037,Columbia County, PA,Mar-18,33453,31632,1821,5.4
CN4203700000000,42,037,Columbia County, PA,Apr-18(p),33297,31863,1434,4.3
CN2019700000000,20,197,Wabaunsee County, KS,Mar-17,3602,3487,115,3.2
CN2019700000000,20,197,Wabaunsee County, KS,Apr-17,3572,3468,104,2.9
CN2019700000000,20,197,Wabaunsee County, KS,May-17,3587,3482,105,2.9
CN2019700000000,20,197,Wabaunsee County, KS,Jun-17,3673,3553,120,3.3
CN2019700000000,20,197,Wabaunsee County, KS,Jul-17,3733,3602,131,3.5
CN2019700000000,20,197,Wabaunsee County, KS,Aug-17,3682,3558,124,3.4
CN2019700000000,20,197,Wabaunsee County, KS,Sep-17,3623,3521,102,2.8
CN2019700000000,20,197,Wabaunsee County, KS,Oct-17,3634,3546,88,2.4
CN2019700000000,20,197,Wabaunsee County, KS,Nov-17,3643,3542,101,2.8
CN2019700000000,20,197,Wabaunsee County, KS,Dec-17,3609,3503,106,2.9
CN2019700000000,20,197,Wabaunsee County, KS,Jan-18,3624,3483,141,3.9
CN2019700000000,20,197,Wabaunsee County, KS,Feb-18,3614,3482,132,3.7
CN2019700000000,20,197,Wabaunsee County, KS,Mar-18,3575,3463,112,3.1
CN2019700000000,20,197,Wabaunsee County, KS,Apr-18(p),3500,3398,102,2.9
CN3801100000000,38,011,Bowman County, ND,Mar-17,1827,1792,35,1.9
CN3801100000000,38,011,Bowman County, ND,Apr-17,1817,1785,32,1.8
CN3801100000000,38,011,Bowman County, ND,May-17,1815,1789,26,1.4
CN3801100000000,38,011,Bowman County, ND,Jun-17,1865,1834,31,1.7
CN3801100000000,38,011,Bowman County, ND,Jul-17,1833,1806,27,1.5
CN3801100000000,38,011,Bowman County, ND,Aug-17,1827,1800,27,1.5
CN3801100000000,38,011,Bowman County, ND,Sep-17,1756,1729,27,1.5
CN3801100000000,38,011,Bowman County, ND,Oct-17,1766,1743,23,1.3
CN3801100000000,38,011,Bowman County, ND,Nov-17,1735,1708,27,1.6
CN3801100000000,38,011,Bowman County, ND,Dec-17,1702,1669,33,1.9
CN3801100000000,38,011,Bowman County, ND,Jan-18,1656,1612,44,2.7
CN3801100000000,38,011,Bowman County, ND,Feb-18,1638,1601,37,2.3
CN3801100000000,38,011,Bowman County, ND,Mar-18,1665,1627,38,2.3
CN3801100000000,38,011,Bowman County, ND,Apr-18(p),1652,1617,35,2.1
CN3703300000000,37,033,Caswell County, NC,Mar-17,9833,9379,454,4.6
CN3703300000000,37,033,Caswell County, NC,Apr-17,9781,9357,424,4.3
CN3703300000000,37,033,Caswell County, NC,May-17,9729,9289,440,4.5
CN3703300000000,37,033,Caswell County, NC,Jun-17,9667,9200,467,4.8
CN3703300000000,37,033,Caswell County, NC,Jul-17,9676,9171,505,5.2
CN3703300000000,37,033,Caswell County, NC,Aug-17,9516,9025,491,5.2
CN3703300000000,37,033,Caswell County, NC,Sep-17,9789,9328,461,4.7
CN3703300000000,37,033,Caswell County, NC,Oct-17,9811,9348,463,4.7
CN3703300000000,37,033,Caswell County, NC,Nov-17,9774,9300,474,4.8
CN3703300000000,37,033,Caswell County, NC,Dec-17,9728,9265,463,4.8
CN3703300000000,37,033,Caswell County, NC,Jan-18,9704,9190,514,5.3
CN3703300000000,37,033,Caswell County, NC,Feb-18,9750,9242,508,5.2
CN3703300000000,37,033,Caswell County, NC,Mar-18,9765,9290,475,4.9
CN3703300000000,37,033,Caswell County, NC,Apr-18(p),9731,9301,430,4.4
CN7205400000000,72,054,Florida Municipio, PR,Mar-17,3456,2931,525,15.2
CN7205400000000,72,054,Florida Municipio, PR,Apr-17,3453,2897,556,16.1
CN7205400000000,72,054,Florida Municipio, PR,May-17,3364,2886,478,14.2
CN7205400000000,72,054,Florida Municipio, PR,Jun-17,3303,2868,435,13.2
CN7205400000000,72,054,Florida Municipio, PR,Jul-17,3314,2859,455,13.7
CN7205400000000,72,054,Florida Municipio, PR,Aug-17,3337,2819,518,15.5
CN7205400000000,72,054,Florida Municipio, PR,Sep-17(y),3303,2848,455,13.8
CN7205400000000,72,054,Florida Municipio, PR,Oct-17,3232,2740,492,15.2
CN7205400000000,72,054,Florida Municipio, PR,Nov-17,3331,2885,446,13.4
CN7205400000000,72,054,Florida Municipio, PR,Dec-17,3319,2904,415,12.5
CN7205400000000,72,054,Florida Municipio, PR,Jan-18,3327,2851,476,14.3
CN7205400000000,72,054,Florida Municipio, PR,Feb-18,3303,2866,437,13.2
CN7205400000000,72,054,Florida Municipio, PR,Mar-18,3291,2872,419,12.7
CN7205400000000,72,054,Florida Municipio, PR,Apr-18(p),3289,2883,406,12.3
CN2919900000000,29,199,Scotland County, MO,Mar-17,2425,2336,89,3.7
CN2919900000000,29,199,Scotland County, MO,Apr-17,2536,2470,66,2.6
CN2919900000000,29,199,Scotland County, MO,May-17,2427,2359,68,2.8
CN2919900000000,29,199,Scotland County, MO,Jun-17,2476,2400,76,3.1
CN2919900000000,29,199,Scotland County, MO,Jul-17,2412,2331,81,3.4
CN2919900000000,29,199,Scotland County, MO,Aug-17,2372,2290,82,3.5
CN2919900000000,29,199,Scotland County, MO,Sep-17,2318,2254,64,2.8
CN2919900000000,29,199,Scotland County, MO,Oct-17,2398,2351,47,2.0
CN2919900000000,29,199,Scotland County, MO,Nov-17,2372,2311,61,2.6
CN2919900000000,29,199,Scotland County, MO,Dec-17,2322,2260,62,2.7
CN2919900000000,29,199,Scotland County, MO,Jan-18,2372,2276,96,4.0
CN2919900000000,29,199,Scotland County, MO,Feb-18,2424,2336,88,3.6
CN2919900000000,29,199,Scotland County, MO,Mar-18,2405,2321,84,3.5
CN2919900000000,29,199,Scotland County, MO,Apr-18(p),2460,2386,74,3.0
CN4105900000000,41,059,Umatilla County, OR,Mar-17,35946,34107,1839,5.1
CN4105900000000,41,059,Umatilla County, OR,Apr-17,36305,34740,1565,4.3
CN4105900000000,41,059,Umatilla County, OR,May-17,36774,35263,1511,4.1
CN4105900000000,41,059,Umatilla County, OR,Jun-17,38158,36447,1711,4.5
CN4105900000000,41,059,Umatilla County, OR,Jul-17,38405,36488,1917,5.0
CN4105900000000,41,059,Umatilla County, OR,Aug-17,38371,36454,1917,5.0
CN4105900000000,41,059,Umatilla County, OR,Sep-17,38244,36623,1621,4.2
CN4105900000000,41,059,Umatilla County, OR,Oct-17,37551,35970,1581,4.2
CN4105900000000,41,059,Umatilla County, OR,Nov-17,36913,35237,1676,4.5
CN4105900000000,41,059,Umatilla County, OR,Dec-17,36031,34168,1863,5.2
CN4105900000000,41,059,Umatilla County, OR,Jan-18,36090,33810,2280,6.3
CN4105900000000,41,059,Umatilla County, OR,Feb-18,36573,34310,2263,6.2
CN4105900000000,41,059,Umatilla County, OR,Mar-18,36526,34625,1901,5.2
CN4105900000000,41,059,Umatilla County, OR,Apr-18(p),36392,34724,1668,4.6
CN1325300000000,13,253,Seminole County, GA,Mar-17,3139,2930,209,6.7
CN1325300000000,13,253,Seminole County, GA,Apr-17,3099,2907,192,6.2
CN1325300000000,13,253,Seminole County, GA,May-17,3134,2929,205,6.5
CN1325300000000,13,253,Seminole County, GA,Jun-17,3160,2950,210,6.6
CN1325300000000,13,253,Seminole County, GA,Jul-17,3116,2908,208,6.7
CN1325300000000,13,253,Seminole County, GA,Aug-17,3098,2896,202,6.5
CN1325300000000,13,253,Seminole County, GA,Sep-17,3122,2933,189,6.1
CN1325300000000,13,253,Seminole County, GA,Oct-17,3093,2915,178,5.8
CN1325300000000,13,253,Seminole County, GA,Nov-17,3087,2911,176,5.7
CN1325300000000,13,253,Seminole County, GA,Dec-17,3102,2909,193,6.2
CN1325300000000,13,253,Seminole County, GA,Jan-18,3180,2979,201,6.3
CN1325300000000,13,253,Seminole County, GA,Feb-18,3118,2916,202,6.5
CN1325300000000,13,253,Seminole County, GA,Mar-18,3095,2923,172,5.6
CN1325300000000,13,253,Seminole County, GA,Apr-18(p),3082,2928,154,5.0
CN1905700000000,19,057,Des Moines County, IA,Mar-17,19754,18870,884,4.5
CN1905700000000,19,057,Des Moines County, IA,Apr-17,19774,18911,863,4.4
CN1905700000000,19,057,Des Moines County, IA,May-17,19644,18841,803,4.1
CN1905700000000,19,057,Des Moines County, IA,Jun-17,20072,19170,902,4.5
CN1905700000000,19,057,Des Moines County, IA,Jul-17,20000,19126,874,4.4
CN1905700000000,19,057,Des Moines County, IA,Aug-17,19765,18912,853,4.3
CN1905700000000,19,057,Des Moines County, IA,Sep-17,19462,18752,710,3.6
CN1905700000000,19,057,Des Moines County, IA,Oct-17,19253,18647,606,3.1
CN1905700000000,19,057,Des Moines County, IA,Nov-17,19305,18653,652,3.4
CN1905700000000,19,057,Des Moines County, IA,Dec-17,19236,18473,763,4.0
CN1905700000000,19,057,Des Moines County, IA,Jan-18,19222,18321,901,4.7
CN1905700000000,19,057,Des Moines County, IA,Feb-18,19223,18371,852,4.4
CN1905700000000,19,057,Des Moines County, IA,Mar-18,19252,18544,708,3.7
CN1905700000000,19,057,Des Moines County, IA,Apr-18(p),19163,18559,604,3.2
CN1602100000000,16,021,Boundary County, ID,Mar-17,4964,4621,343,6.9
CN1602100000000,16,021,Boundary County, ID,Apr-17,5152,4838,314,6.1
CN1602100000000,16,021,Boundary County, ID,May-17,5237,5021,216,4.1
CN1602100000000,16,021,Boundary County, ID,Jun-17,5291,5101,190,3.6
CN1602100000000,16,021,Boundary County, ID,Jul-17,5311,5123,188,3.5
CN1602100000000,16,021,Boundary County, ID,Aug-17,5308,5113,195,3.7
CN1602100000000,16,021,Boundary County, ID,Sep-17,5140,4972,168,3.3
CN1602100000000,16,021,Boundary County, ID,Oct-17,5164,4993,171,3.3
CN1602100000000,16,021,Boundary County, ID,Nov-17,5097,4887,210,4.1
CN1602100000000,16,021,Boundary County, ID,Dec-17,5058,4809,249,4.9
CN1602100000000,16,021,Boundary County, ID,Jan-18,5013,4690,323,6.4
CN1602100000000,16,021,Boundary County, ID,Feb-18,5000,4685,315,6.3
CN1602100000000,16,021,Boundary County, ID,Mar-18,5059,4736,323,6.4
CN1602100000000,16,021,Boundary County, ID,Apr-18(p),5209,4932,277,5.3
CN2119300000000,21,193,Perry County, KY,Mar-17,8930,8055,875,9.8
CN2119300000000,21,193,Perry County, KY,Apr-17,8776,8037,739,8.4
CN2119300000000,21,193,Perry County, KY,May-17,8779,8040,739,8.4
CN2119300000000,21,193,Perry County, KY,Jun-17,8774,8001,773,8.8
CN2119300000000,21,193,Perry County, KY,Jul-17,8591,7864,727,8.5
CN2119300000000,21,193,Perry County, KY,Aug-17,8524,7859,665,7.8
CN2119300000000,21,193,Perry County, KY,Sep-17,8593,7978,615,7.2
CN2119300000000,21,193,Perry County, KY,Oct-17,8423,7878,545,6.5
CN2119300000000,21,193,Perry County, KY,Nov-17,8378,7863,515,6.1
CN2119300000000,21,193,Perry County, KY,Dec-17,8400,7903,497,5.9
CN2119300000000,21,193,Perry County, KY,Jan-18,8370,7860,510,6.1
CN2119300000000,21,193,Perry County, KY,Feb-18,8527,7953,574,6.7
CN2119300000000,21,193,Perry County, KY,Mar-18,8592,8038,554,6.4
CN2119300000000,21,193,Perry County, KY,Apr-18(p),8527,8046,481,5.6
CN2603500000000,26,035,Clare County, MI,Mar-17,12091,11083,1008,8.3
CN2603500000000,26,035,Clare County, MI,Apr-17,11978,11195,783,6.5
CN2603500000000,26,035,Clare County, MI,May-17,12143,11389,754,6.2
CN2603500000000,26,035,Clare County, MI,Jun-17,12215,11404,811,6.6
CN2603500000000,26,035,Clare County, MI,Jul-17,12235,11291,944,7.7
CN2603500000000,26,035,Clare County, MI,Aug-17,12116,11309,807,6.7
CN2603500000000,26,035,Clare County, MI,Sep-17,12163,11465,698,5.7
CN2603500000000,26,035,Clare County, MI,Oct-17,12014,11355,659,5.5
CN2603500000000,26,035,Clare County, MI,Nov-17,12005,11291,714,5.9
CN2603500000000,26,035,Clare County, MI,Dec-17,12018,11171,847,7.0
CN2603500000000,26,035,Clare County, MI,Jan-18,12079,11026,1053,8.7
CN2603500000000,26,035,Clare County, MI,Feb-18,12285,11195,1090,8.9
CN2603500000000,26,035,Clare County, MI,Mar-18,12227,11242,985,8.1
CN2603500000000,26,035,Clare County, MI,Apr-18(p),12159,11363,796,6.5
CN0206800000000,02,068,Denali Borough, AK,Mar-17,640,504,136,21.3
CN0206800000000,02,068,Denali Borough, AK,Apr-17,819,696,123,15.0
CN0206800000000,02,068,Denali Borough, AK,May-17,1501,1405,96,6.4
CN0206800000000,02,068,Denali Borough, AK,Jun-17,1792,1714,78,4.4
CN0206800000000,02,068,Denali Borough, AK,Jul-17,1848,1774,74,4.0
CN0206800000000,02,068,Denali Borough, AK,Aug-17,1812,1749,63,3.5
CN0206800000000,02,068,Denali Borough, AK,Sep-17,1623,1558,65,4.0
CN0206800000000,02,068,Denali Borough, AK,Oct-17,1106,992,114,10.3
CN0206800000000,02,068,Denali Borough, AK,Nov-17,584,466,118,20.2
CN0206800000000,02,068,Denali Borough, AK,Dec-17,585,464,121,20.7
CN0206800000000,02,068,Denali Borough, AK,Jan-18,598,472,126,21.1
CN0206800000000,02,068,Denali Borough, AK,Feb-18,602,487,115,19.1
CN0206800000000,02,068,Denali Borough, AK,Mar-18,619,506,113,18.3
CN0206800000000,02,068,Denali Borough, AK,Apr-18(p),789,691,98,12.4
CN1303500000000,13,035,Butts County, GA,Mar-17,10642,10106,536,5.0
CN1303500000000,13,035,Butts County, GA,Apr-17,10613,10122,491,4.6
CN1303500000000,13,035,Butts County, GA,May-17,10648,10150,498,4.7
CN1303500000000,13,035,Butts County, GA,Jun-17,10674,10147,527,4.9
CN1303500000000,13,035,Butts County, GA,Jul-17,10739,10204,535,5.0
CN1303500000000,13,035,Butts County, GA,Aug-17,10685,10161,524,4.9
CN1303500000000,13,035,Butts County, GA,Sep-17,10777,10288,489,4.5
CN1303500000000,13,035,Butts County, GA,Oct-17,10735,10260,475,4.4
CN1303500000000,13,035,Butts County, GA,Nov-17,10766,10298,468,4.3
CN1303500000000,13,035,Butts County, GA,Dec-17,10783,10297,486,4.5
CN1303500000000,13,035,Butts County, GA,Jan-18,10796,10281,515,4.8
CN1303500000000,13,035,Butts County, GA,Feb-18,10920,10426,494,4.5
CN1303500000000,13,035,Butts County, GA,Mar-18,10917,10464,453,4.1
CN1303500000000,13,035,Butts County, GA,Apr-18(p),10823,10428,395,3.6
CN3808300000000,38,083,Sheridan County, ND,Mar-17,720,671,49,6.8
CN3808300000000,38,083,Sheridan County, ND,Apr-17,708,668,40,5.6
CN3808300000000,38,083,Sheridan County, ND,May-17,712,686,26,3.7
CN3808300000000,38,083,Sheridan County, ND,Jun-17,777,749,28,3.6
CN3808300000000,38,083,Sheridan County, ND,Jul-17,733,713,20,2.7
CN3808300000000,38,083,Sheridan County, ND,Aug-17,749,724,25,3.3
CN3808300000000,38,083,Sheridan County, ND,Sep-17,759,736,23,3.0
CN3808300000000,38,083,Sheridan County, ND,Oct-17,753,732,21,2.8
CN3808300000000,38,083,Sheridan County, ND,Nov-17,717,687,30,4.2
CN3808300000000,38,083,Sheridan County, ND,Dec-17,734,693,41,5.6
CN3808300000000,38,083,Sheridan County, ND,Jan-18,707,652,55,7.8
CN3808300000000,38,083,Sheridan County, ND,Feb-18,687,636,51,7.4
CN3808300000000,38,083,Sheridan County, ND,Mar-18,711,655,56,7.9
CN3808300000000,38,083,Sheridan County, ND,Apr-18(p),688,647,41,6.0
CN3101100000000,31,011,Boone County, NE,Mar-17,2885,2806,79,2.7
CN3101100000000,31,011,Boone County, NE,Apr-17,2990,2929,61,2.0
CN3101100000000,31,011,Boone County, NE,May-17,3024,2958,66,2.2
CN3101100000000,31,011,Boone County, NE,Jun-17,3135,3063,72,2.3
CN3101100000000,31,011,Boone County, NE,Jul-17,3053,2980,73,2.4
CN3101100000000,31,011,Boone County, NE,Aug-17,2911,2841,70,2.4
CN3101100000000,31,011,Boone County, NE,Sep-17,2779,2712,67,2.4
CN3101100000000,31,011,Boone County, NE,Oct-17,2823,2759,64,2.3
CN3101100000000,31,011,Boone County, NE,Nov-17,2830,2773,57,2.0
CN3101100000000,31,011,Boone County, NE,Dec-17,2833,2771,62,2.2
CN3101100000000,31,011,Boone County, NE,Jan-18,2897,2821,76,2.6
CN3101100000000,31,011,Boone County, NE,Feb-18,2808,2734,74,2.6
CN3101100000000,31,011,Boone County, NE,Mar-18,2871,2799,72,2.5
CN3101100000000,31,011,Boone County, NE,Apr-18(p),2879,2814,65,2.3
CN2100900000000,21,009,Barren County, KY,Mar-17,19451,18482,969,5.0
CN2100900000000,21,009,Barren County, KY,Apr-17,19551,18695,856,4.4
CN2100900000000,21,009,Barren County, KY,May-17,19591,18711,880,4.5
CN2100900000000,21,009,Barren County, KY,Jun-17,19655,18676,979,5.0
CN2100900000000,21,009,Barren County, KY,Jul-17,19277,18354,923,4.8
CN2100900000000,21,009,Barren County, KY,Aug-17,19080,18237,843,4.4
CN2100900000000,21,009,Barren County, KY,Sep-17,19096,18313,783,4.1
CN2100900000000,21,009,Barren County, KY,Oct-17,18982,18246,736,3.9
CN2100900000000,21,009,Barren County, KY,Nov-17,18910,18183,727,3.8
CN2100900000000,21,009,Barren County, KY,Dec-17,18874,18186,688,3.6
CN2100900000000,21,009,Barren County, KY,Jan-18,19185,18333,852,4.4
CN2100900000000,21,009,Barren County, KY,Feb-18,19432,18441,991,5.1
CN2100900000000,21,009,Barren County, KY,Mar-18,19628,18712,916,4.7
CN2100900000000,21,009,Barren County, KY,Apr-18(p),19631,18870,761,3.9
CN0606300000000,06,063,Plumas County, CA,Mar-17,7556,6563,993,13.1
CN0606300000000,06,063,Plumas County, CA,Apr-17,7543,6714,829,11.0
CN0606300000000,06,063,Plumas County, CA,May-17,7899,7273,626,7.9
CN0606300000000,06,063,Plumas County, CA,Jun-17,8314,7730,584,7.0
CN0606300000000,06,063,Plumas County, CA,Jul-17,8486,7897,589,6.9
CN0606300000000,06,063,Plumas County, CA,Aug-17,8296,7762,534,6.4
CN0606300000000,06,063,Plumas County, CA,Sep-17,8063,7606,457,5.7
CN0606300000000,06,063,Plumas County, CA,Oct-17,7867,7404,463,5.9
CN0606300000000,06,063,Plumas County, CA,Nov-17,7443,6896,547,7.3
CN0606300000000,06,063,Plumas County, CA,Dec-17,7340,6672,668,9.1
CN0606300000000,06,063,Plumas County, CA,Jan-18,7244,6460,784,10.8
CN0606300000000,06,063,Plumas County, CA,Feb-18,7408,6552,856,11.6
CN0606300000000,06,063,Plumas County, CA,Mar-18,7438,6598,840,11.3
CN0606300000000,06,063,Plumas County, CA,Apr-18(p),7459,6784,675,9.0
CN1701100000000,17,011,Bureau County, IL,Mar-17,17277,16347,930,5.4
CN1701100000000,17,011,Bureau County, IL,Apr-17,17413,16706,707,4.1
CN1701100000000,17,011,Bureau County, IL,May-17,17437,16758,679,3.9
CN1701100000000,17,011,Bureau County, IL,Jun-17,17698,16933,765,4.3
CN1701100000000,17,011,Bureau County, IL,Jul-17,17620,16821,799,4.5
CN1701100000000,17,011,Bureau County, IL,Aug-17,17501,16668,833,4.8
CN1701100000000,17,011,Bureau County, IL,Sep-17,17372,16639,733,4.2
CN1701100000000,17,011,Bureau County, IL,Oct-17,17209,16542,667,3.9
CN1701100000000,17,011,Bureau County, IL,Nov-17,17114,16396,718,4.2
CN1701100000000,17,011,Bureau County, IL,Dec-17,16884,16103,781,4.6
CN1701100000000,17,011,Bureau County, IL,Jan-18,17105,16175,930,5.4
CN1701100000000,17,011,Bureau County, IL,Feb-18,17162,16329,833,4.9
CN1701100000000,17,011,Bureau County, IL,Mar-18,17575,16745,830,4.7
CN1701100000000,17,011,Bureau County, IL,Apr-18(p),17803,17164,639,3.6
CN4903100000000,49,031,Piute County, UT,Mar-17,484,455,29,6.0
CN4903100000000,49,031,Piute County, UT,Apr-17,485,461,24,4.9
CN4903100000000,49,031,Piute County, UT,May-17,495,474,21,4.2
CN4903100000000,49,031,Piute County, UT,Jun-17,509,486,23,4.5
CN4903100000000,49,031,Piute County, UT,Jul-17,483,460,23,4.8
CN4903100000000,49,031,Piute County, UT,Aug-17,496,474,22,4.4
CN4903100000000,49,031,Piute County, UT,Sep-17,509,489,20,3.9
CN4903100000000,49,031,Piute County, UT,Oct-17,503,481,22,4.4
CN4903100000000,49,031,Piute County, UT,Nov-17,480,460,20,4.2
CN4903100000000,49,031,Piute County, UT,Dec-17,491,465,26,5.3
CN4903100000000,49,031,Piute County, UT,Jan-18,487,460,27,5.5
CN4903100000000,49,031,Piute County, UT,Feb-18,497,469,28,5.6
CN4903100000000,49,031,Piute County, UT,Mar-18,505,477,28,5.5
CN4903100000000,49,031,Piute County, UT,Apr-18(p),501,474,27,5.4
CN5303500000000,53,035,Kitsap County, WA,Mar-17,120066,114052,6014,5.0
CN5303500000000,53,035,Kitsap County, WA,Apr-17,119542,113834,5708,4.8
CN5303500000000,53,035,Kitsap County, WA,May-17,120005,114254,5751,4.8
CN5303500000000,53,035,Kitsap County, WA,Jun-17,121064,115306,5758,4.8
CN5303500000000,53,035,Kitsap County, WA,Jul-17,121030,115202,5828,4.8
CN5303500000000,53,035,Kitsap County, WA,Aug-17,120464,114635,5829,4.8
CN5303500000000,53,035,Kitsap County, WA,Sep-17,120467,114748,5719,4.7
CN5303500000000,53,035,Kitsap County, WA,Oct-17,122331,116815,5516,4.5
CN5303500000000,53,035,Kitsap County, WA,Nov-17,123113,117415,5698,4.6
CN5303500000000,53,035,Kitsap County, WA,Dec-17,124095,118018,6077,4.9
CN5303500000000,53,035,Kitsap County, WA,Jan-18,122220,115652,6568,5.4
CN5303500000000,53,035,Kitsap County, WA,Feb-18,121470,114789,6681,5.5
CN5303500000000,53,035,Kitsap County, WA,Mar-18,121734,115391,6343,5.2
CN5303500000000,53,035,Kitsap County, WA,Apr-18(p),120125,114156,5969,5.0
CN4600700000000,46,007,Bennett County, SD,Mar-17,1105,1058,47,4.3
CN4600700000000,46,007,Bennett County, SD,Apr-17,1112,1064,48,4.3
CN4600700000000,46,007,Bennett County, SD,May-17,1140,1091,49,4.3
CN4600700000000,46,007,Bennett County, SD,Jun-17,1135,1087,48,4.2
CN4600700000000,46,007,Bennett County, SD,Jul-17,1141,1089,52,4.6
CN4600700000000,46,007,Bennett County, SD,Aug-17,1149,1097,52,4.5
CN4600700000000,46,007,Bennett County, SD,Sep-17,1125,1073,52,4.6
CN4600700000000,46,007,Bennett County, SD,Oct-17,1122,1069,53,4.7
CN4600700000000,46,007,Bennett County, SD,Nov-17,1119,1068,51,4.6
CN4600700000000,46,007,Bennett County, SD,Dec-17,1115,1066,49,4.4
CN4600700000000,46,007,Bennett County, SD,Jan-18,1115,1064,51,4.6
CN4600700000000,46,007,Bennett County, SD,Feb-18,1121,1062,59,5.3
CN4600700000000,46,007,Bennett County, SD,Mar-18,1129,1073,56,5.0
CN4600700000000,46,007,Bennett County, SD,Apr-18(p),1112,1060,52,4.7
CN4805900000000,48,059,Callahan County, TX,Mar-17,5868,5642,226,3.9
CN4805900000000,48,059,Callahan County, TX,Apr-17,5857,5658,199,3.4
CN4805900000000,48,059,Callahan County, TX,May-17,5854,5638,216,3.7
CN4805900000000,48,059,Callahan County, TX,Jun-17,5832,5612,220,3.8
CN4805900000000,48,059,Callahan County, TX,Jul-17,5792,5566,226,3.9
CN4805900000000,48,059,Callahan County, TX,Aug-17,5800,5579,221,3.8
CN4805900000000,48,059,Callahan County, TX,Sep-17,5855,5654,201,3.4
CN4805900000000,48,059,Callahan County, TX,Oct-17,5835,5648,187,3.2
CN4805900000000,48,059,Callahan County, TX,Nov-17,5885,5687,198,3.4
CN4805900000000,48,059,Callahan County, TX,Dec-17,5886,5701,185,3.1
CN4805900000000,48,059,Callahan County, TX,Jan-18,5884,5672,212,3.6
CN4805900000000,48,059,Callahan County, TX,Feb-18,5984,5767,217,3.6
CN4805900000000,48,059,Callahan County, TX,Mar-18,6019,5795,224,3.7
CN4805900000000,48,059,Callahan County, TX,Apr-18(p),6018,5811,207,3.4
CN4710900000000,47,109,McNairy County, TN,Mar-17,8844,8343,501,5.7
CN4710900000000,47,109,McNairy County, TN,Apr-17,8608,8185,423,4.9
CN4710900000000,47,109,McNairy County, TN,May-17,8621,8202,419,4.9
CN4710900000000,47,109,McNairy County, TN,Jun-17,8493,7967,526,6.2
CN4710900000000,47,109,McNairy County, TN,Jul-17,8414,7910,504,6.0
CN4710900000000,47,109,McNairy County, TN,Aug-17,8630,8137,493,5.7
CN4710900000000,47,109,McNairy County, TN,Sep-17,8578,8145,433,5.0
CN4710900000000,47,109,McNairy County, TN,Oct-17,8434,8027,407,4.8
CN4710900000000,47,109,McNairy County, TN,Nov-17,8356,7947,409,4.9
CN4710900000000,47,109,McNairy County, TN,Dec-17,8376,7970,406,4.8
CN4710900000000,47,109,McNairy County, TN,Jan-18,8408,7917,491,5.8
CN4710900000000,47,109,McNairy County, TN,Feb-18,8498,8007,491,5.8
CN4710900000000,47,109,McNairy County, TN,Mar-18,8433,7969,464,5.5
CN4710900000000,47,109,McNairy County, TN,Apr-18(p),8505,8123,382,4.5
CN1817300000000,18,173,Warrick County, IN,Mar-17,32152,31097,1055,3.3
CN1817300000000,18,173,Warrick County, IN,Apr-17,32105,31255,850,2.6
CN1817300000000,18,173,Warrick County, IN,May-17,32018,31092,926,2.9
CN1817300000000,18,173,Warrick County, IN,Jun-17,32594,31534,1060,3.3
CN1817300000000,18,173,Warrick County, IN,Jul-17,32971,31903,1068,3.2
CN1817300000000,18,173,Warrick County, IN,Aug-17,32486,31334,1152,3.5
CN1817300000000,18,173,Warrick County, IN,Sep-17,32755,31841,914,2.8
CN1817300000000,18,173,Warrick County, IN,Oct-17,32689,31840,849,2.6
CN1817300000000,18,173,Warrick County, IN,Nov-17,32651,31751,900,2.8
CN1817300000000,18,173,Warrick County, IN,Dec-17,32386,31526,860,2.7
CN1817300000000,18,173,Warrick County, IN,Jan-18,32130,31137,993,3.1
CN1817300000000,18,173,Warrick County, IN,Feb-18,32637,31580,1057,3.2
CN1817300000000,18,173,Warrick County, IN,Mar-18,32966,32045,921,2.8
CN1817300000000,18,173,Warrick County, IN,Apr-18(p),33160,32333,827,2.5
CN3505900000000,35,059,Union County, NM,Mar-17,1837,1761,76,4.1
CN3505900000000,35,059,Union County, NM,Apr-17,1847,1785,62,3.4
CN3505900000000,35,059,Union County, NM,May-17,1861,1796,65,3.5
CN3505900000000,35,059,Union County, NM,Jun-17,1940,1863,77,4.0
CN3505900000000,35,059,Union County, NM,Jul-17,1953,1873,80,4.1
CN3505900000000,35,059,Union County, NM,Aug-17,1927,1854,73,3.8
CN3505900000000,35,059,Union County, NM,Sep-17,1930,1866,64,3.3
CN3505900000000,35,059,Union County, NM,Oct-17,1882,1813,69,3.7
CN3505900000000,35,059,Union County, NM,Nov-17,1826,1759,67,3.7
CN3505900000000,35,059,Union County, NM,Dec-17,1808,1747,61,3.4
CN3505900000000,35,059,Union County, NM,Jan-18,1808,1747,61,3.4
CN3505900000000,35,059,Union County, NM,Feb-18,1825,1771,54,3.0
CN3505900000000,35,059,Union County, NM,Mar-18,1822,1770,52,2.9
CN3505900000000,35,059,Union County, NM,Apr-18(p),1820,1775,45,2.5
CN2912100000000,29,121,Macon County, MO,Mar-17,7486,7165,321,4.3
CN2912100000000,29,121,Macon County, MO,Apr-17,7532,7270,262,3.5
CN2912100000000,29,121,Macon County, MO,May-17,7430,7165,265,3.6
CN2912100000000,29,121,Macon County, MO,Jun-17,7483,7218,265,3.5
CN2912100000000,29,121,Macon County, MO,Jul-17,7196,6908,288,4.0
CN2912100000000,29,121,Macon County, MO,Aug-17,7084,6791,293,4.1
CN2912100000000,29,121,Macon County, MO,Sep-17,7308,7088,220,3.0
CN2912100000000,29,121,Macon County, MO,Oct-17,7381,7224,157,2.1
CN2912100000000,29,121,Macon County, MO,Nov-17,7388,7175,213,2.9
CN2912100000000,29,121,Macon County, MO,Dec-17,7378,7139,239,3.2
CN2912100000000,29,121,Macon County, MO,Jan-18,7408,7104,304,4.1
CN2912100000000,29,121,Macon County, MO,Feb-18,7447,7150,297,4.0
CN2912100000000,29,121,Macon County, MO,Mar-18,7402,7129,273,3.7
CN2912100000000,29,121,Macon County, MO,Apr-18(p),7433,7232,201,2.7
CN1204500000000,12,045,Gulf County, FL,Mar-17,5973,5744,229,3.8
CN1204500000000,12,045,Gulf County, FL,Apr-17,5974,5750,224,3.7
CN1204500000000,12,045,Gulf County, FL,May-17,6027,5807,220,3.7
CN1204500000000,12,045,Gulf County, FL,Jun-17,6197,5957,240,3.9
CN1204500000000,12,045,Gulf County, FL,Jul-17,6192,5943,249,4.0
CN1204500000000,12,045,Gulf County, FL,Aug-17,6162,5917,245,4.0
CN1204500000000,12,045,Gulf County, FL,Sep-17,6194,5972,222,3.6
CN1204500000000,12,045,Gulf County, FL,Oct-17,6083,5892,191,3.1
CN1204500000000,12,045,Gulf County, FL,Nov-17,5975,5770,205,3.4
CN1204500000000,12,045,Gulf County, FL,Dec-17,5900,5688,212,3.6
CN1204500000000,12,045,Gulf County, FL,Jan-18,5942,5682,260,4.4
CN1204500000000,12,045,Gulf County, FL,Feb-18,5998,5757,241,4.0
CN1204500000000,12,045,Gulf County, FL,Mar-18,6106,5882,224,3.7
CN1204500000000,12,045,Gulf County, FL,Apr-18(p),6132,5937,195,3.2
CN4400500000000,44,005,Newport County, RI,Mar-17,44078,42018,2060,4.7
CN4400500000000,44,005,Newport County, RI,Apr-17,43835,42282,1553,3.5
CN4400500000000,44,005,Newport County, RI,May-17,43759,42352,1407,3.2
CN4400500000000,44,005,Newport County, RI,Jun-17,44431,42920,1511,3.4
CN4400500000000,44,005,Newport County, RI,Jul-17,44621,42987,1634,3.7
CN4400500000000,44,005,Newport County, RI,Aug-17,44502,42936,1566,3.5
CN4400500000000,44,005,Newport County, RI,Sep-17,44238,42841,1397,3.2
CN4400500000000,44,005,Newport County, RI,Oct-17,44351,42903,1448,3.3
CN4400500000000,44,005,Newport County, RI,Nov-17,44744,43046,1698,3.8
CN4400500000000,44,005,Newport County, RI,Dec-17,44644,42891,1753,3.9
CN4400500000000,44,005,Newport County, RI,Jan-18,44567,42169,2398,5.4
CN4400500000000,44,005,Newport County, RI,Feb-18,44734,42365,2369,5.3
CN4400500000000,44,005,Newport County, RI,Mar-18,44536,42531,2005,4.5
CN4400500000000,44,005,Newport County, RI,Apr-18(p),44487,42895,1592,3.6
CN0109700000000,01,097,Mobile County, AL,Mar-17,187808,176961,10847,5.8
CN0109700000000,01,097,Mobile County, AL,Apr-17,186653,177535,9118,4.9
CN0109700000000,01,097,Mobile County, AL,May-17,185607,176814,8793,4.7
CN0109700000000,01,097,Mobile County, AL,Jun-17,186498,175825,10673,5.7
CN0109700000000,01,097,Mobile County, AL,Jul-17,186095,175974,10121,5.4
CN0109700000000,01,097,Mobile County, AL,Aug-17,184692,175307,9385,5.1
CN0109700000000,01,097,Mobile County, AL,Sep-17,185281,177256,8025,4.3
CN0109700000000,01,097,Mobile County, AL,Oct-17,185865,178042,7823,4.2
CN0109700000000,01,097,Mobile County, AL,Nov-17,185237,177684,7553,4.1
CN0109700000000,01,097,Mobile County, AL,Dec-17,185118,177529,7589,4.1
CN0109700000000,01,097,Mobile County, AL,Jan-18,184627,175446,9181,5.0
CN0109700000000,01,097,Mobile County, AL,Feb-18,186007,176516,9491,5.1
CN0109700000000,01,097,Mobile County, AL,Mar-18,186454,177803,8651,4.6
CN0109700000000,01,097,Mobile County, AL,Apr-18(p),188745,180769,7976,4.2
CN2205900000000,22,059,LaSalle Parish, LA,Mar-17,6109,5801,308,5.0
CN2205900000000,22,059,LaSalle Parish, LA,Apr-17,6176,5881,295,4.8
CN2205900000000,22,059,LaSalle Parish, LA,May-17,6083,5803,280,4.6
CN2205900000000,22,059,LaSalle Parish, LA,Jun-17,6279,5951,328,5.2
CN2205900000000,22,059,LaSalle Parish, LA,Jul-17,6212,5901,311,5.0
CN2205900000000,22,059,LaSalle Parish, LA,Aug-17,6114,5809,305,5.0
CN2205900000000,22,059,LaSalle Parish, LA,Sep-17,6278,6003,275,4.4
CN2205900000000,22,059,LaSalle Parish, LA,Oct-17,6215,5976,239,3.8
CN2205900000000,22,059,LaSalle Parish, LA,Nov-17,6235,5989,246,3.9
CN2205900000000,22,059,LaSalle Parish, LA,Dec-17,6181,5954,227,3.7
CN2205900000000,22,059,LaSalle Parish, LA,Jan-18,6162,5908,254,4.1
CN2205900000000,22,059,LaSalle Parish, LA,Feb-18,6202,5971,231,3.7
CN2205900000000,22,059,LaSalle Parish, LA,Mar-18,6204,5945,259,4.2
CN2205900000000,22,059,LaSalle Parish, LA,Apr-18(p),6250,5993,257,4.1
CN4003500000000,40,035,Craig County, OK,Mar-17,5969,5695,274,4.6
CN4003500000000,40,035,Craig County, OK,Apr-17,6031,5770,261,4.3
CN4003500000000,40,035,Craig County, OK,May-17,6046,5762,284,4.7
CN4003500000000,40,035,Craig County, OK,Jun-17,6151,5860,291,4.7
CN4003500000000,40,035,Craig County, OK,Jul-17,6064,5798,266,4.4
CN4003500000000,40,035,Craig County, OK,Aug-17,6175,5915,260,4.2
CN4003500000000,40,035,Craig County, OK,Sep-17,6195,5931,264,4.3
CN4003500000000,40,035,Craig County, OK,Oct-17,6113,5863,250,4.1
CN4003500000000,40,035,Craig County, OK,Nov-17,6140,5898,242,3.9
CN4003500000000,40,035,Craig County, OK,Dec-17,6063,5813,250,4.1
CN4003500000000,40,035,Craig County, OK,Jan-18,5944,5683,261,4.4
CN4003500000000,40,035,Craig County, OK,Feb-18,6059,5803,256,4.2
CN4003500000000,40,035,Craig County, OK,Mar-18,6037,5799,238,3.9
CN4003500000000,40,035,Craig County, OK,Apr-18(p),5987,5748,239,4.0
CN3300700000000,33,007,Coos County, NH,Mar-17,14309,13714,595,4.2
CN3300700000000,33,007,Coos County, NH,Apr-17,14042,13467,575,4.1
CN3300700000000,33,007,Coos County, NH,May-17,14119,13639,480,3.4
CN3300700000000,33,007,Coos County, NH,Jun-17,14607,14152,455,3.1
CN3300700000000,33,007,Coos County, NH,Jul-17,14833,14393,440,3.0
CN3300700000000,33,007,Coos County, NH,Aug-17,14830,14380,450,3.0
CN3300700000000,33,007,Coos County, NH,Sep-17,14514,14099,415,2.9
CN3300700000000,33,007,Coos County, NH,Oct-17,14302,13933,369,2.6
CN3300700000000,33,007,Coos County, NH,Nov-17,14044,13629,415,3.0
CN3300700000000,33,007,Coos County, NH,Dec-17,14131,13696,435,3.1
CN3300700000000,33,007,Coos County, NH,Jan-18,14257,13640,617,4.3
CN3300700000000,33,007,Coos County, NH,Feb-18,14299,13722,577,4.0
CN3300700000000,33,007,Coos County, NH,Mar-18,14270,13691,579,4.1
CN3300700000000,33,007,Coos County, NH,Apr-18(p),14054,13478,576,4.1
CN4500100000000,45,001,Abbeville County, SC,Mar-17,10175,9747,428,4.2
CN4500100000000,45,001,Abbeville County, SC,Apr-17,10078,9682,396,3.9
CN4500100000000,45,001,Abbeville County, SC,May-17,10077,9660,417,4.1
CN4500100000000,45,001,Abbeville County, SC,Jun-17,10069,9568,501,5.0
CN4500100000000,45,001,Abbeville County, SC,Jul-17,10049,9540,509,5.1
CN4500100000000,45,001,Abbeville County, SC,Aug-17,10014,9496,518,5.2
CN4500100000000,45,001,Abbeville County, SC,Sep-17,10044,9585,459,4.6
CN4500100000000,45,001,Abbeville County, SC,Oct-17,10096,9650,446,4.4
CN4500100000000,45,001,Abbeville County, SC,Nov-17,10112,9677,435,4.3
CN4500100000000,45,001,Abbeville County, SC,Dec-17,10153,9703,450,4.4
CN4500100000000,45,001,Abbeville County, SC,Jan-18,10175,9591,584,5.7
CN4500100000000,45,001,Abbeville County, SC,Feb-18,10254,9747,507,4.9
CN4500100000000,45,001,Abbeville County, SC,Mar-18,10185,9718,467,4.6
CN4500100000000,45,001,Abbeville County, SC,Apr-18(p),10004,9691,313,3.1
CN5169000000000,51,690,Martinsville city, VA,Mar-17,5243,4873,370,7.1
CN5169000000000,51,690,Martinsville city, VA,Apr-17,5205,4861,344,6.6
CN5169000000000,51,690,Martinsville city, VA,May-17,5183,4854,329,6.3
CN5169000000000,51,690,Martinsville city, VA,Jun-17,5245,4882,363,6.9
CN5169000000000,51,690,Martinsville city, VA,Jul-17,5281,4912,369,7.0
CN5169000000000,51,690,Martinsville city, VA,Aug-17,5292,4897,395,7.5
CN5169000000000,51,690,Martinsville city, VA,Sep-17,5212,4873,339,6.5
CN5169000000000,51,690,Martinsville city, VA,Oct-17,5211,4889,322,6.2
CN5169000000000,51,690,Martinsville city, VA,Nov-17,5203,4879,324,6.2
CN5169000000000,51,690,Martinsville city, VA,Dec-17,5185,4875,310,6.0
CN5169000000000,51,690,Martinsville city, VA,Jan-18,5247,4912,335,6.4
CN5169000000000,51,690,Martinsville city, VA,Feb-18,5237,4932,305,5.8
CN5169000000000,51,690,Martinsville city, VA,Mar-18,5238,4937,301,5.7
CN5169000000000,51,690,Martinsville city, VA,Apr-18(p),5193,4930,263,5.1
CN1708900000000,17,089,Kane County, IL,Mar-17,267349,252863,14486,5.4
CN1708900000000,17,089,Kane County, IL,Apr-17,265621,254424,11197,4.2
CN1708900000000,17,089,Kane County, IL,May-17,264911,254141,10770,4.1
CN1708900000000,17,089,Kane County, IL,Jun-17,268524,256635,11889,4.4
CN1708900000000,17,089,Kane County, IL,Jul-17,270087,257748,12339,4.6
CN1708900000000,17,089,Kane County, IL,Aug-17,267463,254888,12575,4.7
CN1708900000000,17,089,Kane County, IL,Sep-17,266901,255983,10918,4.1
CN1708900000000,17,089,Kane County, IL,Oct-17,267927,257318,10609,4.0
CN1708900000000,17,089,Kane County, IL,Nov-17,269353,258153,11200,4.2
CN1708900000000,17,089,Kane County, IL,Dec-17,268529,256372,12157,4.5
CN1708900000000,17,089,Kane County, IL,Jan-18,266458,253159,13299,5.0
CN1708900000000,17,089,Kane County, IL,Feb-18,268359,255779,12580,4.7
CN1708900000000,17,089,Kane County, IL,Mar-18,273300,259927,13373,4.9
CN1708900000000,17,089,Kane County, IL,Apr-18(p),271100,260829,10271,3.8
CN2001300000000,20,013,Brown County, KS,Mar-17,5347,5168,179,3.3
CN2001300000000,20,013,Brown County, KS,Apr-17,5288,5133,155,2.9
CN2001300000000,20,013,Brown County, KS,May-17,5291,5114,177,3.3
CN2001300000000,20,013,Brown County, KS,Jun-17,5449,5248,201,3.7
CN2001300000000,20,013,Brown County, KS,Jul-17,5446,5248,198,3.6
CN2001300000000,20,013,Brown County, KS,Aug-17,5310,5132,178,3.4
CN2001300000000,20,013,Brown County, KS,Sep-17,5298,5149,149,2.8
CN2001300000000,20,013,Brown County, KS,Oct-17,5312,5169,143,2.7
CN2001300000000,20,013,Brown County, KS,Nov-17,5274,5122,152,2.9
CN2001300000000,20,013,Brown County, KS,Dec-17,5256,5115,141,2.7
CN2001300000000,20,013,Brown County, KS,Jan-18,5267,5104,163,3.1
CN2001300000000,20,013,Brown County, KS,Feb-18,5269,5091,178,3.4
CN2001300000000,20,013,Brown County, KS,Mar-18,5319,5148,171,3.2
CN2001300000000,20,013,Brown County, KS,Apr-18(p),5198,5044,154,3.0
CN3400900000000,34,009,Cape May County, NJ,Mar-17,41339,35966,5373,13.0
CN3400900000000,34,009,Cape May County, NJ,Apr-17,42963,38656,4307,10.0
CN3400900000000,34,009,Cape May County, NJ,May-17,46300,42727,3573,7.7
CN3400900000000,34,009,Cape May County, NJ,Jun-17,54774,51305,3469,6.3
CN3400900000000,34,009,Cape May County, NJ,Jul-17,58642,55360,3282,5.6
CN3400900000000,34,009,Cape May County, NJ,Aug-17,57049,54001,3048,5.3
CN3400900000000,34,009,Cape May County, NJ,Sep-17,49997,47023,2974,5.9
CN3400900000000,34,009,Cape May County, NJ,Oct-17,44823,41453,3370,7.5
CN3400900000000,34,009,Cape May County, NJ,Nov-17,43631,38779,4852,11.1
CN3400900000000,34,009,Cape May County, NJ,Dec-17,43543,38215,5328,12.2
CN3400900000000,34,009,Cape May County, NJ,Jan-18,42484,36339,6145,14.5
CN3400900000000,34,009,Cape May County, NJ,Feb-18,42626,36542,6084,14.3
CN3400900000000,34,009,Cape May County, NJ,Mar-18,42680,37055,5625,13.2
CN3400900000000,34,009,Cape May County, NJ,Apr-18(p),43533,39152,4381,10.1
CN3903500000000,39,035,Cuyahoga County, OH,Mar-17,605774,567986,37788,6.2
CN3903500000000,39,035,Cuyahoga County, OH,Apr-17,615417,580876,34541,5.6
CN3903500000000,39,035,Cuyahoga County, OH,May-17,610316,575077,35239,5.8
CN3903500000000,39,035,Cuyahoga County, OH,Jun-17,619569,580347,39222,6.3
CN3903500000000,39,035,Cuyahoga County, OH,Jul-17,626920,587681,39239,6.3
CN3903500000000,39,035,Cuyahoga County, OH,Aug-17,615702,577806,37896,6.2
CN3903500000000,39,035,Cuyahoga County, OH,Sep-17,614718,581804,32914,5.4
CN3903500000000,39,035,Cuyahoga County, OH,Oct-17,605967,576143,29824,4.9
CN3903500000000,39,035,Cuyahoga County, OH,Nov-17,604517,575906,28611,4.7
CN3903500000000,39,035,Cuyahoga County, OH,Dec-17,595821,566569,29252,4.9
CN3903500000000,39,035,Cuyahoga County, OH,Jan-18,597653,564117,33536,5.6
CN3903500000000,39,035,Cuyahoga County, OH,Feb-18,606465,571864,34601,5.7
CN3903500000000,39,035,Cuyahoga County, OH,Mar-18,602971,573872,29099,4.8
CN3903500000000,39,035,Cuyahoga County, OH,Apr-18(p),613604,585253,28351,4.6
CN2808700000000,28,087,Lowndes County, MS,Mar-17,25422,24058,1364,5.4
CN2808700000000,28,087,Lowndes County, MS,Apr-17,25527,24324,1203,4.7
CN2808700000000,28,087,Lowndes County, MS,May-17,25580,24138,1442,5.6
CN2808700000000,28,087,Lowndes County, MS,Jun-17,25484,23802,1682,6.6
CN2808700000000,28,087,Lowndes County, MS,Jul-17,25817,24150,1667,6.5
CN2808700000000,28,087,Lowndes County, MS,Aug-17,25199,23870,1329,5.3
CN2808700000000,28,087,Lowndes County, MS,Sep-17,25364,24125,1239,4.9
CN2808700000000,28,087,Lowndes County, MS,Oct-17,25226,24010,1216,4.8
CN2808700000000,28,087,Lowndes County, MS,Nov-17,25277,24135,1142,4.5
CN2808700000000,28,087,Lowndes County, MS,Dec-17,25224,24068,1156,4.6
CN2808700000000,28,087,Lowndes County, MS,Jan-18,24526,23382,1144,4.7
CN2808700000000,28,087,Lowndes County, MS,Feb-18,24932,23770,1162,4.7
CN2808700000000,28,087,Lowndes County, MS,Mar-18,24974,23865,1109,4.4
CN2808700000000,28,087,Lowndes County, MS,Apr-18(p),25129,24047,1082,4.3
CN4815900000000,48,159,Franklin County, TX,Mar-17,4644,4419,225,4.8
CN4815900000000,48,159,Franklin County, TX,Apr-17,4624,4428,196,4.2
CN4815900000000,48,159,Franklin County, TX,May-17,4599,4404,195,4.2
CN4815900000000,48,159,Franklin County, TX,Jun-17,4575,4359,216,4.7
CN4815900000000,48,159,Franklin County, TX,Jul-17,4507,4287,220,4.9
CN4815900000000,48,159,Franklin County, TX,Aug-17,4506,4283,223,4.9
CN4815900000000,48,159,Franklin County, TX,Sep-17,4483,4295,188,4.2
CN4815900000000,48,159,Franklin County, TX,Oct-17,4448,4272,176,4.0
CN4815900000000,48,159,Franklin County, TX,Nov-17,4451,4271,180,4.0
CN4815900000000,48,159,Franklin County, TX,Dec-17,4458,4282,176,3.9
CN4815900000000,48,159,Franklin County, TX,Jan-18,4491,4291,200,4.5
CN4815900000000,48,159,Franklin County, TX,Feb-18,4593,4381,212,4.6
CN4815900000000,48,159,Franklin County, TX,Mar-18,4636,4429,207,4.5
CN4815900000000,48,159,Franklin County, TX,Apr-18(p),4604,4422,182,4.0
CN4904900000000,49,049,Utah County, UT,Mar-17,289434,280435,8999,3.1
CN4904900000000,49,049,Utah County, UT,Apr-17,289890,281681,8209,2.8
CN4904900000000,49,049,Utah County, UT,May-17,288173,279899,8274,2.9
CN4904900000000,49,049,Utah County, UT,Jun-17,292319,282423,9896,3.4
CN4904900000000,49,049,Utah County, UT,Jul-17,290809,281550,9259,3.2
CN4904900000000,49,049,Utah County, UT,Aug-17,292541,283397,9144,3.1
CN4904900000000,49,049,Utah County, UT,Sep-17,296226,288132,8094,2.7
CN4904900000000,49,049,Utah County, UT,Oct-17,297563,289752,7811,2.6
CN4904900000000,49,049,Utah County, UT,Nov-17,298917,291760,7157,2.4
CN4904900000000,49,049,Utah County, UT,Dec-17,298557,291244,7313,2.4
CN4904900000000,49,049,Utah County, UT,Jan-18,296727,288809,7918,2.7
CN4904900000000,49,049,Utah County, UT,Feb-18,299801,290808,8993,3.0
CN4904900000000,49,049,Utah County, UT,Mar-18,300909,292006,8903,3.0
CN4904900000000,49,049,Utah County, UT,Apr-18(p),300402,292305,8097,2.7
CN5304700000000,53,047,Okanogan County, WA,Mar-17,19714,17853,1861,9.4
CN5304700000000,53,047,Okanogan County, WA,Apr-17,19920,18354,1566,7.9
CN5304700000000,53,047,Okanogan County, WA,May-17,20258,18847,1411,7.0
CN5304700000000,53,047,Okanogan County, WA,Jun-17,21724,20449,1275,5.9
CN5304700000000,53,047,Okanogan County, WA,Jul-17,25150,23933,1217,4.8
CN5304700000000,53,047,Okanogan County, WA,Aug-17,23110,21878,1232,5.3
CN5304700000000,53,047,Okanogan County, WA,Sep-17,22733,21655,1078,4.7
CN5304700000000,53,047,Okanogan County, WA,Oct-17,21280,20228,1052,4.9
CN5304700000000,53,047,Okanogan County, WA,Nov-17,19325,18049,1276,6.6
CN5304700000000,53,047,Okanogan County, WA,Dec-17,18855,17300,1555,8.2
CN5304700000000,53,047,Okanogan County, WA,Jan-18,18490,16734,1756,9.5
CN5304700000000,53,047,Okanogan County, WA,Feb-18,18905,17061,1844,9.8
CN5304700000000,53,047,Okanogan County, WA,Mar-18,19250,17483,1767,9.2
CN5304700000000,53,047,Okanogan County, WA,Apr-18(p),19468,18051,1417,7.3
CN3914100000000,39,141,Ross County, OH,Mar-17,34198,32296,1902,5.6
CN3914100000000,39,141,Ross County, OH,Apr-17,33972,32360,1612,4.7
CN3914100000000,39,141,Ross County, OH,May-17,34050,32518,1532,4.5
CN3914100000000,39,141,Ross County, OH,Jun-17,34511,32739,1772,5.1
CN3914100000000,39,141,Ross County, OH,Jul-17,34514,32736,1778,5.2
CN3914100000000,39,141,Ross County, OH,Aug-17,34505,32714,1791,5.2
CN3914100000000,39,141,Ross County, OH,Sep-17,34125,32572,1553,4.6
CN3914100000000,39,141,Ross County, OH,Oct-17,34068,32572,1496,4.4
CN3914100000000,39,141,Ross County, OH,Nov-17,34056,32466,1590,4.7
CN3914100000000,39,141,Ross County, OH,Dec-17,33914,32275,1639,4.8
CN3914100000000,39,141,Ross County, OH,Jan-18,33324,31529,1795,5.4
CN3914100000000,39,141,Ross County, OH,Feb-18,34039,32333,1706,5.0
CN3914100000000,39,141,Ross County, OH,Mar-18,34520,32937,1583,4.6
CN3914100000000,39,141,Ross County, OH,Apr-18(p),34321,32862,1459,4.3
CN2013700000000,20,137,Norton County, KS,Mar-17,2807,2744,63,2.2
CN2013700000000,20,137,Norton County, KS,Apr-17,2765,2701,64,2.3
CN2013700000000,20,137,Norton County, KS,May-17,2774,2701,73,2.6
CN2013700000000,20,137,Norton County, KS,Jun-17,2863,2786,77,2.7
CN2013700000000,20,137,Norton County, KS,Jul-17,2872,2794,78,2.7
CN2013700000000,20,137,Norton County, KS,Aug-17,2866,2792,74,2.6
CN2013700000000,20,137,Norton County, KS,Sep-17,2838,2783,55,1.9
CN2013700000000,20,137,Norton County, KS,Oct-17,2847,2801,46,1.6
CN2013700000000,20,137,Norton County, KS,Nov-17,2842,2788,54,1.9
CN2013700000000,20,137,Norton County, KS,Dec-17,2809,2756,53,1.9
CN2013700000000,20,137,Norton County, KS,Jan-18,2776,2724,52,1.9
CN2013700000000,20,137,Norton County, KS,Feb-18,2781,2723,58,2.1
CN2013700000000,20,137,Norton County, KS,Mar-18,2738,2678,60,2.2
CN2013700000000,20,137,Norton County, KS,Apr-18(p),2642,2585,57,2.2
CN1314100000000,13,141,Hancock County, GA,Mar-17,2575,2380,195,7.6
CN1314100000000,13,141,Hancock County, GA,Apr-17,2559,2386,173,6.8
CN1314100000000,13,141,Hancock County, GA,May-17,2568,2383,185,7.2
CN1314100000000,13,141,Hancock County, GA,Jun-17,2557,2376,181,7.1
CN1314100000000,13,141,Hancock County, GA,Jul-17,2518,2338,180,7.1
CN1314100000000,13,141,Hancock County, GA,Aug-17,2537,2362,175,6.9
CN1314100000000,13,141,Hancock County, GA,Sep-17,2550,2382,168,6.6
CN1314100000000,13,141,Hancock County, GA,Oct-17,2569,2404,165,6.4
CN1314100000000,13,141,Hancock County, GA,Nov-17,2574,2414,160,6.2
CN1314100000000,13,141,Hancock County, GA,Dec-17,2591,2409,182,7.0
CN1314100000000,13,141,Hancock County, GA,Jan-18,2655,2456,199,7.5
CN1314100000000,13,141,Hancock County, GA,Feb-18,2559,2382,177,6.9
CN1314100000000,13,141,Hancock County, GA,Mar-18,2536,2370,166,6.5
CN1314100000000,13,141,Hancock County, GA,Apr-18(p),2527,2386,141,5.6
CN4010900000000,40,109,Oklahoma County, OK,Mar-17,376073,360722,15351,4.1
CN4010900000000,40,109,Oklahoma County, OK,Apr-17,375482,361481,14001,3.7
CN4010900000000,40,109,Oklahoma County, OK,May-17,375712,360065,15647,4.2
CN4010900000000,40,109,Oklahoma County, OK,Jun-17,380783,364122,16661,4.4
CN4010900000000,40,109,Oklahoma County, OK,Jul-17,381821,366308,15513,4.1
CN4010900000000,40,109,Oklahoma County, OK,Aug-17,377770,362369,15401,4.1
CN4010900000000,40,109,Oklahoma County, OK,Sep-17,381986,367278,14708,3.9
CN4010900000000,40,109,Oklahoma County, OK,Oct-17,381677,367169,14508,3.8
CN4010900000000,40,109,Oklahoma County, OK,Nov-17,381874,367878,13996,3.7
CN4010900000000,40,109,Oklahoma County, OK,Dec-17,380024,365897,14127,3.7
CN4010900000000,40,109,Oklahoma County, OK,Jan-18,377413,362140,15273,4.0
CN4010900000000,40,109,Oklahoma County, OK,Feb-18,383302,368650,14652,3.8
CN4010900000000,40,109,Oklahoma County, OK,Mar-18,386356,371965,14391,3.7
CN4010900000000,40,109,Oklahoma County, OK,Apr-18(p),385720,371685,14035,3.6
CN4816500000000,48,165,Gaines County, TX,Mar-17,9362,9055,307,3.3
CN4816500000000,48,165,Gaines County, TX,Apr-17,9352,9081,271,2.9
CN4816500000000,48,165,Gaines County, TX,May-17,9337,9060,277,3.0
CN4816500000000,48,165,Gaines County, TX,Jun-17,9395,9094,301,3.2
CN4816500000000,48,165,Gaines County, TX,Jul-17,9157,8864,293,3.2
CN4816500000000,48,165,Gaines County, TX,Aug-17,9267,8981,286,3.1
CN4816500000000,48,165,Gaines County, TX,Sep-17,9158,8910,248,2.7
CN4816500000000,48,165,Gaines County, TX,Oct-17,9224,8996,228,2.5
CN4816500000000,48,165,Gaines County, TX,Nov-17,9124,8881,243,2.7
CN4816500000000,48,165,Gaines County, TX,Dec-17,9257,9031,226,2.4
CN4816500000000,48,165,Gaines County, TX,Jan-18,9239,8995,244,2.6
CN4816500000000,48,165,Gaines County, TX,Feb-18,9438,9187,251,2.7
CN4816500000000,48,165,Gaines County, TX,Mar-18,9565,9312,253,2.6
CN4816500000000,48,165,Gaines County, TX,Apr-18(p),9499,9268,231,2.4
CN0804700000000,08,047,Gilpin County, CO,Mar-17,3538,3474,64,1.8
CN0804700000000,08,047,Gilpin County, CO,Apr-17,3550,3486,64,1.8
CN0804700000000,08,047,Gilpin County, CO,May-17,3566,3505,61,1.7
CN0804700000000,08,047,Gilpin County, CO,Jun-17,3618,3542,76,2.1
CN0804700000000,08,047,Gilpin County, CO,Jul-17,3627,3560,67,1.8
CN0804700000000,08,047,Gilpin County, CO,Aug-17,3627,3557,70,1.9
CN0804700000000,08,047,Gilpin County, CO,Sep-17,3648,3575,73,2.0
CN0804700000000,08,047,Gilpin County, CO,Oct-17,3649,3565,84,2.3
CN0804700000000,08,047,Gilpin County, CO,Nov-17,3645,3567,78,2.1
CN0804700000000,08,047,Gilpin County, CO,Dec-17,3628,3551,77,2.1
CN0804700000000,08,047,Gilpin County, CO,Jan-18,3613,3529,84,2.3
CN0804700000000,08,047,Gilpin County, CO,Feb-18,3669,3581,88,2.4
CN0804700000000,08,047,Gilpin County, CO,Mar-18,3674,3600,74,2.0
CN0804700000000,08,047,Gilpin County, CO,Apr-18(p),3678,3612,66,1.8
CN1806700000000,18,067,Howard County, IN,Mar-17,37478,36016,1462,3.9
CN1806700000000,18,067,Howard County, IN,Apr-17,37667,36495,1172,3.1
CN1806700000000,18,067,Howard County, IN,May-17,37880,36625,1255,3.3
CN1806700000000,18,067,Howard County, IN,Jun-17,39416,37265,2151,5.5
CN1806700000000,18,067,Howard County, IN,Jul-17,38230,36802,1428,3.7
CN1806700000000,18,067,Howard County, IN,Aug-17,37950,36392,1558,4.1
CN1806700000000,18,067,Howard County, IN,Sep-17,38135,36856,1279,3.4
CN1806700000000,18,067,Howard County, IN,Oct-17,38021,36809,1212,3.2
CN1806700000000,18,067,Howard County, IN,Nov-17,38061,36839,1222,3.2
CN1806700000000,18,067,Howard County, IN,Dec-17,37981,36829,1152,3.0
CN1806700000000,18,067,Howard County, IN,Jan-18,38211,36863,1348,3.5
CN1806700000000,18,067,Howard County, IN,Feb-18,38874,37458,1416,3.6
CN1806700000000,18,067,Howard County, IN,Mar-18,39121,37848,1273,3.3
CN1806700000000,18,067,Howard County, IN,Apr-18(p),39347,38140,1207,3.1
CN3108900000000,31,089,Holt County, NE,Mar-17,5685,5548,137,2.4
CN3108900000000,31,089,Holt County, NE,Apr-17,5808,5681,127,2.2
CN3108900000000,31,089,Holt County, NE,May-17,5915,5791,124,2.1
CN3108900000000,31,089,Holt County, NE,Jun-17,6129,5973,156,2.5
CN3108900000000,31,089,Holt County, NE,Jul-17,6018,5847,171,2.8
CN3108900000000,31,089,Holt County, NE,Aug-17,5833,5682,151,2.6
CN3108900000000,31,089,Holt County, NE,Sep-17,5557,5433,124,2.2
CN3108900000000,31,089,Holt County, NE,Oct-17,5571,5444,127,2.3
CN3108900000000,31,089,Holt County, NE,Nov-17,5605,5484,121,2.2
CN3108900000000,31,089,Holt County, NE,Dec-17,5601,5462,139,2.5
CN3108900000000,31,089,Holt County, NE,Jan-18,5736,5576,160,2.8
CN3108900000000,31,089,Holt County, NE,Feb-18,5607,5443,164,2.9
CN3108900000000,31,089,Holt County, NE,Mar-18,5739,5586,153,2.7
CN3108900000000,31,089,Holt County, NE,Apr-18(p),5737,5585,152,2.6
CN4506100000000,45,061,Lee County, SC,Mar-17,6378,6029,349,5.5
CN4506100000000,45,061,Lee County, SC,Apr-17,6397,6031,366,5.7
CN4506100000000,45,061,Lee County, SC,May-17,6385,6041,344,5.4
CN4506100000000,45,061,Lee County, SC,Jun-17,6486,6075,411,6.3
CN4506100000000,45,061,Lee County, SC,Jul-17,6505,6089,416,6.4
CN4506100000000,45,061,Lee County, SC,Aug-17,6461,6015,446,6.9
CN4506100000000,45,061,Lee County, SC,Sep-17,6413,6015,398,6.2
CN4506100000000,45,061,Lee County, SC,Oct-17,6381,6009,372,5.8
CN4506100000000,45,061,Lee County, SC,Nov-17,6352,6011,341,5.4
CN4506100000000,45,061,Lee County, SC,Dec-17,6428,6063,365,5.7
CN4506100000000,45,061,Lee County, SC,Jan-18,6452,6044,408,6.3
CN4506100000000,45,061,Lee County, SC,Feb-18,6492,6078,414,6.4
CN4506100000000,45,061,Lee County, SC,Mar-18,6415,6043,372,5.8
CN4506100000000,45,061,Lee County, SC,Apr-18(p),6356,6056,300,4.7
CN1911900000000,19,119,Lyon County, IA,Mar-17,6862,6707,155,2.3
CN1911900000000,19,119,Lyon County, IA,Apr-17,7016,6908,108,1.5
CN1911900000000,19,119,Lyon County, IA,May-17,7012,6907,105,1.5
CN1911900000000,19,119,Lyon County, IA,Jun-17,7150,7037,113,1.6
CN1911900000000,19,119,Lyon County, IA,Jul-17,7258,7141,117,1.6
CN1911900000000,19,119,Lyon County, IA,Aug-17,7107,6988,119,1.7
CN1911900000000,19,119,Lyon County, IA,Sep-17,6991,6883,108,1.5
CN1911900000000,19,119,Lyon County, IA,Oct-17,7050,6963,87,1.2
CN1911900000000,19,119,Lyon County, IA,Nov-17,6896,6809,87,1.3
CN1911900000000,19,119,Lyon County, IA,Dec-17,6902,6785,117,1.7
CN1911900000000,19,119,Lyon County, IA,Jan-18,6765,6611,154,2.3
CN1911900000000,19,119,Lyon County, IA,Feb-18,6813,6655,158,2.3
CN1911900000000,19,119,Lyon County, IA,Mar-18,6768,6610,158,2.3
CN1911900000000,19,119,Lyon County, IA,Apr-18(p),6784,6651,133,2.0
CN3913500000000,39,135,Preble County, OH,Mar-17,21298,20304,994,4.7
CN3913500000000,39,135,Preble County, OH,Apr-17,21188,20297,891,4.2
CN3913500000000,39,135,Preble County, OH,May-17,21129,20273,856,4.1
CN3913500000000,39,135,Preble County, OH,Jun-17,21294,20324,970,4.6
CN3913500000000,39,135,Preble County, OH,Jul-17,21199,20237,962,4.5
CN3913500000000,39,135,Preble County, OH,Aug-17,21241,20285,956,4.5
CN3913500000000,39,135,Preble County, OH,Sep-17,21110,20241,869,4.1
CN3913500000000,39,135,Preble County, OH,Oct-17,21132,20294,838,4.0
CN3913500000000,39,135,Preble County, OH,Nov-17,21122,20283,839,4.0
CN3913500000000,39,135,Preble County, OH,Dec-17,20978,20114,864,4.1
CN3913500000000,39,135,Preble County, OH,Jan-18,20564,19589,975,4.7
CN3913500000000,39,135,Preble County, OH,Feb-18,21253,20326,927,4.4
CN3913500000000,39,135,Preble County, OH,Mar-18,21838,20978,860,3.9
CN3913500000000,39,135,Preble County, OH,Apr-18(p),21677,20893,784,3.6
CN3902900000000,39,029,Columbiana County, OH,Mar-17,48343,45018,3325,6.9
CN3902900000000,39,029,Columbiana County, OH,Apr-17,47936,45136,2800,5.8
CN3902900000000,39,029,Columbiana County, OH,May-17,47995,45461,2534,5.3
CN3902900000000,39,029,Columbiana County, OH,Jun-17,48370,45525,2845,5.9
CN3902900000000,39,029,Columbiana County, OH,Jul-17,48337,45347,2990,6.2
CN3902900000000,39,029,Columbiana County, OH,Aug-17,48393,45633,2760,5.7
CN3902900000000,39,029,Columbiana County, OH,Sep-17,48120,45452,2668,5.5
CN3902900000000,39,029,Columbiana County, OH,Oct-17,48050,45619,2431,5.1
CN3902900000000,39,029,Columbiana County, OH,Nov-17,47681,45312,2369,5.0
CN3902900000000,39,029,Columbiana County, OH,Dec-17,47333,44887,2446,5.2
CN3902900000000,39,029,Columbiana County, OH,Jan-18,46695,43688,3007,6.4
CN3902900000000,39,029,Columbiana County, OH,Feb-18,46932,44259,2673,5.7
CN3902900000000,39,029,Columbiana County, OH,Mar-18,47304,44839,2465,5.2
CN3902900000000,39,029,Columbiana County, OH,Apr-18(p),47043,44802,2241,4.8
CN7207300000000,72,073,Jayuya Municipio, PR,Mar-17,4407,3783,624,14.2
CN7207300000000,72,073,Jayuya Municipio, PR,Apr-17,4383,3761,622,14.2
CN7207300000000,72,073,Jayuya Municipio, PR,May-17,4375,3829,546,12.5
CN7207300000000,72,073,Jayuya Municipio, PR,Jun-17,4305,3821,484,11.2
CN7207300000000,72,073,Jayuya Municipio, PR,Jul-17,4475,3922,553,12.4
CN7207300000000,72,073,Jayuya Municipio, PR,Aug-17,4468,3842,626,14.0
CN7207300000000,72,073,Jayuya Municipio, PR,Sep-17(y),4386,3820,566,12.9
CN7207300000000,72,073,Jayuya Municipio, PR,Oct-17,4240,3738,502,11.8
CN7207300000000,72,073,Jayuya Municipio, PR,Nov-17,4453,3936,517,11.6
CN7207300000000,72,073,Jayuya Municipio, PR,Dec-17,4489,3962,527,11.7
CN7207300000000,72,073,Jayuya Municipio, PR,Jan-18,4272,3702,570,13.3
CN7207300000000,72,073,Jayuya Municipio, PR,Feb-18,4136,3628,508,12.3
CN7207300000000,72,073,Jayuya Municipio, PR,Mar-18,4136,3636,500,12.1
CN7207300000000,72,073,Jayuya Municipio, PR,Apr-18(p),4127,3670,457,11.1
CN4827100000000,48,271,Kinney County, TX,Mar-17,1161,1093,68,5.9
CN4827100000000,48,271,Kinney County, TX,Apr-17,1164,1102,62,5.3
CN4827100000000,48,271,Kinney County, TX,May-17,1211,1149,62,5.1
CN4827100000000,48,271,Kinney County, TX,Jun-17,1210,1150,60,5.0
CN4827100000000,48,271,Kinney County, TX,Jul-17,1146,1086,60,5.2
CN4827100000000,48,271,Kinney County, TX,Aug-17,1172,1108,64,5.5
CN4827100000000,48,271,Kinney County, TX,Sep-17,1122,1067,55,4.9
CN4827100000000,48,271,Kinney County, TX,Oct-17,1135,1083,52,4.6
CN4827100000000,48,271,Kinney County, TX,Nov-17,1111,1055,56,5.0
CN4827100000000,48,271,Kinney County, TX,Dec-17,1112,1056,56,5.0
CN4827100000000,48,271,Kinney County, TX,Jan-18,1132,1067,65,5.7
CN4827100000000,48,271,Kinney County, TX,Feb-18,1157,1089,68,5.9
CN4827100000000,48,271,Kinney County, TX,Mar-18,1196,1126,70,5.9
CN4827100000000,48,271,Kinney County, TX,Apr-18(p),1202,1135,67,5.6
CN0401100000000,04,011,Greenlee County, AZ,Mar-17,3939,3712,227,5.8
CN0401100000000,04,011,Greenlee County, AZ,Apr-17,3945,3743,202,5.1
CN0401100000000,04,011,Greenlee County, AZ,May-17,3949,3753,196,5.0
CN0401100000000,04,011,Greenlee County, AZ,Jun-17,4099,3889,210,5.1
CN0401100000000,04,011,Greenlee County, AZ,Jul-17,4044,3838,206,5.1
CN0401100000000,04,011,Greenlee County, AZ,Aug-17,4069,3867,202,5.0
CN0401100000000,04,011,Greenlee County, AZ,Sep-17,4015,3836,179,4.5
CN0401100000000,04,011,Greenlee County, AZ,Oct-17,4013,3826,187,4.7
CN0401100000000,04,011,Greenlee County, AZ,Nov-17,4019,3839,180,4.5
CN0401100000000,04,011,Greenlee County, AZ,Dec-17,4016,3832,184,4.6
CN0401100000000,04,011,Greenlee County, AZ,Jan-18,4063,3854,209,5.1
CN0401100000000,04,011,Greenlee County, AZ,Feb-18,4130,3929,201,4.9
CN0401100000000,04,011,Greenlee County, AZ,Mar-18,4066,3884,182,4.5
CN0401100000000,04,011,Greenlee County, AZ,Apr-18(p),4029,3854,175,4.3
CN0507300000000,05,073,Lafayette County, AR,Mar-17,2532,2411,121,4.8
CN0507300000000,05,073,Lafayette County, AR,Apr-17,2541,2436,105,4.1
CN0507300000000,05,073,Lafayette County, AR,May-17,2562,2448,114,4.4
CN0507300000000,05,073,Lafayette County, AR,Jun-17,2571,2428,143,5.6
CN0507300000000,05,073,Lafayette County, AR,Jul-17,2452,2304,148,6.0
CN0507300000000,05,073,Lafayette County, AR,Aug-17,2490,2349,141,5.7
CN0507300000000,05,073,Lafayette County, AR,Sep-17,2515,2387,128,5.1
CN0507300000000,05,073,Lafayette County, AR,Oct-17,2509,2397,112,4.5
CN0507300000000,05,073,Lafayette County, AR,Nov-17,2519,2406,113,4.5
CN0507300000000,05,073,Lafayette County, AR,Dec-17,2503,2384,119,4.8
CN0507300000000,05,073,Lafayette County, AR,Jan-18,2448,2298,150,6.1
CN0507300000000,05,073,Lafayette County, AR,Feb-18,2514,2357,157,6.2
CN0507300000000,05,073,Lafayette County, AR,Mar-18,2504,2360,144,5.8
CN0507300000000,05,073,Lafayette County, AR,Apr-18(p),2523,2402,121,4.8
CN2614100000000,26,141,Presque Isle County, MI,Mar-17,5232,4541,691,13.2
CN2614100000000,26,141,Presque Isle County, MI,Apr-17,5106,4636,470,9.2
CN2614100000000,26,141,Presque Isle County, MI,May-17,5244,4863,381,7.3
CN2614100000000,26,141,Presque Isle County, MI,Jun-17,5297,4912,385,7.3
CN2614100000000,26,141,Presque Isle County, MI,Jul-17,5364,4927,437,8.1
CN2614100000000,26,141,Presque Isle County, MI,Aug-17,5287,4865,422,8.0
CN2614100000000,26,141,Presque Isle County, MI,Sep-17,5155,4809,346,6.7
CN2614100000000,26,141,Presque Isle County, MI,Oct-17,5047,4730,317,6.3
CN2614100000000,26,141,Presque Isle County, MI,Nov-17,4985,4598,387,7.8
CN2614100000000,26,141,Presque Isle County, MI,Dec-17,5039,4526,513,10.2
CN2614100000000,26,141,Presque Isle County, MI,Jan-18,5114,4447,667,13.0
CN2614100000000,26,141,Presque Isle County, MI,Feb-18,5218,4453,765,14.7
CN2614100000000,26,141,Presque Isle County, MI,Mar-18,5177,4510,667,12.9
CN2614100000000,26,141,Presque Isle County, MI,Apr-18(p),5075,4619,456,9.0
CN2206500000000,22,065,Madison Parish, LA,Mar-17,3760,3427,333,8.9
CN2206500000000,22,065,Madison Parish, LA,Apr-17,3830,3525,305,8.0
CN2206500000000,22,065,Madison Parish, LA,May-17,3873,3571,302,7.8
CN2206500000000,22,065,Madison Parish, LA,Jun-17,4065,3690,375,9.2
CN2206500000000,22,065,Madison Parish, LA,Jul-17,4013,3676,337,8.4
CN2206500000000,22,065,Madison Parish, LA,Aug-17,3917,3591,326,8.3
CN2206500000000,22,065,Madison Parish, LA,Sep-17,3722,3435,287,7.7
CN2206500000000,22,065,Madison Parish, LA,Oct-17,3777,3506,271,7.2
CN2206500000000,22,065,Madison Parish, LA,Nov-17,3746,3486,260,6.9
CN2206500000000,22,065,Madison Parish, LA,Dec-17,3733,3490,243,6.5
CN2206500000000,22,065,Madison Parish, LA,Jan-18,3777,3506,271,7.2
CN2206500000000,22,065,Madison Parish, LA,Feb-18,3708,3439,269,7.3
CN2206500000000,22,065,Madison Parish, LA,Mar-18,3767,3464,303,8.0
CN2206500000000,22,065,Madison Parish, LA,Apr-18(p),3756,3471,285,7.6
CN1600500000000,16,005,Bannock County, ID,Mar-17,41916,40488,1428,3.4
CN1600500000000,16,005,Bannock County, ID,Apr-17,41693,40428,1265,3.0
CN1600500000000,16,005,Bannock County, ID,May-17,42001,40892,1109,2.6
CN1600500000000,16,005,Bannock County, ID,Jun-17,41383,40189,1194,2.9
CN1600500000000,16,005,Bannock County, ID,Jul-17,41187,40005,1182,2.9
CN1600500000000,16,005,Bannock County, ID,Aug-17,40739,39606,1133,2.8
CN1600500000000,16,005,Bannock County, ID,Sep-17,41233,40161,1072,2.6
CN1600500000000,16,005,Bannock County, ID,Oct-17,42021,40966,1055,2.5
CN1600500000000,16,005,Bannock County, ID,Nov-17,42656,41420,1236,2.9
CN1600500000000,16,005,Bannock County, ID,Dec-17,42808,41620,1188,2.8
CN1600500000000,16,005,Bannock County, ID,Jan-18,42131,40600,1531,3.6
CN1600500000000,16,005,Bannock County, ID,Feb-18,43221,41891,1330,3.1
CN1600500000000,16,005,Bannock County, ID,Mar-18,43228,42036,1192,2.8
CN1600500000000,16,005,Bannock County, ID,Apr-18(p),43054,41944,1110,2.6
CN4845100000000,48,451,Tom Green County, TX,Mar-17,54109,51917,2192,4.1
CN4845100000000,48,451,Tom Green County, TX,Apr-17,54004,52073,1931,3.6
CN4845100000000,48,451,Tom Green County, TX,May-17,53846,51845,2001,3.7
CN4845100000000,48,451,Tom Green County, TX,Jun-17,54191,52046,2145,4.0
CN4845100000000,48,451,Tom Green County, TX,Jul-17,54041,51939,2102,3.9
CN4845100000000,48,451,Tom Green County, TX,Aug-17,53883,51881,2002,3.7
CN4845100000000,48,451,Tom Green County, TX,Sep-17,54242,52467,1775,3.3
CN4845100000000,48,451,Tom Green County, TX,Oct-17,53892,52246,1646,3.1
CN4845100000000,48,451,Tom Green County, TX,Nov-17,54039,52349,1690,3.1
CN4845100000000,48,451,Tom Green County, TX,Dec-17,53942,52352,1590,2.9
CN4845100000000,48,451,Tom Green County, TX,Jan-18,53961,52152,1809,3.4
CN4845100000000,48,451,Tom Green County, TX,Feb-18,54647,52842,1805,3.3
CN4845100000000,48,451,Tom Green County, TX,Mar-18,54749,52907,1842,3.4
CN4845100000000,48,451,Tom Green County, TX,Apr-18(p),54582,52933,1649,3.0
CN5300100000000,53,001,Adams County, WA,Mar-17,8206,7615,591,7.2
CN5300100000000,53,001,Adams County, WA,Apr-17,8624,8178,446,5.2
CN5300100000000,53,001,Adams County, WA,May-17,8875,8433,442,5.0
CN5300100000000,53,001,Adams County, WA,Jun-17,9411,9005,406,4.3
CN5300100000000,53,001,Adams County, WA,Jul-17,9984,9564,420,4.2
CN5300100000000,53,001,Adams County, WA,Aug-17,10023,9635,388,3.9
CN5300100000000,53,001,Adams County, WA,Sep-17,9577,9216,361,3.8
CN5300100000000,53,001,Adams County, WA,Oct-17,9210,8854,356,3.9
CN5300100000000,53,001,Adams County, WA,Nov-17,8666,8188,478,5.5
CN5300100000000,53,001,Adams County, WA,Dec-17,8534,7870,664,7.8
CN5300100000000,53,001,Adams County, WA,Jan-18,8289,7481,808,9.7
CN5300100000000,53,001,Adams County, WA,Feb-18,8451,7675,776,9.2
CN5300100000000,53,001,Adams County, WA,Mar-18,8499,7910,589,6.9
CN5300100000000,53,001,Adams County, WA,Apr-18(p),8969,8500,469,5.2
CN0213000000000,02,130,Ketchikan Gateway Borough, AK,Mar-17,6558,6048,510,7.8
CN0213000000000,02,130,Ketchikan Gateway Borough, AK,Apr-17,6740,6294,446,6.6
CN0213000000000,02,130,Ketchikan Gateway Borough, AK,May-17,7397,6957,440,5.9
CN0213000000000,02,130,Ketchikan Gateway Borough, AK,Jun-17,7753,7307,446,5.8
CN0213000000000,02,130,Ketchikan Gateway Borough, AK,Jul-17,8057,7668,389,4.8
CN0213000000000,02,130,Ketchikan Gateway Borough, AK,Aug-17,7975,7607,368,4.6
CN0213000000000,02,130,Ketchikan Gateway Borough, AK,Sep-17,7567,7183,384,5.1
CN0213000000000,02,130,Ketchikan Gateway Borough, AK,Oct-17,6832,6409,423,6.2
CN0213000000000,02,130,Ketchikan Gateway Borough, AK,Nov-17,6609,6144,465,7.0
CN0213000000000,02,130,Ketchikan Gateway Borough, AK,Dec-17,6648,6194,454,6.8
CN0213000000000,02,130,Ketchikan Gateway Borough, AK,Jan-18,6632,6082,550,8.3
CN0213000000000,02,130,Ketchikan Gateway Borough, AK,Feb-18,6554,6021,533,8.1
CN0213000000000,02,130,Ketchikan Gateway Borough, AK,Mar-18,6631,6104,527,7.9
CN0213000000000,02,130,Ketchikan Gateway Borough, AK,Apr-18(p),6732,6261,471,7.0
CN2202100000000,22,021,Caldwell Parish, LA,Mar-17,3904,3654,250,6.4
CN2202100000000,22,021,Caldwell Parish, LA,Apr-17,3896,3667,229,5.9
CN2202100000000,22,021,Caldwell Parish, LA,May-17,3875,3665,210,5.4
CN2202100000000,22,021,Caldwell Parish, LA,Jun-17,3930,3688,242,6.2
CN2202100000000,22,021,Caldwell Parish, LA,Jul-17,3887,3655,232,6.0
CN2202100000000,22,021,Caldwell Parish, LA,Aug-17,3853,3633,220,5.7
CN2202100000000,22,021,Caldwell Parish, LA,Sep-17,3865,3667,198,5.1
CN2202100000000,22,021,Caldwell Parish, LA,Oct-17,3823,3639,184,4.8
CN2202100000000,22,021,Caldwell Parish, LA,Nov-17,3821,3637,184,4.8
CN2202100000000,22,021,Caldwell Parish, LA,Dec-17,3810,3632,178,4.7
CN2202100000000,22,021,Caldwell Parish, LA,Jan-18,3838,3635,203,5.3
CN2202100000000,22,021,Caldwell Parish, LA,Feb-18,3874,3684,190,4.9
CN2202100000000,22,021,Caldwell Parish, LA,Mar-18,3914,3703,211,5.4
CN2202100000000,22,021,Caldwell Parish, LA,Apr-18(p),3902,3692,210,5.4
CN4205300000000,42,053,Forest County, PA,Mar-17,1839,1705,134,7.3
CN4205300000000,42,053,Forest County, PA,Apr-17,1829,1720,109,6.0
CN4205300000000,42,053,Forest County, PA,May-17,1856,1736,120,6.5
CN4205300000000,42,053,Forest County, PA,Jun-17,1877,1760,117,6.2
CN4205300000000,42,053,Forest County, PA,Jul-17,1886,1765,121,6.4
CN4205300000000,42,053,Forest County, PA,Aug-17,1837,1720,117,6.4
CN4205300000000,42,053,Forest County, PA,Sep-17,1815,1721,94,5.2
CN4205300000000,42,053,Forest County, PA,Oct-17,1789,1696,93,5.2
CN4205300000000,42,053,Forest County, PA,Nov-17,1779,1663,116,6.5
CN4205300000000,42,053,Forest County, PA,Dec-17,1774,1643,131,7.4
CN4205300000000,42,053,Forest County, PA,Jan-18,1795,1639,156,8.7
CN4205300000000,42,053,Forest County, PA,Feb-18,1795,1647,148,8.2
CN4205300000000,42,053,Forest County, PA,Mar-18,1773,1645,128,7.2
CN4205300000000,42,053,Forest County, PA,Apr-18(p),1769,1657,112,6.3
CN0505700000000,05,057,Hempstead County, AR,Mar-17,9832,9516,316,3.2
CN0505700000000,05,057,Hempstead County, AR,Apr-17,9936,9632,304,3.1
CN0505700000000,05,057,Hempstead County, AR,May-17,9960,9631,329,3.3
CN0505700000000,05,057,Hempstead County, AR,Jun-17,10161,9789,372,3.7
CN0505700000000,05,057,Hempstead County, AR,Jul-17,9761,9368,393,4.0
CN0505700000000,05,057,Hempstead County, AR,Aug-17,9727,9369,358,3.7
CN0505700000000,05,057,Hempstead County, AR,Sep-17,9974,9638,336,3.4
CN0505700000000,05,057,Hempstead County, AR,Oct-17,9959,9662,297,3.0
CN0505700000000,05,057,Hempstead County, AR,Nov-17,9888,9595,293,3.0
CN0505700000000,05,057,Hempstead County, AR,Dec-17,9835,9515,320,3.3
CN0505700000000,05,057,Hempstead County, AR,Jan-18,9689,9302,387,4.0
CN0505700000000,05,057,Hempstead County, AR,Feb-18,9732,9378,354,3.6
CN0505700000000,05,057,Hempstead County, AR,Mar-18,9763,9434,329,3.4
CN0505700000000,05,057,Hempstead County, AR,Apr-18(p),9805,9509,296,3.0
CN3502500000000,35,025,Lea County, NM,Mar-17,27437,25516,1921,7.0
CN3502500000000,35,025,Lea County, NM,Apr-17,27408,25647,1761,6.4
CN3502500000000,35,025,Lea County, NM,May-17,27271,25514,1757,6.4
CN3502500000000,35,025,Lea County, NM,Jun-17,27507,25455,2052,7.5
CN3502500000000,35,025,Lea County, NM,Jul-17,27551,25577,1974,7.2
CN3502500000000,35,025,Lea County, NM,Aug-17,27373,25558,1815,6.6
CN3502500000000,35,025,Lea County, NM,Sep-17,27484,25774,1710,6.2
CN3502500000000,35,025,Lea County, NM,Oct-17,27888,26284,1604,5.8
CN3502500000000,35,025,Lea County, NM,Nov-17,27902,26387,1515,5.4
CN3502500000000,35,025,Lea County, NM,Dec-17,27739,26325,1414,5.1
CN3502500000000,35,025,Lea County, NM,Jan-18,28231,26811,1420,5.0
CN3502500000000,35,025,Lea County, NM,Feb-18,28359,27030,1329,4.7
CN3502500000000,35,025,Lea County, NM,Mar-18,28074,26828,1246,4.4
CN3502500000000,35,025,Lea County, NM,Apr-18(p),28217,27166,1051,3.7
CN0900900000000,09,009,New Haven County, CT,Mar-17,464190,439007,25183,5.4
CN0900900000000,09,009,New Haven County, CT,Apr-17,464330,440956,23374,5.0
CN0900900000000,09,009,New Haven County, CT,May-17,466211,442679,23532,5.0
CN0900900000000,09,009,New Haven County, CT,Jun-17,468816,444475,24341,5.2
CN0900900000000,09,009,New Haven County, CT,Jul-17,469588,444880,24708,5.3
CN0900900000000,09,009,New Haven County, CT,Aug-17,462073,438670,23403,5.1
CN0900900000000,09,009,New Haven County, CT,Sep-17,458849,437901,20948,4.6
CN0900900000000,09,009,New Haven County, CT,Oct-17,457508,437013,20495,4.5
CN0900900000000,09,009,New Haven County, CT,Nov-17,458146,437795,20351,4.4
CN0900900000000,09,009,New Haven County, CT,Dec-17,455455,435945,19510,4.3
CN0900900000000,09,009,New Haven County, CT,Jan-18,451628,426258,25370,5.6
CN0900900000000,09,009,New Haven County, CT,Feb-18,455439,430843,24596,5.4
CN0900900000000,09,009,New Haven County, CT,Mar-18,453136,430664,22472,5.0
CN0900900000000,09,009,New Haven County, CT,Apr-18(p),453285,433006,20279,4.5
CN3009300000000,30,093,Silver Bow County, MT,Mar-17,17018,16210,808,4.7
CN3009300000000,30,093,Silver Bow County, MT,Apr-17,17140,16471,669,3.9
CN3009300000000,30,093,Silver Bow County, MT,May-17,16986,16393,593,3.5
CN3009300000000,30,093,Silver Bow County, MT,Jun-17,17321,16589,732,4.2
CN3009300000000,30,093,Silver Bow County, MT,Jul-17,17641,16966,675,3.8
CN3009300000000,30,093,Silver Bow County, MT,Aug-17,17373,16736,637,3.7
CN3009300000000,30,093,Silver Bow County, MT,Sep-17,17023,16377,646,3.8
CN3009300000000,30,093,Silver Bow County, MT,Oct-17,17158,16468,690,4.0
CN3009300000000,30,093,Silver Bow County, MT,Nov-17,17178,16430,748,4.4
CN3009300000000,30,093,Silver Bow County, MT,Dec-17,17064,16288,776,4.5
CN3009300000000,30,093,Silver Bow County, MT,Jan-18,17051,16148,903,5.3
CN3009300000000,30,093,Silver Bow County, MT,Feb-18,16961,16054,907,5.3
CN3009300000000,30,093,Silver Bow County, MT,Mar-18,17071,16219,852,5.0
CN3009300000000,30,093,Silver Bow County, MT,Apr-18(p),17035,16388,647,3.8
CN3107300000000,31,073,Gosper County, NE,Mar-17,1032,1009,23,2.2
CN3107300000000,31,073,Gosper County, NE,Apr-17,1030,1010,20,1.9
CN3107300000000,31,073,Gosper County, NE,May-17,1065,1042,23,2.2
CN3107300000000,31,073,Gosper County, NE,Jun-17,1104,1075,29,2.6
CN3107300000000,31,073,Gosper County, NE,Jul-17,1087,1054,33,3.0
CN3107300000000,31,073,Gosper County, NE,Aug-17,1051,1021,30,2.9
CN3107300000000,31,073,Gosper County, NE,Sep-17,1016,989,27,2.7
CN3107300000000,31,073,Gosper County, NE,Oct-17,1016,988,28,2.8
CN3107300000000,31,073,Gosper County, NE,Nov-17,1016,985,31,3.1
CN3107300000000,31,073,Gosper County, NE,Dec-17,1020,992,28,2.7
CN3107300000000,31,073,Gosper County, NE,Jan-18,1034,1010,24,2.3
CN3107300000000,31,073,Gosper County, NE,Feb-18,1019,997,22,2.2
CN3107300000000,31,073,Gosper County, NE,Mar-18,1038,1013,25,2.4
CN3107300000000,31,073,Gosper County, NE,Apr-18(p),1031,1004,27,2.6
CN4104100000000,41,041,Lincoln County, OR,Mar-17,20733,19701,1032,5.0
CN4104100000000,41,041,Lincoln County, OR,Apr-17,20911,19970,941,4.5
CN4104100000000,41,041,Lincoln County, OR,May-17,21026,20123,903,4.3
CN4104100000000,41,041,Lincoln County, OR,Jun-17,21730,20707,1023,4.7
CN4104100000000,41,041,Lincoln County, OR,Jul-17,22341,21276,1065,4.8
CN4104100000000,41,041,Lincoln County, OR,Aug-17,22430,21403,1027,4.6
CN4104100000000,41,041,Lincoln County, OR,Sep-17,21813,20854,959,4.4
CN4104100000000,41,041,Lincoln County, OR,Oct-17,21115,20154,961,4.6
CN4104100000000,41,041,Lincoln County, OR,Nov-17,20788,19792,996,4.8
CN4104100000000,41,041,Lincoln County, OR,Dec-17,20243,19239,1004,5.0
CN4104100000000,41,041,Lincoln County, OR,Jan-18,20675,19565,1110,5.4
CN4104100000000,41,041,Lincoln County, OR,Feb-18,20855,19771,1084,5.2
CN4104100000000,41,041,Lincoln County, OR,Mar-18,20983,19913,1070,5.1
CN4104100000000,41,041,Lincoln County, OR,Apr-18(p),21008,20065,943,4.5
CN4202100000000,42,021,Cambria County, PA,Mar-17,60409,56445,3964,6.6
CN4202100000000,42,021,Cambria County, PA,Apr-17,60158,56883,3275,5.4
CN4202100000000,42,021,Cambria County, PA,May-17,60126,56677,3449,5.7
CN4202100000000,42,021,Cambria County, PA,Jun-17,59998,56041,3957,6.6
CN4202100000000,42,021,Cambria County, PA,Jul-17,59943,55909,4034,6.7
CN4202100000000,42,021,Cambria County, PA,Aug-17,59296,55293,4003,6.8
CN4202100000000,42,021,Cambria County, PA,Sep-17,59236,56162,3074,5.2
CN4202100000000,42,021,Cambria County, PA,Oct-17,59211,56292,2919,4.9
CN4202100000000,42,021,Cambria County, PA,Nov-17,59299,56269,3030,5.1
CN4202100000000,42,021,Cambria County, PA,Dec-17,58819,55707,3112,5.3
CN4202100000000,42,021,Cambria County, PA,Jan-18,58908,55149,3759,6.4
CN4202100000000,42,021,Cambria County, PA,Feb-18,59397,55708,3689,6.2
CN4202100000000,42,021,Cambria County, PA,Mar-18,58488,55305,3183,5.4
CN4202100000000,42,021,Cambria County, PA,Apr-18(p),58615,55925,2690,4.6
CN5168300000000,51,683,Manassas city, VA,Mar-17,22062,21240,822,3.7
CN5168300000000,51,683,Manassas city, VA,Apr-17,21987,21290,697,3.2
CN5168300000000,51,683,Manassas city, VA,May-17,22107,21372,735,3.3
CN5168300000000,51,683,Manassas city, VA,Jun-17,22209,21459,750,3.4
CN5168300000000,51,683,Manassas city, VA,Jul-17,22334,21591,743,3.3
CN5168300000000,51,683,Manassas city, VA,Aug-17,22032,21276,756,3.4
CN5168300000000,51,683,Manassas city, VA,Sep-17,22068,21350,718,3.3
CN5168300000000,51,683,Manassas city, VA,Oct-17,22005,21354,651,3.0
CN5168300000000,51,683,Manassas city, VA,Nov-17,22034,21370,664,3.0
CN5168300000000,51,683,Manassas city, VA,Dec-17,21970,21316,654,3.0
CN5168300000000,51,683,Manassas city, VA,Jan-18,22231,21442,789,3.5
CN5168300000000,51,683,Manassas city, VA,Feb-18,22393,21678,715,3.2
CN5168300000000,51,683,Manassas city, VA,Mar-18,22427,21750,677,3.0
CN5168300000000,51,683,Manassas city, VA,Apr-18(p),22332,21774,558,2.5
CN3603700000000,36,037,Genesee County, NY,Mar-17,29418,27828,1590,5.4
CN3603700000000,36,037,Genesee County, NY,Apr-17,29807,28444,1363,4.6
CN3603700000000,36,037,Genesee County, NY,May-17,29909,28602,1307,4.4
CN3603700000000,36,037,Genesee County, NY,Jun-17,30632,29327,1305,4.3
CN3603700000000,36,037,Genesee County, NY,Jul-17,30548,29238,1310,4.3
CN3603700000000,36,037,Genesee County, NY,Aug-17,30320,29055,1265,4.2
CN3603700000000,36,037,Genesee County, NY,Sep-17,29875,28604,1271,4.3
CN3603700000000,36,037,Genesee County, NY,Oct-17,29051,27748,1303,4.5
CN3603700000000,36,037,Genesee County, NY,Nov-17,29273,27803,1470,5.0
CN3603700000000,36,037,Genesee County, NY,Dec-17,29126,27580,1546,5.3
CN3603700000000,36,037,Genesee County, NY,Jan-18,29460,27578,1882,6.4
CN3603700000000,36,037,Genesee County, NY,Feb-18,29232,27335,1897,6.5
CN3603700000000,36,037,Genesee County, NY,Mar-18,28772,27036,1736,6.0
CN3603700000000,36,037,Genesee County, NY,Apr-18(p),29152,27747,1405,4.8
CN4812100000000,48,121,Denton County, TX,Mar-17,460658,444210,16448,3.6
CN4812100000000,48,121,Denton County, TX,Apr-17,461800,447218,14582,3.2
CN4812100000000,48,121,Denton County, TX,May-17,461002,446052,14950,3.2
CN4812100000000,48,121,Denton County, TX,Jun-17,463427,446981,16446,3.5
CN4812100000000,48,121,Denton County, TX,Jul-17,467021,450621,16400,3.5
CN4812100000000,48,121,Denton County, TX,Aug-17,465708,449468,16240,3.5
CN4812100000000,48,121,Denton County, TX,Sep-17,469591,455244,14347,3.1
CN4812100000000,48,121,Denton County, TX,Oct-17,467257,453869,13388,2.9
CN4812100000000,48,121,Denton County, TX,Nov-17,471167,457360,13807,2.9
CN4812100000000,48,121,Denton County, TX,Dec-17,468634,455305,13329,2.8
CN4812100000000,48,121,Denton County, TX,Jan-18,469029,453837,15192,3.2
CN4812100000000,48,121,Denton County, TX,Feb-18,475990,460267,15723,3.3
CN4812100000000,48,121,Denton County, TX,Mar-18,476804,460418,16386,3.4
CN4812100000000,48,121,Denton County, TX,Apr-18(p),478147,463594,14553,3.0
CN1315900000000,13,159,Jasper County, GA,Mar-17,6786,6471,315,4.6
CN1315900000000,13,159,Jasper County, GA,Apr-17,6775,6491,284,4.2
CN1315900000000,13,159,Jasper County, GA,May-17,6798,6510,288,4.2
CN1315900000000,13,159,Jasper County, GA,Jun-17,6830,6518,312,4.6
CN1315900000000,13,159,Jasper County, GA,Jul-17,6859,6541,318,4.6
CN1315900000000,13,159,Jasper County, GA,Aug-17,6813,6507,306,4.5
CN1315900000000,13,159,Jasper County, GA,Sep-17,6862,6585,277,4.0
CN1315900000000,13,159,Jasper County, GA,Oct-17,6844,6576,268,3.9
CN1315900000000,13,159,Jasper County, GA,Nov-17,6851,6595,256,3.7
CN1315900000000,13,159,Jasper County, GA,Dec-17,6858,6598,260,3.8
CN1315900000000,13,159,Jasper County, GA,Jan-18,6877,6602,275,4.0
CN1315900000000,13,159,Jasper County, GA,Feb-18,6928,6662,266,3.8
CN1315900000000,13,159,Jasper County, GA,Mar-18,6929,6682,247,3.6
CN1315900000000,13,159,Jasper County, GA,Apr-18(p),6891,6676,215,3.1
CN2018700000000,20,187,Stanton County, KS,Mar-17,965,937,28,2.9
CN2018700000000,20,187,Stanton County, KS,Apr-17,959,931,28,2.9
CN2018700000000,20,187,Stanton County, KS,May-17,966,938,28,2.9
CN2018700000000,20,187,Stanton County, KS,Jun-17,1045,1016,29,2.8
CN2018700000000,20,187,Stanton County, KS,Jul-17,1013,981,32,3.2
CN2018700000000,20,187,Stanton County, KS,Aug-17,999,969,30,3.0
CN2018700000000,20,187,Stanton County, KS,Sep-17,1005,980,25,2.5
CN2018700000000,20,187,Stanton County, KS,Oct-17,1028,1006,22,2.1
CN2018700000000,20,187,Stanton County, KS,Nov-17,1000,974,26,2.6
CN2018700000000,20,187,Stanton County, KS,Dec-17,998,974,24,2.4
CN2018700000000,20,187,Stanton County, KS,Jan-18,954,930,24,2.5
CN2018700000000,20,187,Stanton County, KS,Feb-18,954,928,26,2.7
CN2018700000000,20,187,Stanton County, KS,Mar-18,979,951,28,2.9
CN2018700000000,20,187,Stanton County, KS,Apr-18(p),914,887,27,3.0
CN2918300000000,29,183,St. Charles County, MO,Mar-17,219115,212279,6836,3.1
CN2918300000000,29,183,St. Charles County, MO,Apr-17,219548,213552,5996,2.7
CN2918300000000,29,183,St. Charles County, MO,May-17,220577,214306,6271,2.8
CN2918300000000,29,183,St. Charles County, MO,Jun-17,222369,215840,6529,2.9
CN2918300000000,29,183,St. Charles County, MO,Jul-17,223885,216922,6963,3.1
CN2918300000000,29,183,St. Charles County, MO,Aug-17,220565,213647,6918,3.1
CN2918300000000,29,183,St. Charles County, MO,Sep-17,220116,214341,5775,2.6
CN2918300000000,29,183,St. Charles County, MO,Oct-17,217977,213635,4342,2.0
CN2918300000000,29,183,St. Charles County, MO,Nov-17,218866,213425,5441,2.5
CN2918300000000,29,183,St. Charles County, MO,Dec-17,217640,211952,5688,2.6
CN2918300000000,29,183,St. Charles County, MO,Jan-18,215038,208223,6815,3.2
CN2918300000000,29,183,St. Charles County, MO,Feb-18,218478,211709,6769,3.1
CN2918300000000,29,183,St. Charles County, MO,Mar-18,218649,212036,6613,3.0
CN2918300000000,29,183,St. Charles County, MO,Apr-18(p),219487,213708,5779,2.6
CN3113500000000,31,135,Perkins County, NE,Mar-17,1781,1748,33,1.9
CN3113500000000,31,135,Perkins County, NE,Apr-17,1841,1806,35,1.9
CN3113500000000,31,135,Perkins County, NE,May-17,1860,1828,32,1.7
CN3113500000000,31,135,Perkins County, NE,Jun-17,1932,1895,37,1.9
CN3113500000000,31,135,Perkins County, NE,Jul-17,1861,1821,40,2.1
CN3113500000000,31,135,Perkins County, NE,Aug-17,1796,1761,35,1.9
CN3113500000000,31,135,Perkins County, NE,Sep-17,1716,1684,32,1.9
CN3113500000000,31,135,Perkins County, NE,Oct-17,1742,1709,33,1.9
CN3113500000000,31,135,Perkins County, NE,Nov-17,1738,1707,31,1.8
CN3113500000000,31,135,Perkins County, NE,Dec-17,1737,1702,35,2.0
CN3113500000000,31,135,Perkins County, NE,Jan-18,1773,1740,33,1.9
CN3113500000000,31,135,Perkins County, NE,Feb-18,1737,1704,33,1.9
CN3113500000000,31,135,Perkins County, NE,Mar-18,1764,1730,34,1.9
CN3113500000000,31,135,Perkins County, NE,Apr-18(p),1782,1743,39,2.2
CN3915100000000,39,151,Stark County, OH,Mar-17,187143,176552,10591,5.7
CN3915100000000,39,151,Stark County, OH,Apr-17,187167,178008,9159,4.9
CN3915100000000,39,151,Stark County, OH,May-17,188009,179119,8890,4.7
CN3915100000000,39,151,Stark County, OH,Jun-17,189386,179566,9820,5.2
CN3915100000000,39,151,Stark County, OH,Jul-17,189037,179183,9854,5.2
CN3915100000000,39,151,Stark County, OH,Aug-17,188090,178340,9750,5.2
CN3915100000000,39,151,Stark County, OH,Sep-17,187115,178223,8892,4.8
CN3915100000000,39,151,Stark County, OH,Oct-17,187988,179345,8643,4.6
CN3915100000000,39,151,Stark County, OH,Nov-17,187683,178898,8785,4.7
CN3915100000000,39,151,Stark County, OH,Dec-17,186927,177730,9197,4.9
CN3915100000000,39,151,Stark County, OH,Jan-18,184796,174476,10320,5.6
CN3915100000000,39,151,Stark County, OH,Feb-18,186858,177122,9736,5.2
CN3915100000000,39,151,Stark County, OH,Mar-18,188306,178840,9466,5.0
CN3915100000000,39,151,Stark County, OH,Apr-18(p),187656,178885,8771,4.7
CN5513700000000,55,137,Waushara County, WI,Mar-17,11450,10912,538,4.7
CN5513700000000,55,137,Waushara County, WI,Apr-17,11416,10991,425,3.7
CN5513700000000,55,137,Waushara County, WI,May-17,11516,11109,407,3.5
CN5513700000000,55,137,Waushara County, WI,Jun-17,11981,11487,494,4.1
CN5513700000000,55,137,Waushara County, WI,Jul-17,11558,11135,423,3.7
CN5513700000000,55,137,Waushara County, WI,Aug-17,11506,11090,416,3.6
CN5513700000000,55,137,Waushara County, WI,Sep-17,11464,11107,357,3.1
CN5513700000000,55,137,Waushara County, WI,Oct-17,11555,11220,335,2.9
CN5513700000000,55,137,Waushara County, WI,Nov-17,11617,11248,369,3.2
CN5513700000000,55,137,Waushara County, WI,Dec-17,11638,11227,411,3.5
CN5513700000000,55,137,Waushara County, WI,Jan-18,11598,11130,468,4.0
CN5513700000000,55,137,Waushara County, WI,Feb-18,11530,11017,513,4.4
CN5513700000000,55,137,Waushara County, WI,Mar-18,11608,11127,481,4.1
CN5513700000000,55,137,Waushara County, WI,Apr-18(p),11600,11217,383,3.3
CN1919700000000,19,197,Wright County, IA,Mar-17,6461,6196,265,4.1
CN1919700000000,19,197,Wright County, IA,Apr-17,6612,6369,243,3.7
CN1919700000000,19,197,Wright County, IA,May-17,6574,6375,199,3.0
CN1919700000000,19,197,Wright County, IA,Jun-17,6774,6535,239,3.5
CN1919700000000,19,197,Wright County, IA,Jul-17,6785,6557,228,3.4
CN1919700000000,19,197,Wright County, IA,Aug-17,6699,6463,236,3.5
CN1919700000000,19,197,Wright County, IA,Sep-17,6511,6315,196,3.0
CN1919700000000,19,197,Wright County, IA,Oct-17,6500,6338,162,2.5
CN1919700000000,19,197,Wright County, IA,Nov-17,6426,6262,164,2.6
CN1919700000000,19,197,Wright County, IA,Dec-17,6381,6218,163,2.6
CN1919700000000,19,197,Wright County, IA,Jan-18,6339,6101,238,3.8
CN1919700000000,19,197,Wright County, IA,Feb-18,6347,6121,226,3.6
CN1919700000000,19,197,Wright County, IA,Mar-18,6298,6087,211,3.4
CN1919700000000,19,197,Wright County, IA,Apr-18(p),6304,6125,179,2.8
CN3717300000000,37,173,Swain County, NC,Mar-17,6735,6323,412,6.1
CN3717300000000,37,173,Swain County, NC,Apr-17,6361,6039,322,5.1
CN3717300000000,37,173,Swain County, NC,May-17,6783,6464,319,4.7
CN3717300000000,37,173,Swain County, NC,Jun-17,7232,6908,324,4.5
CN3717300000000,37,173,Swain County, NC,Jul-17,7266,6937,329,4.5
CN3717300000000,37,173,Swain County, NC,Aug-17,7161,6833,328,4.6
CN3717300000000,37,173,Swain County, NC,Sep-17,7152,6867,285,4.0
CN3717300000000,37,173,Swain County, NC,Oct-17,7243,6962,281,3.9
CN3717300000000,37,173,Swain County, NC,Nov-17,7100,6797,303,4.3
CN3717300000000,37,173,Swain County, NC,Dec-17,6939,6609,330,4.8
CN3717300000000,37,173,Swain County, NC,Jan-18,6809,6335,474,7.0
CN3717300000000,37,173,Swain County, NC,Feb-18,6739,6284,455,6.8
CN3717300000000,37,173,Swain County, NC,Mar-18,6808,6408,400,5.9
CN3717300000000,37,173,Swain County, NC,Apr-18(p),6709,6404,305,4.5
CN2121500000000,21,215,Spencer County, KY,Mar-17,9800,9387,413,4.2
CN2121500000000,21,215,Spencer County, KY,Apr-17,9772,9420,352,3.6
CN2121500000000,21,215,Spencer County, KY,May-17,9802,9439,363,3.7
CN2121500000000,21,215,Spencer County, KY,Jun-17,9961,9553,408,4.1
CN2121500000000,21,215,Spencer County, KY,Jul-17,10026,9589,437,4.4
CN2121500000000,21,215,Spencer County, KY,Aug-17,9877,9496,381,3.9
CN2121500000000,21,215,Spencer County, KY,Sep-17,9912,9569,343,3.5
CN2121500000000,21,215,Spencer County, KY,Oct-17,9821,9497,324,3.3
CN2121500000000,21,215,Spencer County, KY,Nov-17,9857,9552,305,3.1
CN2121500000000,21,215,Spencer County, KY,Dec-17,9862,9560,302,3.1
CN2121500000000,21,215,Spencer County, KY,Jan-18,9744,9404,340,3.5
CN2121500000000,21,215,Spencer County, KY,Feb-18,9886,9505,381,3.9
CN2121500000000,21,215,Spencer County, KY,Mar-18,9987,9633,354,3.5
CN2121500000000,21,215,Spencer County, KY,Apr-18(p),9983,9681,302,3.0
CN4826500000000,48,265,Kerr County, TX,Mar-17,21252,20501,751,3.5
CN4826500000000,48,265,Kerr County, TX,Apr-17,21200,20554,646,3.0
CN4826500000000,48,265,Kerr County, TX,May-17,21294,20591,703,3.3
CN4826500000000,48,265,Kerr County, TX,Jun-17,21676,20927,749,3.5
CN4826500000000,48,265,Kerr County, TX,Jul-17,21776,20999,777,3.6
CN4826500000000,48,265,Kerr County, TX,Aug-17,21120,20364,756,3.6
CN4826500000000,48,265,Kerr County, TX,Sep-17,21284,20579,705,3.3
CN4826500000000,48,265,Kerr County, TX,Oct-17,21217,20557,660,3.1
CN4826500000000,48,265,Kerr County, TX,Nov-17,21362,20661,701,3.3
CN4826500000000,48,265,Kerr County, TX,Dec-17,21365,20714,651,3.0
CN4826500000000,48,265,Kerr County, TX,Jan-18,20947,20203,744,3.6
CN4826500000000,48,265,Kerr County, TX,Feb-18,21553,20778,775,3.6
CN4826500000000,48,265,Kerr County, TX,Mar-18,21658,20886,772,3.6
CN4826500000000,48,265,Kerr County, TX,Apr-18(p),21601,20922,679,3.1
CN0601900000000,06,019,Fresno County, CA,Mar-17,450116,403931,46185,10.3
CN0601900000000,06,019,Fresno County, CA,Apr-17,452602,411863,40739,9.0
CN0601900000000,06,019,Fresno County, CA,May-17,451039,415745,35294,7.8
CN0601900000000,06,019,Fresno County, CA,Jun-17,452041,415596,36445,8.1
CN0601900000000,06,019,Fresno County, CA,Jul-17,451774,415105,36669,8.1
CN0601900000000,06,019,Fresno County, CA,Aug-17,451731,417045,34686,7.7
CN0601900000000,06,019,Fresno County, CA,Sep-17,452568,421996,30572,6.8
CN0601900000000,06,019,Fresno County, CA,Oct-17,446056,414063,31993,7.2
CN0601900000000,06,019,Fresno County, CA,Nov-17,447026,412232,34794,7.8
CN0601900000000,06,019,Fresno County, CA,Dec-17,445933,409960,35973,8.1
CN0601900000000,06,019,Fresno County, CA,Jan-18,448437,409624,38813,8.7
CN0601900000000,06,019,Fresno County, CA,Feb-18,454123,413318,40805,9.0
CN0601900000000,06,019,Fresno County, CA,Mar-18,449833,410771,39062,8.7
CN0601900000000,06,019,Fresno County, CA,Apr-18(p),450414,416603,33811,7.5
CN2108700000000,21,087,Green County, KY,Mar-17,5234,4959,275,5.3
CN2108700000000,21,087,Green County, KY,Apr-17,5240,5007,233,4.4
CN2108700000000,21,087,Green County, KY,May-17,5195,4954,241,4.6
CN2108700000000,21,087,Green County, KY,Jun-17,5261,4979,282,5.4
CN2108700000000,21,087,Green County, KY,Jul-17,5006,4740,266,5.3
CN2108700000000,21,087,Green County, KY,Aug-17,5155,4925,230,4.5
CN2108700000000,21,087,Green County, KY,Sep-17,5129,4912,217,4.2
CN2108700000000,21,087,Green County, KY,Oct-17,5043,4843,200,4.0
CN2108700000000,21,087,Green County, KY,Nov-17,5081,4897,184,3.6
CN2108700000000,21,087,Green County, KY,Dec-17,5105,4933,172,3.4
CN2108700000000,21,087,Green County, KY,Jan-18,5034,4843,191,3.8
CN2108700000000,21,087,Green County, KY,Feb-18,5244,5025,219,4.2
CN2108700000000,21,087,Green County, KY,Mar-18,5317,5083,234,4.4
CN2108700000000,21,087,Green County, KY,Apr-18(p),5309,5109,200,3.8
CN4834500000000,48,345,Motley County, TX,Mar-17,515,497,18,3.5
CN4834500000000,48,345,Motley County, TX,Apr-17,507,491,16,3.2
CN4834500000000,48,345,Motley County, TX,May-17,517,498,19,3.7
CN4834500000000,48,345,Motley County, TX,Jun-17,511,493,18,3.5
CN4834500000000,48,345,Motley County, TX,Jul-17,478,460,18,3.8
CN4834500000000,48,345,Motley County, TX,Aug-17,476,457,19,4.0
CN4834500000000,48,345,Motley County, TX,Sep-17,468,451,17,3.6
CN4834500000000,48,345,Motley County, TX,Oct-17,486,471,15,3.1
CN4834500000000,48,345,Motley County, TX,Nov-17,474,458,16,3.4
CN4834500000000,48,345,Motley County, TX,Dec-17,477,460,17,3.6
CN4834500000000,48,345,Motley County, TX,Jan-18,478,461,17,3.6
CN4834500000000,48,345,Motley County, TX,Feb-18,490,468,22,4.5
CN4834500000000,48,345,Motley County, TX,Mar-18,518,498,20,3.9
CN4834500000000,48,345,Motley County, TX,Apr-18(p),479,463,16,3.3
CN4209900000000,42,099,Perry County, PA,Mar-17,24209,23072,1137,4.7
CN4209900000000,42,099,Perry County, PA,Apr-17,24277,23359,918,3.8
CN4209900000000,42,099,Perry County, PA,May-17,24299,23319,980,4.0
CN4209900000000,42,099,Perry County, PA,Jun-17,24761,23677,1084,4.4
CN4209900000000,42,099,Perry County, PA,Jul-17,25018,23867,1151,4.6
CN4209900000000,42,099,Perry County, PA,Aug-17,24719,23579,1140,4.6
CN4209900000000,42,099,Perry County, PA,Sep-17,24164,23250,914,3.8
CN4209900000000,42,099,Perry County, PA,Oct-17,23856,22994,862,3.6
CN4209900000000,42,099,Perry County, PA,Nov-17,23728,22840,888,3.7
CN4209900000000,42,099,Perry County, PA,Dec-17,23748,22794,954,4.0
CN4209900000000,42,099,Perry County, PA,Jan-18,23809,22601,1208,5.1
CN4209900000000,42,099,Perry County, PA,Feb-18,23863,22730,1133,4.7
CN4209900000000,42,099,Perry County, PA,Mar-18,23592,22658,934,4.0
CN4209900000000,42,099,Perry County, PA,Apr-18(p),23572,22771,801,3.4
CN2209900000000,22,099,St. Martin Parish, LA,Mar-17,22624,21154,1470,6.5
CN2209900000000,22,099,St. Martin Parish, LA,Apr-17,22559,21178,1381,6.1
CN2209900000000,22,099,St. Martin Parish, LA,May-17,22541,21140,1401,6.2
CN2209900000000,22,099,St. Martin Parish, LA,Jun-17,22886,21324,1562,6.8
CN2209900000000,22,099,St. Martin Parish, LA,Jul-17,22968,21493,1475,6.4
CN2209900000000,22,099,St. Martin Parish, LA,Aug-17,22691,21240,1451,6.4
CN2209900000000,22,099,St. Martin Parish, LA,Sep-17,22631,21331,1300,5.7
CN2209900000000,22,099,St. Martin Parish, LA,Oct-17,22472,21335,1137,5.1
CN2209900000000,22,099,St. Martin Parish, LA,Nov-17,22410,21329,1081,4.8
CN2209900000000,22,099,St. Martin Parish, LA,Dec-17,22250,21214,1036,4.7
CN2209900000000,22,099,St. Martin Parish, LA,Jan-18,22289,21184,1105,5.0
CN2209900000000,22,099,St. Martin Parish, LA,Feb-18,22396,21370,1026,4.6
CN2209900000000,22,099,St. Martin Parish, LA,Mar-18,22569,21492,1077,4.8
CN2209900000000,22,099,St. Martin Parish, LA,Apr-18(p),22522,21461,1061,4.7
CN2601900000000,26,019,Benzie County, MI,Mar-17,8694,7953,741,8.5
CN2601900000000,26,019,Benzie County, MI,Apr-17,8616,8050,566,6.6
CN2601900000000,26,019,Benzie County, MI,May-17,8832,8325,507,5.7
CN2601900000000,26,019,Benzie County, MI,Jun-17,9263,8743,520,5.6
CN2601900000000,26,019,Benzie County, MI,Jul-17,9508,8948,560,5.9
CN2601900000000,26,019,Benzie County, MI,Aug-17,9288,8770,518,5.6
CN2601900000000,26,019,Benzie County, MI,Sep-17,8887,8460,427,4.8
CN2601900000000,26,019,Benzie County, MI,Oct-17,8788,8386,402,4.6
CN2601900000000,26,019,Benzie County, MI,Nov-17,8768,8297,471,5.4
CN2601900000000,26,019,Benzie County, MI,Dec-17,8836,8213,623,7.1
CN2601900000000,26,019,Benzie County, MI,Jan-18,8767,8034,733,8.4
CN2601900000000,26,019,Benzie County, MI,Feb-18,8868,8071,797,9.0
CN2601900000000,26,019,Benzie County, MI,Mar-18,8803,8100,703,8.0
CN2601900000000,26,019,Benzie County, MI,Apr-18(p),8752,8202,550,6.3
CN4837100000000,48,371,Pecos County, TX,Mar-17,6353,6004,349,5.5
CN4837100000000,48,371,Pecos County, TX,Apr-17,6205,5894,311,5.0
CN4837100000000,48,371,Pecos County, TX,May-17,6162,5870,292,4.7
CN4837100000000,48,371,Pecos County, TX,Jun-17,6246,5943,303,4.9
CN4837100000000,48,371,Pecos County, TX,Jul-17,6536,6257,279,4.3
CN4837100000000,48,371,Pecos County, TX,Aug-17,6936,6636,300,4.3
CN4837100000000,48,371,Pecos County, TX,Sep-17,6857,6609,248,3.6
CN4837100000000,48,371,Pecos County, TX,Oct-17,6795,6569,226,3.3
CN4837100000000,48,371,Pecos County, TX,Nov-17,6791,6566,225,3.3
CN4837100000000,48,371,Pecos County, TX,Dec-17,6729,6521,208,3.1
CN4837100000000,48,371,Pecos County, TX,Jan-18,6697,6455,242,3.6
CN4837100000000,48,371,Pecos County, TX,Feb-18,6821,6561,260,3.8
CN4837100000000,48,371,Pecos County, TX,Mar-18,6816,6551,265,3.9
CN4837100000000,48,371,Pecos County, TX,Apr-18(p),6708,6468,240,3.6
CN1816700000000,18,167,Vigo County, IN,Mar-17,48678,46535,2143,4.4
CN1816700000000,18,167,Vigo County, IN,Apr-17,48939,47152,1787,3.7
CN1816700000000,18,167,Vigo County, IN,May-17,48717,46880,1837,3.8
CN1816700000000,18,167,Vigo County, IN,Jun-17,48733,46733,2000,4.1
CN1816700000000,18,167,Vigo County, IN,Jul-17,48613,46524,2089,4.3
CN1816700000000,18,167,Vigo County, IN,Aug-17,48219,45954,2265,4.7
CN1816700000000,18,167,Vigo County, IN,Sep-17,48760,46859,1901,3.9
CN1816700000000,18,167,Vigo County, IN,Oct-17,48404,46589,1815,3.7
CN1816700000000,18,167,Vigo County, IN,Nov-17,48263,46359,1904,3.9
CN1816700000000,18,167,Vigo County, IN,Dec-17,48282,46453,1829,3.8
CN1816700000000,18,167,Vigo County, IN,Jan-18,47854,45665,2189,4.6
CN1816700000000,18,167,Vigo County, IN,Feb-18,48670,46333,2337,4.8
CN1816700000000,18,167,Vigo County, IN,Mar-18,48982,46985,1997,4.1
CN1816700000000,18,167,Vigo County, IN,Apr-18(p),49086,47314,1772,3.6
CN3102900000000,31,029,Chase County, NE,Mar-17,2269,2226,43,1.9
CN3102900000000,31,029,Chase County, NE,Apr-17,2318,2277,41,1.8
CN3102900000000,31,029,Chase County, NE,May-17,2372,2328,44,1.9
CN3102900000000,31,029,Chase County, NE,Jun-17,2465,2416,49,2.0
CN3102900000000,31,029,Chase County, NE,Jul-17,2389,2342,47,2.0
CN3102900000000,31,029,Chase County, NE,Aug-17,2307,2261,46,2.0
CN3102900000000,31,029,Chase County, NE,Sep-17,2193,2152,41,1.9
CN3102900000000,31,029,Chase County, NE,Oct-17,2231,2189,42,1.9
CN3102900000000,31,029,Chase County, NE,Nov-17,2245,2208,37,1.6
CN3102900000000,31,029,Chase County, NE,Dec-17,2247,2208,39,1.7
CN3102900000000,31,029,Chase County, NE,Jan-18,2289,2239,50,2.2
CN3102900000000,31,029,Chase County, NE,Feb-18,2246,2200,46,2.0
CN3102900000000,31,029,Chase County, NE,Mar-18,2288,2235,53,2.3
CN3102900000000,31,029,Chase County, NE,Apr-18(p),2289,2242,47,2.1
CN1326500000000,13,265,Taliaferro County, GA,Mar-17,572,527,45,7.9
CN1326500000000,13,265,Taliaferro County, GA,Apr-17,573,533,40,7.0
CN1326500000000,13,265,Taliaferro County, GA,May-17,580,537,43,7.4
CN1326500000000,13,265,Taliaferro County, GA,Jun-17,577,539,38,6.6
CN1326500000000,13,265,Taliaferro County, GA,Jul-17,573,538,35,6.1
CN1326500000000,13,265,Taliaferro County, GA,Aug-17,570,535,35,6.1
CN1326500000000,13,265,Taliaferro County, GA,Sep-17,572,539,33,5.8
CN1326500000000,13,265,Taliaferro County, GA,Oct-17,566,535,31,5.5
CN1326500000000,13,265,Taliaferro County, GA,Nov-17,566,533,33,5.8
CN1326500000000,13,265,Taliaferro County, GA,Dec-17,568,534,34,6.0
CN1326500000000,13,265,Taliaferro County, GA,Jan-18,578,537,41,7.1
CN1326500000000,13,265,Taliaferro County, GA,Feb-18,567,535,32,5.6
CN1326500000000,13,265,Taliaferro County, GA,Mar-18,576,538,38,6.6
CN1326500000000,13,265,Taliaferro County, GA,Apr-18(p),568,541,27,4.8
CN2907700000000,29,077,Greene County, MO,Mar-17,148161,143165,4996,3.4
CN2907700000000,29,077,Greene County, MO,Apr-17,148094,143678,4416,3.0
CN2907700000000,29,077,Greene County, MO,May-17,148331,143704,4627,3.1
CN2907700000000,29,077,Greene County, MO,Jun-17,148578,143934,4644,3.1
CN2907700000000,29,077,Greene County, MO,Jul-17,149790,145018,4772,3.2
CN2907700000000,29,077,Greene County, MO,Aug-17,146652,141572,5080,3.5
CN2907700000000,29,077,Greene County, MO,Sep-17,149313,145197,4116,2.8
CN2907700000000,29,077,Greene County, MO,Oct-17,146856,143869,2987,2.0
CN2907700000000,29,077,Greene County, MO,Nov-17,147329,143552,3777,2.6
CN2907700000000,29,077,Greene County, MO,Dec-17,147995,144170,3825,2.6
CN2907700000000,29,077,Greene County, MO,Jan-18,146755,142196,4559,3.1
CN2907700000000,29,077,Greene County, MO,Feb-18,148181,143718,4463,3.0
CN2907700000000,29,077,Greene County, MO,Mar-18,147713,143236,4477,3.0
CN2907700000000,29,077,Greene County, MO,Apr-18(p),147941,144039,3902,2.6
CN4014100000000,40,141,Tillman County, OK,Mar-17,3294,3164,130,3.9
CN4014100000000,40,141,Tillman County, OK,Apr-17,3328,3205,123,3.7
CN4014100000000,40,141,Tillman County, OK,May-17,3305,3171,134,4.1
CN4014100000000,40,141,Tillman County, OK,Jun-17,3125,2981,144,4.6
CN4014100000000,40,141,Tillman County, OK,Jul-17,3139,2997,142,4.5
CN4014100000000,40,141,Tillman County, OK,Aug-17,3208,3055,153,4.8
CN4014100000000,40,141,Tillman County, OK,Sep-17,3260,3124,136,4.2
CN4014100000000,40,141,Tillman County, OK,Oct-17,3329,3170,159,4.8
CN4014100000000,40,141,Tillman County, OK,Nov-17,3345,3212,133,4.0
CN4014100000000,40,141,Tillman County, OK,Dec-17,3267,3138,129,3.9
CN4014100000000,40,141,Tillman County, OK,Jan-18,3217,3069,148,4.6
CN4014100000000,40,141,Tillman County, OK,Feb-18,3255,3124,131,4.0
CN4014100000000,40,141,Tillman County, OK,Mar-18,3237,3112,125,3.9
CN4014100000000,40,141,Tillman County, OK,Apr-18(p),3185,3060,125,3.9
CN3001700000000,30,017,Custer County, MT,Mar-17,6191,5938,253,4.1
CN3001700000000,30,017,Custer County, MT,Apr-17,6194,6023,171,2.8
CN3001700000000,30,017,Custer County, MT,May-17,6323,6169,154,2.4
CN3001700000000,30,017,Custer County, MT,Jun-17,6293,6101,192,3.1
CN3001700000000,30,017,Custer County, MT,Jul-17,6233,6055,178,2.9
CN3001700000000,30,017,Custer County, MT,Aug-17,6166,5990,176,2.9
CN3001700000000,30,017,Custer County, MT,Sep-17,6145,5979,166,2.7
CN3001700000000,30,017,Custer County, MT,Oct-17,6199,6024,175,2.8
CN3001700000000,30,017,Custer County, MT,Nov-17,6187,6015,172,2.8
CN3001700000000,30,017,Custer County, MT,Dec-17,6162,5948,214,3.5
CN3001700000000,30,017,Custer County, MT,Jan-18,6070,5817,253,4.2
CN3001700000000,30,017,Custer County, MT,Feb-18,6093,5804,289,4.7
CN3001700000000,30,017,Custer County, MT,Mar-18,6105,5826,279,4.6
CN3001700000000,30,017,Custer County, MT,Apr-18(p),6017,5824,193,3.2
CN4718700000000,47,187,Williamson County, TN,Mar-17,116883,113523,3360,2.9
CN4718700000000,47,187,Williamson County, TN,Apr-17,117133,114306,2827,2.4
CN4718700000000,47,187,Williamson County, TN,May-17,117350,114659,2691,2.3
CN4718700000000,47,187,Williamson County, TN,Jun-17,119320,115672,3648,3.1
CN4718700000000,47,187,Williamson County, TN,Jul-17,119761,116284,3477,2.9
CN4718700000000,47,187,Williamson County, TN,Aug-17,118474,115181,3293,2.8
CN4718700000000,47,187,Williamson County, TN,Sep-17,119492,116634,2858,2.4
CN4718700000000,47,187,Williamson County, TN,Oct-17,119304,116605,2699,2.3
CN4718700000000,47,187,Williamson County, TN,Nov-17,118756,115960,2796,2.4
CN4718700000000,47,187,Williamson County, TN,Dec-17,118509,115943,2566,2.2
CN4718700000000,47,187,Williamson County, TN,Jan-18,118193,115195,2998,2.5
CN4718700000000,47,187,Williamson County, TN,Feb-18,119598,116686,2912,2.4
CN4718700000000,47,187,Williamson County, TN,Mar-18,120057,117117,2940,2.4
CN4718700000000,47,187,Williamson County, TN,Apr-18(p),120917,118481,2436,2.0
CN4700300000000,47,003,Bedford County, TN,Mar-17,20320,19507,813,4.0
CN4700300000000,47,003,Bedford County, TN,Apr-17,20649,19943,706,3.4
CN4700300000000,47,003,Bedford County, TN,May-17,20716,19938,778,3.8
CN4700300000000,47,003,Bedford County, TN,Jun-17,20818,19874,944,4.5
CN4700300000000,47,003,Bedford County, TN,Jul-17,20660,19740,920,4.5
CN4700300000000,47,003,Bedford County, TN,Aug-17,20673,19842,831,4.0
CN4700300000000,47,003,Bedford County, TN,Sep-17,20872,20132,740,3.5
CN4700300000000,47,003,Bedford County, TN,Oct-17,20569,19885,684,3.3
CN4700300000000,47,003,Bedford County, TN,Nov-17,20510,19846,664,3.2
CN4700300000000,47,003,Bedford County, TN,Dec-17,20478,19836,642,3.1
CN4700300000000,47,003,Bedford County, TN,Jan-18,20469,19696,773,3.8
CN4700300000000,47,003,Bedford County, TN,Feb-18,20685,19939,746,3.6
CN4700300000000,47,003,Bedford County, TN,Mar-18,20740,20013,727,3.5
CN4700300000000,47,003,Bedford County, TN,Apr-18(p),20905,20280,625,3.0
CN4801500000000,48,015,Austin County, TX,Mar-17,14115,13430,685,4.9
CN4801500000000,48,015,Austin County, TX,Apr-17,14063,13461,602,4.3
CN4801500000000,48,015,Austin County, TX,May-17,14062,13447,615,4.4
CN4801500000000,48,015,Austin County, TX,Jun-17,14064,13418,646,4.6
CN4801500000000,48,015,Austin County, TX,Jul-17,14001,13369,632,4.5
CN4801500000000,48,015,Austin County, TX,Aug-17,13948,13338,610,4.4
CN4801500000000,48,015,Austin County, TX,Sep-17,13935,13391,544,3.9
CN4801500000000,48,015,Austin County, TX,Oct-17,13922,13435,487,3.5
CN4801500000000,48,015,Austin County, TX,Nov-17,13975,13468,507,3.6
CN4801500000000,48,015,Austin County, TX,Dec-17,14000,13517,483,3.5
CN4801500000000,48,015,Austin County, TX,Jan-18,13997,13439,558,4.0
CN4801500000000,48,015,Austin County, TX,Feb-18,14216,13655,561,3.9
CN4801500000000,48,015,Austin County, TX,Mar-18,14329,13777,552,3.9
CN4801500000000,48,015,Austin County, TX,Apr-18(p),14316,13819,497,3.5
CN4819900000000,48,199,Hardin County, TX,Mar-17,25335,23765,1570,6.2
CN4819900000000,48,199,Hardin County, TX,Apr-17,25177,23744,1433,5.7
CN4819900000000,48,199,Hardin County, TX,May-17,25021,23614,1407,5.6
CN4819900000000,48,199,Hardin County, TX,Jun-17,25110,23571,1539,6.1
CN4819900000000,48,199,Hardin County, TX,Jul-17,25013,23457,1556,6.2
CN4819900000000,48,199,Hardin County, TX,Aug-17,24741,23159,1582,6.4
CN4819900000000,48,199,Hardin County, TX,Sep-17,24913,23263,1650,6.6
CN4819900000000,48,199,Hardin County, TX,Oct-17,24888,23485,1403,5.6
CN4819900000000,48,199,Hardin County, TX,Nov-17,24928,23514,1414,5.7
CN4819900000000,48,199,Hardin County, TX,Dec-17,24859,23454,1405,5.7
CN4819900000000,48,199,Hardin County, TX,Jan-18,24989,23453,1536,6.1
CN4819900000000,48,199,Hardin County, TX,Feb-18,25223,23766,1457,5.8
CN4819900000000,48,199,Hardin County, TX,Mar-18,25230,23778,1452,5.8
CN4819900000000,48,199,Hardin County, TX,Apr-18(p),25027,23711,1316,5.3
CN4604100000000,46,041,Dewey County, SD,Mar-17,2176,2016,160,7.4
CN4604100000000,46,041,Dewey County, SD,Apr-17,2160,2005,155,7.2
CN4604100000000,46,041,Dewey County, SD,May-17,2195,2037,158,7.2
CN4604100000000,46,041,Dewey County, SD,Jun-17,2410,2074,336,13.9
CN4604100000000,46,041,Dewey County, SD,Jul-17,2374,1977,397,16.7
CN4604100000000,46,041,Dewey County, SD,Aug-17,2293,1947,346,15.1
CN4604100000000,46,041,Dewey County, SD,Sep-17,2273,2040,233,10.3
CN4604100000000,46,041,Dewey County, SD,Oct-17,2204,1996,208,9.4
CN4604100000000,46,041,Dewey County, SD,Nov-17,2221,2011,210,9.5
CN4604100000000,46,041,Dewey County, SD,Dec-17,2213,2018,195,8.8
CN4604100000000,46,041,Dewey County, SD,Jan-18,2194,1999,195,8.9
CN4604100000000,46,041,Dewey County, SD,Feb-18,2195,2006,189,8.6
CN4604100000000,46,041,Dewey County, SD,Mar-18,2210,2036,174,7.9
CN4604100000000,46,041,Dewey County, SD,Apr-18(p),2131,1979,152,7.1
CN5107900000000,51,079,Greene County, VA,Mar-17,10200,9870,330,3.2
CN5107900000000,51,079,Greene County, VA,Apr-17,10250,9956,294,2.9
CN5107900000000,51,079,Greene County, VA,May-17,10206,9894,312,3.1
CN5107900000000,51,079,Greene County, VA,Jun-17,10231,9897,334,3.3
CN5107900000000,51,079,Greene County, VA,Jul-17,10121,9784,337,3.3
CN5107900000000,51,079,Greene County, VA,Aug-17,9976,9654,322,3.2
CN5107900000000,51,079,Greene County, VA,Sep-17,10347,10058,289,2.8
CN5107900000000,51,079,Greene County, VA,Oct-17,10208,9934,274,2.7
CN5107900000000,51,079,Greene County, VA,Nov-17,10266,9995,271,2.6
CN5107900000000,51,079,Greene County, VA,Dec-17,10208,9954,254,2.5
CN5107900000000,51,079,Greene County, VA,Jan-18,10117,9807,310,3.1
CN5107900000000,51,079,Greene County, VA,Feb-18,10433,10146,287,2.8
CN5107900000000,51,079,Greene County, VA,Mar-18,10501,10217,284,2.7
CN5107900000000,51,079,Greene County, VA,Apr-18(p),10595,10358,237,2.2
CN4705300000000,47,053,Gibson County, TN,Mar-17,21301,20225,1076,5.1
CN4705300000000,47,053,Gibson County, TN,Apr-17,21193,20273,920,4.3
CN4705300000000,47,053,Gibson County, TN,May-17,21114,20250,864,4.1
CN4705300000000,47,053,Gibson County, TN,Jun-17,21356,20329,1027,4.8
CN4705300000000,47,053,Gibson County, TN,Jul-17,21557,20558,999,4.6
CN4705300000000,47,053,Gibson County, TN,Aug-17,21588,20636,952,4.4
CN4705300000000,47,053,Gibson County, TN,Sep-17,21604,20733,871,4.0
CN4705300000000,47,053,Gibson County, TN,Oct-17,21438,20606,832,3.9
CN4705300000000,47,053,Gibson County, TN,Nov-17,21386,20571,815,3.8
CN4705300000000,47,053,Gibson County, TN,Dec-17,21409,20593,816,3.8
CN4705300000000,47,053,Gibson County, TN,Jan-18,21380,20386,994,4.6
CN4705300000000,47,053,Gibson County, TN,Feb-18,21562,20607,955,4.4
CN4705300000000,47,053,Gibson County, TN,Mar-18,21524,20597,927,4.3
CN4705300000000,47,053,Gibson County, TN,Apr-18(p),21697,20888,809,3.7
CN3611700000000,36,117,Wayne County, NY,Mar-17,44172,41769,2403,5.4
CN3611700000000,36,117,Wayne County, NY,Apr-17,44291,42180,2111,4.8
CN3611700000000,36,117,Wayne County, NY,May-17,43761,41688,2073,4.7
CN3611700000000,36,117,Wayne County, NY,Jun-17,44326,42226,2100,4.7
CN3611700000000,36,117,Wayne County, NY,Jul-17,44060,41982,2078,4.7
CN3611700000000,36,117,Wayne County, NY,Aug-17,43733,41671,2062,4.7
CN3611700000000,36,117,Wayne County, NY,Sep-17,43870,41861,2009,4.6
CN3611700000000,36,117,Wayne County, NY,Oct-17,43781,41854,1927,4.4
CN3611700000000,36,117,Wayne County, NY,Nov-17,43979,41887,2092,4.8
CN3611700000000,36,117,Wayne County, NY,Dec-17,43824,41554,2270,5.2
CN3611700000000,36,117,Wayne County, NY,Jan-18,44314,41686,2628,5.9
CN3611700000000,36,117,Wayne County, NY,Feb-18,44203,41457,2746,6.2
CN3611700000000,36,117,Wayne County, NY,Mar-18,43574,41075,2499,5.7
CN3611700000000,36,117,Wayne County, NY,Apr-18(p),43717,41580,2137,4.9
CN5118500000000,51,185,Tazewell County, VA,Mar-17,16069,15065,1004,6.2
CN5118500000000,51,185,Tazewell County, VA,Apr-17,16013,15131,882,5.5
CN5118500000000,51,185,Tazewell County, VA,May-17,15862,14954,908,5.7
CN5118500000000,51,185,Tazewell County, VA,Jun-17,15922,14967,955,6.0
CN5118500000000,51,185,Tazewell County, VA,Jul-17,15775,14789,986,6.3
CN5118500000000,51,185,Tazewell County, VA,Aug-17,15607,14656,951,6.1
CN5118500000000,51,185,Tazewell County, VA,Sep-17,15901,15041,860,5.4
CN5118500000000,51,185,Tazewell County, VA,Oct-17,15815,14996,819,5.2
CN5118500000000,51,185,Tazewell County, VA,Nov-17,15755,14954,801,5.1
CN5118500000000,51,185,Tazewell County, VA,Dec-17,15713,14879,834,5.3
CN5118500000000,51,185,Tazewell County, VA,Jan-18,15649,14741,908,5.8
CN5118500000000,51,185,Tazewell County, VA,Feb-18,15688,14868,820,5.2
CN5118500000000,51,185,Tazewell County, VA,Mar-18,15811,14967,844,5.3
CN5118500000000,51,185,Tazewell County, VA,Apr-18(p),15762,15073,689,4.4
CN2011900000000,20,119,Meade County, KS,Mar-17,2276,2218,58,2.5
CN2011900000000,20,119,Meade County, KS,Apr-17,2197,2140,57,2.6
CN2011900000000,20,119,Meade County, KS,May-17,2262,2205,57,2.5
CN2011900000000,20,119,Meade County, KS,Jun-17,2365,2305,60,2.5
CN2011900000000,20,119,Meade County, KS,Jul-17,2250,2189,61,2.7
CN2011900000000,20,119,Meade County, KS,Aug-17,2250,2191,59,2.6
CN2011900000000,20,119,Meade County, KS,Sep-17,2303,2256,47,2.0
CN2011900000000,20,119,Meade County, KS,Oct-17,2271,2228,43,1.9
CN2011900000000,20,119,Meade County, KS,Nov-17,2227,2175,52,2.3
CN2011900000000,20,119,Meade County, KS,Dec-17,2238,2191,47,2.1
CN2011900000000,20,119,Meade County, KS,Jan-18,2218,2173,45,2.0
CN2011900000000,20,119,Meade County, KS,Feb-18,2216,2171,45,2.0
CN2011900000000,20,119,Meade County, KS,Mar-18,2197,2150,47,2.1
CN2011900000000,20,119,Meade County, KS,Apr-18(p),2044,1996,48,2.3
CN1305100000000,13,051,Chatham County, GA,Mar-17,138849,132445,6404,4.6
CN1305100000000,13,051,Chatham County, GA,Apr-17,139162,133197,5965,4.3
CN1305100000000,13,051,Chatham County, GA,May-17,139682,133627,6055,4.3
CN1305100000000,13,051,Chatham County, GA,Jun-17,139975,133356,6619,4.7
CN1305100000000,13,051,Chatham County, GA,Jul-17,141300,134684,6616,4.7
CN1305100000000,13,051,Chatham County, GA,Aug-17,139637,133133,6504,4.7
CN1305100000000,13,051,Chatham County, GA,Sep-17,138781,132834,5947,4.3
CN1305100000000,13,051,Chatham County, GA,Oct-17,139366,133510,5856,4.2
CN1305100000000,13,051,Chatham County, GA,Nov-17,138709,133099,5610,4.0
CN1305100000000,13,051,Chatham County, GA,Dec-17,138647,133005,5642,4.1
CN1305100000000,13,051,Chatham County, GA,Jan-18,139072,133070,6002,4.3
CN1305100000000,13,051,Chatham County, GA,Feb-18,141238,135289,5949,4.2
CN1305100000000,13,051,Chatham County, GA,Mar-18,141795,136285,5510,3.9
CN1305100000000,13,051,Chatham County, GA,Apr-18(p),140992,136111,4881,3.5
CN1717900000000,17,179,Tazewell County, IL,Mar-17,63804,59990,3814,6.0
CN1717900000000,17,179,Tazewell County, IL,Apr-17,64568,61430,3138,4.9
CN1717900000000,17,179,Tazewell County, IL,May-17,64102,61180,2922,4.6
CN1717900000000,17,179,Tazewell County, IL,Jun-17,64832,61567,3265,5.0
CN1717900000000,17,179,Tazewell County, IL,Jul-17,64666,61210,3456,5.3
CN1717900000000,17,179,Tazewell County, IL,Aug-17,64302,60967,3335,5.2
CN1717900000000,17,179,Tazewell County, IL,Sep-17,63733,60812,2921,4.6
CN1717900000000,17,179,Tazewell County, IL,Oct-17,63625,60871,2754,4.3
CN1717900000000,17,179,Tazewell County, IL,Nov-17,63561,60715,2846,4.5
CN1717900000000,17,179,Tazewell County, IL,Dec-17,63329,60355,2974,4.7
CN1717900000000,17,179,Tazewell County, IL,Jan-18,62704,59395,3309,5.3
CN1717900000000,17,179,Tazewell County, IL,Feb-18,63272,60224,3048,4.8
CN1717900000000,17,179,Tazewell County, IL,Mar-18,64642,61533,3109,4.8
CN1717900000000,17,179,Tazewell County, IL,Apr-18(p),64602,62143,2459,3.8
CN4900300000000,49,003,Box Elder County, UT,Mar-17,25523,24612,911,3.6
CN4900300000000,49,003,Box Elder County, UT,Apr-17,25500,24692,808,3.2
CN4900300000000,49,003,Box Elder County, UT,May-17,25417,24628,789,3.1
CN4900300000000,49,003,Box Elder County, UT,Jun-17,25669,24752,917,3.6
CN4900300000000,49,003,Box Elder County, UT,Jul-17,25797,24933,864,3.3
CN4900300000000,49,003,Box Elder County, UT,Aug-17,25768,24904,864,3.4
CN4900300000000,49,003,Box Elder County, UT,Sep-17,25628,24878,750,2.9
CN4900300000000,49,003,Box Elder County, UT,Oct-17,25802,25054,748,2.9
CN4900300000000,49,003,Box Elder County, UT,Nov-17,25534,24816,718,2.8
CN4900300000000,49,003,Box Elder County, UT,Dec-17,25514,24793,721,2.8
CN4900300000000,49,003,Box Elder County, UT,Jan-18,25512,24694,818,3.2
CN4900300000000,49,003,Box Elder County, UT,Feb-18,25618,24767,851,3.3
CN4900300000000,49,003,Box Elder County, UT,Mar-18,25872,25023,849,3.3
CN4900300000000,49,003,Box Elder County, UT,Apr-18(p),25717,24931,786,3.1
CN0809100000000,08,091,Ouray County, CO,Mar-17,2075,2004,71,3.4
CN0809100000000,08,091,Ouray County, CO,Apr-17,2131,2065,66,3.1
CN0809100000000,08,091,Ouray County, CO,May-17,2274,2207,67,2.9
CN0809100000000,08,091,Ouray County, CO,Jun-17,2482,2414,68,2.7
CN0809100000000,08,091,Ouray County, CO,Jul-17,2583,2524,59,2.3
CN0809100000000,08,091,Ouray County, CO,Aug-17,2537,2479,58,2.3
CN0809100000000,08,091,Ouray County, CO,Sep-17,2417,2359,58,2.4
CN0809100000000,08,091,Ouray County, CO,Oct-17,2384,2323,61,2.6
CN0809100000000,08,091,Ouray County, CO,Nov-17,2231,2163,68,3.0
CN0809100000000,08,091,Ouray County, CO,Dec-17,2207,2133,74,3.4
CN0809100000000,08,091,Ouray County, CO,Jan-18,2230,2147,83,3.7
CN0809100000000,08,091,Ouray County, CO,Feb-18,2234,2150,84,3.8
CN0809100000000,08,091,Ouray County, CO,Mar-18,2208,2131,77,3.5
CN0809100000000,08,091,Ouray County, CO,Apr-18(p),2284,2211,73,3.2
CN3100500000000,31,005,Arthur County, NE,Mar-17,219,205,14,6.4
CN3100500000000,31,005,Arthur County, NE,Apr-17,230,217,13,5.7
CN3100500000000,31,005,Arthur County, NE,May-17,232,221,11,4.7
CN3100500000000,31,005,Arthur County, NE,Jun-17,243,233,10,4.1
CN3100500000000,31,005,Arthur County, NE,Jul-17,236,226,10,4.2
CN3100500000000,31,005,Arthur County, NE,Aug-17,225,215,10,4.4
CN3100500000000,31,005,Arthur County, NE,Sep-17,216,202,14,6.5
CN3100500000000,31,005,Arthur County, NE,Oct-17,218,205,13,6.0
CN3100500000000,31,005,Arthur County, NE,Nov-17,218,207,11,5.0
CN3100500000000,31,005,Arthur County, NE,Dec-17,219,207,12,5.5
CN3100500000000,31,005,Arthur County, NE,Jan-18,225,213,12,5.3
CN3100500000000,31,005,Arthur County, NE,Feb-18,212,200,12,5.7
CN3100500000000,31,005,Arthur County, NE,Mar-18,221,210,11,5.0
CN3100500000000,31,005,Arthur County, NE,Apr-18(p),222,211,11,5.0
CN4823900000000,48,239,Jackson County, TX,Mar-17,7442,7124,318,4.3
CN4823900000000,48,239,Jackson County, TX,Apr-17,7353,7087,266,3.6
CN4823900000000,48,239,Jackson County, TX,May-17,7353,7072,281,3.8
CN4823900000000,48,239,Jackson County, TX,Jun-17,7420,7094,326,4.4
CN4823900000000,48,239,Jackson County, TX,Jul-17,7433,7112,321,4.3
CN4823900000000,48,239,Jackson County, TX,Aug-17,7431,7123,308,4.1
CN4823900000000,48,239,Jackson County, TX,Sep-17,7385,7095,290,3.9
CN4823900000000,48,239,Jackson County, TX,Oct-17,7319,7067,252,3.4
CN4823900000000,48,239,Jackson County, TX,Nov-17,7328,7070,258,3.5
CN4823900000000,48,239,Jackson County, TX,Dec-17,7347,7103,244,3.3
CN4823900000000,48,239,Jackson County, TX,Jan-18,7266,6994,272,3.7
CN4823900000000,48,239,Jackson County, TX,Feb-18,7344,7082,262,3.6
CN4823900000000,48,239,Jackson County, TX,Mar-18,7451,7178,273,3.7
CN4823900000000,48,239,Jackson County, TX,Apr-18(p),7346,7107,239,3.3
CN2615700000000,26,157,Tuscola County, MI,Mar-17,24236,22595,1641,6.8
CN2615700000000,26,157,Tuscola County, MI,Apr-17,23941,22556,1385,5.8
CN2615700000000,26,157,Tuscola County, MI,May-17,23991,22616,1375,5.7
CN2615700000000,26,157,Tuscola County, MI,Jun-17,24319,22803,1516,6.2
CN2615700000000,26,157,Tuscola County, MI,Jul-17,24178,22367,1811,7.5
CN2615700000000,26,157,Tuscola County, MI,Aug-17,23975,22359,1616,6.7
CN2615700000000,26,157,Tuscola County, MI,Sep-17,23833,22563,1270,5.3
CN2615700000000,26,157,Tuscola County, MI,Oct-17,23802,22616,1186,5.0
CN2615700000000,26,157,Tuscola County, MI,Nov-17,23800,22546,1254,5.3
CN2615700000000,26,157,Tuscola County, MI,Dec-17,23853,22376,1477,6.2
CN2615700000000,26,157,Tuscola County, MI,Jan-18,24052,22118,1934,8.0
CN2615700000000,26,157,Tuscola County, MI,Feb-18,24231,22311,1920,7.9
CN2615700000000,26,157,Tuscola County, MI,Mar-18,24201,22484,1717,7.1
CN2615700000000,26,157,Tuscola County, MI,Apr-18(p),23973,22502,1471,6.1
CN2713700000000,27,137,St. Louis County, MN,Mar-17,102931,97158,5773,5.6
CN2713700000000,27,137,St. Louis County, MN,Apr-17,103056,98004,5052,4.9
CN2713700000000,27,137,St. Louis County, MN,May-17,102530,98097,4433,4.3
CN2713700000000,27,137,St. Louis County, MN,Jun-17,102541,97770,4771,4.7
CN2713700000000,27,137,St. Louis County, MN,Jul-17,102941,98380,4561,4.4
CN2713700000000,27,137,St. Louis County, MN,Aug-17,102400,97775,4625,4.5
CN2713700000000,27,137,St. Louis County, MN,Sep-17,103139,99470,3669,3.6
CN2713700000000,27,137,St. Louis County, MN,Oct-17,101962,98883,3079,3.0
CN2713700000000,27,137,St. Louis County, MN,Nov-17,102951,98913,4038,3.9
CN2713700000000,27,137,St. Louis County, MN,Dec-17,102546,98031,4515,4.4
CN2713700000000,27,137,St. Louis County, MN,Jan-18,103914,98702,5212,5.0
CN2713700000000,27,137,St. Louis County, MN,Feb-18,105258,100093,5165,4.9
CN2713700000000,27,137,St. Louis County, MN,Mar-18,104529,99638,4891,4.7
CN2713700000000,27,137,St. Louis County, MN,Apr-18(p),103879,99765,4114,4.0
CN2707500000000,27,075,Lake County, MN,Mar-17,5387,5123,264,4.9
CN2707500000000,27,075,Lake County, MN,Apr-17,5357,5123,234,4.4
CN2707500000000,27,075,Lake County, MN,May-17,5545,5352,193,3.5
CN2707500000000,27,075,Lake County, MN,Jun-17,5820,5626,194,3.3
CN2707500000000,27,075,Lake County, MN,Jul-17,5828,5646,182,3.1
CN2707500000000,27,075,Lake County, MN,Aug-17,5802,5622,180,3.1
CN2707500000000,27,075,Lake County, MN,Sep-17,5636,5479,157,2.8
CN2707500000000,27,075,Lake County, MN,Oct-17,5611,5453,158,2.8
CN2707500000000,27,075,Lake County, MN,Nov-17,5655,5453,202,3.6
CN2707500000000,27,075,Lake County, MN,Dec-17,5671,5432,239,4.2
CN2707500000000,27,075,Lake County, MN,Jan-18,5643,5375,268,4.7
CN2707500000000,27,075,Lake County, MN,Feb-18,5707,5450,257,4.5
CN2707500000000,27,075,Lake County, MN,Mar-18,5662,5427,235,4.2
CN2707500000000,27,075,Lake County, MN,Apr-18(p),5675,5495,180,3.2
CN1802300000000,18,023,Clinton County, IN,Mar-17,16885,16346,539,3.2
CN1802300000000,18,023,Clinton County, IN,Apr-17,16840,16410,430,2.6
CN1802300000000,18,023,Clinton County, IN,May-17,17052,16583,469,2.8
CN1802300000000,18,023,Clinton County, IN,Jun-17,17262,16702,560,3.2
CN1802300000000,18,023,Clinton County, IN,Jul-17,16984,16408,576,3.4
CN1802300000000,18,023,Clinton County, IN,Aug-17,17029,16427,602,3.5
CN1802300000000,18,023,Clinton County, IN,Sep-17,16865,16397,468,2.8
CN1802300000000,18,023,Clinton County, IN,Oct-17,16902,16457,445,2.6
CN1802300000000,18,023,Clinton County, IN,Nov-17,16933,16470,463,2.7
CN1802300000000,18,023,Clinton County, IN,Dec-17,16640,16220,420,2.5
CN1802300000000,18,023,Clinton County, IN,Jan-18,16397,15888,509,3.1
CN1802300000000,18,023,Clinton County, IN,Feb-18,16696,16132,564,3.4
CN1802300000000,18,023,Clinton County, IN,Mar-18,16736,16265,471,2.8
CN1802300000000,18,023,Clinton County, IN,Apr-18(p),16796,16372,424,2.5
CN1707100000000,17,071,Henderson County, IL,Mar-17,3620,3422,198,5.5
CN1707100000000,17,071,Henderson County, IL,Apr-17,3661,3506,155,4.2
CN1707100000000,17,071,Henderson County, IL,May-17,3689,3539,150,4.1
CN1707100000000,17,071,Henderson County, IL,Jun-17,3785,3617,168,4.4
CN1707100000000,17,071,Henderson County, IL,Jul-17,3724,3539,185,5.0
CN1707100000000,17,071,Henderson County, IL,Aug-17,3690,3507,183,5.0
CN1707100000000,17,071,Henderson County, IL,Sep-17,3635,3476,159,4.4
CN1707100000000,17,071,Henderson County, IL,Oct-17,3622,3480,142,3.9
CN1707100000000,17,071,Henderson County, IL,Nov-17,3585,3441,144,4.0
CN1707100000000,17,071,Henderson County, IL,Dec-17,3562,3408,154,4.3
CN1707100000000,17,071,Henderson County, IL,Jan-18,3541,3337,204,5.8
CN1707100000000,17,071,Henderson County, IL,Feb-18,3491,3310,181,5.2
CN1707100000000,17,071,Henderson County, IL,Mar-18,3603,3423,180,5.0
CN1707100000000,17,071,Henderson County, IL,Apr-18(p),3638,3509,129,3.5
CN1318100000000,13,181,Lincoln County, GA,Mar-17,3552,3377,175,4.9
CN1318100000000,13,181,Lincoln County, GA,Apr-17,3565,3400,165,4.6
CN1318100000000,13,181,Lincoln County, GA,May-17,3549,3372,177,5.0
CN1318100000000,13,181,Lincoln County, GA,Jun-17,3568,3378,190,5.3
CN1318100000000,13,181,Lincoln County, GA,Jul-17,3558,3358,200,5.6
CN1318100000000,13,181,Lincoln County, GA,Aug-17,3557,3357,200,5.6
CN1318100000000,13,181,Lincoln County, GA,Sep-17,3557,3387,170,4.8
CN1318100000000,13,181,Lincoln County, GA,Oct-17,3607,3421,186,5.2
CN1318100000000,13,181,Lincoln County, GA,Nov-17,3629,3443,186,5.1
CN1318100000000,13,181,Lincoln County, GA,Dec-17,3684,3475,209,5.7
CN1318100000000,13,181,Lincoln County, GA,Jan-18,3751,3515,236,6.3
CN1318100000000,13,181,Lincoln County, GA,Feb-18,3700,3487,213,5.8
CN1318100000000,13,181,Lincoln County, GA,Mar-18,3700,3504,196,5.3
CN1318100000000,13,181,Lincoln County, GA,Apr-18(p),3703,3527,176,4.8
CN1805100000000,18,051,Gibson County, IN,Mar-17,19050,18483,567,3.0
CN1805100000000,18,051,Gibson County, IN,Apr-17,18922,18446,476,2.5
CN1805100000000,18,051,Gibson County, IN,May-17,19062,18547,515,2.7
CN1805100000000,18,051,Gibson County, IN,Jun-17,19229,18647,582,3.0
CN1805100000000,18,051,Gibson County, IN,Jul-17,19263,18679,584,3.0
CN1805100000000,18,051,Gibson County, IN,Aug-17,19119,18463,656,3.4
CN1805100000000,18,051,Gibson County, IN,Sep-17,19003,18476,527,2.8
CN1805100000000,18,051,Gibson County, IN,Oct-17,18946,18450,496,2.6
CN1805100000000,18,051,Gibson County, IN,Nov-17,18901,18412,489,2.6
CN1805100000000,18,051,Gibson County, IN,Dec-17,18811,18342,469,2.5
CN1805100000000,18,051,Gibson County, IN,Jan-18,18833,18296,537,2.9
CN1805100000000,18,051,Gibson County, IN,Feb-18,19133,18572,561,2.9
CN1805100000000,18,051,Gibson County, IN,Mar-18,19291,18806,485,2.5
CN1805100000000,18,051,Gibson County, IN,Apr-18(p),19363,18939,424,2.2
CN2000300000000,20,003,Anderson County, KS,Mar-17,4256,4078,178,4.2
CN2000300000000,20,003,Anderson County, KS,Apr-17,4151,3989,162,3.9
CN2000300000000,20,003,Anderson County, KS,May-17,4053,3887,166,4.1
CN2000300000000,20,003,Anderson County, KS,Jun-17,4158,3975,183,4.4
CN2000300000000,20,003,Anderson County, KS,Jul-17,4328,4139,189,4.4
CN2000300000000,20,003,Anderson County, KS,Aug-17,4202,4033,169,4.0
CN2000300000000,20,003,Anderson County, KS,Sep-17,4068,3927,141,3.5
CN2000300000000,20,003,Anderson County, KS,Oct-17,4075,3952,123,3.0
CN2000300000000,20,003,Anderson County, KS,Nov-17,4037,3901,136,3.4
CN2000300000000,20,003,Anderson County, KS,Dec-17,4028,3897,131,3.3
CN2000300000000,20,003,Anderson County, KS,Jan-18,3979,3814,165,4.1
CN2000300000000,20,003,Anderson County, KS,Feb-18,3971,3828,143,3.6
CN2000300000000,20,003,Anderson County, KS,Mar-18,4051,3897,154,3.8
CN2000300000000,20,003,Anderson County, KS,Apr-18(p),3997,3867,130,3.3
CN0104700000000,01,047,Dallas County, AL,Mar-17,15190,13964,1226,8.1
CN0104700000000,01,047,Dallas County, AL,Apr-17,15100,14101,999,6.6
CN0104700000000,01,047,Dallas County, AL,May-17,14947,13988,959,6.4
CN0104700000000,01,047,Dallas County, AL,Jun-17,15048,13711,1337,8.9
CN0104700000000,01,047,Dallas County, AL,Jul-17,14973,13539,1434,9.6
CN0104700000000,01,047,Dallas County, AL,Aug-17,14784,13609,1175,7.9
CN0104700000000,01,047,Dallas County, AL,Sep-17,14887,13853,1034,6.9
CN0104700000000,01,047,Dallas County, AL,Oct-17,14726,13842,884,6.0
CN0104700000000,01,047,Dallas County, AL,Nov-17,14585,13763,822,5.6
CN0104700000000,01,047,Dallas County, AL,Dec-17,14436,13615,821,5.7
CN0104700000000,01,047,Dallas County, AL,Jan-18,14432,13469,963,6.7
CN0104700000000,01,047,Dallas County, AL,Feb-18,14692,13717,975,6.6
CN0104700000000,01,047,Dallas County, AL,Mar-18,14680,13820,860,5.9
CN0104700000000,01,047,Dallas County, AL,Apr-18(p),14789,13975,814,5.5
CN1901300000000,19,013,Black Hawk County, IA,Mar-17,68995,65999,2996,4.3
CN1901300000000,19,013,Black Hawk County, IA,Apr-17,68814,66224,2590,3.8
CN1901300000000,19,013,Black Hawk County, IA,May-17,68064,65670,2394,3.5
CN1901300000000,19,013,Black Hawk County, IA,Jun-17,67907,65269,2638,3.9
CN1901300000000,19,013,Black Hawk County, IA,Jul-17,67839,65404,2435,3.6
CN1901300000000,19,013,Black Hawk County, IA,Aug-17,67138,64562,2576,3.8
CN1901300000000,19,013,Black Hawk County, IA,Sep-17,68310,66099,2211,3.2
CN1901300000000,19,013,Black Hawk County, IA,Oct-17,67939,66052,1887,2.8
CN1901300000000,19,013,Black Hawk County, IA,Nov-17,67927,65929,1998,2.9
CN1901300000000,19,013,Black Hawk County, IA,Dec-17,67459,65153,2306,3.4
CN1901300000000,19,013,Black Hawk County, IA,Jan-18,67188,64502,2686,4.0
CN1901300000000,19,013,Black Hawk County, IA,Feb-18,68158,65647,2511,3.7
CN1901300000000,19,013,Black Hawk County, IA,Mar-18,68205,65928,2277,3.3
CN1901300000000,19,013,Black Hawk County, IA,Apr-18(p),68371,66454,1917,2.8
CN4501700000000,45,017,Calhoun County, SC,Mar-17,6817,6490,327,4.8
CN4501700000000,45,017,Calhoun County, SC,Apr-17,6830,6526,304,4.5
CN4501700000000,45,017,Calhoun County, SC,May-17,6847,6539,308,4.5
CN4501700000000,45,017,Calhoun County, SC,Jun-17,6937,6579,358,5.2
CN4501700000000,45,017,Calhoun County, SC,Jul-17,6953,6599,354,5.1
CN4501700000000,45,017,Calhoun County, SC,Aug-17,6910,6469,441,6.4
CN4501700000000,45,017,Calhoun County, SC,Sep-17,6825,6470,355,5.2
CN4501700000000,45,017,Calhoun County, SC,Oct-17,6829,6455,374,5.5
CN4501700000000,45,017,Calhoun County, SC,Nov-17,6745,6419,326,4.8
CN4501700000000,45,017,Calhoun County, SC,Dec-17,6766,6437,329,4.9
CN4501700000000,45,017,Calhoun County, SC,Jan-18,6799,6413,386,5.7
CN4501700000000,45,017,Calhoun County, SC,Feb-18,6813,6476,337,4.9
CN4501700000000,45,017,Calhoun County, SC,Mar-18,6767,6462,305,4.5
CN4501700000000,45,017,Calhoun County, SC,Apr-18(p),6685,6475,210,3.1
CN2714700000000,27,147,Steele County, MN,Mar-17,20467,19660,807,3.9
CN2714700000000,27,147,Steele County, MN,Apr-17,20571,19895,676,3.3
CN2714700000000,27,147,Steele County, MN,May-17,20619,20003,616,3.0
CN2714700000000,27,147,Steele County, MN,Jun-17,20917,20176,741,3.5
CN2714700000000,27,147,Steele County, MN,Jul-17,20663,19944,719,3.5
CN2714700000000,27,147,Steele County, MN,Aug-17,20643,19911,732,3.5
CN2714700000000,27,147,Steele County, MN,Sep-17,20486,19934,552,2.7
CN2714700000000,27,147,Steele County, MN,Oct-17,20450,19986,464,2.3
CN2714700000000,27,147,Steele County, MN,Nov-17,20453,19954,499,2.4
CN2714700000000,27,147,Steele County, MN,Dec-17,20549,19869,680,3.3
CN2714700000000,27,147,Steele County, MN,Jan-18,19968,19093,875,4.4
CN2714700000000,27,147,Steele County, MN,Feb-18,19920,19077,843,4.2
CN2714700000000,27,147,Steele County, MN,Mar-18,19975,19146,829,4.2
CN2714700000000,27,147,Steele County, MN,Apr-18(p),20028,19347,681,3.4
CN4601300000000,46,013,Brown County, SD,Mar-17,20915,20221,694,3.3
CN4601300000000,46,013,Brown County, SD,Apr-17,20974,20338,636,3.0
CN4601300000000,46,013,Brown County, SD,May-17,21022,20418,604,2.9
CN4601300000000,46,013,Brown County, SD,Jun-17,21171,20554,617,2.9
CN4601300000000,46,013,Brown County, SD,Jul-17,21034,20436,598,2.8
CN4601300000000,46,013,Brown County, SD,Aug-17,20787,20148,639,3.1
CN4601300000000,46,013,Brown County, SD,Sep-17,20841,20282,559,2.7
CN4601300000000,46,013,Brown County, SD,Oct-17,21002,20457,545,2.6
CN4601300000000,46,013,Brown County, SD,Nov-17,21051,20448,603,2.9
CN4601300000000,46,013,Brown County, SD,Dec-17,20985,20292,693,3.3
CN4601300000000,46,013,Brown County, SD,Jan-18,20891,20150,741,3.5
CN4601300000000,46,013,Brown County, SD,Feb-18,20970,20214,756,3.6
CN4601300000000,46,013,Brown County, SD,Mar-18,20982,20320,662,3.2
CN4601300000000,46,013,Brown County, SD,Apr-18(p),21116,20425,691,3.3
CN5164000000000,51,640,Galax city, VA,Mar-17,2909,2771,138,4.7
CN5164000000000,51,640,Galax city, VA,Apr-17,2872,2755,117,4.1
CN5164000000000,51,640,Galax city, VA,May-17,2910,2780,130,4.5
CN5164000000000,51,640,Galax city, VA,Jun-17,2939,2800,139,4.7
CN5164000000000,51,640,Galax city, VA,Jul-17,2886,2744,142,4.9
CN5164000000000,51,640,Galax city, VA,Aug-17,2856,2714,142,5.0
CN5164000000000,51,640,Galax city, VA,Sep-17,2869,2749,120,4.2
CN5164000000000,51,640,Galax city, VA,Oct-17,2835,2726,109,3.8
CN5164000000000,51,640,Galax city, VA,Nov-17,2849,2740,109,3.8
CN5164000000000,51,640,Galax city, VA,Dec-17,2837,2735,102,3.6
CN5164000000000,51,640,Galax city, VA,Jan-18,2875,2761,114,4.0
CN5164000000000,51,640,Galax city, VA,Feb-18,2874,2767,107,3.7
CN5164000000000,51,640,Galax city, VA,Mar-18,2916,2799,117,4.0
CN5164000000000,51,640,Galax city, VA,Apr-18(p),2900,2802,98,3.4
CN0110900000000,01,109,Pike County, AL,Mar-17,15318,14513,805,5.3
CN0110900000000,01,109,Pike County, AL,Apr-17,15225,14555,670,4.4
CN0110900000000,01,109,Pike County, AL,May-17,15028,14392,636,4.2
CN0110900000000,01,109,Pike County, AL,Jun-17,15183,14328,855,5.6
CN0110900000000,01,109,Pike County, AL,Jul-17,15193,14384,809,5.3
CN0110900000000,01,109,Pike County, AL,Aug-17,15108,14376,732,4.8
CN0110900000000,01,109,Pike County, AL,Sep-17,15263,14629,634,4.2
CN0110900000000,01,109,Pike County, AL,Oct-17,15414,14788,626,4.1
CN0110900000000,01,109,Pike County, AL,Nov-17,15334,14709,625,4.1
CN0110900000000,01,109,Pike County, AL,Dec-17,15100,14493,607,4.0
CN0110900000000,01,109,Pike County, AL,Jan-18,15107,14389,718,4.8
CN0110900000000,01,109,Pike County, AL,Feb-18,15438,14734,704,4.6
CN0110900000000,01,109,Pike County, AL,Mar-18,15522,14823,699,4.5
CN0110900000000,01,109,Pike County, AL,Apr-18(p),15646,15032,614,3.9
CN1713300000000,17,133,Monroe County, IL,Mar-17,18322,17721,601,3.3
CN1713300000000,17,133,Monroe County, IL,Apr-17,18411,17878,533,2.9
CN1713300000000,17,133,Monroe County, IL,May-17,18271,17718,553,3.0
CN1713300000000,17,133,Monroe County, IL,Jun-17,18456,17834,622,3.4
CN1713300000000,17,133,Monroe County, IL,Jul-17,18457,17825,632,3.4
CN1713300000000,17,133,Monroe County, IL,Aug-17,18324,17674,650,3.5
CN1713300000000,17,133,Monroe County, IL,Sep-17,18343,17770,573,3.1
CN1713300000000,17,133,Monroe County, IL,Oct-17,18344,17801,543,3.0
CN1713300000000,17,133,Monroe County, IL,Nov-17,18393,17828,565,3.1
CN1713300000000,17,133,Monroe County, IL,Dec-17,18225,17700,525,2.9
CN1713300000000,17,133,Monroe County, IL,Jan-18,18202,17588,614,3.4
CN1713300000000,17,133,Monroe County, IL,Feb-18,18405,17839,566,3.1
CN1713300000000,17,133,Monroe County, IL,Mar-18,18678,18111,567,3.0
CN1713300000000,17,133,Monroe County, IL,Apr-18(p),18749,18281,468,2.5
CN5163000000000,51,630,Fredericksburg city, VA,Mar-17,13813,13180,633,4.6
CN5163000000000,51,630,Fredericksburg city, VA,Apr-17,13784,13220,564,4.1
CN5163000000000,51,630,Fredericksburg city, VA,May-17,13858,13269,589,4.3
CN5163000000000,51,630,Fredericksburg city, VA,Jun-17,13935,13307,628,4.5
CN5163000000000,51,630,Fredericksburg city, VA,Jul-17,14033,13407,626,4.5
CN5163000000000,51,630,Fredericksburg city, VA,Aug-17,13836,13216,620,4.5
CN5163000000000,51,630,Fredericksburg city, VA,Sep-17,13836,13265,571,4.1
CN5163000000000,51,630,Fredericksburg city, VA,Oct-17,13794,13274,520,3.8
CN5163000000000,51,630,Fredericksburg city, VA,Nov-17,13803,13263,540,3.9
CN5163000000000,51,630,Fredericksburg city, VA,Dec-17,13755,13214,541,3.9
CN5163000000000,51,630,Fredericksburg city, VA,Jan-18,13899,13309,590,4.2
CN5163000000000,51,630,Fredericksburg city, VA,Feb-18,13994,13446,548,3.9
CN5163000000000,51,630,Fredericksburg city, VA,Mar-18,14021,13484,537,3.8
CN5163000000000,51,630,Fredericksburg city, VA,Apr-18(p),13963,13500,463,3.3
CN2803700000000,28,037,Franklin County, MS,Mar-17,2884,2692,192,6.7
CN2803700000000,28,037,Franklin County, MS,Apr-17,2862,2692,170,5.9
CN2803700000000,28,037,Franklin County, MS,May-17,2858,2658,200,7.0
CN2803700000000,28,037,Franklin County, MS,Jun-17,2884,2650,234,8.1
CN2803700000000,28,037,Franklin County, MS,Jul-17,2830,2600,230,8.1
CN2803700000000,28,037,Franklin County, MS,Aug-17,2769,2570,199,7.2
CN2803700000000,28,037,Franklin County, MS,Sep-17,2844,2666,178,6.3
CN2803700000000,28,037,Franklin County, MS,Oct-17,2812,2655,157,5.6
CN2803700000000,28,037,Franklin County, MS,Nov-17,2773,2623,150,5.4
CN2803700000000,28,037,Franklin County, MS,Dec-17,2808,2631,177,6.3
CN2803700000000,28,037,Franklin County, MS,Jan-18,2762,2590,172,6.2
CN2803700000000,28,037,Franklin County, MS,Feb-18,2777,2622,155,5.6
CN2803700000000,28,037,Franklin County, MS,Mar-18,2803,2659,144,5.1
CN2803700000000,28,037,Franklin County, MS,Apr-18(p),2792,2653,139,5.0
CN3713300000000,37,133,Onslow County, NC,Mar-17,64659,61564,3095,4.8
CN3713300000000,37,133,Onslow County, NC,Apr-17,64475,61645,2830,4.4
CN3713300000000,37,133,Onslow County, NC,May-17,64554,61531,3023,4.7
CN3713300000000,37,133,Onslow County, NC,Jun-17,64458,61258,3200,5.0
CN3713300000000,37,133,Onslow County, NC,Jul-17,62777,59298,3479,5.5
CN3713300000000,37,133,Onslow County, NC,Aug-17,64344,60912,3432,5.3
CN3713300000000,37,133,Onslow County, NC,Sep-17,64655,61510,3145,4.9
CN3713300000000,37,133,Onslow County, NC,Oct-17,63973,60791,3182,5.0
CN3713300000000,37,133,Onslow County, NC,Nov-17,64183,60856,3327,5.2
CN3713300000000,37,133,Onslow County, NC,Dec-17,63730,60557,3173,5.0
CN3713300000000,37,133,Onslow County, NC,Jan-18,64023,60649,3374,5.3
CN3713300000000,37,133,Onslow County, NC,Feb-18,64831,61544,3287,5.1
CN3713300000000,37,133,Onslow County, NC,Mar-18,65013,61898,3115,4.8
CN3713300000000,37,133,Onslow County, NC,Apr-18(p),64773,62121,2652,4.1
CN2110900000000,21,109,Jackson County, KY,Mar-17,4246,3850,396,9.3
CN2110900000000,21,109,Jackson County, KY,Apr-17,4162,3837,325,7.8
CN2110900000000,21,109,Jackson County, KY,May-17,4192,3853,339,8.1
CN2110900000000,21,109,Jackson County, KY,Jun-17,4254,3867,387,9.1
CN2110900000000,21,109,Jackson County, KY,Jul-17,4102,3715,387,9.4
CN2110900000000,21,109,Jackson County, KY,Aug-17,4234,3876,358,8.5
CN2110900000000,21,109,Jackson County, KY,Sep-17,4250,3922,328,7.7
CN2110900000000,21,109,Jackson County, KY,Oct-17,4229,3921,308,7.3
CN2110900000000,21,109,Jackson County, KY,Nov-17,4199,3923,276,6.6
CN2110900000000,21,109,Jackson County, KY,Dec-17,4192,3913,279,6.7
CN2110900000000,21,109,Jackson County, KY,Jan-18,4055,3768,287,7.1
CN2110900000000,21,109,Jackson County, KY,Feb-18,4144,3809,335,8.1
CN2110900000000,21,109,Jackson County, KY,Mar-18,4141,3851,290,7.0
CN2110900000000,21,109,Jackson County, KY,Apr-18(p),4130,3864,266,6.4
CN0103700000000,01,037,Coosa County, AL,Mar-17,4399,4156,243,5.5
CN0103700000000,01,037,Coosa County, AL,Apr-17,4357,4171,186,4.3
CN0103700000000,01,037,Coosa County, AL,May-17,4351,4171,180,4.1
CN0103700000000,01,037,Coosa County, AL,Jun-17,4343,4135,208,4.8
CN0103700000000,01,037,Coosa County, AL,Jul-17,4364,4141,223,5.1
CN0103700000000,01,037,Coosa County, AL,Aug-17,4330,4145,185,4.3
CN0103700000000,01,037,Coosa County, AL,Sep-17,4367,4211,156,3.6
CN0103700000000,01,037,Coosa County, AL,Oct-17,4350,4186,164,3.8
CN0103700000000,01,037,Coosa County, AL,Nov-17,4302,4151,151,3.5
CN0103700000000,01,037,Coosa County, AL,Dec-17,4291,4137,154,3.6
CN0103700000000,01,037,Coosa County, AL,Jan-18,4242,4054,188,4.4
CN0103700000000,01,037,Coosa County, AL,Feb-18,4265,4075,190,4.5
CN0103700000000,01,037,Coosa County, AL,Mar-18,4277,4099,178,4.2
CN0103700000000,01,037,Coosa County, AL,Apr-18(p),4309,4146,163,3.8
CN3802300000000,38,023,Divide County, ND,Mar-17,1542,1506,36,2.3
CN3802300000000,38,023,Divide County, ND,Apr-17,1602,1570,32,2.0
CN3802300000000,38,023,Divide County, ND,May-17,1625,1601,24,1.5
CN3802300000000,38,023,Divide County, ND,Jun-17,1704,1676,28,1.6
CN3802300000000,38,023,Divide County, ND,Jul-17,1698,1674,24,1.4
CN3802300000000,38,023,Divide County, ND,Aug-17,1712,1687,25,1.5
CN3802300000000,38,023,Divide County, ND,Sep-17,1679,1657,22,1.3
CN3802300000000,38,023,Divide County, ND,Oct-17,1674,1659,15,0.9
CN3802300000000,38,023,Divide County, ND,Nov-17,1620,1601,19,1.2
CN3802300000000,38,023,Divide County, ND,Dec-17,1570,1549,21,1.3
CN3802300000000,38,023,Divide County, ND,Jan-18,1548,1525,23,1.5
CN3802300000000,38,023,Divide County, ND,Feb-18,1529,1508,21,1.4
CN3802300000000,38,023,Divide County, ND,Mar-18,1551,1530,21,1.4
CN3802300000000,38,023,Divide County, ND,Apr-18(p),1571,1550,21,1.3
CN4505100000000,45,051,Horry County, SC,Mar-17,140082,133325,6757,4.8
CN4505100000000,45,051,Horry County, SC,Apr-17,144152,138129,6023,4.2
CN4505100000000,45,051,Horry County, SC,May-17,146711,140520,6191,4.2
CN4505100000000,45,051,Horry County, SC,Jun-17,152268,145300,6968,4.6
CN4505100000000,45,051,Horry County, SC,Jul-17,151451,144750,6701,4.4
CN4505100000000,45,051,Horry County, SC,Aug-17,149009,141885,7124,4.8
CN4505100000000,45,051,Horry County, SC,Sep-17,144378,137810,6568,4.5
CN4505100000000,45,051,Horry County, SC,Oct-17,142129,135427,6702,4.7
CN4505100000000,45,051,Horry County, SC,Nov-17,139802,133175,6627,4.7
CN4505100000000,45,051,Horry County, SC,Dec-17,137356,129647,7709,5.6
CN4505100000000,45,051,Horry County, SC,Jan-18,138881,129134,9747,7.0
CN4505100000000,45,051,Horry County, SC,Feb-18,140401,131594,8807,6.3
CN4505100000000,45,051,Horry County, SC,Mar-18,142524,135285,7239,5.1
CN4505100000000,45,051,Horry County, SC,Apr-18(p),143862,139040,4822,3.4
CN2114900000000,21,149,McLean County, KY,Mar-17,4416,4169,247,5.6
CN2114900000000,21,149,McLean County, KY,Apr-17,4449,4233,216,4.9
CN2114900000000,21,149,McLean County, KY,May-17,4457,4228,229,5.1
CN2114900000000,21,149,McLean County, KY,Jun-17,4485,4228,257,5.7
CN2114900000000,21,149,McLean County, KY,Jul-17,4431,4186,245,5.5
CN2114900000000,21,149,McLean County, KY,Aug-17,4385,4138,247,5.6
CN2114900000000,21,149,McLean County, KY,Sep-17,4347,4141,206,4.7
CN2114900000000,21,149,McLean County, KY,Oct-17,4337,4139,198,4.6
CN2114900000000,21,149,McLean County, KY,Nov-17,4382,4184,198,4.5
CN2114900000000,21,149,McLean County, KY,Dec-17,4357,4163,194,4.5
CN2114900000000,21,149,McLean County, KY,Jan-18,4401,4176,225,5.1
CN2114900000000,21,149,McLean County, KY,Feb-18,4389,4140,249,5.7
CN2114900000000,21,149,McLean County, KY,Mar-18,4393,4167,226,5.1
CN2114900000000,21,149,McLean County, KY,Apr-18(p),4390,4198,192,4.4
CN5111700000000,51,117,Mecklenburg County, VA,Mar-17,12125,11463,662,5.5
CN5111700000000,51,117,Mecklenburg County, VA,Apr-17,12031,11446,585,4.9
CN5111700000000,51,117,Mecklenburg County, VA,May-17,12205,11612,593,4.9
CN5111700000000,51,117,Mecklenburg County, VA,Jun-17,12317,11683,634,5.1
CN5111700000000,51,117,Mecklenburg County, VA,Jul-17,12207,11571,636,5.2
CN5111700000000,51,117,Mecklenburg County, VA,Aug-17,12138,11504,634,5.2
CN5111700000000,51,117,Mecklenburg County, VA,Sep-17,12237,11639,598,4.9
CN5111700000000,51,117,Mecklenburg County, VA,Oct-17,12070,11502,568,4.7
CN5111700000000,51,117,Mecklenburg County, VA,Nov-17,12070,11472,598,5.0
CN5111700000000,51,117,Mecklenburg County, VA,Dec-17,12143,11538,605,5.0
CN5111700000000,51,117,Mecklenburg County, VA,Jan-18,11900,11213,687,5.8
CN5111700000000,51,117,Mecklenburg County, VA,Feb-18,11959,11342,617,5.2
CN5111700000000,51,117,Mecklenburg County, VA,Mar-18,11988,11388,600,5.0
CN5111700000000,51,117,Mecklenburg County, VA,Apr-18(p),11967,11466,501,4.2
CN4840700000000,48,407,San Jacinto County, TX,Mar-17,11442,10761,681,6.0
CN4840700000000,48,407,San Jacinto County, TX,Apr-17,11455,10850,605,5.3
CN4840700000000,48,407,San Jacinto County, TX,May-17,11443,10830,613,5.4
CN4840700000000,48,407,San Jacinto County, TX,Jun-17,11508,10855,653,5.7
CN4840700000000,48,407,San Jacinto County, TX,Jul-17,11447,10788,659,5.8
CN4840700000000,48,407,San Jacinto County, TX,Aug-17,11390,10729,661,5.8
CN4840700000000,48,407,San Jacinto County, TX,Sep-17,11420,10806,614,5.4
CN4840700000000,48,407,San Jacinto County, TX,Oct-17,11404,10848,556,4.9
CN4840700000000,48,407,San Jacinto County, TX,Nov-17,11465,10887,578,5.0
CN4840700000000,48,407,San Jacinto County, TX,Dec-17,11498,10919,579,5.0
CN4840700000000,48,407,San Jacinto County, TX,Jan-18,11539,10885,654,5.7
CN4840700000000,48,407,San Jacinto County, TX,Feb-18,11616,11005,611,5.3
CN4840700000000,48,407,San Jacinto County, TX,Mar-18,11723,11123,600,5.1
CN4840700000000,48,407,San Jacinto County, TX,Apr-18(p),11643,11100,543,4.7
CN0810300000000,08,103,Rio Blanco County, CO,Mar-17,2689,2569,120,4.5
CN0810300000000,08,103,Rio Blanco County, CO,Apr-17,2751,2650,101,3.7
CN0810300000000,08,103,Rio Blanco County, CO,May-17,2827,2735,92,3.3
CN0810300000000,08,103,Rio Blanco County, CO,Jun-17,2889,2784,105,3.6
CN0810300000000,08,103,Rio Blanco County, CO,Jul-17,2910,2813,97,3.3
CN0810300000000,08,103,Rio Blanco County, CO,Aug-17,2921,2822,99,3.4
CN0810300000000,08,103,Rio Blanco County, CO,Sep-17,2881,2785,96,3.3
CN0810300000000,08,103,Rio Blanco County, CO,Oct-17,2977,2871,106,3.6
CN0810300000000,08,103,Rio Blanco County, CO,Nov-17,2938,2835,103,3.5
CN0810300000000,08,103,Rio Blanco County, CO,Dec-17,2804,2699,105,3.7
CN0810300000000,08,103,Rio Blanco County, CO,Jan-18,2733,2609,124,4.5
CN0810300000000,08,103,Rio Blanco County, CO,Feb-18,2728,2603,125,4.6
CN0810300000000,08,103,Rio Blanco County, CO,Mar-18,2799,2685,114,4.1
CN0810300000000,08,103,Rio Blanco County, CO,Apr-18(p),2859,2758,101,3.5
CN1706100000000,17,061,Greene County, IL,Mar-17,6002,5693,309,5.1
CN1706100000000,17,061,Greene County, IL,Apr-17,6016,5758,258,4.3
CN1706100000000,17,061,Greene County, IL,May-17,6048,5790,258,4.3
CN1706100000000,17,061,Greene County, IL,Jun-17,6116,5822,294,4.8
CN1706100000000,17,061,Greene County, IL,Jul-17,5984,5675,309,5.2
CN1706100000000,17,061,Greene County, IL,Aug-17,5980,5680,300,5.0
CN1706100000000,17,061,Greene County, IL,Sep-17,5941,5668,273,4.6
CN1706100000000,17,061,Greene County, IL,Oct-17,5902,5638,264,4.5
CN1706100000000,17,061,Greene County, IL,Nov-17,5853,5581,272,4.6
CN1706100000000,17,061,Greene County, IL,Dec-17,5811,5551,260,4.5
CN1706100000000,17,061,Greene County, IL,Jan-18,5800,5507,293,5.1
CN1706100000000,17,061,Greene County, IL,Feb-18,5815,5542,273,4.7
CN1706100000000,17,061,Greene County, IL,Mar-18,5963,5669,294,4.9
CN1706100000000,17,061,Greene County, IL,Apr-18(p),5965,5736,229,3.8
CN1608100000000,16,081,Teton County, ID,Mar-17,5544,5359,185,3.3
CN1608100000000,16,081,Teton County, ID,Apr-17,5654,5442,212,3.7
CN1608100000000,16,081,Teton County, ID,May-17,6006,5820,186,3.1
CN1608100000000,16,081,Teton County, ID,Jun-17,6605,6472,133,2.0
CN1608100000000,16,081,Teton County, ID,Jul-17,6865,6746,119,1.7
CN1608100000000,16,081,Teton County, ID,Aug-17,6769,6651,118,1.7
CN1608100000000,16,081,Teton County, ID,Sep-17,6367,6251,116,1.8
CN1608100000000,16,081,Teton County, ID,Oct-17,6384,6230,154,2.4
CN1608100000000,16,081,Teton County, ID,Nov-17,5738,5522,216,3.8
CN1608100000000,16,081,Teton County, ID,Dec-17,5881,5723,158,2.7
CN1608100000000,16,081,Teton County, ID,Jan-18,5769,5590,179,3.1
CN1608100000000,16,081,Teton County, ID,Feb-18,5736,5574,162,2.8
CN1608100000000,16,081,Teton County, ID,Mar-18,5710,5558,152,2.7
CN1608100000000,16,081,Teton County, ID,Apr-18(p),5793,5612,181,3.1
CN2123900000000,21,239,Woodford County, KY,Mar-17,14869,14332,537,3.6
CN2123900000000,21,239,Woodford County, KY,Apr-17,15316,14848,468,3.1
CN2123900000000,21,239,Woodford County, KY,May-17,15218,14728,490,3.2
CN2123900000000,21,239,Woodford County, KY,Jun-17,15239,14682,557,3.7
CN2123900000000,21,239,Woodford County, KY,Jul-17,14754,14180,574,3.9
CN2123900000000,21,239,Woodford County, KY,Aug-17,14503,14026,477,3.3
CN2123900000000,21,239,Woodford County, KY,Sep-17,14474,14008,466,3.2
CN2123900000000,21,239,Woodford County, KY,Oct-17,14737,14341,396,2.7
CN2123900000000,21,239,Woodford County, KY,Nov-17,14961,14576,385,2.6
CN2123900000000,21,239,Woodford County, KY,Dec-17,14788,14403,385,2.6
CN2123900000000,21,239,Woodford County, KY,Jan-18,14735,14314,421,2.9
CN2123900000000,21,239,Woodford County, KY,Feb-18,14347,13878,469,3.3
CN2123900000000,21,239,Woodford County, KY,Mar-18,14417,13963,454,3.1
CN2123900000000,21,239,Woodford County, KY,Apr-18(p),14693,14291,402,2.7
CN5001100000000,50,011,Franklin County, VT,Mar-17,27229,26239,990,3.6
CN5001100000000,50,011,Franklin County, VT,Apr-17,27391,26486,905,3.3
CN5001100000000,50,011,Franklin County, VT,May-17,27416,26686,730,2.7
CN5001100000000,50,011,Franklin County, VT,Jun-17,27741,26896,845,3.0
CN5001100000000,50,011,Franklin County, VT,Jul-17,27827,26954,873,3.1
CN5001100000000,50,011,Franklin County, VT,Aug-17,27565,26738,827,3.0
CN5001100000000,50,011,Franklin County, VT,Sep-17,27433,26650,783,2.9
CN5001100000000,50,011,Franklin County, VT,Oct-17,27581,26950,631,2.3
CN5001100000000,50,011,Franklin County, VT,Nov-17,27573,26809,764,2.8
CN5001100000000,50,011,Franklin County, VT,Dec-17,27067,26381,686,2.5
CN5001100000000,50,011,Franklin County, VT,Jan-18,26958,26101,857,3.2
CN5001100000000,50,011,Franklin County, VT,Feb-18,27328,26498,830,3.0
CN5001100000000,50,011,Franklin County, VT,Mar-18,27447,26629,818,3.0
CN5001100000000,50,011,Franklin County, VT,Apr-18(p),27609,26844,765,2.8
CN5512700000000,55,127,Walworth County, WI,Mar-17,57705,55520,2185,3.8
CN5512700000000,55,127,Walworth County, WI,Apr-17,57859,56077,1782,3.1
CN5512700000000,55,127,Walworth County, WI,May-17,58592,56845,1747,3.0
CN5512700000000,55,127,Walworth County, WI,Jun-17,59192,57108,2084,3.5
CN5512700000000,55,127,Walworth County, WI,Jul-17,58746,56821,1925,3.3
CN5512700000000,55,127,Walworth County, WI,Aug-17,57993,56079,1914,3.3
CN5512700000000,55,127,Walworth County, WI,Sep-17,59081,57447,1634,2.8
CN5512700000000,55,127,Walworth County, WI,Oct-17,59086,57533,1553,2.6
CN5512700000000,55,127,Walworth County, WI,Nov-17,58567,56987,1580,2.7
CN5512700000000,55,127,Walworth County, WI,Dec-17,57535,55999,1536,2.7
CN5512700000000,55,127,Walworth County, WI,Jan-18,57043,55160,1883,3.3
CN5512700000000,55,127,Walworth County, WI,Feb-18,58311,56265,2046,3.5
CN5512700000000,55,127,Walworth County, WI,Mar-18,58512,56652,1860,3.2
CN5512700000000,55,127,Walworth County, WI,Apr-18(p),58703,57223,1480,2.5
CN4711900000000,47,119,Maury County, TN,Mar-17,45319,43788,1531,3.4
CN4711900000000,47,119,Maury County, TN,Apr-17,45321,44061,1260,2.8
CN4711900000000,47,119,Maury County, TN,May-17,45396,44182,1214,2.7
CN4711900000000,47,119,Maury County, TN,Jun-17,46287,44624,1663,3.6
CN4711900000000,47,119,Maury County, TN,Jul-17,46526,44881,1645,3.5
CN4711900000000,47,119,Maury County, TN,Aug-17,45913,44435,1478,3.2
CN4711900000000,47,119,Maury County, TN,Sep-17,46334,45005,1329,2.9
CN4711900000000,47,119,Maury County, TN,Oct-17,46310,44944,1366,2.9
CN4711900000000,47,119,Maury County, TN,Nov-17,46068,44789,1279,2.8
CN4711900000000,47,119,Maury County, TN,Dec-17,46170,44743,1427,3.1
CN4711900000000,47,119,Maury County, TN,Jan-18,46202,44410,1792,3.9
CN4711900000000,47,119,Maury County, TN,Feb-18,46725,44993,1732,3.7
CN4711900000000,47,119,Maury County, TN,Mar-18,46741,45130,1611,3.4
CN4711900000000,47,119,Maury County, TN,Apr-18(p),46924,45630,1294,2.8
CN2501100000000,25,011,Franklin County, MA,Mar-17,40048,38525,1523,3.8
CN2501100000000,25,011,Franklin County, MA,Apr-17,39854,38527,1327,3.3
CN2501100000000,25,011,Franklin County, MA,May-17,39758,38447,1311,3.3
CN2501100000000,25,011,Franklin County, MA,Jun-17,40271,38903,1368,3.4
CN2501100000000,25,011,Franklin County, MA,Jul-17,40256,38914,1342,3.3
CN2501100000000,25,011,Franklin County, MA,Aug-17,40217,38940,1277,3.2
CN2501100000000,25,011,Franklin County, MA,Sep-17,39657,38456,1201,3.0
CN2501100000000,25,011,Franklin County, MA,Oct-17,39765,38681,1084,2.7
CN2501100000000,25,011,Franklin County, MA,Nov-17,39917,38835,1082,2.7
CN2501100000000,25,011,Franklin County, MA,Dec-17,39833,38678,1155,2.9
CN2501100000000,25,011,Franklin County, MA,Jan-18,39730,38225,1505,3.8
CN2501100000000,25,011,Franklin County, MA,Feb-18,40362,38810,1552,3.8
CN2501100000000,25,011,Franklin County, MA,Mar-18,40655,39192,1463,3.6
CN2501100000000,25,011,Franklin County, MA,Apr-18(p),40855,39583,1272,3.1
CN1210100000000,12,101,Pasco County, FL,Mar-17,226561,216478,10083,4.5
CN1210100000000,12,101,Pasco County, FL,Apr-17,226563,217008,9555,4.2
CN1210100000000,12,101,Pasco County, FL,May-17,227252,217492,9760,4.3
CN1210100000000,12,101,Pasco County, FL,Jun-17,228853,218457,10396,4.5
CN1210100000000,12,101,Pasco County, FL,Jul-17,229603,219254,10349,4.5
CN1210100000000,12,101,Pasco County, FL,Aug-17,228497,218337,10160,4.4
CN1210100000000,12,101,Pasco County, FL,Sep-17,231671,222188,9483,4.1
CN1210100000000,12,101,Pasco County, FL,Oct-17,229327,220309,9018,3.9
CN1210100000000,12,101,Pasco County, FL,Nov-17,228464,219300,9164,4.0
CN1210100000000,12,101,Pasco County, FL,Dec-17,227183,218488,8695,3.8
CN1210100000000,12,101,Pasco County, FL,Jan-18,228845,218860,9985,4.4
CN1210100000000,12,101,Pasco County, FL,Feb-18,230830,221589,9241,4.0
CN1210100000000,12,101,Pasco County, FL,Mar-18,231418,222219,9199,4.0
CN1210100000000,12,101,Pasco County, FL,Apr-18(p),231156,222844,8312,3.6
CN3004900000000,30,049,Lewis and Clark County, MT,Mar-17,35312,33952,1360,3.9
CN3004900000000,30,049,Lewis and Clark County, MT,Apr-17,35026,33922,1104,3.2
CN3004900000000,30,049,Lewis and Clark County, MT,May-17,35196,34209,987,2.8
CN3004900000000,30,049,Lewis and Clark County, MT,Jun-17,35399,34187,1212,3.4
CN3004900000000,30,049,Lewis and Clark County, MT,Jul-17,36098,34936,1162,3.2
CN3004900000000,30,049,Lewis and Clark County, MT,Aug-17,35840,34688,1152,3.2
CN3004900000000,30,049,Lewis and Clark County, MT,Sep-17,34877,33785,1092,3.1
CN3004900000000,30,049,Lewis and Clark County, MT,Oct-17,34892,33744,1148,3.3
CN3004900000000,30,049,Lewis and Clark County, MT,Nov-17,35062,33886,1176,3.4
CN3004900000000,30,049,Lewis and Clark County, MT,Dec-17,34779,33495,1284,3.7
CN3004900000000,30,049,Lewis and Clark County, MT,Jan-18,34739,33144,1595,4.6
CN3004900000000,30,049,Lewis and Clark County, MT,Feb-18,34625,33089,1536,4.4
CN3004900000000,30,049,Lewis and Clark County, MT,Mar-18,34776,33310,1466,4.2
CN3004900000000,30,049,Lewis and Clark County, MT,Apr-18(p),34466,33411,1055,3.1
CN2809700000000,28,097,Montgomery County, MS,Mar-17,4244,4034,210,4.9
CN2809700000000,28,097,Montgomery County, MS,Apr-17,4264,4082,182,4.3
CN2809700000000,28,097,Montgomery County, MS,May-17,4244,4026,218,5.1
CN2809700000000,28,097,Montgomery County, MS,Jun-17,4271,4022,249,5.8
CN2809700000000,28,097,Montgomery County, MS,Jul-17,4204,3968,236,5.6
CN2809700000000,28,097,Montgomery County, MS,Aug-17,4115,3917,198,4.8
CN2809700000000,28,097,Montgomery County, MS,Sep-17,4112,3924,188,4.6
CN2809700000000,28,097,Montgomery County, MS,Oct-17,4071,3879,192,4.7
CN2809700000000,28,097,Montgomery County, MS,Nov-17,4059,3860,199,4.9
CN2809700000000,28,097,Montgomery County, MS,Dec-17,4056,3849,207,5.1
CN2809700000000,28,097,Montgomery County, MS,Jan-18,4012,3794,218,5.4
CN2809700000000,28,097,Montgomery County, MS,Feb-18,4047,3842,205,5.1
CN2809700000000,28,097,Montgomery County, MS,Mar-18,4075,3882,193,4.7
CN2809700000000,28,097,Montgomery County, MS,Apr-18(p),4114,3923,191,4.6
CN4607300000000,46,073,Jerauld County, SD,Mar-17,1106,1080,26,2.4
CN4607300000000,46,073,Jerauld County, SD,Apr-17,1144,1115,29,2.5
CN4607300000000,46,073,Jerauld County, SD,May-17,1150,1120,30,2.6
CN4607300000000,46,073,Jerauld County, SD,Jun-17,1190,1165,25,2.1
CN4607300000000,46,073,Jerauld County, SD,Jul-17,1163,1138,25,2.1
CN4607300000000,46,073,Jerauld County, SD,Aug-17,1121,1093,28,2.5
CN4607300000000,46,073,Jerauld County, SD,Sep-17,1116,1089,27,2.4
CN4607300000000,46,073,Jerauld County, SD,Oct-17,1101,1075,26,2.4
CN4607300000000,46,073,Jerauld County, SD,Nov-17,1093,1066,27,2.5
CN4607300000000,46,073,Jerauld County, SD,Dec-17,1100,1074,26,2.4
CN4607300000000,46,073,Jerauld County, SD,Jan-18,1102,1073,29,2.6
CN4607300000000,46,073,Jerauld County, SD,Feb-18,1144,1116,28,2.4
CN4607300000000,46,073,Jerauld County, SD,Mar-18,1166,1137,29,2.5
CN4607300000000,46,073,Jerauld County, SD,Apr-18(p),1153,1120,33,2.9
CN3706700000000,37,067,Forsyth County, NC,Mar-17,184447,176376,8071,4.4
CN3706700000000,37,067,Forsyth County, NC,Apr-17,183673,176285,7388,4.0
CN3706700000000,37,067,Forsyth County, NC,May-17,184130,176246,7884,4.3
CN3706700000000,37,067,Forsyth County, NC,Jun-17,184304,175944,8360,4.5
CN3706700000000,37,067,Forsyth County, NC,Jul-17,185037,176293,8744,4.7
CN3706700000000,37,067,Forsyth County, NC,Aug-17,183300,174577,8723,4.8
CN3706700000000,37,067,Forsyth County, NC,Sep-17,185981,178338,7643,4.1
CN3706700000000,37,067,Forsyth County, NC,Oct-17,185187,177519,7668,4.1
CN3706700000000,37,067,Forsyth County, NC,Nov-17,185047,177017,8030,4.3
CN3706700000000,37,067,Forsyth County, NC,Dec-17,183559,175872,7687,4.2
CN3706700000000,37,067,Forsyth County, NC,Jan-18,184590,176285,8305,4.5
CN3706700000000,37,067,Forsyth County, NC,Feb-18,185964,177709,8255,4.4
CN3706700000000,37,067,Forsyth County, NC,Mar-18,186376,178542,7834,4.2
CN3706700000000,37,067,Forsyth County, NC,Apr-18(p),186304,179565,6739,3.6
CN2101900000000,21,019,Boyd County, KY,Mar-17,18799,17252,1547,8.2
CN2101900000000,21,019,Boyd County, KY,Apr-17,18525,17191,1334,7.2
CN2101900000000,21,019,Boyd County, KY,May-17,18613,17203,1410,7.6
CN2101900000000,21,019,Boyd County, KY,Jun-17,18639,17191,1448,7.8
CN2101900000000,21,019,Boyd County, KY,Jul-17,18554,17213,1341,7.2
CN2101900000000,21,019,Boyd County, KY,Aug-17,18359,17138,1221,6.7
CN2101900000000,21,019,Boyd County, KY,Sep-17,18542,17441,1101,5.9
CN2101900000000,21,019,Boyd County, KY,Oct-17,18331,17325,1006,5.5
CN2101900000000,21,019,Boyd County, KY,Nov-17,18278,17284,994,5.4
CN2101900000000,21,019,Boyd County, KY,Dec-17,18251,17222,1029,5.6
CN2101900000000,21,019,Boyd County, KY,Jan-18,18034,16844,1190,6.6
CN2101900000000,21,019,Boyd County, KY,Feb-18,18321,17151,1170,6.4
CN2101900000000,21,019,Boyd County, KY,Mar-18,18465,17330,1135,6.1
CN2101900000000,21,019,Boyd County, KY,Apr-18(p),18398,17402,996,5.4
CN2112500000000,21,125,Laurel County, KY,Mar-17,24994,23390,1604,6.4
CN2112500000000,21,125,Laurel County, KY,Apr-17,24680,23265,1415,5.7
CN2112500000000,21,125,Laurel County, KY,May-17,24687,23208,1479,6.0
CN2112500000000,21,125,Laurel County, KY,Jun-17,25006,23386,1620,6.5
CN2112500000000,21,125,Laurel County, KY,Jul-17,24991,23406,1585,6.3
CN2112500000000,21,125,Laurel County, KY,Aug-17,24633,23140,1493,6.1
CN2112500000000,21,125,Laurel County, KY,Sep-17,24792,23475,1317,5.3
CN2112500000000,21,125,Laurel County, KY,Oct-17,24481,23265,1216,5.0
CN2112500000000,21,125,Laurel County, KY,Nov-17,24411,23248,1163,4.8
CN2112500000000,21,125,Laurel County, KY,Dec-17,24458,23313,1145,4.7
CN2112500000000,21,125,Laurel County, KY,Jan-18,24483,23260,1223,5.0
CN2112500000000,21,125,Laurel County, KY,Feb-18,24884,23504,1380,5.5
CN2112500000000,21,125,Laurel County, KY,Mar-18,25181,23868,1313,5.2
CN2112500000000,21,125,Laurel County, KY,Apr-18(p),25002,23882,1120,4.5
CN1605900000000,16,059,Lemhi County, ID,Mar-17,3274,3037,237,7.2
CN1605900000000,16,059,Lemhi County, ID,Apr-17,3346,3136,210,6.3
CN1605900000000,16,059,Lemhi County, ID,May-17,3479,3318,161,4.6
CN1605900000000,16,059,Lemhi County, ID,Jun-17,3642,3496,146,4.0
CN1605900000000,16,059,Lemhi County, ID,Jul-17,3722,3578,144,3.9
CN1605900000000,16,059,Lemhi County, ID,Aug-17,3729,3590,139,3.7
CN1605900000000,16,059,Lemhi County, ID,Sep-17,3555,3430,125,3.5
CN1605900000000,16,059,Lemhi County, ID,Oct-17,3509,3386,123,3.5
CN1605900000000,16,059,Lemhi County, ID,Nov-17,3420,3267,153,4.5
CN1605900000000,16,059,Lemhi County, ID,Dec-17,3382,3202,180,5.3
CN1605900000000,16,059,Lemhi County, ID,Jan-18,3327,3090,237,7.1
CN1605900000000,16,059,Lemhi County, ID,Feb-18,3352,3126,226,6.7
CN1605900000000,16,059,Lemhi County, ID,Mar-18,3358,3167,191,5.7
CN1605900000000,16,059,Lemhi County, ID,Apr-18(p),3351,3185,166,5.0
CN3403500000000,34,035,Somerset County, NJ,Mar-17,173749,167357,6392,3.7
CN3403500000000,34,035,Somerset County, NJ,Apr-17,173848,167766,6082,3.5
CN3403500000000,34,035,Somerset County, NJ,May-17,173680,167272,6408,3.7
CN3403500000000,34,035,Somerset County, NJ,Jun-17,175214,168493,6721,3.8
CN3403500000000,34,035,Somerset County, NJ,Jul-17,175740,168282,7458,4.2
CN3403500000000,34,035,Somerset County, NJ,Aug-17,173762,166591,7171,4.1
CN3403500000000,34,035,Somerset County, NJ,Sep-17,172522,165748,6774,3.9
CN3403500000000,34,035,Somerset County, NJ,Oct-17,172315,165960,6355,3.7
CN3403500000000,34,035,Somerset County, NJ,Nov-17,171484,165470,6014,3.5
CN3403500000000,34,035,Somerset County, NJ,Dec-17,170936,165314,5622,3.3
CN3403500000000,34,035,Somerset County, NJ,Jan-18,170517,163973,6544,3.8
CN3403500000000,34,035,Somerset County, NJ,Feb-18,172565,165710,6855,4.0
CN3403500000000,34,035,Somerset County, NJ,Mar-18,170929,164467,6462,3.8
CN3403500000000,34,035,Somerset County, NJ,Apr-18(p),169372,163799,5573,3.3
CN4106500000000,41,065,Wasco County, OR,Mar-17,12773,12188,585,4.6
CN4106500000000,41,065,Wasco County, OR,Apr-17,12941,12437,504,3.9
CN4106500000000,41,065,Wasco County, OR,May-17,13162,12674,488,3.7
CN4106500000000,41,065,Wasco County, OR,Jun-17,16586,16002,584,3.5
CN4106500000000,41,065,Wasco County, OR,Jul-17,19928,19337,591,3.0
CN4106500000000,41,065,Wasco County, OR,Aug-17,14457,13842,615,4.3
CN4106500000000,41,065,Wasco County, OR,Sep-17,13239,12696,543,4.1
CN4106500000000,41,065,Wasco County, OR,Oct-17,13106,12551,555,4.2
CN4106500000000,41,065,Wasco County, OR,Nov-17,13288,12724,564,4.2
CN4106500000000,41,065,Wasco County, OR,Dec-17,12985,12419,566,4.4
CN4106500000000,41,065,Wasco County, OR,Jan-18,12684,12034,650,5.1
CN4106500000000,41,065,Wasco County, OR,Feb-18,12846,12192,654,5.1
CN4106500000000,41,065,Wasco County, OR,Mar-18,12900,12274,626,4.9
CN4106500000000,41,065,Wasco County, OR,Apr-18(p),12933,12411,522,4.0
CN2812700000000,28,127,Simpson County, MS,Mar-17,11009,10496,513,4.7
CN2812700000000,28,127,Simpson County, MS,Apr-17,10996,10520,476,4.3
CN2812700000000,28,127,Simpson County, MS,May-17,11022,10452,570,5.2
CN2812700000000,28,127,Simpson County, MS,Jun-17,11110,10481,629,5.7
CN2812700000000,28,127,Simpson County, MS,Jul-17,11102,10498,604,5.4
CN2812700000000,28,127,Simpson County, MS,Aug-17,10913,10375,538,4.9
CN2812700000000,28,127,Simpson County, MS,Sep-17,10937,10452,485,4.4
CN2812700000000,28,127,Simpson County, MS,Oct-17,10991,10516,475,4.3
CN2812700000000,28,127,Simpson County, MS,Nov-17,11000,10532,468,4.3
CN2812700000000,28,127,Simpson County, MS,Dec-17,11022,10548,474,4.3
CN2812700000000,28,127,Simpson County, MS,Jan-18,10888,10419,469,4.3
CN2812700000000,28,127,Simpson County, MS,Feb-18,10979,10511,468,4.3
CN2812700000000,28,127,Simpson County, MS,Mar-18,11015,10571,444,4.0
CN2812700000000,28,127,Simpson County, MS,Apr-18(p),11017,10574,443,4.0
CN4610300000000,46,103,Pennington County, SD,Mar-17,54188,52183,2005,3.7
CN4610300000000,46,103,Pennington County, SD,Apr-17,54669,52844,1825,3.3
CN4610300000000,46,103,Pennington County, SD,May-17,55658,53821,1837,3.3
CN4610300000000,46,103,Pennington County, SD,Jun-17,57080,55229,1851,3.2
CN4610300000000,46,103,Pennington County, SD,Jul-17,57848,56096,1752,3.0
CN4610300000000,46,103,Pennington County, SD,Aug-17,58587,56704,1883,3.2
CN4610300000000,46,103,Pennington County, SD,Sep-17,56119,54381,1738,3.1
CN4610300000000,46,103,Pennington County, SD,Oct-17,56315,54587,1728,3.1
CN4610300000000,46,103,Pennington County, SD,Nov-17,55872,53946,1926,3.4
CN4610300000000,46,103,Pennington County, SD,Dec-17,54987,53005,1982,3.6
CN4610300000000,46,103,Pennington County, SD,Jan-18,54952,52850,2102,3.8
CN4610300000000,46,103,Pennington County, SD,Feb-18,55646,53460,2186,3.9
CN4610300000000,46,103,Pennington County, SD,Mar-18,55510,53565,1945,3.5
CN4610300000000,46,103,Pennington County, SD,Apr-18(p),56096,54171,1925,3.4
CN2301100000000,23,011,Kennebec County, ME,Mar-17,62483,60170,2313,3.7
CN2301100000000,23,011,Kennebec County, ME,Apr-17,62190,60120,2070,3.3
CN2301100000000,23,011,Kennebec County, ME,May-17,62351,60328,2023,3.2
CN2301100000000,23,011,Kennebec County, ME,Jun-17,63328,61234,2094,3.3
CN2301100000000,23,011,Kennebec County, ME,Jul-17,64165,62067,2098,3.3
CN2301100000000,23,011,Kennebec County, ME,Aug-17,64031,62217,1814,2.8
CN2301100000000,23,011,Kennebec County, ME,Sep-17,62609,60830,1779,2.8
CN2301100000000,23,011,Kennebec County, ME,Oct-17,62711,60934,1777,2.8
CN2301100000000,23,011,Kennebec County, ME,Nov-17,62605,60798,1807,2.9
CN2301100000000,23,011,Kennebec County, ME,Dec-17,62220,60657,1563,2.5
CN2301100000000,23,011,Kennebec County, ME,Jan-18,62347,60339,2008,3.2
CN2301100000000,23,011,Kennebec County, ME,Feb-18,62400,60445,1955,3.1
CN2301100000000,23,011,Kennebec County, ME,Mar-18,62468,60623,1845,3.0
CN2301100000000,23,011,Kennebec County, ME,Apr-18(p),62793,60990,1803,2.9
CN2016300000000,20,163,Rooks County, KS,Mar-17,2480,2382,98,4.0
CN2016300000000,20,163,Rooks County, KS,Apr-17,2446,2357,89,3.6
CN2016300000000,20,163,Rooks County, KS,May-17,2493,2402,91,3.7
CN2016300000000,20,163,Rooks County, KS,Jun-17,2537,2431,106,4.2
CN2016300000000,20,163,Rooks County, KS,Jul-17,2451,2350,101,4.1
CN2016300000000,20,163,Rooks County, KS,Aug-17,2473,2371,102,4.1
CN2016300000000,20,163,Rooks County, KS,Sep-17,2534,2449,85,3.4
CN2016300000000,20,163,Rooks County, KS,Oct-17,2570,2490,80,3.1
CN2016300000000,20,163,Rooks County, KS,Nov-17,2584,2499,85,3.3
CN2016300000000,20,163,Rooks County, KS,Dec-17,2516,2437,79,3.1
CN2016300000000,20,163,Rooks County, KS,Jan-18,2474,2383,91,3.7
CN2016300000000,20,163,Rooks County, KS,Feb-18,2450,2361,89,3.6
CN2016300000000,20,163,Rooks County, KS,Mar-18,2432,2345,87,3.6
CN2016300000000,20,163,Rooks County, KS,Apr-18(p),2350,2265,85,3.6
CN5103600000000,51,036,Charles City County, VA,Mar-17,3730,3560,170,4.6
CN5103600000000,51,036,Charles City County, VA,Apr-17,3784,3617,167,4.4
CN5103600000000,51,036,Charles City County, VA,May-17,3782,3603,179,4.7
CN5103600000000,51,036,Charles City County, VA,Jun-17,3828,3641,187,4.9
CN5103600000000,51,036,Charles City County, VA,Jul-17,3868,3668,200,5.2
CN5103600000000,51,036,Charles City County, VA,Aug-17,3800,3604,196,5.2
CN5103600000000,51,036,Charles City County, VA,Sep-17,3818,3637,181,4.7
CN5103600000000,51,036,Charles City County, VA,Oct-17,3776,3607,169,4.5
CN5103600000000,51,036,Charles City County, VA,Nov-17,3735,3564,171,4.6
CN5103600000000,51,036,Charles City County, VA,Dec-17,3759,3576,183,4.9
CN5103600000000,51,036,Charles City County, VA,Jan-18,3718,3528,190,5.1
CN5103600000000,51,036,Charles City County, VA,Feb-18,3751,3587,164,4.4
CN5103600000000,51,036,Charles City County, VA,Mar-18,3748,3583,165,4.4
CN5103600000000,51,036,Charles City County, VA,Apr-18(p),3789,3643,146,3.9
CN3704300000000,37,043,Clay County, NC,Mar-17,3958,3761,197,5.0
CN3704300000000,37,043,Clay County, NC,Apr-17,3924,3753,171,4.4
CN3704300000000,37,043,Clay County, NC,May-17,3925,3745,180,4.6
CN3704300000000,37,043,Clay County, NC,Jun-17,4001,3804,197,4.9
CN3704300000000,37,043,Clay County, NC,Jul-17,4001,3789,212,5.3
CN3704300000000,37,043,Clay County, NC,Aug-17,3936,3725,211,5.4
CN3704300000000,37,043,Clay County, NC,Sep-17,4030,3840,190,4.7
CN3704300000000,37,043,Clay County, NC,Oct-17,4004,3815,189,4.7
CN3704300000000,37,043,Clay County, NC,Nov-17,3997,3801,196,4.9
CN3704300000000,37,043,Clay County, NC,Dec-17,3924,3727,197,5.0
CN3704300000000,37,043,Clay County, NC,Jan-18,3923,3709,214,5.5
CN3704300000000,37,043,Clay County, NC,Feb-18,3954,3741,213,5.4
CN3704300000000,37,043,Clay County, NC,Mar-18,3977,3769,208,5.2
CN3704300000000,37,043,Clay County, NC,Apr-18(p),3973,3807,166,4.2
CN3608100000000,36,081,Queens County, NY,Mar-17,1195181,1148666,46515,3.9
CN3608100000000,36,081,Queens County, NY,Apr-17,1188659,1145506,43153,3.6
CN3608100000000,36,081,Queens County, NY,May-17,1186915,1141875,45040,3.8
CN3608100000000,36,081,Queens County, NY,Jun-17,1189768,1142101,47667,4.0
CN3608100000000,36,081,Queens County, NY,Jul-17,1200200,1147691,52509,4.4
CN3608100000000,36,081,Queens County, NY,Aug-17,1192577,1139947,52630,4.4
CN3608100000000,36,081,Queens County, NY,Sep-17,1195719,1148566,47153,3.9
CN3608100000000,36,081,Queens County, NY,Oct-17,1191341,1145708,45633,3.8
CN3608100000000,36,081,Queens County, NY,Nov-17,1185368,1143663,41705,3.5
CN3608100000000,36,081,Queens County, NY,Dec-17,1181013,1140693,40320,3.4
CN3608100000000,36,081,Queens County, NY,Jan-18,1191491,1143817,47674,4.0
CN3608100000000,36,081,Queens County, NY,Feb-18,1204733,1158934,45799,3.8
CN3608100000000,36,081,Queens County, NY,Mar-18,1196346,1152700,43646,3.6
CN3608100000000,36,081,Queens County, NY,Apr-18(p),1187505,1145333,42172,3.6
CN5509700000000,55,097,Portage County, WI,Mar-17,40132,38686,1446,3.6
CN5509700000000,55,097,Portage County, WI,Apr-17,40081,38931,1150,2.9
CN5509700000000,55,097,Portage County, WI,May-17,40234,39092,1142,2.8
CN5509700000000,55,097,Portage County, WI,Jun-17,39152,37753,1399,3.6
CN5509700000000,55,097,Portage County, WI,Jul-17,39139,37873,1266,3.2
CN5509700000000,55,097,Portage County, WI,Aug-17,38652,37548,1104,2.9
CN5509700000000,55,097,Portage County, WI,Sep-17,40185,39167,1018,2.5
CN5509700000000,55,097,Portage County, WI,Oct-17,40456,39469,987,2.4
CN5509700000000,55,097,Portage County, WI,Nov-17,40564,39570,994,2.5
CN5509700000000,55,097,Portage County, WI,Dec-17,40566,39559,1007,2.5
CN5509700000000,55,097,Portage County, WI,Jan-18,38945,37762,1183,3.0
CN5509700000000,55,097,Portage County, WI,Feb-18,40190,38798,1392,3.5
CN5509700000000,55,097,Portage County, WI,Mar-18,40631,39246,1385,3.4
CN5509700000000,55,097,Portage County, WI,Apr-18(p),40649,39556,1093,2.7
CN2005700000000,20,057,Ford County, KS,Mar-17,17735,17212,523,2.9
CN2005700000000,20,057,Ford County, KS,Apr-17,17587,17103,484,2.8
CN2005700000000,20,057,Ford County, KS,May-17,17615,17116,499,2.8
CN2005700000000,20,057,Ford County, KS,Jun-17,18017,17480,537,3.0
CN2005700000000,20,057,Ford County, KS,Jul-17,18227,17635,592,3.2
CN2005700000000,20,057,Ford County, KS,Aug-17,17933,17397,536,3.0
CN2005700000000,20,057,Ford County, KS,Sep-17,17756,17323,433,2.4
CN2005700000000,20,057,Ford County, KS,Oct-17,17724,17342,382,2.2
CN2005700000000,20,057,Ford County, KS,Nov-17,17753,17327,426,2.4
CN2005700000000,20,057,Ford County, KS,Dec-17,17616,17215,401,2.3
CN2005700000000,20,057,Ford County, KS,Jan-18,17384,16985,399,2.3
CN2005700000000,20,057,Ford County, KS,Feb-18,17459,17022,437,2.5
CN2005700000000,20,057,Ford County, KS,Mar-18,17481,17046,435,2.5
CN2005700000000,20,057,Ford County, KS,Apr-18(p),17402,16978,424,2.4
CN1212500000000,12,125,Union County, FL,Mar-17,4889,4715,174,3.6
CN1212500000000,12,125,Union County, FL,Apr-17,4896,4734,162,3.3
CN1212500000000,12,125,Union County, FL,May-17,4896,4735,161,3.3
CN1212500000000,12,125,Union County, FL,Jun-17,4844,4652,192,4.0
CN1212500000000,12,125,Union County, FL,Jul-17,4813,4624,189,3.9
CN1212500000000,12,125,Union County, FL,Aug-17,4834,4657,177,3.7
CN1212500000000,12,125,Union County, FL,Sep-17,5042,4868,174,3.5
CN1212500000000,12,125,Union County, FL,Oct-17,4920,4757,163,3.3
CN1212500000000,12,125,Union County, FL,Nov-17,4842,4672,170,3.5
CN1212500000000,12,125,Union County, FL,Dec-17,4800,4647,153,3.2
CN1212500000000,12,125,Union County, FL,Jan-18,4853,4665,188,3.9
CN1212500000000,12,125,Union County, FL,Feb-18,4870,4708,162,3.3
CN1212500000000,12,125,Union County, FL,Mar-18,4834,4667,167,3.5
CN1212500000000,12,125,Union County, FL,Apr-18(p),4828,4683,145,3.0
CN4900500000000,49,005,Cache County, UT,Mar-17,63234,61364,1870,3.0
CN4900500000000,49,005,Cache County, UT,Apr-17,63537,61836,1701,2.7
CN4900500000000,49,005,Cache County, UT,May-17,63658,61945,1713,2.7
CN4900500000000,49,005,Cache County, UT,Jun-17,63444,61418,2026,3.2
CN4900500000000,49,005,Cache County, UT,Jul-17,61114,59248,1866,3.1
CN4900500000000,49,005,Cache County, UT,Aug-17,61012,59174,1838,3.0
CN4900500000000,49,005,Cache County, UT,Sep-17,63367,61788,1579,2.5
CN4900500000000,49,005,Cache County, UT,Oct-17,64101,62534,1567,2.4
CN4900500000000,49,005,Cache County, UT,Nov-17,64028,62563,1465,2.3
CN4900500000000,49,005,Cache County, UT,Dec-17,63973,62515,1458,2.3
CN4900500000000,49,005,Cache County, UT,Jan-18,63424,61800,1624,2.6
CN4900500000000,49,005,Cache County, UT,Feb-18,63886,62027,1859,2.9
CN4900500000000,49,005,Cache County, UT,Mar-18,64311,62484,1827,2.8
CN4900500000000,49,005,Cache County, UT,Apr-18(p),64536,62877,1659,2.6
CN2208100000000,22,081,Red River Parish, LA,Mar-17,3831,3621,210,5.5
CN2208100000000,22,081,Red River Parish, LA,Apr-17,3861,3662,199,5.2
CN2208100000000,22,081,Red River Parish, LA,May-17,3864,3675,189,4.9
CN2208100000000,22,081,Red River Parish, LA,Jun-17,3985,3763,222,5.6
CN2208100000000,22,081,Red River Parish, LA,Jul-17,3958,3739,219,5.5
CN2208100000000,22,081,Red River Parish, LA,Aug-17,3890,3678,212,5.4
CN2208100000000,22,081,Red River Parish, LA,Sep-17,3913,3703,210,5.4
CN2208100000000,22,081,Red River Parish, LA,Oct-17,3833,3649,184,4.8
CN2208100000000,22,081,Red River Parish, LA,Nov-17,3801,3627,174,4.6
CN2208100000000,22,081,Red River Parish, LA,Dec-17,3789,3624,165,4.4
CN2208100000000,22,081,Red River Parish, LA,Jan-18,3867,3684,183,4.7
CN2208100000000,22,081,Red River Parish, LA,Feb-18,3903,3738,165,4.2
CN2208100000000,22,081,Red River Parish, LA,Mar-18,3933,3771,162,4.1
CN2208100000000,22,081,Red River Parish, LA,Apr-18(p),3903,3745,158,4.0
CN2113100000000,21,131,Leslie County, KY,Mar-17,2864,2547,317,11.1
CN2113100000000,21,131,Leslie County, KY,Apr-17,2818,2549,269,9.5
CN2113100000000,21,131,Leslie County, KY,May-17,2825,2548,277,9.8
CN2113100000000,21,131,Leslie County, KY,Jun-17,2846,2533,313,11.0
CN2113100000000,21,131,Leslie County, KY,Jul-17,2775,2479,296,10.7
CN2113100000000,21,131,Leslie County, KY,Aug-17,2800,2476,324,11.6
CN2113100000000,21,131,Leslie County, KY,Sep-17,2802,2509,293,10.5
CN2113100000000,21,131,Leslie County, KY,Oct-17,2702,2488,214,7.9
CN2113100000000,21,131,Leslie County, KY,Nov-17,2677,2485,192,7.2
CN2113100000000,21,131,Leslie County, KY,Dec-17,2678,2495,183,6.8
CN2113100000000,21,131,Leslie County, KY,Jan-18,2671,2483,188,7.0
CN2113100000000,21,131,Leslie County, KY,Feb-18,2710,2503,207,7.6
CN2113100000000,21,131,Leslie County, KY,Mar-18,2731,2531,200,7.3
CN2113100000000,21,131,Leslie County, KY,Apr-18(p),2714,2537,177,6.5
CN4823700000000,48,237,Jack County, TX,Mar-17,3890,3717,173,4.4
CN4823700000000,48,237,Jack County, TX,Apr-17,3999,3842,157,3.9
CN4823700000000,48,237,Jack County, TX,May-17,4000,3853,147,3.7
CN4823700000000,48,237,Jack County, TX,Jun-17,3976,3821,155,3.9
CN4823700000000,48,237,Jack County, TX,Jul-17,3940,3791,149,3.8
CN4823700000000,48,237,Jack County, TX,Aug-17,3984,3837,147,3.7
CN4823700000000,48,237,Jack County, TX,Sep-17,3955,3823,132,3.3
CN4823700000000,48,237,Jack County, TX,Oct-17,3906,3787,119,3.0
CN4823700000000,48,237,Jack County, TX,Nov-17,3906,3787,119,3.0
CN4823700000000,48,237,Jack County, TX,Dec-17,3920,3813,107,2.7
CN4823700000000,48,237,Jack County, TX,Jan-18,3874,3757,117,3.0
CN4823700000000,48,237,Jack County, TX,Feb-18,3882,3769,113,2.9
CN4823700000000,48,237,Jack County, TX,Mar-18,3852,3732,120,3.1
CN4823700000000,48,237,Jack County, TX,Apr-18(p),3954,3839,115,2.9
CN3906900000000,39,069,Henry County, OH,Mar-17,13755,12877,878,6.4
CN3906900000000,39,069,Henry County, OH,Apr-17,13616,12897,719,5.3
CN3906900000000,39,069,Henry County, OH,May-17,13607,12978,629,4.6
CN3906900000000,39,069,Henry County, OH,Jun-17,13682,12983,699,5.1
CN3906900000000,39,069,Henry County, OH,Jul-17,13558,12890,668,4.9
CN3906900000000,39,069,Henry County, OH,Aug-17,13779,13148,631,4.6
CN3906900000000,39,069,Henry County, OH,Sep-17,13728,13186,542,3.9
CN3906900000000,39,069,Henry County, OH,Oct-17,13780,13249,531,3.9
CN3906900000000,39,069,Henry County, OH,Nov-17,13716,13175,541,3.9
CN3906900000000,39,069,Henry County, OH,Dec-17,13479,12789,690,5.1
CN3906900000000,39,069,Henry County, OH,Jan-18,13262,12395,867,6.5
CN3906900000000,39,069,Henry County, OH,Feb-18,13363,12567,796,6.0
CN3906900000000,39,069,Henry County, OH,Mar-18,13496,12764,732,5.4
CN3906900000000,39,069,Henry County, OH,Apr-18(p),13402,12778,624,4.7
CN2915500000000,29,155,Pemiscot County, MO,Mar-17,6603,6072,531,8.0
CN2915500000000,29,155,Pemiscot County, MO,Apr-17,6685,6172,513,7.7
CN2915500000000,29,155,Pemiscot County, MO,May-17,6633,6107,526,7.9
CN2915500000000,29,155,Pemiscot County, MO,Jun-17,6543,5993,550,8.4
CN2915500000000,29,155,Pemiscot County, MO,Jul-17,6338,5777,561,8.9
CN2915500000000,29,155,Pemiscot County, MO,Aug-17,6426,5905,521,8.1
CN2915500000000,29,155,Pemiscot County, MO,Sep-17,6365,5967,398,6.3
CN2915500000000,29,155,Pemiscot County, MO,Oct-17,6281,5916,365,5.8
CN2915500000000,29,155,Pemiscot County, MO,Nov-17,6276,5895,381,6.1
CN2915500000000,29,155,Pemiscot County, MO,Dec-17,6229,5812,417,6.7
CN2915500000000,29,155,Pemiscot County, MO,Jan-18,6235,5784,451,7.2
CN2915500000000,29,155,Pemiscot County, MO,Feb-18,6404,5955,449,7.0
CN2915500000000,29,155,Pemiscot County, MO,Mar-18,6382,5941,441,6.9
CN2915500000000,29,155,Pemiscot County, MO,Apr-18(p),6395,6021,374,5.8
CN2401700000000,24,017,Charles County, MD,Mar-17,85771,82469,3302,3.8
CN2401700000000,24,017,Charles County, MD,Apr-17,85938,82634,3304,3.8
CN2401700000000,24,017,Charles County, MD,May-17,86039,82840,3199,3.7
CN2401700000000,24,017,Charles County, MD,Jun-17,86325,82524,3801,4.4
CN2401700000000,24,017,Charles County, MD,Jul-17,87246,83448,3798,4.4
CN2401700000000,24,017,Charles County, MD,Aug-17,86073,82375,3698,4.3
CN2401700000000,24,017,Charles County, MD,Sep-17,85808,82607,3201,3.7
CN2401700000000,24,017,Charles County, MD,Oct-17,85716,82484,3232,3.8
CN2401700000000,24,017,Charles County, MD,Nov-17,85450,82200,3250,3.8
CN2401700000000,24,017,Charles County, MD,Dec-17,84972,81905,3067,3.6
CN2401700000000,24,017,Charles County, MD,Jan-18,84723,81041,3682,4.3
CN2401700000000,24,017,Charles County, MD,Feb-18,85296,81528,3768,4.4
CN2401700000000,24,017,Charles County, MD,Mar-18,85341,81594,3747,4.4
CN2401700000000,24,017,Charles County, MD,Apr-18(p),84860,81649,3211,3.8
CN3104500000000,31,045,Dawes County, NE,Mar-17,5188,5062,126,2.4
CN3104500000000,31,045,Dawes County, NE,Apr-17,5226,5104,122,2.3
CN3104500000000,31,045,Dawes County, NE,May-17,5260,5132,128,2.4
CN3104500000000,31,045,Dawes County, NE,Jun-17,5141,4957,184,3.6
CN3104500000000,31,045,Dawes County, NE,Jul-17,5169,4982,187,3.6
CN3104500000000,31,045,Dawes County, NE,Aug-17,5108,4959,149,2.9
CN3104500000000,31,045,Dawes County, NE,Sep-17,5198,5072,126,2.4
CN3104500000000,31,045,Dawes County, NE,Oct-17,5190,5072,118,2.3
CN3104500000000,31,045,Dawes County, NE,Nov-17,5181,5067,114,2.2
CN3104500000000,31,045,Dawes County, NE,Dec-17,5135,4994,141,2.7
CN3104500000000,31,045,Dawes County, NE,Jan-18,5042,4896,146,2.9
CN3104500000000,31,045,Dawes County, NE,Feb-18,5102,4968,134,2.6
CN3104500000000,31,045,Dawes County, NE,Mar-18,5166,5032,134,2.6
CN3104500000000,31,045,Dawes County, NE,Apr-18(p),5117,4983,134,2.6
CN2909300000000,29,093,Iron County, MO,Mar-17,3495,3253,242,6.9
CN2909300000000,29,093,Iron County, MO,Apr-17,3538,3317,221,6.2
CN2909300000000,29,093,Iron County, MO,May-17,3526,3297,229,6.5
CN2909300000000,29,093,Iron County, MO,Jun-17,3568,3324,244,6.8
CN2909300000000,29,093,Iron County, MO,Jul-17,3476,3214,262,7.5
CN2909300000000,29,093,Iron County, MO,Aug-17,3503,3240,263,7.5
CN2909300000000,29,093,Iron County, MO,Sep-17,3483,3296,187,5.4
CN2909300000000,29,093,Iron County, MO,Oct-17,3388,3245,143,4.2
CN2909300000000,29,093,Iron County, MO,Nov-17,3419,3237,182,5.3
CN2909300000000,29,093,Iron County, MO,Dec-17,3437,3218,219,6.4
CN2909300000000,29,093,Iron County, MO,Jan-18,3402,3153,249,7.3
CN2909300000000,29,093,Iron County, MO,Feb-18,3483,3236,247,7.1
CN2909300000000,29,093,Iron County, MO,Mar-18,3474,3248,226,6.5
CN2909300000000,29,093,Iron County, MO,Apr-18(p),3487,3289,198,5.7
CN1306900000000,13,069,Coffee County, GA,Mar-17,18499,17488,1011,5.5
CN1306900000000,13,069,Coffee County, GA,Apr-17,18345,17430,915,5.0
CN1306900000000,13,069,Coffee County, GA,May-17,18310,17419,891,4.9
CN1306900000000,13,069,Coffee County, GA,Jun-17,18549,17384,1165,6.3
CN1306900000000,13,069,Coffee County, GA,Jul-17,18541,17542,999,5.4
CN1306900000000,13,069,Coffee County, GA,Aug-17,18377,17481,896,4.9
CN1306900000000,13,069,Coffee County, GA,Sep-17,18455,17621,834,4.5
CN1306900000000,13,069,Coffee County, GA,Oct-17,18317,17513,804,4.4
CN1306900000000,13,069,Coffee County, GA,Nov-17,18376,17557,819,4.5
CN1306900000000,13,069,Coffee County, GA,Dec-17,18403,17499,904,4.9
CN1306900000000,13,069,Coffee County, GA,Jan-18,18825,17641,1184,6.3
CN1306900000000,13,069,Coffee County, GA,Feb-18,18761,17772,989,5.3
CN1306900000000,13,069,Coffee County, GA,Mar-18,18715,17816,899,4.8
CN1306900000000,13,069,Coffee County, GA,Apr-18(p),18688,17895,793,4.2
CN4009700000000,40,097,Mayes County, OK,Mar-17,19203,18259,944,4.9
CN4009700000000,40,097,Mayes County, OK,Apr-17,19224,18349,875,4.6
CN4009700000000,40,097,Mayes County, OK,May-17,19201,18268,933,4.9
CN4009700000000,40,097,Mayes County, OK,Jun-17,19264,18276,988,5.1
CN4009700000000,40,097,Mayes County, OK,Jul-17,18831,17906,925,4.9
CN4009700000000,40,097,Mayes County, OK,Aug-17,19129,18213,916,4.8
CN4009700000000,40,097,Mayes County, OK,Sep-17,19564,18698,866,4.4
CN4009700000000,40,097,Mayes County, OK,Oct-17,18999,18171,828,4.4
CN4009700000000,40,097,Mayes County, OK,Nov-17,19067,18254,813,4.3
CN4009700000000,40,097,Mayes County, OK,Dec-17,18915,18066,849,4.5
CN4009700000000,40,097,Mayes County, OK,Jan-18,18881,17968,913,4.8
CN4009700000000,40,097,Mayes County, OK,Feb-18,19517,18697,820,4.2
CN4009700000000,40,097,Mayes County, OK,Mar-18,19625,18857,768,3.9
CN4009700000000,40,097,Mayes County, OK,Apr-18(p),19556,18815,741,3.8
CN0210500000000,02,105,Hoonah-Angoon Census Area, AK,Mar-17,983,807,176,17.9
CN0210500000000,02,105,Hoonah-Angoon Census Area, AK,Apr-17,1012,861,151,14.9
CN0210500000000,02,105,Hoonah-Angoon Census Area, AK,May-17,1265,1139,126,10.0
CN0210500000000,02,105,Hoonah-Angoon Census Area, AK,Jun-17,1379,1263,116,8.4
CN0210500000000,02,105,Hoonah-Angoon Census Area, AK,Jul-17,1411,1305,106,7.5
CN0210500000000,02,105,Hoonah-Angoon Census Area, AK,Aug-17,1397,1292,105,7.5
CN0210500000000,02,105,Hoonah-Angoon Census Area, AK,Sep-17,1312,1214,98,7.5
CN0210500000000,02,105,Hoonah-Angoon Census Area, AK,Oct-17,994,871,123,12.4
CN0210500000000,02,105,Hoonah-Angoon Census Area, AK,Nov-17,992,829,163,16.4
CN0210500000000,02,105,Hoonah-Angoon Census Area, AK,Dec-17,1012,825,187,18.5
CN0210500000000,02,105,Hoonah-Angoon Census Area, AK,Jan-18,961,756,205,21.3
CN0210500000000,02,105,Hoonah-Angoon Census Area, AK,Feb-18,1019,792,227,22.3
CN0210500000000,02,105,Hoonah-Angoon Census Area, AK,Mar-18,1026,816,210,20.5
CN0210500000000,02,105,Hoonah-Angoon Census Area, AK,Apr-18(p),1034,859,175,16.9
CN4818100000000,48,181,Grayson County, TX,Mar-17,62161,59832,2329,3.7
CN4818100000000,48,181,Grayson County, TX,Apr-17,62038,59933,2105,3.4
CN4818100000000,48,181,Grayson County, TX,May-17,62025,59880,2145,3.5
CN4818100000000,48,181,Grayson County, TX,Jun-17,62070,59779,2291,3.7
CN4818100000000,48,181,Grayson County, TX,Jul-17,62524,60259,2265,3.6
CN4818100000000,48,181,Grayson County, TX,Aug-17,62196,59945,2251,3.6
CN4818100000000,48,181,Grayson County, TX,Sep-17,62261,60254,2007,3.2
CN4818100000000,48,181,Grayson County, TX,Oct-17,61739,59884,1855,3.0
CN4818100000000,48,181,Grayson County, TX,Nov-17,62171,60226,1945,3.1
CN4818100000000,48,181,Grayson County, TX,Dec-17,62045,60201,1844,3.0
CN4818100000000,48,181,Grayson County, TX,Jan-18,62055,59931,2124,3.4
CN4818100000000,48,181,Grayson County, TX,Feb-18,63138,60972,2166,3.4
CN4818100000000,48,181,Grayson County, TX,Mar-18,63487,61282,2205,3.5
CN4818100000000,48,181,Grayson County, TX,Apr-18(p),63432,61453,1979,3.1
CN4807500000000,48,075,Childress County, TX,Mar-17,2917,2830,87,3.0
CN4807500000000,48,075,Childress County, TX,Apr-17,2951,2874,77,2.6
CN4807500000000,48,075,Childress County, TX,May-17,2944,2859,85,2.9
CN4807500000000,48,075,Childress County, TX,Jun-17,2952,2862,90,3.0
CN4807500000000,48,075,Childress County, TX,Jul-17,2978,2887,91,3.1
CN4807500000000,48,075,Childress County, TX,Aug-17,2963,2876,87,2.9
CN4807500000000,48,075,Childress County, TX,Sep-17,2902,2817,85,2.9
CN4807500000000,48,075,Childress County, TX,Oct-17,2866,2783,83,2.9
CN4807500000000,48,075,Childress County, TX,Nov-17,2840,2750,90,3.2
CN4807500000000,48,075,Childress County, TX,Dec-17,2850,2775,75,2.6
CN4807500000000,48,075,Childress County, TX,Jan-18,2854,2772,82,2.9
CN4807500000000,48,075,Childress County, TX,Feb-18,2877,2792,85,3.0
CN4807500000000,48,075,Childress County, TX,Mar-18,2927,2841,86,2.9
CN4807500000000,48,075,Childress County, TX,Apr-18(p),2917,2843,74,2.5
CN0806300000000,08,063,Kit Carson County, CO,Mar-17,4352,4271,81,1.9
CN0806300000000,08,063,Kit Carson County, CO,Apr-17,4554,4482,72,1.6
CN0806300000000,08,063,Kit Carson County, CO,May-17,4652,4580,72,1.5
CN0806300000000,08,063,Kit Carson County, CO,Jun-17,4668,4579,89,1.9
CN0806300000000,08,063,Kit Carson County, CO,Jul-17,4765,4686,79,1.7
CN0806300000000,08,063,Kit Carson County, CO,Aug-17,4637,4556,81,1.7
CN0806300000000,08,063,Kit Carson County, CO,Sep-17,4586,4508,78,1.7
CN0806300000000,08,063,Kit Carson County, CO,Oct-17,4837,4751,86,1.8
CN0806300000000,08,063,Kit Carson County, CO,Nov-17,4739,4655,84,1.8
CN0806300000000,08,063,Kit Carson County, CO,Dec-17,4654,4570,84,1.8
CN0806300000000,08,063,Kit Carson County, CO,Jan-18,4555,4459,96,2.1
CN0806300000000,08,063,Kit Carson County, CO,Feb-18,4390,4281,109,2.5
CN0806300000000,08,063,Kit Carson County, CO,Mar-18,4433,4340,93,2.1
CN0806300000000,08,063,Kit Carson County, CO,Apr-18(p),4583,4496,87,1.9
CN1901100000000,19,011,Benton County, IA,Mar-17,13423,12914,509,3.8
CN1901100000000,19,011,Benton County, IA,Apr-17,13433,13029,404,3.0
CN1901100000000,19,011,Benton County, IA,May-17,13393,12989,404,3.0
CN1901100000000,19,011,Benton County, IA,Jun-17,13640,13208,432,3.2
CN1901100000000,19,011,Benton County, IA,Jul-17,13710,13286,424,3.1
CN1901100000000,19,011,Benton County, IA,Aug-17,13526,13097,429,3.2
CN1901100000000,19,011,Benton County, IA,Sep-17,13436,13038,398,3.0
CN1901100000000,19,011,Benton County, IA,Oct-17,13457,13126,331,2.5
CN1901100000000,19,011,Benton County, IA,Nov-17,13389,13040,349,2.6
CN1901100000000,19,011,Benton County, IA,Dec-17,13363,12936,427,3.2
CN1901100000000,19,011,Benton County, IA,Jan-18,13366,12798,568,4.2
CN1901100000000,19,011,Benton County, IA,Feb-18,13453,12938,515,3.8
CN1901100000000,19,011,Benton County, IA,Mar-18,13361,12917,444,3.3
CN1901100000000,19,011,Benton County, IA,Apr-18(p),13366,13022,344,2.6
CN3916900000000,39,169,Wayne County, OH,Mar-17,62519,60007,2512,4.0
CN3916900000000,39,169,Wayne County, OH,Apr-17,62308,60158,2150,3.5
CN3916900000000,39,169,Wayne County, OH,May-17,61663,59499,2164,3.5
CN3916900000000,39,169,Wayne County, OH,Jun-17,61826,59333,2493,4.0
CN3916900000000,39,169,Wayne County, OH,Jul-17,61128,58641,2487,4.1
CN3916900000000,39,169,Wayne County, OH,Aug-17,62589,60093,2496,4.0
CN3916900000000,39,169,Wayne County, OH,Sep-17,61685,59412,2273,3.7
CN3916900000000,39,169,Wayne County, OH,Oct-17,61865,59677,2188,3.5
CN3916900000000,39,169,Wayne County, OH,Nov-17,61980,59717,2263,3.7
CN3916900000000,39,169,Wayne County, OH,Dec-17,60636,58340,2296,3.8
CN3916900000000,39,169,Wayne County, OH,Jan-18,60320,57903,2417,4.0
CN3916900000000,39,169,Wayne County, OH,Feb-18,62024,59714,2310,3.7
CN3916900000000,39,169,Wayne County, OH,Mar-18,62698,60616,2082,3.3
CN3916900000000,39,169,Wayne County, OH,Apr-18(p),62356,60449,1907,3.1
CN2600100000000,26,001,Alcona County, MI,Mar-17,3743,3425,318,8.5
CN2600100000000,26,001,Alcona County, MI,Apr-17,3726,3481,245,6.6
CN2600100000000,26,001,Alcona County, MI,May-17,3918,3678,240,6.1
CN2600100000000,26,001,Alcona County, MI,Jun-17,3983,3734,249,6.3
CN2600100000000,26,001,Alcona County, MI,Jul-17,4026,3734,292,7.3
CN2600100000000,26,001,Alcona County, MI,Aug-17,3966,3695,271,6.8
CN2600100000000,26,001,Alcona County, MI,Sep-17,3914,3681,233,6.0
CN2600100000000,26,001,Alcona County, MI,Oct-17,3844,3619,225,5.9
CN2600100000000,26,001,Alcona County, MI,Nov-17,3815,3545,270,7.1
CN2600100000000,26,001,Alcona County, MI,Dec-17,3807,3481,326,8.6
CN2600100000000,26,001,Alcona County, MI,Jan-18,3806,3445,361,9.5
CN2600100000000,26,001,Alcona County, MI,Feb-18,3853,3487,366,9.5
CN2600100000000,26,001,Alcona County, MI,Mar-18,3833,3489,344,9.0
CN2600100000000,26,001,Alcona County, MI,Apr-18(p),3831,3552,279,7.3
CN1702700000000,17,027,Clinton County, IL,Mar-17,20247,19494,753,3.7
CN1702700000000,17,027,Clinton County, IL,Apr-17,20367,19750,617,3.0
CN1702700000000,17,027,Clinton County, IL,May-17,20231,19634,597,3.0
CN1702700000000,17,027,Clinton County, IL,Jun-17,20487,19800,687,3.4
CN1702700000000,17,027,Clinton County, IL,Jul-17,20393,19689,704,3.5
CN1702700000000,17,027,Clinton County, IL,Aug-17,20219,19513,706,3.5
CN1702700000000,17,027,Clinton County, IL,Sep-17,20176,19560,616,3.1
CN1702700000000,17,027,Clinton County, IL,Oct-17,20189,19586,603,3.0
CN1702700000000,17,027,Clinton County, IL,Nov-17,20210,19573,637,3.2
CN1702700000000,17,027,Clinton County, IL,Dec-17,19960,19349,611,3.1
CN1702700000000,17,027,Clinton County, IL,Jan-18,20053,19248,805,4.0
CN1702700000000,17,027,Clinton County, IL,Feb-18,20204,19515,689,3.4
CN1702700000000,17,027,Clinton County, IL,Mar-18,20560,19872,688,3.3
CN1702700000000,17,027,Clinton County, IL,Apr-18(p),20636,20109,527,2.6
CN2607900000000,26,079,Kalkaska County, MI,Mar-17,7573,6905,668,8.8
CN2607900000000,26,079,Kalkaska County, MI,Apr-17,7551,6991,560,7.4
CN2607900000000,26,079,Kalkaska County, MI,May-17,7710,7233,477,6.2
CN2607900000000,26,079,Kalkaska County, MI,Jun-17,8099,7601,498,6.1
CN2607900000000,26,079,Kalkaska County, MI,Jul-17,8360,7784,576,6.9
CN2607900000000,26,079,Kalkaska County, MI,Aug-17,8144,7640,504,6.2
CN2607900000000,26,079,Kalkaska County, MI,Sep-17,7787,7356,431,5.5
CN2607900000000,26,079,Kalkaska County, MI,Oct-17,7679,7279,400,5.2
CN2607900000000,26,079,Kalkaska County, MI,Nov-17,7668,7202,466,6.1
CN2607900000000,26,079,Kalkaska County, MI,Dec-17,7699,7127,572,7.4
CN2607900000000,26,079,Kalkaska County, MI,Jan-18,7659,6969,690,9.0
CN2607900000000,26,079,Kalkaska County, MI,Feb-18,7755,6997,758,9.8
CN2607900000000,26,079,Kalkaska County, MI,Mar-18,7703,7032,671,8.7
CN2607900000000,26,079,Kalkaska County, MI,Apr-18(p),7690,7121,569,7.4
CN4846700000000,48,467,Van Zandt County, TX,Mar-17,25321,24344,977,3.9
CN4846700000000,48,467,Van Zandt County, TX,Apr-17,25156,24276,880,3.5
CN4846700000000,48,467,Van Zandt County, TX,May-17,25387,24497,890,3.5
CN4846700000000,48,467,Van Zandt County, TX,Jun-17,25737,24742,995,3.9
CN4846700000000,48,467,Van Zandt County, TX,Jul-17,25630,24618,1012,3.9
CN4846700000000,48,467,Van Zandt County, TX,Aug-17,25471,24466,1005,3.9
CN4846700000000,48,467,Van Zandt County, TX,Sep-17,25324,24426,898,3.5
CN4846700000000,48,467,Van Zandt County, TX,Oct-17,25127,24300,827,3.3
CN4846700000000,48,467,Van Zandt County, TX,Nov-17,25265,24399,866,3.4
CN4846700000000,48,467,Van Zandt County, TX,Dec-17,25225,24401,824,3.3
CN4846700000000,48,467,Van Zandt County, TX,Jan-18,25418,24487,931,3.7
CN4846700000000,48,467,Van Zandt County, TX,Feb-18,25772,24841,931,3.6
CN4846700000000,48,467,Van Zandt County, TX,Mar-18,26043,25092,951,3.7
CN4846700000000,48,467,Van Zandt County, TX,Apr-18(p),25825,24957,868,3.4
CN2117700000000,21,177,Muhlenberg County, KY,Mar-17,12013,11163,850,7.1
CN2117700000000,21,177,Muhlenberg County, KY,Apr-17,11874,11128,746,6.3
CN2117700000000,21,177,Muhlenberg County, KY,May-17,11793,10969,824,7.0
CN2117700000000,21,177,Muhlenberg County, KY,Jun-17,11922,10997,925,7.8
CN2117700000000,21,177,Muhlenberg County, KY,Jul-17,11673,10828,845,7.2
CN2117700000000,21,177,Muhlenberg County, KY,Aug-17,11583,10800,783,6.8
CN2117700000000,21,177,Muhlenberg County, KY,Sep-17,11662,11015,647,5.5
CN2117700000000,21,177,Muhlenberg County, KY,Oct-17,11495,10891,604,5.3
CN2117700000000,21,177,Muhlenberg County, KY,Nov-17,11540,10934,606,5.3
CN2117700000000,21,177,Muhlenberg County, KY,Dec-17,11400,10772,628,5.5
CN2117700000000,21,177,Muhlenberg County, KY,Jan-18,11591,10796,795,6.9
CN2117700000000,21,177,Muhlenberg County, KY,Feb-18,11798,10964,834,7.1
CN2117700000000,21,177,Muhlenberg County, KY,Mar-18,12129,11334,795,6.6
CN2117700000000,21,177,Muhlenberg County, KY,Apr-18(p),12094,11410,684,5.7
CN4828100000000,48,281,Lampasas County, TX,Mar-17,9252,8895,357,3.9
CN4828100000000,48,281,Lampasas County, TX,Apr-17,9258,8944,314,3.4
CN4828100000000,48,281,Lampasas County, TX,May-17,9281,8959,322,3.5
CN4828100000000,48,281,Lampasas County, TX,Jun-17,9245,8904,341,3.7
CN4828100000000,48,281,Lampasas County, TX,Jul-17,9222,8868,354,3.8
CN4828100000000,48,281,Lampasas County, TX,Aug-17,9224,8870,354,3.8
CN4828100000000,48,281,Lampasas County, TX,Sep-17,9242,8920,322,3.5
CN4828100000000,48,281,Lampasas County, TX,Oct-17,9214,8912,302,3.3
CN4828100000000,48,281,Lampasas County, TX,Nov-17,9244,8924,320,3.5
CN4828100000000,48,281,Lampasas County, TX,Dec-17,9226,8919,307,3.3
CN4828100000000,48,281,Lampasas County, TX,Jan-18,9232,8896,336,3.6
CN4828100000000,48,281,Lampasas County, TX,Feb-18,9364,9023,341,3.6
CN4828100000000,48,281,Lampasas County, TX,Mar-18,9436,9087,349,3.7
CN4828100000000,48,281,Lampasas County, TX,Apr-18(p),9431,9108,323,3.4
CN2102500000000,21,025,Breathitt County, KY,Mar-17,4064,3652,412,10.1
CN2102500000000,21,025,Breathitt County, KY,Apr-17,4011,3669,342,8.5
CN2102500000000,21,025,Breathitt County, KY,May-17,4005,3659,346,8.6
CN2102500000000,21,025,Breathitt County, KY,Jun-17,4032,3656,376,9.3
CN2102500000000,21,025,Breathitt County, KY,Jul-17,3976,3616,360,9.1
CN2102500000000,21,025,Breathitt County, KY,Aug-17,3846,3534,312,8.1
CN2102500000000,21,025,Breathitt County, KY,Sep-17,3875,3593,282,7.3
CN2102500000000,21,025,Breathitt County, KY,Oct-17,3811,3565,246,6.5
CN2102500000000,21,025,Breathitt County, KY,Nov-17,3844,3605,239,6.2
CN2102500000000,21,025,Breathitt County, KY,Dec-17,3850,3604,246,6.4
CN2102500000000,21,025,Breathitt County, KY,Jan-18,3910,3614,296,7.6
CN2102500000000,21,025,Breathitt County, KY,Feb-18,3938,3628,310,7.9
CN2102500000000,21,025,Breathitt County, KY,Mar-18,3962,3675,287,7.2
CN2102500000000,21,025,Breathitt County, KY,Apr-18(p),3934,3684,250,6.4
CN3602100000000,36,021,Columbia County, NY,Mar-17,31090,29783,1307,4.2
CN3602100000000,36,021,Columbia County, NY,Apr-17,31277,30130,1147,3.7
CN3602100000000,36,021,Columbia County, NY,May-17,31169,30050,1119,3.6
CN3602100000000,36,021,Columbia County, NY,Jun-17,32015,30875,1140,3.6
CN3602100000000,36,021,Columbia County, NY,Jul-17,32273,31085,1188,3.7
CN3602100000000,36,021,Columbia County, NY,Aug-17,32032,30861,1171,3.7
CN3602100000000,36,021,Columbia County, NY,Sep-17,31609,30459,1150,3.6
CN3602100000000,36,021,Columbia County, NY,Oct-17,31426,30333,1093,3.5
CN3602100000000,36,021,Columbia County, NY,Nov-17,31499,30403,1096,3.5
CN3602100000000,36,021,Columbia County, NY,Dec-17,31202,30015,1187,3.8
CN3602100000000,36,021,Columbia County, NY,Jan-18,31489,30007,1482,4.7
CN3602100000000,36,021,Columbia County, NY,Feb-18,31206,29650,1556,5.0
CN3602100000000,36,021,Columbia County, NY,Mar-18,30658,29276,1382,4.5
CN3602100000000,36,021,Columbia County, NY,Apr-18(p),30945,29754,1191,3.8
CN3605300000000,36,053,Madison County, NY,Mar-17,32978,30958,2020,6.1
CN3605300000000,36,053,Madison County, NY,Apr-17,32914,31144,1770,5.4
CN3605300000000,36,053,Madison County, NY,May-17,32348,30754,1594,4.9
CN3605300000000,36,053,Madison County, NY,Jun-17,32994,31234,1760,5.3
CN3605300000000,36,053,Madison County, NY,Jul-17,32995,31221,1774,5.4
CN3605300000000,36,053,Madison County, NY,Aug-17,32640,30972,1668,5.1
CN3605300000000,36,053,Madison County, NY,Sep-17,32715,31072,1643,5.0
CN3605300000000,36,053,Madison County, NY,Oct-17,32563,31011,1552,4.8
CN3605300000000,36,053,Madison County, NY,Nov-17,32896,31175,1721,5.2
CN3605300000000,36,053,Madison County, NY,Dec-17,32541,30655,1886,5.8
CN3605300000000,36,053,Madison County, NY,Jan-18,32981,30655,2326,7.1
CN3605300000000,36,053,Madison County, NY,Feb-18,32788,30420,2368,7.2
CN3605300000000,36,053,Madison County, NY,Mar-18,32373,30211,2162,6.7
CN3605300000000,36,053,Madison County, NY,Apr-18(p),32556,30712,1844,5.7
CN1323700000000,13,237,Putnam County, GA,Mar-17,8188,7695,493,6.0
CN1323700000000,13,237,Putnam County, GA,Apr-17,8086,7633,453,5.6
CN1323700000000,13,237,Putnam County, GA,May-17,8115,7663,452,5.6
CN1323700000000,13,237,Putnam County, GA,Jun-17,8171,7692,479,5.9
CN1323700000000,13,237,Putnam County, GA,Jul-17,8173,7682,491,6.0
CN1323700000000,13,237,Putnam County, GA,Aug-17,8102,7613,489,6.0
CN1323700000000,13,237,Putnam County, GA,Sep-17,8148,7718,430,5.3
CN1323700000000,13,237,Putnam County, GA,Oct-17,8175,7741,434,5.3
CN1323700000000,13,237,Putnam County, GA,Nov-17,8149,7725,424,5.2
CN1323700000000,13,237,Putnam County, GA,Dec-17,8142,7706,436,5.4
CN1323700000000,13,237,Putnam County, GA,Jan-18,8195,7700,495,6.0
CN1323700000000,13,237,Putnam County, GA,Feb-18,8189,7719,470,5.7
CN1323700000000,13,237,Putnam County, GA,Mar-18,8214,7781,433,5.3
CN1323700000000,13,237,Putnam County, GA,Apr-18(p),8207,7823,384,4.7
CN0108100000000,01,081,Lee County, AL,Mar-17,74334,70919,3415,4.6
CN0108100000000,01,081,Lee County, AL,Apr-17,73562,70922,2640,3.6
CN0108100000000,01,081,Lee County, AL,May-17,72762,70149,2613,3.6
CN0108100000000,01,081,Lee County, AL,Jun-17,73280,70003,3277,4.5
CN0108100000000,01,081,Lee County, AL,Jul-17,73019,70009,3010,4.1
CN0108100000000,01,081,Lee County, AL,Aug-17,72707,69822,2885,4.0
CN0108100000000,01,081,Lee County, AL,Sep-17,73324,70956,2368,3.2
CN0108100000000,01,081,Lee County, AL,Oct-17,73808,71452,2356,3.2
CN0108100000000,01,081,Lee County, AL,Nov-17,73861,71577,2284,3.1
CN0108100000000,01,081,Lee County, AL,Dec-17,73629,71434,2195,3.0
CN0108100000000,01,081,Lee County, AL,Jan-18,72685,69981,2704,3.7
CN0108100000000,01,081,Lee County, AL,Feb-18,74098,71305,2793,3.8
CN0108100000000,01,081,Lee County, AL,Mar-18,74342,71662,2680,3.6
CN0108100000000,01,081,Lee County, AL,Apr-18(p),74769,72440,2329,3.1
CN2914900000000,29,149,Oregon County, MO,Mar-17,4061,3857,204,5.0
CN2914900000000,29,149,Oregon County, MO,Apr-17,4113,3928,185,4.5
CN2914900000000,29,149,Oregon County, MO,May-17,4122,3898,224,5.4
CN2914900000000,29,149,Oregon County, MO,Jun-17,3988,3793,195,4.9
CN2914900000000,29,149,Oregon County, MO,Jul-17,3726,3523,203,5.4
CN2914900000000,29,149,Oregon County, MO,Aug-17,3931,3737,194,4.9
CN2914900000000,29,149,Oregon County, MO,Sep-17,3912,3762,150,3.8
CN2914900000000,29,149,Oregon County, MO,Oct-17,3934,3823,111,2.8
CN2914900000000,29,149,Oregon County, MO,Nov-17,3942,3803,139,3.5
CN2914900000000,29,149,Oregon County, MO,Dec-17,3883,3739,144,3.7
CN2914900000000,29,149,Oregon County, MO,Jan-18,3909,3748,161,4.1
CN2914900000000,29,149,Oregon County, MO,Feb-18,3937,3774,163,4.1
CN2914900000000,29,149,Oregon County, MO,Mar-18,3954,3789,165,4.2
CN2914900000000,29,149,Oregon County, MO,Apr-18(p),3964,3824,140,3.5
CN4712500000000,47,125,Montgomery County, TN,Mar-17,81153,77593,3560,4.4
CN4712500000000,47,125,Montgomery County, TN,Apr-17,81006,77970,3036,3.7
CN4712500000000,47,125,Montgomery County, TN,May-17,80823,77930,2893,3.6
CN4712500000000,47,125,Montgomery County, TN,Jun-17,81418,77787,3631,4.5
CN4712500000000,47,125,Montgomery County, TN,Jul-17,81235,77671,3564,4.4
CN4712500000000,47,125,Montgomery County, TN,Aug-17,81056,77675,3381,4.2
CN4712500000000,47,125,Montgomery County, TN,Sep-17,81578,78578,3000,3.7
CN4712500000000,47,125,Montgomery County, TN,Oct-17,80882,78048,2834,3.5
CN4712500000000,47,125,Montgomery County, TN,Nov-17,80947,78087,2860,3.5
CN4712500000000,47,125,Montgomery County, TN,Dec-17,80373,77669,2704,3.4
CN4712500000000,47,125,Montgomery County, TN,Jan-18,80486,77270,3216,4.0
CN4712500000000,47,125,Montgomery County, TN,Feb-18,82013,78889,3124,3.8
CN4712500000000,47,125,Montgomery County, TN,Mar-18,82030,79010,3020,3.7
CN4712500000000,47,125,Montgomery County, TN,Apr-18(p),82690,80151,2539,3.1
CN0503300000000,05,033,Crawford County, AR,Mar-17,26684,25807,877,3.3
CN0503300000000,05,033,Crawford County, AR,Apr-17,26670,25877,793,3.0
CN0503300000000,05,033,Crawford County, AR,May-17,26869,25946,923,3.4
CN0503300000000,05,033,Crawford County, AR,Jun-17,27125,26098,1027,3.8
CN0503300000000,05,033,Crawford County, AR,Jul-17,27169,26094,1075,4.0
CN0503300000000,05,033,Crawford County, AR,Aug-17,26911,25918,993,3.7
CN0503300000000,05,033,Crawford County, AR,Sep-17,26799,25865,934,3.5
CN0503300000000,05,033,Crawford County, AR,Oct-17,26533,25683,850,3.2
CN0503300000000,05,033,Crawford County, AR,Nov-17,26440,25573,867,3.3
CN0503300000000,05,033,Crawford County, AR,Dec-17,26203,25274,929,3.5
CN0503300000000,05,033,Crawford County, AR,Jan-18,25876,24776,1100,4.3
CN0503300000000,05,033,Crawford County, AR,Feb-18,26200,25086,1114,4.3
CN0503300000000,05,033,Crawford County, AR,Mar-18,26305,25314,991,3.8
CN0503300000000,05,033,Crawford County, AR,Apr-18(p),26264,25353,911,3.5
CN3403700000000,34,037,Sussex County, NJ,Mar-17,75716,72238,3478,4.6
CN3403700000000,34,037,Sussex County, NJ,Apr-17,75356,72365,2991,4.0
CN3403700000000,34,037,Sussex County, NJ,May-17,75414,72345,3069,4.1
CN3403700000000,34,037,Sussex County, NJ,Jun-17,75992,72727,3265,4.3
CN3403700000000,34,037,Sussex County, NJ,Jul-17,76295,72602,3693,4.8
CN3403700000000,34,037,Sussex County, NJ,Aug-17,75327,71814,3513,4.7
CN3403700000000,34,037,Sussex County, NJ,Sep-17,74687,71502,3185,4.3
CN3403700000000,34,037,Sussex County, NJ,Oct-17,74780,71785,2995,4.0
CN3403700000000,34,037,Sussex County, NJ,Nov-17,74375,71480,2895,3.9
CN3403700000000,34,037,Sussex County, NJ,Dec-17,74362,71473,2889,3.9
CN3403700000000,34,037,Sussex County, NJ,Jan-18,74322,70758,3564,4.8
CN3403700000000,34,037,Sussex County, NJ,Feb-18,75145,71460,3685,4.9
CN3403700000000,34,037,Sussex County, NJ,Mar-18,74428,70933,3495,4.7
CN3403700000000,34,037,Sussex County, NJ,Apr-18(p),73587,70705,2882,3.9
CN2207500000000,22,075,Plaquemines Parish, LA,Mar-17,10083,9613,470,4.7
CN2207500000000,22,075,Plaquemines Parish, LA,Apr-17,10144,9695,449,4.4
CN2207500000000,22,075,Plaquemines Parish, LA,May-17,10228,9780,448,4.4
CN2207500000000,22,075,Plaquemines Parish, LA,Jun-17,10382,9859,523,5.0
CN2207500000000,22,075,Plaquemines Parish, LA,Jul-17,10322,9810,512,5.0
CN2207500000000,22,075,Plaquemines Parish, LA,Aug-17,10169,9652,517,5.1
CN2207500000000,22,075,Plaquemines Parish, LA,Sep-17,10099,9643,456,4.5
CN2207500000000,22,075,Plaquemines Parish, LA,Oct-17,10087,9680,407,4.0
CN2207500000000,22,075,Plaquemines Parish, LA,Nov-17,10093,9690,403,4.0
CN2207500000000,22,075,Plaquemines Parish, LA,Dec-17,10077,9685,392,3.9
CN2207500000000,22,075,Plaquemines Parish, LA,Jan-18,10172,9738,434,4.3
CN2207500000000,22,075,Plaquemines Parish, LA,Feb-18,10216,9830,386,3.8
CN2207500000000,22,075,Plaquemines Parish, LA,Mar-18,10300,9872,428,4.2
CN2207500000000,22,075,Plaquemines Parish, LA,Apr-18(p),10322,9886,436,4.2
CN4005100000000,40,051,Grady County, OK,Mar-17,25933,24842,1091,4.2
CN4005100000000,40,051,Grady County, OK,Apr-17,25892,24911,981,3.8
CN4005100000000,40,051,Grady County, OK,May-17,25830,24752,1078,4.2
CN4005100000000,40,051,Grady County, OK,Jun-17,26122,24967,1155,4.4
CN4005100000000,40,051,Grady County, OK,Jul-17,26257,25193,1064,4.1
CN4005100000000,40,051,Grady County, OK,Aug-17,26114,25047,1067,4.1
CN4005100000000,40,051,Grady County, OK,Sep-17,26310,25300,1010,3.8
CN4005100000000,40,051,Grady County, OK,Oct-17,26421,25425,996,3.8
CN4005100000000,40,051,Grady County, OK,Nov-17,26518,25553,965,3.6
CN4005100000000,40,051,Grady County, OK,Dec-17,26240,25285,955,3.6
CN4005100000000,40,051,Grady County, OK,Jan-18,25975,24947,1028,4.0
CN4005100000000,40,051,Grady County, OK,Feb-18,26357,25389,968,3.7
CN4005100000000,40,051,Grady County, OK,Mar-18,26447,25519,928,3.5
CN4005100000000,40,051,Grady County, OK,Apr-18(p),26297,25423,874,3.3
CN1710100000000,17,101,Lawrence County, IL,Mar-17,6154,5772,382,6.2
CN1710100000000,17,101,Lawrence County, IL,Apr-17,6094,5772,322,5.3
CN1710100000000,17,101,Lawrence County, IL,May-17,6062,5743,319,5.3
CN1710100000000,17,101,Lawrence County, IL,Jun-17,6050,5698,352,5.8
CN1710100000000,17,101,Lawrence County, IL,Jul-17,6001,5638,363,6.0
CN1710100000000,17,101,Lawrence County, IL,Aug-17,5977,5606,371,6.2
CN1710100000000,17,101,Lawrence County, IL,Sep-17,5950,5639,311,5.2
CN1710100000000,17,101,Lawrence County, IL,Oct-17,5956,5667,289,4.9
CN1710100000000,17,101,Lawrence County, IL,Nov-17,5954,5639,315,5.3
CN1710100000000,17,101,Lawrence County, IL,Dec-17,5949,5615,334,5.6
CN1710100000000,17,101,Lawrence County, IL,Jan-18,5930,5590,340,5.7
CN1710100000000,17,101,Lawrence County, IL,Feb-18,5968,5641,327,5.5
CN1710100000000,17,101,Lawrence County, IL,Mar-18,6078,5751,327,5.4
CN1710100000000,17,101,Lawrence County, IL,Apr-18(p),6000,5741,259,4.3
CN3709500000000,37,095,Hyde County, NC,Mar-17,2018,1782,236,11.7
CN3709500000000,37,095,Hyde County, NC,Apr-17,2109,1934,175,8.3
CN3709500000000,37,095,Hyde County, NC,May-17,2136,1981,155,7.3
CN3709500000000,37,095,Hyde County, NC,Jun-17,2270,2123,147,6.5
CN3709500000000,37,095,Hyde County, NC,Jul-17,2386,2247,139,5.8
CN3709500000000,37,095,Hyde County, NC,Aug-17,2227,2096,131,5.9
CN3709500000000,37,095,Hyde County, NC,Sep-17,2197,2078,119,5.4
CN3709500000000,37,095,Hyde County, NC,Oct-17,2149,2034,115,5.4
CN3709500000000,37,095,Hyde County, NC,Nov-17,2016,1872,144,7.1
CN3709500000000,37,095,Hyde County, NC,Dec-17,1969,1766,203,10.3
CN3709500000000,37,095,Hyde County, NC,Jan-18,1976,1687,289,14.6
CN3709500000000,37,095,Hyde County, NC,Feb-18,2049,1745,304,14.8
CN3709500000000,37,095,Hyde County, NC,Mar-18,2011,1755,256,12.7
CN3709500000000,37,095,Hyde County, NC,Apr-18(p),2076,1912,164,7.9
CN5507100000000,55,071,Manitowoc County, WI,Mar-17,41890,40241,1649,3.9
CN5507100000000,55,071,Manitowoc County, WI,Apr-17,41698,40318,1380,3.3
CN5507100000000,55,071,Manitowoc County, WI,May-17,41921,40521,1400,3.3
CN5507100000000,55,071,Manitowoc County, WI,Jun-17,42897,41232,1665,3.9
CN5507100000000,55,071,Manitowoc County, WI,Jul-17,42307,40796,1511,3.6
CN5507100000000,55,071,Manitowoc County, WI,Aug-17,41965,40481,1484,3.5
CN5507100000000,55,071,Manitowoc County, WI,Sep-17,42209,40893,1316,3.1
CN5507100000000,55,071,Manitowoc County, WI,Oct-17,42158,40906,1252,3.0
CN5507100000000,55,071,Manitowoc County, WI,Nov-17,41944,40707,1237,2.9
CN5507100000000,55,071,Manitowoc County, WI,Dec-17,41536,40301,1235,3.0
CN5507100000000,55,071,Manitowoc County, WI,Jan-18,41691,40213,1478,3.5
CN5507100000000,55,071,Manitowoc County, WI,Feb-18,41838,40288,1550,3.7
CN5507100000000,55,071,Manitowoc County, WI,Mar-18,42245,40728,1517,3.6
CN5507100000000,55,071,Manitowoc County, WI,Apr-18(p),41779,40551,1228,2.9
CN0610900000000,06,109,Tuolumne County, CA,Mar-17,21528,20183,1345,6.2
CN0610900000000,06,109,Tuolumne County, CA,Apr-17,21357,20162,1195,5.6
CN0610900000000,06,109,Tuolumne County, CA,May-17,21200,20146,1054,5.0
CN0610900000000,06,109,Tuolumne County, CA,Jun-17,21655,20536,1119,5.2
CN0610900000000,06,109,Tuolumne County, CA,Jul-17,21844,20660,1184,5.4
CN0610900000000,06,109,Tuolumne County, CA,Aug-17,21676,20538,1138,5.3
CN0610900000000,06,109,Tuolumne County, CA,Sep-17,21544,20544,1000,4.6
CN0610900000000,06,109,Tuolumne County, CA,Oct-17,21514,20529,985,4.6
CN0610900000000,06,109,Tuolumne County, CA,Nov-17,21358,20372,986,4.6
CN0610900000000,06,109,Tuolumne County, CA,Dec-17,21250,20237,1013,4.8
CN0610900000000,06,109,Tuolumne County, CA,Jan-18,21213,20065,1148,5.4
CN0610900000000,06,109,Tuolumne County, CA,Feb-18,21714,20519,1195,5.5
CN0610900000000,06,109,Tuolumne County, CA,Mar-18,21410,20311,1099,5.1
CN0610900000000,06,109,Tuolumne County, CA,Apr-18(p),21012,20055,957,4.6
CN1307500000000,13,075,Cook County, GA,Mar-17,7774,7408,366,4.7
CN1307500000000,13,075,Cook County, GA,Apr-17,7772,7425,347,4.5
CN1307500000000,13,075,Cook County, GA,May-17,7817,7477,340,4.3
CN1307500000000,13,075,Cook County, GA,Jun-17,7734,7362,372,4.8
CN1307500000000,13,075,Cook County, GA,Jul-17,7691,7332,359,4.7
CN1307500000000,13,075,Cook County, GA,Aug-17,7697,7328,369,4.8
CN1307500000000,13,075,Cook County, GA,Sep-17,7767,7420,347,4.5
CN1307500000000,13,075,Cook County, GA,Oct-17,7738,7417,321,4.1
CN1307500000000,13,075,Cook County, GA,Nov-17,7725,7421,304,3.9
CN1307500000000,13,075,Cook County, GA,Dec-17,7726,7405,321,4.2
CN1307500000000,13,075,Cook County, GA,Jan-18,7828,7484,344,4.4
CN1307500000000,13,075,Cook County, GA,Feb-18,7773,7430,343,4.4
CN1307500000000,13,075,Cook County, GA,Mar-18,7805,7492,313,4.0
CN1307500000000,13,075,Cook County, GA,Apr-18(p),7771,7498,273,3.5
CN4806900000000,48,069,Castro County, TX,Mar-17,3539,3419,120,3.4
CN4806900000000,48,069,Castro County, TX,Apr-17,3495,3392,103,2.9
CN4806900000000,48,069,Castro County, TX,May-17,3516,3406,110,3.1
CN4806900000000,48,069,Castro County, TX,Jun-17,3442,3320,122,3.5
CN4806900000000,48,069,Castro County, TX,Jul-17,3216,3095,121,3.8
CN4806900000000,48,069,Castro County, TX,Aug-17,3307,3193,114,3.4
CN4806900000000,48,069,Castro County, TX,Sep-17,3294,3193,101,3.1
CN4806900000000,48,069,Castro County, TX,Oct-17,3364,3270,94,2.8
CN4806900000000,48,069,Castro County, TX,Nov-17,3236,3145,91,2.8
CN4806900000000,48,069,Castro County, TX,Dec-17,3267,3176,91,2.8
CN4806900000000,48,069,Castro County, TX,Jan-18,3201,3103,98,3.1
CN4806900000000,48,069,Castro County, TX,Feb-18,3286,3178,108,3.3
CN4806900000000,48,069,Castro County, TX,Mar-18,3472,3365,107,3.1
CN4806900000000,48,069,Castro County, TX,Apr-18(p),3408,3311,97,2.8
CN3917500000000,39,175,Wyandot County, OH,Mar-17,12859,12363,496,3.9
CN3917500000000,39,175,Wyandot County, OH,Apr-17,12741,12318,423,3.3
CN3917500000000,39,175,Wyandot County, OH,May-17,12760,12338,422,3.3
CN3917500000000,39,175,Wyandot County, OH,Jun-17,12842,12356,486,3.8
CN3917500000000,39,175,Wyandot County, OH,Jul-17,12743,12263,480,3.8
CN3917500000000,39,175,Wyandot County, OH,Aug-17,12962,12494,468,3.6
CN3917500000000,39,175,Wyandot County, OH,Sep-17,12791,12364,427,3.3
CN3917500000000,39,175,Wyandot County, OH,Oct-17,12698,12307,391,3.1
CN3917500000000,39,175,Wyandot County, OH,Nov-17,12688,12287,401,3.2
CN3917500000000,39,175,Wyandot County, OH,Dec-17,12544,12103,441,3.5
CN3917500000000,39,175,Wyandot County, OH,Jan-18,12379,11918,461,3.7
CN3917500000000,39,175,Wyandot County, OH,Feb-18,12489,12051,438,3.5
CN3917500000000,39,175,Wyandot County, OH,Mar-18,12705,12307,398,3.1
CN3917500000000,39,175,Wyandot County, OH,Apr-18(p),12598,12235,363,2.9
CN4817500000000,48,175,Goliad County, TX,Mar-17,3296,3112,184,5.6
CN4817500000000,48,175,Goliad County, TX,Apr-17,3293,3123,170,5.2
CN4817500000000,48,175,Goliad County, TX,May-17,3273,3115,158,4.8
CN4817500000000,48,175,Goliad County, TX,Jun-17,3260,3104,156,4.8
CN4817500000000,48,175,Goliad County, TX,Jul-17,3228,3073,155,4.8
CN4817500000000,48,175,Goliad County, TX,Aug-17,3214,3060,154,4.8
CN4817500000000,48,175,Goliad County, TX,Sep-17,3207,3059,148,4.6
CN4817500000000,48,175,Goliad County, TX,Oct-17,3210,3077,133,4.1
CN4817500000000,48,175,Goliad County, TX,Nov-17,3211,3075,136,4.2
CN4817500000000,48,175,Goliad County, TX,Dec-17,3206,3085,121,3.8
CN4817500000000,48,175,Goliad County, TX,Jan-18,3180,3042,138,4.3
CN4817500000000,48,175,Goliad County, TX,Feb-18,3220,3076,144,4.5
CN4817500000000,48,175,Goliad County, TX,Mar-18,3238,3093,145,4.5
CN4817500000000,48,175,Goliad County, TX,Apr-18(p),3208,3083,125,3.9
CN3504900000000,35,049,Santa Fe County, NM,Mar-17,72417,68778,3639,5.0
CN3504900000000,35,049,Santa Fe County, NM,Apr-17,71202,67847,3355,4.7
CN3504900000000,35,049,Santa Fe County, NM,May-17,71997,68539,3458,4.8
CN3504900000000,35,049,Santa Fe County, NM,Jun-17,73136,69055,4081,5.6
CN3504900000000,35,049,Santa Fe County, NM,Jul-17,73758,69631,4127,5.6
CN3504900000000,35,049,Santa Fe County, NM,Aug-17,73653,69777,3876,5.3
CN3504900000000,35,049,Santa Fe County, NM,Sep-17,73038,69274,3764,5.2
CN3504900000000,35,049,Santa Fe County, NM,Oct-17,73660,70001,3659,5.0
CN3504900000000,35,049,Santa Fe County, NM,Nov-17,73880,70335,3545,4.8
CN3504900000000,35,049,Santa Fe County, NM,Dec-17,73571,70192,3379,4.6
CN3504900000000,35,049,Santa Fe County, NM,Jan-18,72799,69326,3473,4.8
CN3504900000000,35,049,Santa Fe County, NM,Feb-18,73361,69977,3384,4.6
CN3504900000000,35,049,Santa Fe County, NM,Mar-18,73298,70237,3061,4.2
CN3504900000000,35,049,Santa Fe County, NM,Apr-18(p),73279,70565,2714,3.7
CN1912900000000,19,129,Mills County, IA,Mar-17,7289,7071,218,3.0
CN1912900000000,19,129,Mills County, IA,Apr-17,7308,7109,199,2.7
CN1912900000000,19,129,Mills County, IA,May-17,7313,7125,188,2.6
CN1912900000000,19,129,Mills County, IA,Jun-17,7372,7165,207,2.8
CN1912900000000,19,129,Mills County, IA,Jul-17,7469,7267,202,2.7
CN1912900000000,19,129,Mills County, IA,Aug-17,7364,7162,202,2.7
CN1912900000000,19,129,Mills County, IA,Sep-17,7291,7108,183,2.5
CN1912900000000,19,129,Mills County, IA,Oct-17,7315,7163,152,2.1
CN1912900000000,19,129,Mills County, IA,Nov-17,7272,7128,144,2.0
CN1912900000000,19,129,Mills County, IA,Dec-17,7261,7080,181,2.5
CN1912900000000,19,129,Mills County, IA,Jan-18,7232,6998,234,3.2
CN1912900000000,19,129,Mills County, IA,Feb-18,7247,7035,212,2.9
CN1912900000000,19,129,Mills County, IA,Mar-18,7245,7074,171,2.4
CN1912900000000,19,129,Mills County, IA,Apr-18(p),7262,7112,150,2.1
CN2612500000000,26,125,Oakland County, MI,Mar-17,657328,634710,22618,3.4
CN2612500000000,26,125,Oakland County, MI,Apr-17,652182,635547,16635,2.6
CN2612500000000,26,125,Oakland County, MI,May-17,659798,642183,17615,2.7
CN2612500000000,26,125,Oakland County, MI,Jun-17,665157,643725,21432,3.2
CN2612500000000,26,125,Oakland County, MI,Jul-17,671589,645851,25738,3.8
CN2612500000000,26,125,Oakland County, MI,Aug-17,671467,644688,26779,4.0
CN2612500000000,26,125,Oakland County, MI,Sep-17,671980,647847,24133,3.6
CN2612500000000,26,125,Oakland County, MI,Oct-17,666101,643637,22464,3.4
CN2612500000000,26,125,Oakland County, MI,Nov-17,665178,644462,20716,3.1
CN2612500000000,26,125,Oakland County, MI,Dec-17,663281,642201,21080,3.2
CN2612500000000,26,125,Oakland County, MI,Jan-18,652392,627858,24534,3.8
CN2612500000000,26,125,Oakland County, MI,Feb-18,656644,632966,23678,3.6
CN2612500000000,26,125,Oakland County, MI,Mar-18,659549,637374,22175,3.4
CN2612500000000,26,125,Oakland County, MI,Apr-18(p),656882,637874,19008,2.9
CN3710500000000,37,105,Lee County, NC,Mar-17,27166,25782,1384,5.1
CN3710500000000,37,105,Lee County, NC,Apr-17,26428,25138,1290,4.9
CN3710500000000,37,105,Lee County, NC,May-17,26532,25210,1322,5.0
CN3710500000000,37,105,Lee County, NC,Jun-17,26891,25512,1379,5.1
CN3710500000000,37,105,Lee County, NC,Jul-17,25983,24546,1437,5.5
CN3710500000000,37,105,Lee County, NC,Aug-17,26477,25062,1415,5.3
CN3710500000000,37,105,Lee County, NC,Sep-17,26607,25342,1265,4.8
CN3710500000000,37,105,Lee County, NC,Oct-17,26833,25574,1259,4.7
CN3710500000000,37,105,Lee County, NC,Nov-17,26731,25360,1371,5.1
CN3710500000000,37,105,Lee County, NC,Dec-17,26697,25401,1296,4.9
CN3710500000000,37,105,Lee County, NC,Jan-18,26723,25387,1336,5.0
CN3710500000000,37,105,Lee County, NC,Feb-18,26530,25230,1300,4.9
CN3710500000000,37,105,Lee County, NC,Mar-18,26763,25519,1244,4.6
CN3710500000000,37,105,Lee County, NC,Apr-18(p),26467,25377,1090,4.1
CN5306300000000,53,063,Spokane County, WA,Mar-17,239939,225621,14318,6.0
CN5306300000000,53,063,Spokane County, WA,Apr-17,238543,226209,12334,5.2
CN5306300000000,53,063,Spokane County, WA,May-17,238910,226894,12016,5.0
CN5306300000000,53,063,Spokane County, WA,Jun-17,240216,228139,12077,5.0
CN5306300000000,53,063,Spokane County, WA,Jul-17,237693,225423,12270,5.2
CN5306300000000,53,063,Spokane County, WA,Aug-17,237714,225385,12329,5.2
CN5306300000000,53,063,Spokane County, WA,Sep-17,240053,228589,11464,4.8
CN5306300000000,53,063,Spokane County, WA,Oct-17,242982,231744,11238,4.6
CN5306300000000,53,063,Spokane County, WA,Nov-17,244878,232933,11945,4.9
CN5306300000000,53,063,Spokane County, WA,Dec-17,243063,229211,13852,5.7
CN5306300000000,53,063,Spokane County, WA,Jan-18,237421,221992,15429,6.5
CN5306300000000,53,063,Spokane County, WA,Feb-18,238106,222110,15996,6.7
CN5306300000000,53,063,Spokane County, WA,Mar-18,238029,223374,14655,6.2
CN5306300000000,53,063,Spokane County, WA,Apr-18(p),235840,223087,12753,5.4
CN5400900000000,54,009,Brooke County, WV,Mar-17,9704,9056,648,6.7
CN5400900000000,54,009,Brooke County, WV,Apr-17,9888,9308,580,5.9
CN5400900000000,54,009,Brooke County, WV,May-17,9865,9321,544,5.5
CN5400900000000,54,009,Brooke County, WV,Jun-17,10033,9399,634,6.3
CN5400900000000,54,009,Brooke County, WV,Jul-17,10020,9424,596,5.9
CN5400900000000,54,009,Brooke County, WV,Aug-17,9944,9337,607,6.1
CN5400900000000,54,009,Brooke County, WV,Sep-17,9910,9404,506,5.1
CN5400900000000,54,009,Brooke County, WV,Oct-17,9870,9354,516,5.2
CN5400900000000,54,009,Brooke County, WV,Nov-17,9777,9194,583,6.0
CN5400900000000,54,009,Brooke County, WV,Dec-17,9698,9110,588,6.1
CN5400900000000,54,009,Brooke County, WV,Jan-18,9717,9028,689,7.1
CN5400900000000,54,009,Brooke County, WV,Feb-18,9852,9137,715,7.3
CN5400900000000,54,009,Brooke County, WV,Mar-18,9754,9073,681,7.0
CN5400900000000,54,009,Brooke County, WV,Apr-18(p),9844,9213,631,6.4
CN1300700000000,13,007,Baker County, GA,Mar-17,1210,1139,71,5.9
CN1300700000000,13,007,Baker County, GA,Apr-17,1197,1121,76,6.3
CN1300700000000,13,007,Baker County, GA,May-17,1213,1141,72,5.9
CN1300700000000,13,007,Baker County, GA,Jun-17,1233,1159,74,6.0
CN1300700000000,13,007,Baker County, GA,Jul-17,1197,1120,77,6.4
CN1300700000000,13,007,Baker County, GA,Aug-17,1207,1125,82,6.8
CN1300700000000,13,007,Baker County, GA,Sep-17,1194,1116,78,6.5
CN1300700000000,13,007,Baker County, GA,Oct-17,1233,1159,74,6.0
CN1300700000000,13,007,Baker County, GA,Nov-17,1234,1164,70,5.7
CN1300700000000,13,007,Baker County, GA,Dec-17,1244,1174,70,5.6
CN1300700000000,13,007,Baker County, GA,Jan-18,1271,1197,74,5.8
CN1300700000000,13,007,Baker County, GA,Feb-18,1188,1123,65,5.5
CN1300700000000,13,007,Baker County, GA,Mar-18,1180,1118,62,5.3
CN1300700000000,13,007,Baker County, GA,Apr-18(p),1178,1119,59,5.0
CN4707900000000,47,079,Henry County, TN,Mar-17,13964,13274,690,4.9
CN4707900000000,47,079,Henry County, TN,Apr-17,13959,13408,551,3.9
CN4707900000000,47,079,Henry County, TN,May-17,13969,13440,529,3.8
CN4707900000000,47,079,Henry County, TN,Jun-17,14074,13426,648,4.6
CN4707900000000,47,079,Henry County, TN,Jul-17,14172,13542,630,4.4
CN4707900000000,47,079,Henry County, TN,Aug-17,14240,13639,601,4.2
CN4707900000000,47,079,Henry County, TN,Sep-17,14170,13617,553,3.9
CN4707900000000,47,079,Henry County, TN,Oct-17,14054,13477,577,4.1
CN4707900000000,47,079,Henry County, TN,Nov-17,13928,13382,546,3.9
CN4707900000000,47,079,Henry County, TN,Dec-17,14023,13478,545,3.9
CN4707900000000,47,079,Henry County, TN,Jan-18,13986,13308,678,4.8
CN4707900000000,47,079,Henry County, TN,Feb-18,14073,13392,681,4.8
CN4707900000000,47,079,Henry County, TN,Mar-18,13994,13400,594,4.2
CN4707900000000,47,079,Henry County, TN,Apr-18(p),14118,13625,493,3.5
CN7214500000000,72,145,Vega Baja Municipio, PR,Mar-17,13661,12023,1638,12.0
CN7214500000000,72,145,Vega Baja Municipio, PR,Apr-17,13576,11864,1712,12.6
CN7214500000000,72,145,Vega Baja Municipio, PR,May-17,13317,11843,1474,11.1
CN7214500000000,72,145,Vega Baja Municipio, PR,Jun-17,13190,11777,1413,10.7
CN7214500000000,72,145,Vega Baja Municipio, PR,Jul-17,13527,11757,1770,13.1
CN7214500000000,72,145,Vega Baja Municipio, PR,Aug-17,13582,11594,1988,14.6
CN7214500000000,72,145,Vega Baja Municipio, PR,Sep-17(y),13478,11693,1785,13.2
CN7214500000000,72,145,Vega Baja Municipio, PR,Oct-17,13038,11242,1796,13.8
CN7214500000000,72,145,Vega Baja Municipio, PR,Nov-17,13363,11833,1530,11.4
CN7214500000000,72,145,Vega Baja Municipio, PR,Dec-17,13405,11899,1506,11.2
CN7214500000000,72,145,Vega Baja Municipio, PR,Jan-18,13301,11678,1623,12.2
CN7214500000000,72,145,Vega Baja Municipio, PR,Feb-18,13215,11732,1483,11.2
CN7214500000000,72,145,Vega Baja Municipio, PR,Mar-18,13174,11765,1409,10.7
CN7214500000000,72,145,Vega Baja Municipio, PR,Apr-18(p),13203,11812,1391,10.5
CN3603900000000,36,039,Greene County, NY,Mar-17,20706,19568,1138,5.5
CN3603900000000,36,039,Greene County, NY,Apr-17,20199,19139,1060,5.2
CN3603900000000,36,039,Greene County, NY,May-17,20315,19312,1003,4.9
CN3603900000000,36,039,Greene County, NY,Jun-17,21200,20204,996,4.7
CN3603900000000,36,039,Greene County, NY,Jul-17,21301,20226,1075,5.0
CN3603900000000,36,039,Greene County, NY,Aug-17,21099,20029,1070,5.1
CN3603900000000,36,039,Greene County, NY,Sep-17,20726,19730,996,4.8
CN3603900000000,36,039,Greene County, NY,Oct-17,20572,19598,974,4.7
CN3603900000000,36,039,Greene County, NY,Nov-17,20349,19257,1092,5.4
CN3603900000000,36,039,Greene County, NY,Dec-17,20769,19616,1153,5.6
CN3603900000000,36,039,Greene County, NY,Jan-18,21493,20175,1318,6.1
CN3603900000000,36,039,Greene County, NY,Feb-18,21167,19810,1357,6.4
CN3603900000000,36,039,Greene County, NY,Mar-18,20617,19410,1207,5.9
CN3603900000000,36,039,Greene County, NY,Apr-18(p),20064,18972,1092,5.4
CN5401500000000,54,015,Clay County, WV,Mar-17,3186,2868,318,10.0
CN5401500000000,54,015,Clay County, WV,Apr-17,3180,2908,272,8.6
CN5401500000000,54,015,Clay County, WV,May-17,3138,2911,227,7.2
CN5401500000000,54,015,Clay County, WV,Jun-17,3229,2965,264,8.2
CN5401500000000,54,015,Clay County, WV,Jul-17,3193,2947,246,7.7
CN5401500000000,54,015,Clay County, WV,Aug-17,3171,2920,251,7.9
CN5401500000000,54,015,Clay County, WV,Sep-17,3158,2941,217,6.9
CN5401500000000,54,015,Clay County, WV,Oct-17,3140,2918,222,7.1
CN5401500000000,54,015,Clay County, WV,Nov-17,3133,2888,245,7.8
CN5401500000000,54,015,Clay County, WV,Dec-17,3145,2868,277,8.8
CN5401500000000,54,015,Clay County, WV,Jan-18,3242,2875,367,11.3
CN5401500000000,54,015,Clay County, WV,Feb-18,3271,2895,376,11.5
CN5401500000000,54,015,Clay County, WV,Mar-18,3239,2881,358,11.1
CN5401500000000,54,015,Clay County, WV,Apr-18(p),3191,2908,283,8.9
CN2903100000000,29,031,Cape Girardeau County, MO,Mar-17,40069,38545,1524,3.8
CN2903100000000,29,031,Cape Girardeau County, MO,Apr-17,40201,38877,1324,3.3
CN2903100000000,29,031,Cape Girardeau County, MO,May-17,40089,38675,1414,3.5
CN2903100000000,29,031,Cape Girardeau County, MO,Jun-17,40486,38996,1490,3.7
CN2903100000000,29,031,Cape Girardeau County, MO,Jul-17,39633,38086,1547,3.9
CN2903100000000,29,031,Cape Girardeau County, MO,Aug-17,39967,38482,1485,3.7
CN2903100000000,29,031,Cape Girardeau County, MO,Sep-17,40296,39092,1204,3.0
CN2903100000000,29,031,Cape Girardeau County, MO,Oct-17,40116,39230,886,2.2
CN2903100000000,29,031,Cape Girardeau County, MO,Nov-17,40427,39319,1108,2.7
CN2903100000000,29,031,Cape Girardeau County, MO,Dec-17,40550,39349,1201,3.0
CN2903100000000,29,031,Cape Girardeau County, MO,Jan-18,39730,38363,1367,3.4
CN2903100000000,29,031,Cape Girardeau County, MO,Feb-18,40436,39134,1302,3.2
CN2903100000000,29,031,Cape Girardeau County, MO,Mar-18,40421,39099,1322,3.3
CN2903100000000,29,031,Cape Girardeau County, MO,Apr-18(p),40518,39339,1179,2.9
CN1808300000000,18,083,Knox County, IN,Mar-17,18751,18088,663,3.5
CN1808300000000,18,083,Knox County, IN,Apr-17,18644,18121,523,2.8
CN1808300000000,18,083,Knox County, IN,May-17,19022,18451,571,3.0
CN1808300000000,18,083,Knox County, IN,Jun-17,19080,18420,660,3.5
CN1808300000000,18,083,Knox County, IN,Jul-17,18635,17974,661,3.5
CN1808300000000,18,083,Knox County, IN,Aug-17,18474,17744,730,4.0
CN1808300000000,18,083,Knox County, IN,Sep-17,18375,17804,571,3.1
CN1808300000000,18,083,Knox County, IN,Oct-17,18661,18095,566,3.0
CN1808300000000,18,083,Knox County, IN,Nov-17,18764,18182,582,3.1
CN1808300000000,18,083,Knox County, IN,Dec-17,18554,18026,528,2.8
CN1808300000000,18,083,Knox County, IN,Jan-18,18172,17537,635,3.5
CN1808300000000,18,083,Knox County, IN,Feb-18,18355,17678,677,3.7
CN1808300000000,18,083,Knox County, IN,Mar-18,18554,17991,563,3.0
CN1808300000000,18,083,Knox County, IN,Apr-18(p),18431,17932,499,2.7
CN1913500000000,19,135,Monroe County, IA,Mar-17,3886,3724,162,4.2
CN1913500000000,19,135,Monroe County, IA,Apr-17,3901,3764,137,3.5
CN1913500000000,19,135,Monroe County, IA,May-17,3911,3781,130,3.3
CN1913500000000,19,135,Monroe County, IA,Jun-17,3970,3831,139,3.5
CN1913500000000,19,135,Monroe County, IA,Jul-17,3972,3840,132,3.3
CN1913500000000,19,135,Monroe County, IA,Aug-17,3940,3786,154,3.9
CN1913500000000,19,135,Monroe County, IA,Sep-17,3908,3758,150,3.8
CN1913500000000,19,135,Monroe County, IA,Oct-17,3875,3748,127,3.3
CN1913500000000,19,135,Monroe County, IA,Nov-17,3825,3702,123,3.2
CN1913500000000,19,135,Monroe County, IA,Dec-17,3825,3686,139,3.6
CN1913500000000,19,135,Monroe County, IA,Jan-18,3811,3639,172,4.5
CN1913500000000,19,135,Monroe County, IA,Feb-18,3844,3688,156,4.1
CN1913500000000,19,135,Monroe County, IA,Mar-18,3820,3683,137,3.6
CN1913500000000,19,135,Monroe County, IA,Apr-18(p),3785,3684,101,2.7
CN1908900000000,19,089,Howard County, IA,Mar-17,5073,4853,220,4.3
CN1908900000000,19,089,Howard County, IA,Apr-17,5085,4925,160,3.1
CN1908900000000,19,089,Howard County, IA,May-17,5137,5002,135,2.6
CN1908900000000,19,089,Howard County, IA,Jun-17,5201,5063,138,2.7
CN1908900000000,19,089,Howard County, IA,Jul-17,5309,5183,126,2.4
CN1908900000000,19,089,Howard County, IA,Aug-17,5198,5072,126,2.4
CN1908900000000,19,089,Howard County, IA,Sep-17,5059,4942,117,2.3
CN1908900000000,19,089,Howard County, IA,Oct-17,5091,4997,94,1.8
CN1908900000000,19,089,Howard County, IA,Nov-17,5024,4916,108,2.1
CN1908900000000,19,089,Howard County, IA,Dec-17,5073,4942,131,2.6
CN1908900000000,19,089,Howard County, IA,Jan-18,5058,4813,245,4.8
CN1908900000000,19,089,Howard County, IA,Feb-18,5007,4804,203,4.1
CN1908900000000,19,089,Howard County, IA,Mar-18,4997,4822,175,3.5
CN1908900000000,19,089,Howard County, IA,Apr-18(p),4948,4807,141,2.8
CN3904500000000,39,045,Fairfield County, OH,Mar-17,76912,73525,3387,4.4
CN3904500000000,39,045,Fairfield County, OH,Apr-17,76810,73837,2973,3.9
CN3904500000000,39,045,Fairfield County, OH,May-17,77287,74294,2993,3.9
CN3904500000000,39,045,Fairfield County, OH,Jun-17,78192,74667,3525,4.5
CN3904500000000,39,045,Fairfield County, OH,Jul-17,78613,75138,3475,4.4
CN3904500000000,39,045,Fairfield County, OH,Aug-17,78464,75082,3382,4.3
CN3904500000000,39,045,Fairfield County, OH,Sep-17,77623,74531,3092,4.0
CN3904500000000,39,045,Fairfield County, OH,Oct-17,77461,74534,2927,3.8
CN3904500000000,39,045,Fairfield County, OH,Nov-17,77488,74505,2983,3.8
CN3904500000000,39,045,Fairfield County, OH,Dec-17,77531,74456,3075,4.0
CN3904500000000,39,045,Fairfield County, OH,Jan-18,76298,72979,3319,4.4
CN3904500000000,39,045,Fairfield County, OH,Feb-18,77464,74241,3223,4.2
CN3904500000000,39,045,Fairfield County, OH,Mar-18,78313,75338,2975,3.8
CN3904500000000,39,045,Fairfield County, OH,Apr-18(p),77972,75166,2806,3.6
CN3910700000000,39,107,Mercer County, OH,Mar-17,23856,23137,719,3.0
CN3910700000000,39,107,Mercer County, OH,Apr-17,23771,23138,633,2.7
CN3910700000000,39,107,Mercer County, OH,May-17,23871,23202,669,2.8
CN3910700000000,39,107,Mercer County, OH,Jun-17,24135,23360,775,3.2
CN3910700000000,39,107,Mercer County, OH,Jul-17,23964,23175,789,3.3
CN3910700000000,39,107,Mercer County, OH,Aug-17,24361,23602,759,3.1
CN3910700000000,39,107,Mercer County, OH,Sep-17,23872,23195,677,2.8
CN3910700000000,39,107,Mercer County, OH,Oct-17,23667,23035,632,2.7
CN3910700000000,39,107,Mercer County, OH,Nov-17,23580,22919,661,2.8
CN3910700000000,39,107,Mercer County, OH,Dec-17,23239,22590,649,2.8
CN3910700000000,39,107,Mercer County, OH,Jan-18,22927,22224,703,3.1
CN3910700000000,39,107,Mercer County, OH,Feb-18,23233,22554,679,2.9
CN3910700000000,39,107,Mercer County, OH,Mar-18,23754,23176,578,2.4
CN3910700000000,39,107,Mercer County, OH,Apr-18(p),23546,22997,549,2.3
CN1919500000000,19,195,Worth County, IA,Mar-17,4152,3975,177,4.3
CN1919500000000,19,195,Worth County, IA,Apr-17,4202,4065,137,3.3
CN1919500000000,19,195,Worth County, IA,May-17,4221,4102,119,2.8
CN1919500000000,19,195,Worth County, IA,Jun-17,4345,4217,128,2.9
CN1919500000000,19,195,Worth County, IA,Jul-17,4375,4258,117,2.7
CN1919500000000,19,195,Worth County, IA,Aug-17,4317,4196,121,2.8
CN1919500000000,19,195,Worth County, IA,Sep-17,4215,4106,109,2.6
CN1919500000000,19,195,Worth County, IA,Oct-17,4212,4127,85,2.0
CN1919500000000,19,195,Worth County, IA,Nov-17,4159,4067,92,2.2
CN1919500000000,19,195,Worth County, IA,Dec-17,4160,4041,119,2.9
CN1919500000000,19,195,Worth County, IA,Jan-18,4129,3967,162,3.9
CN1919500000000,19,195,Worth County, IA,Feb-18,4152,4000,152,3.7
CN1919500000000,19,195,Worth County, IA,Mar-18,4128,3977,151,3.7
CN1919500000000,19,195,Worth County, IA,Apr-18(p),4161,4024,137,3.3
CN4014300000000,40,143,Tulsa County, OK,Mar-17,317977,304244,13733,4.3
CN4014300000000,40,143,Tulsa County, OK,Apr-17,316425,303699,12726,4.0
CN4014300000000,40,143,Tulsa County, OK,May-17,317595,303480,14115,4.4
CN4014300000000,40,143,Tulsa County, OK,Jun-17,323069,308227,14842,4.6
CN4014300000000,40,143,Tulsa County, OK,Jul-17,323476,309654,13822,4.3
CN4014300000000,40,143,Tulsa County, OK,Aug-17,318671,304819,13852,4.3
CN4014300000000,40,143,Tulsa County, OK,Sep-17,321105,307884,13221,4.1
CN4014300000000,40,143,Tulsa County, OK,Oct-17,323033,309809,13224,4.1
CN4014300000000,40,143,Tulsa County, OK,Nov-17,324767,312065,12702,3.9
CN4014300000000,40,143,Tulsa County, OK,Dec-17,323506,310791,12715,3.9
CN4014300000000,40,143,Tulsa County, OK,Jan-18,321166,307562,13604,4.2
CN4014300000000,40,143,Tulsa County, OK,Feb-18,322016,309387,12629,3.9
CN4014300000000,40,143,Tulsa County, OK,Mar-18,324041,311789,12252,3.8
CN4014300000000,40,143,Tulsa County, OK,Apr-18(p),324839,312858,11981,3.7
CN2913100000000,29,131,Miller County, MO,Mar-17,11721,11139,582,5.0
CN2913100000000,29,131,Miller County, MO,Apr-17,11972,11508,464,3.9
CN2913100000000,29,131,Miller County, MO,May-17,12084,11580,504,4.2
CN2913100000000,29,131,Miller County, MO,Jun-17,12357,11891,466,3.8
CN2913100000000,29,131,Miller County, MO,Jul-17,11769,11203,566,4.8
CN2913100000000,29,131,Miller County, MO,Aug-17,11578,11040,538,4.6
CN2913100000000,29,131,Miller County, MO,Sep-17,11898,11490,408,3.4
CN2913100000000,29,131,Miller County, MO,Oct-17,11786,11418,368,3.1
CN2913100000000,29,131,Miller County, MO,Nov-17,11680,11236,444,3.8
CN2913100000000,29,131,Miller County, MO,Dec-17,11678,11126,552,4.7
CN2913100000000,29,131,Miller County, MO,Jan-18,11635,10947,688,5.9
CN2913100000000,29,131,Miller County, MO,Feb-18,11659,10963,696,6.0
CN2913100000000,29,131,Miller County, MO,Mar-18,11747,11140,607,5.2
CN2913100000000,29,131,Miller County, MO,Apr-18(p),11987,11520,467,3.9
CN5406900000000,54,069,Ohio County, WV,Mar-17,20383,19264,1119,5.5
CN5406900000000,54,069,Ohio County, WV,Apr-17,20583,19633,950,4.6
CN5406900000000,54,069,Ohio County, WV,May-17,20644,19759,885,4.3
CN5406900000000,54,069,Ohio County, WV,Jun-17,20904,19879,1025,4.9
CN5406900000000,54,069,Ohio County, WV,Jul-17,20855,19883,972,4.7
CN5406900000000,54,069,Ohio County, WV,Aug-17,20613,19610,1003,4.9
CN5406900000000,54,069,Ohio County, WV,Sep-17,20576,19715,861,4.2
CN5406900000000,54,069,Ohio County, WV,Oct-17,20563,19709,854,4.2
CN5406900000000,54,069,Ohio County, WV,Nov-17,20500,19605,895,4.4
CN5406900000000,54,069,Ohio County, WV,Dec-17,20399,19500,899,4.4
CN5406900000000,54,069,Ohio County, WV,Jan-18,20310,19206,1104,5.4
CN5406900000000,54,069,Ohio County, WV,Feb-18,20569,19324,1245,6.1
CN5406900000000,54,069,Ohio County, WV,Mar-18,20466,19304,1162,5.7
CN5406900000000,54,069,Ohio County, WV,Apr-18(p),20602,19546,1056,5.1
CN7215100000000,72,151,Yabucoa Municipio, PR,Mar-17,9261,7649,1612,17.4
CN7215100000000,72,151,Yabucoa Municipio, PR,Apr-17,9144,7564,1580,17.3
CN7215100000000,72,151,Yabucoa Municipio, PR,May-17,8927,7552,1375,15.4
CN7215100000000,72,151,Yabucoa Municipio, PR,Jun-17,8753,7524,1229,14.0
CN7215100000000,72,151,Yabucoa Municipio, PR,Jul-17,8941,7518,1423,15.9
CN7215100000000,72,151,Yabucoa Municipio, PR,Aug-17,9013,7419,1594,17.7
CN7215100000000,72,151,Yabucoa Municipio, PR,Sep-17(y),8876,7475,1401,15.8
CN7215100000000,72,151,Yabucoa Municipio, PR,Oct-17,8602,7149,1453,16.9
CN7215100000000,72,151,Yabucoa Municipio, PR,Nov-17,8972,7588,1384,15.4
CN7215100000000,72,151,Yabucoa Municipio, PR,Dec-17,9028,7641,1387,15.4
CN7215100000000,72,151,Yabucoa Municipio, PR,Jan-18,9083,7485,1598,17.6
CN7215100000000,72,151,Yabucoa Municipio, PR,Feb-18,8932,7484,1448,16.2
CN7215100000000,72,151,Yabucoa Municipio, PR,Mar-18,8925,7499,1426,16.0
CN7215100000000,72,151,Yabucoa Municipio, PR,Apr-18(p),8919,7559,1360,15.2
CN1310700000000,13,107,Emanuel County, GA,Mar-17,8880,8322,558,6.3
CN1310700000000,13,107,Emanuel County, GA,Apr-17,8583,8031,552,6.4
CN1310700000000,13,107,Emanuel County, GA,May-17,8670,8116,554,6.4
CN1310700000000,13,107,Emanuel County, GA,Jun-17,8579,7995,584,6.8
CN1310700000000,13,107,Emanuel County, GA,Jul-17,8578,7950,628,7.3
CN1310700000000,13,107,Emanuel County, GA,Aug-17,8594,7961,633,7.4
CN1310700000000,13,107,Emanuel County, GA,Sep-17,8632,8019,613,7.1
CN1310700000000,13,107,Emanuel County, GA,Oct-17,8573,8033,540,6.3
CN1310700000000,13,107,Emanuel County, GA,Nov-17,8586,8048,538,6.3
CN1310700000000,13,107,Emanuel County, GA,Dec-17,8645,8107,538,6.2
CN1310700000000,13,107,Emanuel County, GA,Jan-18,8879,8286,593,6.7
CN1310700000000,13,107,Emanuel County, GA,Feb-18,8684,8135,549,6.3
CN1310700000000,13,107,Emanuel County, GA,Mar-18,8644,8123,521,6.0
CN1310700000000,13,107,Emanuel County, GA,Apr-18(p),8580,8129,451,5.3
CN2815900000000,28,159,Winston County, MS,Mar-17,7131,6700,431,6.0
CN2815900000000,28,159,Winston County, MS,Apr-17,7141,6746,395,5.5
CN2815900000000,28,159,Winston County, MS,May-17,7187,6749,438,6.1
CN2815900000000,28,159,Winston County, MS,Jun-17,7491,6984,507,6.8
CN2815900000000,28,159,Winston County, MS,Jul-17,7456,6971,485,6.5
CN2815900000000,28,159,Winston County, MS,Aug-17,7324,6876,448,6.1
CN2815900000000,28,159,Winston County, MS,Sep-17,7301,6912,389,5.3
CN2815900000000,28,159,Winston County, MS,Oct-17,7235,6855,380,5.3
CN2815900000000,28,159,Winston County, MS,Nov-17,7189,6811,378,5.3
CN2815900000000,28,159,Winston County, MS,Dec-17,7230,6831,399,5.5
CN2815900000000,28,159,Winston County, MS,Jan-18,7210,6804,406,5.6
CN2815900000000,28,159,Winston County, MS,Feb-18,7239,6842,397,5.5
CN2815900000000,28,159,Winston County, MS,Mar-18,7263,6887,376,5.2
CN2815900000000,28,159,Winston County, MS,Apr-18(p),7298,6941,357,4.9
CN2904900000000,29,049,Clinton County, MO,Mar-17,11065,10556,509,4.6
CN2904900000000,29,049,Clinton County, MO,Apr-17,11074,10726,348,3.1
CN2904900000000,29,049,Clinton County, MO,May-17,11001,10643,358,3.3
CN2904900000000,29,049,Clinton County, MO,Jun-17,11101,10715,386,3.5
CN2904900000000,29,049,Clinton County, MO,Jul-17,11334,10762,572,5.0
CN2904900000000,29,049,Clinton County, MO,Aug-17,11143,10596,547,4.9
CN2904900000000,29,049,Clinton County, MO,Sep-17,10966,10646,320,2.9
CN2904900000000,29,049,Clinton County, MO,Oct-17,11111,10693,418,3.8
CN2904900000000,29,049,Clinton County, MO,Nov-17,10959,10631,328,3.0
CN2904900000000,29,049,Clinton County, MO,Dec-17,10919,10548,371,3.4
CN2904900000000,29,049,Clinton County, MO,Jan-18,10937,10468,469,4.3
CN2904900000000,29,049,Clinton County, MO,Feb-18,11009,10585,424,3.9
CN2904900000000,29,049,Clinton County, MO,Mar-18,10996,10600,396,3.6
CN2904900000000,29,049,Clinton County, MO,Apr-18(p),11031,10688,343,3.1
CN7204500000000,72,045,Comerio Municipio, PR,Mar-17,5029,4427,602,12.0
CN7204500000000,72,045,Comerio Municipio, PR,Apr-17,4999,4358,641,12.8
CN7204500000000,72,045,Comerio Municipio, PR,May-17,4938,4388,550,11.1
CN7204500000000,72,045,Comerio Municipio, PR,Jun-17,4926,4388,538,10.9
CN7204500000000,72,045,Comerio Municipio, PR,Jul-17,4975,4405,570,11.5
CN7204500000000,72,045,Comerio Municipio, PR,Aug-17,4989,4347,642,12.9
CN7204500000000,72,045,Comerio Municipio, PR,Sep-17(y),4936,4348,588,11.9
CN7204500000000,72,045,Comerio Municipio, PR,Oct-17,4650,4131,519,11.2
CN7204500000000,72,045,Comerio Municipio, PR,Nov-17,4880,4356,524,10.7
CN7204500000000,72,045,Comerio Municipio, PR,Dec-17,4882,4382,500,10.2
CN7204500000000,72,045,Comerio Municipio, PR,Jan-18,4846,4300,546,11.3
CN7204500000000,72,045,Comerio Municipio, PR,Feb-18,4799,4285,514,10.7
CN7204500000000,72,045,Comerio Municipio, PR,Mar-18,4800,4295,505,10.5
CN7204500000000,72,045,Comerio Municipio, PR,Apr-18(p),4833,4334,499,10.3
CN5506500000000,55,065,Lafayette County, WI,Mar-17,9940,9643,297,3.0
CN5506500000000,55,065,Lafayette County, WI,Apr-17,10199,9965,234,2.3
CN5506500000000,55,065,Lafayette County, WI,May-17,10311,10071,240,2.3
CN5506500000000,55,065,Lafayette County, WI,Jun-17,10700,10412,288,2.7
CN5506500000000,55,065,Lafayette County, WI,Jul-17,10139,9880,259,2.6
CN5506500000000,55,065,Lafayette County, WI,Aug-17,9991,9757,234,2.3
CN5506500000000,55,065,Lafayette County, WI,Sep-17,10102,9883,219,2.2
CN5506500000000,55,065,Lafayette County, WI,Oct-17,10336,10127,209,2.0
CN5506500000000,55,065,Lafayette County, WI,Nov-17,10451,10244,207,2.0
CN5506500000000,55,065,Lafayette County, WI,Dec-17,10444,10251,193,1.8
CN5506500000000,55,065,Lafayette County, WI,Jan-18,10462,10205,257,2.5
CN5506500000000,55,065,Lafayette County, WI,Feb-18,10369,10073,296,2.9
CN5506500000000,55,065,Lafayette County, WI,Mar-18,10506,10251,255,2.4
CN5506500000000,55,065,Lafayette County, WI,Apr-18(p),10662,10471,191,1.8
CN2108500000000,21,085,Grayson County, KY,Mar-17,11187,10440,747,6.7
CN2108500000000,21,085,Grayson County, KY,Apr-17,11077,10453,624,5.6
CN2108500000000,21,085,Grayson County, KY,May-17,10969,10357,612,5.6
CN2108500000000,21,085,Grayson County, KY,Jun-17,11164,10474,690,6.2
CN2108500000000,21,085,Grayson County, KY,Jul-17,11466,10606,860,7.5
CN2108500000000,21,085,Grayson County, KY,Aug-17,10865,10247,618,5.7
CN2108500000000,21,085,Grayson County, KY,Sep-17,10872,10295,577,5.3
CN2108500000000,21,085,Grayson County, KY,Oct-17,10678,10195,483,4.5
CN2108500000000,21,085,Grayson County, KY,Nov-17,10659,10187,472,4.4
CN2108500000000,21,085,Grayson County, KY,Dec-17,10725,10266,459,4.3
CN2108500000000,21,085,Grayson County, KY,Jan-18,10842,10281,561,5.2
CN2108500000000,21,085,Grayson County, KY,Feb-18,10866,10288,578,5.3
CN2108500000000,21,085,Grayson County, KY,Mar-18,11010,10471,539,4.9
CN2108500000000,21,085,Grayson County, KY,Apr-18(p),11040,10590,450,4.1
CN3203300000000,32,033,White Pine County, NV,Mar-17,4717,4516,201,4.3
CN3203300000000,32,033,White Pine County, NV,Apr-17,4480,4287,193,4.3
CN3203300000000,32,033,White Pine County, NV,May-17,4599,4416,183,4.0
CN3203300000000,32,033,White Pine County, NV,Jun-17,4737,4550,187,3.9
CN3203300000000,32,033,White Pine County, NV,Jul-17,4658,4475,183,3.9
CN3203300000000,32,033,White Pine County, NV,Aug-17,4622,4441,181,3.9
CN3203300000000,32,033,White Pine County, NV,Sep-17,4596,4421,175,3.8
CN3203300000000,32,033,White Pine County, NV,Oct-17,4481,4316,165,3.7
CN3203300000000,32,033,White Pine County, NV,Nov-17,4456,4301,155,3.5
CN3203300000000,32,033,White Pine County, NV,Dec-17,4462,4307,155,3.5
CN3203300000000,32,033,White Pine County, NV,Jan-18,4436,4233,203,4.6
CN3203300000000,32,033,White Pine County, NV,Feb-18,4488,4293,195,4.3
CN3203300000000,32,033,White Pine County, NV,Mar-18,4589,4391,198,4.3
CN3203300000000,32,033,White Pine County, NV,Apr-18(p),4501,4311,190,4.2
CN3905100000000,39,051,Fulton County, OH,Mar-17,23170,21880,1290,5.6
CN3905100000000,39,051,Fulton County, OH,Apr-17,22723,21658,1065,4.7
CN3905100000000,39,051,Fulton County, OH,May-17,22680,21654,1026,4.5
CN3905100000000,39,051,Fulton County, OH,Jun-17,22626,21510,1116,4.9
CN3905100000000,39,051,Fulton County, OH,Jul-17,22415,21274,1141,5.1
CN3905100000000,39,051,Fulton County, OH,Aug-17,22528,21468,1060,4.7
CN3905100000000,39,051,Fulton County, OH,Sep-17,22550,21607,943,4.2
CN3905100000000,39,051,Fulton County, OH,Oct-17,22522,21631,891,4.0
CN3905100000000,39,051,Fulton County, OH,Nov-17,22554,21668,886,3.9
CN3905100000000,39,051,Fulton County, OH,Dec-17,22358,21353,1005,4.5
CN3905100000000,39,051,Fulton County, OH,Jan-18,22141,20951,1190,5.4
CN3905100000000,39,051,Fulton County, OH,Feb-18,22441,21321,1120,5.0
CN3905100000000,39,051,Fulton County, OH,Mar-18,22631,21624,1007,4.4
CN3905100000000,39,051,Fulton County, OH,Apr-18(p),22378,21544,834,3.7
CN4700100000000,47,001,Anderson County, TN,Mar-17,34102,32593,1509,4.4
CN4700100000000,47,001,Anderson County, TN,Apr-17,34032,32861,1171,3.4
CN4700100000000,47,001,Anderson County, TN,May-17,34120,32987,1133,3.3
CN4700100000000,47,001,Anderson County, TN,Jun-17,34506,32992,1514,4.4
CN4700100000000,47,001,Anderson County, TN,Jul-17,34609,33158,1451,4.2
CN4700100000000,47,001,Anderson County, TN,Aug-17,34104,32763,1341,3.9
CN4700100000000,47,001,Anderson County, TN,Sep-17,34440,33226,1214,3.5
CN4700100000000,47,001,Anderson County, TN,Oct-17,34271,33094,1177,3.4
CN4700100000000,47,001,Anderson County, TN,Nov-17,34250,33130,1120,3.3
CN4700100000000,47,001,Anderson County, TN,Dec-17,33979,32882,1097,3.2
CN4700100000000,47,001,Anderson County, TN,Jan-18,33934,32595,1339,3.9
CN4700100000000,47,001,Anderson County, TN,Feb-18,34487,33181,1306,3.8
CN4700100000000,47,001,Anderson County, TN,Mar-18,34481,33203,1278,3.7
CN4700100000000,47,001,Anderson County, TN,Apr-18(p),34426,33375,1051,3.1
CN7203900000000,72,039,Ciales Municipio, PR,Mar-17,3891,3258,633,16.3
CN7203900000000,72,039,Ciales Municipio, PR,Apr-17,3896,3226,670,17.2
CN7203900000000,72,039,Ciales Municipio, PR,May-17,3824,3234,590,15.4
CN7203900000000,72,039,Ciales Municipio, PR,Jun-17,3802,3231,571,15.0
CN7203900000000,72,039,Ciales Municipio, PR,Jul-17,3884,3257,627,16.1
CN7203900000000,72,039,Ciales Municipio, PR,Aug-17,3940,3213,727,18.5
CN7203900000000,72,039,Ciales Municipio, PR,Sep-17(y),3875,3222,653,16.9
CN7203900000000,72,039,Ciales Municipio, PR,Oct-17,3709,3060,649,17.5
CN7203900000000,72,039,Ciales Municipio, PR,Nov-17,3826,3254,572,15.0
CN7203900000000,72,039,Ciales Municipio, PR,Dec-17,3800,3278,522,13.7
CN7203900000000,72,039,Ciales Municipio, PR,Jan-18,3761,3206,555,14.8
CN7203900000000,72,039,Ciales Municipio, PR,Feb-18,3703,3195,508,13.7
CN7203900000000,72,039,Ciales Municipio, PR,Mar-18,3705,3203,502,13.5
CN7203900000000,72,039,Ciales Municipio, PR,Apr-18(p),3701,3231,470,12.7
CN1311300000000,13,113,Fayette County, GA,Mar-17,57146,54774,2372,4.2
CN1311300000000,13,113,Fayette County, GA,Apr-17,57110,54883,2227,3.9
CN1311300000000,13,113,Fayette County, GA,May-17,57237,54988,2249,3.9
CN1311300000000,13,113,Fayette County, GA,Jun-17,57475,54930,2545,4.4
CN1311300000000,13,113,Fayette County, GA,Jul-17,57850,55320,2530,4.4
CN1311300000000,13,113,Fayette County, GA,Aug-17,57492,55062,2430,4.2
CN1311300000000,13,113,Fayette County, GA,Sep-17,58033,55805,2228,3.8
CN1311300000000,13,113,Fayette County, GA,Oct-17,57759,55582,2177,3.8
CN1311300000000,13,113,Fayette County, GA,Nov-17,57890,55783,2107,3.6
CN1311300000000,13,113,Fayette County, GA,Dec-17,57879,55758,2121,3.7
CN1311300000000,13,113,Fayette County, GA,Jan-18,57831,55639,2192,3.8
CN1311300000000,13,113,Fayette County, GA,Feb-18,58908,56578,2330,4.0
CN1311300000000,13,113,Fayette County, GA,Mar-18,58913,56783,2130,3.6
CN1311300000000,13,113,Fayette County, GA,Apr-18(p),58513,56601,1912,3.3
CN2902500000000,29,025,Caldwell County, MO,Mar-17,4471,4258,213,4.8
CN2902500000000,29,025,Caldwell County, MO,Apr-17,4557,4388,169,3.7
CN2902500000000,29,025,Caldwell County, MO,May-17,4457,4302,155,3.5
CN2902500000000,29,025,Caldwell County, MO,Jun-17,4504,4340,164,3.6
CN2902500000000,29,025,Caldwell County, MO,Jul-17,4539,4327,212,4.7
CN2902500000000,29,025,Caldwell County, MO,Aug-17,4462,4272,190,4.3
CN2902500000000,29,025,Caldwell County, MO,Sep-17,4395,4264,131,3.0
CN2902500000000,29,025,Caldwell County, MO,Oct-17,4500,4332,168,3.7
CN2902500000000,29,025,Caldwell County, MO,Nov-17,4421,4292,129,2.9
CN2902500000000,29,025,Caldwell County, MO,Dec-17,4379,4237,142,3.2
CN2902500000000,29,025,Caldwell County, MO,Jan-18,4418,4228,190,4.3
CN2902500000000,29,025,Caldwell County, MO,Feb-18,4461,4280,181,4.1
CN2902500000000,29,025,Caldwell County, MO,Mar-18,4441,4287,154,3.5
CN2902500000000,29,025,Caldwell County, MO,Apr-18(p),4481,4342,139,3.1
CN4718500000000,47,185,White County, TN,Mar-17,11977,11463,514,4.3
CN4718500000000,47,185,White County, TN,Apr-17,11927,11495,432,3.6
CN4718500000000,47,185,White County, TN,May-17,11904,11479,425,3.6
CN4718500000000,47,185,White County, TN,Jun-17,12012,11496,516,4.3
CN4718500000000,47,185,White County, TN,Jul-17,11970,11464,506,4.2
CN4718500000000,47,185,White County, TN,Aug-17,11965,11491,474,4.0
CN4718500000000,47,185,White County, TN,Sep-17,12055,11630,425,3.5
CN4718500000000,47,185,White County, TN,Oct-17,11971,11572,399,3.3
CN4718500000000,47,185,White County, TN,Nov-17,11953,11557,396,3.3
CN4718500000000,47,185,White County, TN,Dec-17,11981,11587,394,3.3
CN4718500000000,47,185,White County, TN,Jan-18,11948,11481,467,3.9
CN4718500000000,47,185,White County, TN,Feb-18,12066,11619,447,3.7
CN4718500000000,47,185,White County, TN,Mar-18,12068,11644,424,3.5
CN4718500000000,47,185,White County, TN,Apr-18(p),12140,11789,351,2.9
CN5301900000000,53,019,Ferry County, WA,Mar-17,2516,2184,332,13.2
CN5301900000000,53,019,Ferry County, WA,Apr-17,2453,2185,268,10.9
CN5301900000000,53,019,Ferry County, WA,May-17,2483,2233,250,10.1
CN5301900000000,53,019,Ferry County, WA,Jun-17,2584,2317,267,10.3
CN5301900000000,53,019,Ferry County, WA,Jul-17,2555,2312,243,9.5
CN5301900000000,53,019,Ferry County, WA,Aug-17,2557,2305,252,9.9
CN5301900000000,53,019,Ferry County, WA,Sep-17,2575,2344,231,9.0
CN5301900000000,53,019,Ferry County, WA,Oct-17,2558,2317,241,9.4
CN5301900000000,53,019,Ferry County, WA,Nov-17,2597,2315,282,10.9
CN5301900000000,53,019,Ferry County, WA,Dec-17,2594,2232,362,14.0
CN5301900000000,53,019,Ferry County, WA,Jan-18,2526,2132,394,15.6
CN5301900000000,53,019,Ferry County, WA,Feb-18,2529,2098,431,17.0
CN5301900000000,53,019,Ferry County, WA,Mar-18,2555,2133,422,16.5
CN5301900000000,53,019,Ferry County, WA,Apr-18(p),2528,2186,342,13.5
CN1206100000000,12,061,Indian River County, FL,Mar-17,63868,60827,3041,4.8
CN1206100000000,12,061,Indian River County, FL,Apr-17,63391,60504,2887,4.6
CN1206100000000,12,061,Indian River County, FL,May-17,63512,60429,3083,4.9
CN1206100000000,12,061,Indian River County, FL,Jun-17,63552,60253,3299,5.2
CN1206100000000,12,061,Indian River County, FL,Jul-17,63216,59779,3437,5.4
CN1206100000000,12,061,Indian River County, FL,Aug-17,63018,59568,3450,5.5
CN1206100000000,12,061,Indian River County, FL,Sep-17,63208,60012,3196,5.1
CN1206100000000,12,061,Indian River County, FL,Oct-17,62588,59663,2925,4.7
CN1206100000000,12,061,Indian River County, FL,Nov-17,63574,60706,2868,4.5
CN1206100000000,12,061,Indian River County, FL,Dec-17,63119,60385,2734,4.3
CN1206100000000,12,061,Indian River County, FL,Jan-18,63776,60732,3044,4.8
CN1206100000000,12,061,Indian River County, FL,Feb-18,64284,61466,2818,4.4
CN1206100000000,12,061,Indian River County, FL,Mar-18,64331,61539,2792,4.3
CN1206100000000,12,061,Indian River County, FL,Apr-18(p),63728,61207,2521,4.0
CN1813900000000,18,139,Rush County, IN,Mar-17,8911,8622,289,3.2
CN1813900000000,18,139,Rush County, IN,Apr-17,8921,8691,230,2.6
CN1813900000000,18,139,Rush County, IN,May-17,9260,9006,254,2.7
CN1813900000000,18,139,Rush County, IN,Jun-17,9112,8845,267,2.9
CN1813900000000,18,139,Rush County, IN,Jul-17,8992,8721,271,3.0
CN1813900000000,18,139,Rush County, IN,Aug-17,8965,8670,295,3.3
CN1813900000000,18,139,Rush County, IN,Sep-17,8810,8558,252,2.9
CN1813900000000,18,139,Rush County, IN,Oct-17,8805,8575,230,2.6
CN1813900000000,18,139,Rush County, IN,Nov-17,8929,8689,240,2.7
CN1813900000000,18,139,Rush County, IN,Dec-17,8787,8556,231,2.6
CN1813900000000,18,139,Rush County, IN,Jan-18,8615,8342,273,3.2
CN1813900000000,18,139,Rush County, IN,Feb-18,8803,8520,283,3.2
CN1813900000000,18,139,Rush County, IN,Mar-18,8913,8670,243,2.7
CN1813900000000,18,139,Rush County, IN,Apr-18(p),8919,8686,233,2.6
CN1329700000000,13,297,Walton County, GA,Mar-17,44543,42563,1980,4.4
CN1329700000000,13,297,Walton County, GA,Apr-17,44494,42644,1850,4.2
CN1329700000000,13,297,Walton County, GA,May-17,44639,42737,1902,4.3
CN1329700000000,13,297,Walton County, GA,Jun-17,44764,42708,2056,4.6
CN1329700000000,13,297,Walton County, GA,Jul-17,45054,42986,2068,4.6
CN1329700000000,13,297,Walton County, GA,Aug-17,44766,42790,1976,4.4
CN1329700000000,13,297,Walton County, GA,Sep-17,45148,43352,1796,4.0
CN1329700000000,13,297,Walton County, GA,Oct-17,44991,43202,1789,4.0
CN1329700000000,13,297,Walton County, GA,Nov-17,45074,43361,1713,3.8
CN1329700000000,13,297,Walton County, GA,Dec-17,45064,43345,1719,3.8
CN1329700000000,13,297,Walton County, GA,Jan-18,45065,43267,1798,4.0
CN1329700000000,13,297,Walton County, GA,Feb-18,45794,43943,1851,4.0
CN1329700000000,13,297,Walton County, GA,Mar-18,45781,44100,1681,3.7
CN1329700000000,13,297,Walton County, GA,Apr-18(p),45502,43961,1541,3.4
CN1902900000000,19,029,Cass County, IA,Mar-17,7066,6817,249,3.5
CN1902900000000,19,029,Cass County, IA,Apr-17,7227,6977,250,3.5
CN1902900000000,19,029,Cass County, IA,May-17,7276,7076,200,2.7
CN1902900000000,19,029,Cass County, IA,Jun-17,7540,7229,311,4.1
CN1902900000000,19,029,Cass County, IA,Jul-17,7144,6861,283,4.0
CN1902900000000,19,029,Cass County, IA,Aug-17,7067,6781,286,4.0
CN1902900000000,19,029,Cass County, IA,Sep-17,7124,6896,228,3.2
CN1902900000000,19,029,Cass County, IA,Oct-17,7005,6806,199,2.8
CN1902900000000,19,029,Cass County, IA,Nov-17,6953,6745,208,3.0
CN1902900000000,19,029,Cass County, IA,Dec-17,6981,6725,256,3.7
CN1902900000000,19,029,Cass County, IA,Jan-18,7004,6682,322,4.6
CN1902900000000,19,029,Cass County, IA,Feb-18,7000,6703,297,4.2
CN1902900000000,19,029,Cass County, IA,Mar-18,6941,6683,258,3.7
CN1902900000000,19,029,Cass County, IA,Apr-18(p),6922,6719,203,2.9
CN5118300000000,51,183,Sussex County, VA,Mar-17,3838,3600,238,6.2
CN5118300000000,51,183,Sussex County, VA,Apr-17,3960,3744,216,5.5
CN5118300000000,51,183,Sussex County, VA,May-17,3915,3699,216,5.5
CN5118300000000,51,183,Sussex County, VA,Jun-17,4016,3792,224,5.6
CN5118300000000,51,183,Sussex County, VA,Jul-17,4061,3815,246,6.1
CN5118300000000,51,183,Sussex County, VA,Aug-17,3953,3699,254,6.4
CN5118300000000,51,183,Sussex County, VA,Sep-17,3977,3760,217,5.5
CN5118300000000,51,183,Sussex County, VA,Oct-17,3900,3688,212,5.4
CN5118300000000,51,183,Sussex County, VA,Nov-17,3840,3627,213,5.5
CN5118300000000,51,183,Sussex County, VA,Dec-17,3917,3690,227,5.8
CN5118300000000,51,183,Sussex County, VA,Jan-18,3776,3546,230,6.1
CN5118300000000,51,183,Sussex County, VA,Feb-18,3857,3629,228,5.9
CN5118300000000,51,183,Sussex County, VA,Mar-18,3805,3576,229,6.0
CN5118300000000,51,183,Sussex County, VA,Apr-18(p),3903,3718,185,4.7
CN2402300000000,24,023,Garrett County, MD,Mar-17,15875,14825,1050,6.6
CN2402300000000,24,023,Garrett County, MD,Apr-17,15769,15020,749,4.7
CN2402300000000,24,023,Garrett County, MD,May-17,15399,14712,687,4.5
CN2402300000000,24,023,Garrett County, MD,Jun-17,15898,15137,761,4.8
CN2402300000000,24,023,Garrett County, MD,Jul-17,15967,15238,729,4.6
CN2402300000000,24,023,Garrett County, MD,Aug-17,15656,14942,714,4.6
CN2402300000000,24,023,Garrett County, MD,Sep-17,15344,14701,643,4.2
CN2402300000000,24,023,Garrett County, MD,Oct-17,15528,14867,661,4.3
CN2402300000000,24,023,Garrett County, MD,Nov-17,15127,14458,669,4.4
CN2402300000000,24,023,Garrett County, MD,Dec-17,15335,14526,809,5.3
CN2402300000000,24,023,Garrett County, MD,Jan-18,15490,14455,1035,6.7
CN2402300000000,24,023,Garrett County, MD,Feb-18,15617,14559,1058,6.8
CN2402300000000,24,023,Garrett County, MD,Mar-18,15631,14638,993,6.4
CN2402300000000,24,023,Garrett County, MD,Apr-18(p),15321,14481,840,5.5
CN5107700000000,51,077,Grayson County, VA,Mar-17,7270,6896,374,5.1
CN5107700000000,51,077,Grayson County, VA,Apr-17,7178,6901,277,3.9
CN5107700000000,51,077,Grayson County, VA,May-17,7249,6961,288,4.0
CN5107700000000,51,077,Grayson County, VA,Jun-17,7368,7066,302,4.1
CN5107700000000,51,077,Grayson County, VA,Jul-17,7216,6919,297,4.1
CN5107700000000,51,077,Grayson County, VA,Aug-17,7069,6763,306,4.3
CN5107700000000,51,077,Grayson County, VA,Sep-17,7169,6904,265,3.7
CN5107700000000,51,077,Grayson County, VA,Oct-17,7247,6990,257,3.5
CN5107700000000,51,077,Grayson County, VA,Nov-17,7290,7022,268,3.7
CN5107700000000,51,077,Grayson County, VA,Dec-17,7198,6935,263,3.7
CN5107700000000,51,077,Grayson County, VA,Jan-18,7333,7010,323,4.4
CN5107700000000,51,077,Grayson County, VA,Feb-18,7266,6970,296,4.1
CN5107700000000,51,077,Grayson County, VA,Mar-18,7327,7040,287,3.9
CN5107700000000,51,077,Grayson County, VA,Apr-18(p),7300,7085,215,2.9
CN0604700000000,06,047,Merced County, CA,Mar-17,117345,103296,14049,12.0
CN0604700000000,06,047,Merced County, CA,Apr-17,116007,104073,11934,10.3
CN0604700000000,06,047,Merced County, CA,May-17,115976,105774,10202,8.8
CN0604700000000,06,047,Merced County, CA,Jun-17,116302,105755,10547,9.1
CN0604700000000,06,047,Merced County, CA,Jul-17,113666,103343,10323,9.1
CN0604700000000,06,047,Merced County, CA,Aug-17,116155,106661,9494,8.2
CN0604700000000,06,047,Merced County, CA,Sep-17,119164,111160,8004,6.7
CN0604700000000,06,047,Merced County, CA,Oct-17,117584,109673,7911,6.7
CN0604700000000,06,047,Merced County, CA,Nov-17,116224,107402,8822,7.6
CN0604700000000,06,047,Merced County, CA,Dec-17,115295,105160,10135,8.8
CN0604700000000,06,047,Merced County, CA,Jan-18,113979,102611,11368,10.0
CN0604700000000,06,047,Merced County, CA,Feb-18,116434,104133,12301,10.6
CN0604700000000,06,047,Merced County, CA,Mar-18,116645,104791,11854,10.2
CN0604700000000,06,047,Merced County, CA,Apr-18(p),115718,105645,10073,8.7
CN2302700000000,23,027,Waldo County, ME,Mar-17,20742,19820,922,4.4
CN2302700000000,23,027,Waldo County, ME,Apr-17,20841,20025,816,3.9
CN2302700000000,23,027,Waldo County, ME,May-17,21044,20283,761,3.6
CN2302700000000,23,027,Waldo County, ME,Jun-17,21498,20732,766,3.6
CN2302700000000,23,027,Waldo County, ME,Jul-17,21852,21071,781,3.6
CN2302700000000,23,027,Waldo County, ME,Aug-17,21795,21137,658,3.0
CN2302700000000,23,027,Waldo County, ME,Sep-17,21236,20623,613,2.9
CN2302700000000,23,027,Waldo County, ME,Oct-17,21163,20569,594,2.8
CN2302700000000,23,027,Waldo County, ME,Nov-17,20909,20259,650,3.1
CN2302700000000,23,027,Waldo County, ME,Dec-17,20746,20157,589,2.8
CN2302700000000,23,027,Waldo County, ME,Jan-18,20660,19872,788,3.8
CN2302700000000,23,027,Waldo County, ME,Feb-18,20685,19913,772,3.7
CN2302700000000,23,027,Waldo County, ME,Mar-18,20821,20107,714,3.4
CN2302700000000,23,027,Waldo County, ME,Apr-18(p),21025,20320,705,3.4
CN3805500000000,38,055,McLean County, ND,Mar-17,5050,4836,214,4.2
CN3805500000000,38,055,McLean County, ND,Apr-17,5195,5031,164,3.2
CN3805500000000,38,055,McLean County, ND,May-17,5175,5050,125,2.4
CN3805500000000,38,055,McLean County, ND,Jun-17,5313,5160,153,2.9
CN3805500000000,38,055,McLean County, ND,Jul-17,5234,5102,132,2.5
CN3805500000000,38,055,McLean County, ND,Aug-17,5207,5071,136,2.6
CN3805500000000,38,055,McLean County, ND,Sep-17,5107,4997,110,2.2
CN3805500000000,38,055,McLean County, ND,Oct-17,5142,5037,105,2.0
CN3805500000000,38,055,McLean County, ND,Nov-17,4981,4846,135,2.7
CN3805500000000,38,055,McLean County, ND,Dec-17,4985,4804,181,3.6
CN3805500000000,38,055,McLean County, ND,Jan-18,4937,4707,230,4.7
CN3805500000000,38,055,McLean County, ND,Feb-18,4900,4672,228,4.7
CN3805500000000,38,055,McLean County, ND,Mar-18,5004,4803,201,4.0
CN3805500000000,38,055,McLean County, ND,Apr-18(p),5049,4863,186,3.7
CN4834300000000,48,343,Morris County, TX,Mar-17,4667,4179,488,10.5
CN4834300000000,48,343,Morris County, TX,Apr-17,4710,4260,450,9.6
CN4834300000000,48,343,Morris County, TX,May-17,4687,4285,402,8.6
CN4834300000000,48,343,Morris County, TX,Jun-17,4632,4238,394,8.5
CN4834300000000,48,343,Morris County, TX,Jul-17,4688,4309,379,8.1
CN4834300000000,48,343,Morris County, TX,Aug-17,4705,4335,370,7.9
CN4834300000000,48,343,Morris County, TX,Sep-17,4689,4371,318,6.8
CN4834300000000,48,343,Morris County, TX,Oct-17,4540,4240,300,6.6
CN4834300000000,48,343,Morris County, TX,Nov-17,4567,4257,310,6.8
CN4834300000000,48,343,Morris County, TX,Dec-17,4520,4229,291,6.4
CN4834300000000,48,343,Morris County, TX,Jan-18,4514,4175,339,7.5
CN4834300000000,48,343,Morris County, TX,Feb-18,4587,4242,345,7.5
CN4834300000000,48,343,Morris County, TX,Mar-18,4577,4242,335,7.3
CN4834300000000,48,343,Morris County, TX,Apr-18(p),4596,4279,317,6.9
CN4808500000000,48,085,Collin County, TX,Mar-17,522392,503640,18752,3.6
CN4808500000000,48,085,Collin County, TX,Apr-17,524170,506994,17176,3.3
CN4808500000000,48,085,Collin County, TX,May-17,523254,505707,17547,3.4
CN4808500000000,48,085,Collin County, TX,Jun-17,526108,506869,19239,3.7
CN4808500000000,48,085,Collin County, TX,Jul-17,529904,510808,19096,3.6
CN4808500000000,48,085,Collin County, TX,Aug-17,528593,509493,19100,3.6
CN4808500000000,48,085,Collin County, TX,Sep-17,532898,515951,16947,3.2
CN4808500000000,48,085,Collin County, TX,Oct-17,530370,514476,15894,3.0
CN4808500000000,48,085,Collin County, TX,Nov-17,535015,518508,16507,3.1
CN4808500000000,48,085,Collin County, TX,Dec-17,532325,516400,15925,3.0
CN4808500000000,48,085,Collin County, TX,Jan-18,532876,514771,18105,3.4
CN4808500000000,48,085,Collin County, TX,Feb-18,540708,521944,18764,3.5
CN4808500000000,48,085,Collin County, TX,Mar-18,541482,522273,19209,3.5
CN4808500000000,48,085,Collin County, TX,Apr-18(p),543108,525838,17270,3.2
CN3915900000000,39,159,Union County, OH,Mar-17,28280,27221,1059,3.7
CN3915900000000,39,159,Union County, OH,Apr-17,28181,27265,916,3.3
CN3915900000000,39,159,Union County, OH,May-17,28220,27264,956,3.4
CN3915900000000,39,159,Union County, OH,Jun-17,28462,27324,1138,4.0
CN3915900000000,39,159,Union County, OH,Jul-17,28438,27321,1117,3.9
CN3915900000000,39,159,Union County, OH,Aug-17,28704,27601,1103,3.8
CN3915900000000,39,159,Union County, OH,Sep-17,28319,27322,997,3.5
CN3915900000000,39,159,Union County, OH,Oct-17,28197,27271,926,3.3
CN3915900000000,39,159,Union County, OH,Nov-17,28272,27310,962,3.4
CN3915900000000,39,159,Union County, OH,Dec-17,28075,27098,977,3.5
CN3915900000000,39,159,Union County, OH,Jan-18,27631,26591,1040,3.8
CN3915900000000,39,159,Union County, OH,Feb-18,28138,27163,975,3.5
CN3915900000000,39,159,Union County, OH,Mar-18,28540,27666,874,3.1
CN3915900000000,39,159,Union County, OH,Apr-18(p),28333,27497,836,3.0
CN4713500000000,47,135,Perry County, TN,Mar-17,3216,3023,193,6.0
CN4713500000000,47,135,Perry County, TN,Apr-17,3246,3096,150,4.6
CN4713500000000,47,135,Perry County, TN,May-17,3198,3067,131,4.1
CN4713500000000,47,135,Perry County, TN,Jun-17,3178,3024,154,4.8
CN4713500000000,47,135,Perry County, TN,Jul-17,3206,3057,149,4.6
CN4713500000000,47,135,Perry County, TN,Aug-17,3273,3131,142,4.3
CN4713500000000,47,135,Perry County, TN,Sep-17,3292,3168,124,3.8
CN4713500000000,47,135,Perry County, TN,Oct-17,3285,3158,127,3.9
CN4713500000000,47,135,Perry County, TN,Nov-17,3275,3143,132,4.0
CN4713500000000,47,135,Perry County, TN,Dec-17,3256,3130,126,3.9
CN4713500000000,47,135,Perry County, TN,Jan-18,3298,3142,156,4.7
CN4713500000000,47,135,Perry County, TN,Feb-18,3320,3172,148,4.5
CN4713500000000,47,135,Perry County, TN,Mar-18,3288,3153,135,4.1
CN4713500000000,47,135,Perry County, TN,Apr-18(p),3311,3195,116,3.5
CN2707300000000,27,073,Lac qui Parle County, MN,Mar-17,3599,3437,162,4.5
CN2707300000000,27,073,Lac qui Parle County, MN,Apr-17,3642,3516,126,3.5
CN2707300000000,27,073,Lac qui Parle County, MN,May-17,3600,3492,108,3.0
CN2707300000000,27,073,Lac qui Parle County, MN,Jun-17,3648,3533,115,3.2
CN2707300000000,27,073,Lac qui Parle County, MN,Jul-17,3374,3272,102,3.0
CN2707300000000,27,073,Lac qui Parle County, MN,Aug-17,3305,3200,105,3.2
CN2707300000000,27,073,Lac qui Parle County, MN,Sep-17,3351,3264,87,2.6
CN2707300000000,27,073,Lac qui Parle County, MN,Oct-17,3557,3475,82,2.3
CN2707300000000,27,073,Lac qui Parle County, MN,Nov-17,3501,3414,87,2.5
CN2707300000000,27,073,Lac qui Parle County, MN,Dec-17,3523,3388,135,3.8
CN2707300000000,27,073,Lac qui Parle County, MN,Jan-18,3520,3316,204,5.8
CN2707300000000,27,073,Lac qui Parle County, MN,Feb-18,3504,3317,187,5.3
CN2707300000000,27,073,Lac qui Parle County, MN,Mar-18,3528,3348,180,5.1
CN2707300000000,27,073,Lac qui Parle County, MN,Apr-18(p),3555,3411,144,4.1
CN4830100000000,48,301,Loving County, TX,Mar-17,110,104,6,5.5
CN4830100000000,48,301,Loving County, TX,Apr-17,100,96,4,4.0
CN4830100000000,48,301,Loving County, TX,May-17,104,99,5,4.8
CN4830100000000,48,301,Loving County, TX,Jun-17,97,93,4,4.1
CN4830100000000,48,301,Loving County, TX,Jul-17,94,90,4,4.3
CN4830100000000,48,301,Loving County, TX,Aug-17,91,87,4,4.4
CN4830100000000,48,301,Loving County, TX,Sep-17,89,85,4,4.5
CN4830100000000,48,301,Loving County, TX,Oct-17,94,90,4,4.3
CN4830100000000,48,301,Loving County, TX,Nov-17,90,86,4,4.4
CN4830100000000,48,301,Loving County, TX,Dec-17,93,89,4,4.3
CN4830100000000,48,301,Loving County, TX,Jan-18,96,92,4,4.2
CN4830100000000,48,301,Loving County, TX,Feb-18,96,92,4,4.2
CN4830100000000,48,301,Loving County, TX,Mar-18,99,95,4,4.0
CN4830100000000,48,301,Loving County, TX,Apr-18(p),96,92,4,4.2
CN7204700000000,72,047,Corozal Municipio, PR,Mar-17,9071,8116,955,10.5
CN7204700000000,72,047,Corozal Municipio, PR,Apr-17,8998,7964,1034,11.5
CN7204700000000,72,047,Corozal Municipio, PR,May-17,8933,8044,889,10.0
CN7204700000000,72,047,Corozal Municipio, PR,Jun-17,8998,8043,955,10.6
CN7204700000000,72,047,Corozal Municipio, PR,Jul-17,9177,8084,1093,11.9
CN7204700000000,72,047,Corozal Municipio, PR,Aug-17,9142,7973,1169,12.8
CN7204700000000,72,047,Corozal Municipio, PR,Sep-17(y),9016,7958,1058,11.7
CN7204700000000,72,047,Corozal Municipio, PR,Oct-17,8629,7574,1055,12.2
CN7204700000000,72,047,Corozal Municipio, PR,Nov-17,9046,8062,984,10.9
CN7204700000000,72,047,Corozal Municipio, PR,Dec-17,9045,8100,945,10.4
CN7204700000000,72,047,Corozal Municipio, PR,Jan-18,8972,7972,1000,11.1
CN7204700000000,72,047,Corozal Municipio, PR,Feb-18,8814,7907,907,10.3
CN7204700000000,72,047,Corozal Municipio, PR,Mar-18,8795,7941,854,9.7
CN7204700000000,72,047,Corozal Municipio, PR,Apr-18(p),8802,7982,820,9.3
CN1808500000000,18,085,Kosciusko County, IN,Mar-17,41213,40039,1174,2.8
CN1808500000000,18,085,Kosciusko County, IN,Apr-17,41419,40501,918,2.2
CN1808500000000,18,085,Kosciusko County, IN,May-17,42021,40980,1041,2.5
CN1808500000000,18,085,Kosciusko County, IN,Jun-17,42407,41249,1158,2.7
CN1808500000000,18,085,Kosciusko County, IN,Jul-17,42014,40850,1164,2.8
CN1808500000000,18,085,Kosciusko County, IN,Aug-17,41692,40390,1302,3.1
CN1808500000000,18,085,Kosciusko County, IN,Sep-17,41304,40296,1008,2.4
CN1808500000000,18,085,Kosciusko County, IN,Oct-17,41075,40107,968,2.4
CN1808500000000,18,085,Kosciusko County, IN,Nov-17,40981,39946,1035,2.5
CN1808500000000,18,085,Kosciusko County, IN,Dec-17,40700,39743,957,2.4
CN1808500000000,18,085,Kosciusko County, IN,Jan-18,40505,39402,1103,2.7
CN1808500000000,18,085,Kosciusko County, IN,Feb-18,41096,39955,1141,2.8
CN1808500000000,18,085,Kosciusko County, IN,Mar-18,41458,40461,997,2.4
CN1808500000000,18,085,Kosciusko County, IN,Apr-18(p),41835,40912,923,2.2
CN2903300000000,29,033,Carroll County, MO,Mar-17,4734,4505,229,4.8
CN2903300000000,29,033,Carroll County, MO,Apr-17,5009,4831,178,3.6
CN2903300000000,29,033,Carroll County, MO,May-17,4916,4736,180,3.7
CN2903300000000,29,033,Carroll County, MO,Jun-17,4825,4630,195,4.0
CN2903300000000,29,033,Carroll County, MO,Jul-17,4605,4379,226,4.9
CN2903300000000,29,033,Carroll County, MO,Aug-17,4627,4406,221,4.8
CN2903300000000,29,033,Carroll County, MO,Sep-17,4657,4501,156,3.3
CN2903300000000,29,033,Carroll County, MO,Oct-17,4656,4511,145,3.1
CN2903300000000,29,033,Carroll County, MO,Nov-17,4637,4483,154,3.3
CN2903300000000,29,033,Carroll County, MO,Dec-17,4550,4380,170,3.7
CN2903300000000,29,033,Carroll County, MO,Jan-18,4623,4401,222,4.8
CN2903300000000,29,033,Carroll County, MO,Feb-18,4804,4588,216,4.5
CN2903300000000,29,033,Carroll County, MO,Mar-18,4763,4574,189,4.0
CN2903300000000,29,033,Carroll County, MO,Apr-18(p),4875,4720,155,3.2
CN3802100000000,38,021,Dickey County, ND,Mar-17,2527,2468,59,2.3
CN3802100000000,38,021,Dickey County, ND,Apr-17,2553,2510,43,1.7
CN3802100000000,38,021,Dickey County, ND,May-17,2560,2519,41,1.6
CN3802100000000,38,021,Dickey County, ND,Jun-17,2702,2645,57,2.1
CN3802100000000,38,021,Dickey County, ND,Jul-17,2673,2626,47,1.8
CN3802100000000,38,021,Dickey County, ND,Aug-17,2665,2622,43,1.6
CN3802100000000,38,021,Dickey County, ND,Sep-17,2582,2542,40,1.5
CN3802100000000,38,021,Dickey County, ND,Oct-17,2532,2502,30,1.2
CN3802100000000,38,021,Dickey County, ND,Nov-17,2450,2410,40,1.6
CN3802100000000,38,021,Dickey County, ND,Dec-17,2463,2425,38,1.5
CN3802100000000,38,021,Dickey County, ND,Jan-18,2421,2374,47,1.9
CN3802100000000,38,021,Dickey County, ND,Feb-18,2406,2357,49,2.0
CN3802100000000,38,021,Dickey County, ND,Mar-18,2437,2393,44,1.8
CN3802100000000,38,021,Dickey County, ND,Apr-18(p),2412,2371,41,1.7
CN0802100000000,08,021,Conejos County, CO,Mar-17,3774,3571,203,5.4
CN0802100000000,08,021,Conejos County, CO,Apr-17,3884,3727,157,4.0
CN0802100000000,08,021,Conejos County, CO,May-17,3945,3799,146,3.7
CN0802100000000,08,021,Conejos County, CO,Jun-17,3892,3734,158,4.1
CN0802100000000,08,021,Conejos County, CO,Jul-17,3952,3774,178,4.5
CN0802100000000,08,021,Conejos County, CO,Aug-17,3866,3717,149,3.9
CN0802100000000,08,021,Conejos County, CO,Sep-17,3883,3746,137,3.5
CN0802100000000,08,021,Conejos County, CO,Oct-17,4153,4018,135,3.3
CN0802100000000,08,021,Conejos County, CO,Nov-17,4080,3929,151,3.7
CN0802100000000,08,021,Conejos County, CO,Dec-17,4009,3845,164,4.1
CN0802100000000,08,021,Conejos County, CO,Jan-18,3932,3744,188,4.8
CN0802100000000,08,021,Conejos County, CO,Feb-18,3875,3682,193,5.0
CN0802100000000,08,021,Conejos County, CO,Mar-18,3860,3691,169,4.4
CN0802100000000,08,021,Conejos County, CO,Apr-18(p),3965,3821,144,3.6
CN3601100000000,36,011,Cayuga County, NY,Mar-17,36046,34028,2018,5.6
CN3601100000000,36,011,Cayuga County, NY,Apr-17,36072,34352,1720,4.8
CN3601100000000,36,011,Cayuga County, NY,May-17,35741,34130,1611,4.5
CN3601100000000,36,011,Cayuga County, NY,Jun-17,36780,35073,1707,4.6
CN3601100000000,36,011,Cayuga County, NY,Jul-17,37195,35337,1858,5.0
CN3601100000000,36,011,Cayuga County, NY,Aug-17,36680,34842,1838,5.0
CN3601100000000,36,011,Cayuga County, NY,Sep-17,36162,34481,1681,4.6
CN3601100000000,36,011,Cayuga County, NY,Oct-17,35632,34051,1581,4.4
CN3601100000000,36,011,Cayuga County, NY,Nov-17,35789,34051,1738,4.9
CN3601100000000,36,011,Cayuga County, NY,Dec-17,35282,33482,1800,5.1
CN3601100000000,36,011,Cayuga County, NY,Jan-18,35850,33570,2280,6.4
CN3601100000000,36,011,Cayuga County, NY,Feb-18,35554,33239,2315,6.5
CN3601100000000,36,011,Cayuga County, NY,Mar-18,35008,32858,2150,6.1
CN3601100000000,36,011,Cayuga County, NY,Apr-18(p),35153,33308,1845,5.2
CN4104900000000,41,049,Morrow County, OR,Mar-17,5758,5511,247,4.3
CN4104900000000,41,049,Morrow County, OR,Apr-17,5727,5517,210,3.7
CN4104900000000,41,049,Morrow County, OR,May-17,5766,5556,210,3.6
CN4104900000000,41,049,Morrow County, OR,Jun-17,5990,5725,265,4.4
CN4104900000000,41,049,Morrow County, OR,Jul-17,6214,5850,364,5.9
CN4104900000000,41,049,Morrow County, OR,Aug-17,6180,5903,277,4.5
CN4104900000000,41,049,Morrow County, OR,Sep-17,6077,5843,234,3.9
CN4104900000000,41,049,Morrow County, OR,Oct-17,5933,5722,211,3.6
CN4104900000000,41,049,Morrow County, OR,Nov-17,5817,5573,244,4.2
CN4104900000000,41,049,Morrow County, OR,Dec-17,5618,5374,244,4.3
CN4104900000000,41,049,Morrow County, OR,Jan-18,5690,5400,290,5.1
CN4104900000000,41,049,Morrow County, OR,Feb-18,5762,5467,295,5.1
CN4104900000000,41,049,Morrow County, OR,Mar-18,5829,5581,248,4.3
CN4104900000000,41,049,Morrow County, OR,Apr-18(p),5715,5506,209,3.7
CN2103500000000,21,035,Calloway County, KY,Mar-17,18850,17943,907,4.8
CN2103500000000,21,035,Calloway County, KY,Apr-17,18743,17964,779,4.2
CN2103500000000,21,035,Calloway County, KY,May-17,18697,17906,791,4.2
CN2103500000000,21,035,Calloway County, KY,Jun-17,18930,17958,972,5.1
CN2103500000000,21,035,Calloway County, KY,Jul-17,18646,17723,923,5.0
CN2103500000000,21,035,Calloway County, KY,Aug-17,18605,17832,773,4.2
CN2103500000000,21,035,Calloway County, KY,Sep-17,18693,17968,725,3.9
CN2103500000000,21,035,Calloway County, KY,Oct-17,18409,17732,677,3.7
CN2103500000000,21,035,Calloway County, KY,Nov-17,18322,17640,682,3.7
CN2103500000000,21,035,Calloway County, KY,Dec-17,18207,17581,626,3.4
CN2103500000000,21,035,Calloway County, KY,Jan-18,18212,17493,719,3.9
CN2103500000000,21,035,Calloway County, KY,Feb-18,18526,17676,850,4.6
CN2103500000000,21,035,Calloway County, KY,Mar-18,18754,17995,759,4.0
CN2103500000000,21,035,Calloway County, KY,Apr-18(p),18785,18153,632,3.4
CN2702300000000,27,023,Chippewa County, MN,Mar-17,7130,6765,365,5.1
CN2702300000000,27,023,Chippewa County, MN,Apr-17,7049,6740,309,4.4
CN2702300000000,27,023,Chippewa County, MN,May-17,6982,6753,229,3.3
CN2702300000000,27,023,Chippewa County, MN,Jun-17,7098,6838,260,3.7
CN2702300000000,27,023,Chippewa County, MN,Jul-17,6875,6633,242,3.5
CN2702300000000,27,023,Chippewa County, MN,Aug-17,6751,6490,261,3.9
CN2702300000000,27,023,Chippewa County, MN,Sep-17,6770,6558,212,3.1
CN2702300000000,27,023,Chippewa County, MN,Oct-17,6916,6738,178,2.6
CN2702300000000,27,023,Chippewa County, MN,Nov-17,6896,6681,215,3.1
CN2702300000000,27,023,Chippewa County, MN,Dec-17,6950,6646,304,4.4
CN2702300000000,27,023,Chippewa County, MN,Jan-18,6902,6537,365,5.3
CN2702300000000,27,023,Chippewa County, MN,Feb-18,6896,6580,316,4.6
CN2702300000000,27,023,Chippewa County, MN,Mar-18,6970,6639,331,4.7
CN2702300000000,27,023,Chippewa County, MN,Apr-18(p),6946,6681,265,3.8
CN3002300000000,30,023,Deer Lodge County, MT,Mar-17,5037,4831,206,4.1
CN3002300000000,30,023,Deer Lodge County, MT,Apr-17,5132,4969,163,3.2
CN3002300000000,30,023,Deer Lodge County, MT,May-17,5162,5017,145,2.8
CN3002300000000,30,023,Deer Lodge County, MT,Jun-17,5235,5053,182,3.5
CN3002300000000,30,023,Deer Lodge County, MT,Jul-17,5365,5197,168,3.1
CN3002300000000,30,023,Deer Lodge County, MT,Aug-17,5322,5152,170,3.2
CN3002300000000,30,023,Deer Lodge County, MT,Sep-17,5137,4987,150,2.9
CN3002300000000,30,023,Deer Lodge County, MT,Oct-17,5100,4931,169,3.3
CN3002300000000,30,023,Deer Lodge County, MT,Nov-17,5095,4897,198,3.9
CN3002300000000,30,023,Deer Lodge County, MT,Dec-17,5070,4854,216,4.3
CN3002300000000,30,023,Deer Lodge County, MT,Jan-18,5076,4801,275,5.4
CN3002300000000,30,023,Deer Lodge County, MT,Feb-18,5024,4778,246,4.9
CN3002300000000,30,023,Deer Lodge County, MT,Mar-18,5033,4805,228,4.5
CN3002300000000,30,023,Deer Lodge County, MT,Apr-18(p),5043,4872,171,3.4
CN1904700000000,19,047,Crawford County, IA,Mar-17,8276,7829,447,5.4
CN1904700000000,19,047,Crawford County, IA,Apr-17,8327,7983,344,4.1
CN1904700000000,19,047,Crawford County, IA,May-17,8263,7968,295,3.6
CN1904700000000,19,047,Crawford County, IA,Jun-17,8368,8061,307,3.7
CN1904700000000,19,047,Crawford County, IA,Jul-17,8352,8074,278,3.3
CN1904700000000,19,047,Crawford County, IA,Aug-17,8181,7890,291,3.6
CN1904700000000,19,047,Crawford County, IA,Sep-17,8119,7846,273,3.4
CN1904700000000,19,047,Crawford County, IA,Oct-17,8126,7904,222,2.7
CN1904700000000,19,047,Crawford County, IA,Nov-17,8013,7776,237,3.0
CN1904700000000,19,047,Crawford County, IA,Dec-17,8054,7692,362,4.5
CN1904700000000,19,047,Crawford County, IA,Jan-18,7937,7498,439,5.5
CN1904700000000,19,047,Crawford County, IA,Feb-18,7933,7520,413,5.2
CN1904700000000,19,047,Crawford County, IA,Mar-18,7869,7493,376,4.8
CN1904700000000,19,047,Crawford County, IA,Apr-18(p),7837,7564,273,3.5
CN2803500000000,28,035,Forrest County, MS,Mar-17,33960,32337,1623,4.8
CN2803500000000,28,035,Forrest County, MS,Apr-17,33792,32304,1488,4.4
CN2803500000000,28,035,Forrest County, MS,May-17,33797,32027,1770,5.2
CN2803500000000,28,035,Forrest County, MS,Jun-17,34074,32059,2015,5.9
CN2803500000000,28,035,Forrest County, MS,Jul-17,33980,32038,1942,5.7
CN2803500000000,28,035,Forrest County, MS,Aug-17,33431,31848,1583,4.7
CN2803500000000,28,035,Forrest County, MS,Sep-17,33758,32271,1487,4.4
CN2803500000000,28,035,Forrest County, MS,Oct-17,33994,32615,1379,4.1
CN2803500000000,28,035,Forrest County, MS,Nov-17,34339,32989,1350,3.9
CN2803500000000,28,035,Forrest County, MS,Dec-17,34295,32926,1369,4.0
CN2803500000000,28,035,Forrest County, MS,Jan-18,33677,32282,1395,4.1
CN2803500000000,28,035,Forrest County, MS,Feb-18,34147,32742,1405,4.1
CN2803500000000,28,035,Forrest County, MS,Mar-18,34002,32632,1370,4.0
CN2803500000000,28,035,Forrest County, MS,Apr-18(p),34116,32745,1371,4.0
CN1316500000000,13,165,Jenkins County, GA,Mar-17,3204,2981,223,7.0
CN1316500000000,13,165,Jenkins County, GA,Apr-17,3199,2989,210,6.6
CN1316500000000,13,165,Jenkins County, GA,May-17,3186,2985,201,6.3
CN1316500000000,13,165,Jenkins County, GA,Jun-17,3203,2965,238,7.4
CN1316500000000,13,165,Jenkins County, GA,Jul-17,3221,2968,253,7.9
CN1316500000000,13,165,Jenkins County, GA,Aug-17,3197,2981,216,6.8
CN1316500000000,13,165,Jenkins County, GA,Sep-17,3231,3019,212,6.6
CN1316500000000,13,165,Jenkins County, GA,Oct-17,3202,3013,189,5.9
CN1316500000000,13,165,Jenkins County, GA,Nov-17,3212,3012,200,6.2
CN1316500000000,13,165,Jenkins County, GA,Dec-17,3195,3002,193,6.0
CN1316500000000,13,165,Jenkins County, GA,Jan-18,3254,3036,218,6.7
CN1316500000000,13,165,Jenkins County, GA,Feb-18,3146,2959,187,5.9
CN1316500000000,13,165,Jenkins County, GA,Mar-18,3163,2964,199,6.3
CN1316500000000,13,165,Jenkins County, GA,Apr-18(p),3140,2990,150,4.8
CN2114100000000,21,141,Logan County, KY,Mar-17,12350,11775,575,4.7
CN2114100000000,21,141,Logan County, KY,Apr-17,12461,11941,520,4.2
CN2114100000000,21,141,Logan County, KY,May-17,12484,11953,531,4.3
CN2114100000000,21,141,Logan County, KY,Jun-17,12425,11797,628,5.1
CN2114100000000,21,141,Logan County, KY,Jul-17,11818,11222,596,5.0
CN2114100000000,21,141,Logan County, KY,Aug-17,12093,11561,532,4.4
CN2114100000000,21,141,Logan County, KY,Sep-17,12059,11578,481,4.0
CN2114100000000,21,141,Logan County, KY,Oct-17,12018,11564,454,3.8
CN2114100000000,21,141,Logan County, KY,Nov-17,12012,11576,436,3.6
CN2114100000000,21,141,Logan County, KY,Dec-17,11957,11531,426,3.6
CN2114100000000,21,141,Logan County, KY,Jan-18,11977,11522,455,3.8
CN2114100000000,21,141,Logan County, KY,Feb-18,12453,11921,532,4.3
CN2114100000000,21,141,Logan County, KY,Mar-18,12556,12053,503,4.0
CN2114100000000,21,141,Logan County, KY,Apr-18(p),12620,12178,442,3.5
CN1300900000000,13,009,Baldwin County, GA,Mar-17,17856,16798,1058,5.9
CN1300900000000,13,009,Baldwin County, GA,Apr-17,17899,16896,1003,5.6
CN1300900000000,13,009,Baldwin County, GA,May-17,17729,16720,1009,5.7
CN1300900000000,13,009,Baldwin County, GA,Jun-17,17633,16476,1157,6.6
CN1300900000000,13,009,Baldwin County, GA,Jul-17,17590,16468,1122,6.4
CN1300900000000,13,009,Baldwin County, GA,Aug-17,17696,16620,1076,6.1
CN1300900000000,13,009,Baldwin County, GA,Sep-17,17962,16947,1015,5.7
CN1300900000000,13,009,Baldwin County, GA,Oct-17,17827,16841,986,5.5
CN1300900000000,13,009,Baldwin County, GA,Nov-17,17857,16882,975,5.5
CN1300900000000,13,009,Baldwin County, GA,Dec-17,17763,16771,992,5.6
CN1300900000000,13,009,Baldwin County, GA,Jan-18,18095,16986,1109,6.1
CN1300900000000,13,009,Baldwin County, GA,Feb-18,18107,17047,1060,5.9
CN1300900000000,13,009,Baldwin County, GA,Mar-18,17890,16953,937,5.2
CN1300900000000,13,009,Baldwin County, GA,Apr-18(p),17901,17073,828,4.6
CN4210900000000,42,109,Snyder County, PA,Mar-17,20883,19850,1033,4.9
CN4210900000000,42,109,Snyder County, PA,Apr-17,21088,20242,846,4.0
CN4210900000000,42,109,Snyder County, PA,May-17,21025,20141,884,4.2
CN4210900000000,42,109,Snyder County, PA,Jun-17,20690,19819,871,4.2
CN4210900000000,42,109,Snyder County, PA,Jul-17,20688,19739,949,4.6
CN4210900000000,42,109,Snyder County, PA,Aug-17,20335,19439,896,4.4
CN4210900000000,42,109,Snyder County, PA,Sep-17,20387,19628,759,3.7
CN4210900000000,42,109,Snyder County, PA,Oct-17,20252,19479,773,3.8
CN4210900000000,42,109,Snyder County, PA,Nov-17,20231,19416,815,4.0
CN4210900000000,42,109,Snyder County, PA,Dec-17,20255,19396,859,4.2
CN4210900000000,42,109,Snyder County, PA,Jan-18,19872,18850,1022,5.1
CN4210900000000,42,109,Snyder County, PA,Feb-18,20545,19537,1008,4.9
CN4210900000000,42,109,Snyder County, PA,Mar-18,20277,19401,876,4.3
CN4210900000000,42,109,Snyder County, PA,Apr-18(p),20229,19490,739,3.7
CN4607500000000,46,075,Jones County, SD,Mar-17,537,517,20,3.7
CN4607500000000,46,075,Jones County, SD,Apr-17,542,523,19,3.5
CN4607500000000,46,075,Jones County, SD,May-17,590,572,18,3.1
CN4607500000000,46,075,Jones County, SD,Jun-17,632,616,16,2.5
CN4607500000000,46,075,Jones County, SD,Jul-17,632,619,13,2.1
CN4607500000000,46,075,Jones County, SD,Aug-17,607,591,16,2.6
CN4607500000000,46,075,Jones County, SD,Sep-17,571,557,14,2.5
CN4607500000000,46,075,Jones County, SD,Oct-17,534,516,18,3.4
CN4607500000000,46,075,Jones County, SD,Nov-17,519,503,16,3.1
CN4607500000000,46,075,Jones County, SD,Dec-17,535,521,14,2.6
CN4607500000000,46,075,Jones County, SD,Jan-18,524,506,18,3.4
CN4607500000000,46,075,Jones County, SD,Feb-18,517,497,20,3.9
CN4607500000000,46,075,Jones County, SD,Mar-18,523,508,15,2.9
CN4607500000000,46,075,Jones County, SD,Apr-18(p),514,496,18,3.5
CN4008700000000,40,087,McClain County, OK,Mar-17,18919,18198,721,3.8
CN4008700000000,40,087,McClain County, OK,Apr-17,18870,18244,626,3.3
CN4008700000000,40,087,McClain County, OK,May-17,18822,18115,707,3.8
CN4008700000000,40,087,McClain County, OK,Jun-17,19009,18265,744,3.9
CN4008700000000,40,087,McClain County, OK,Jul-17,19146,18447,699,3.7
CN4008700000000,40,087,McClain County, OK,Aug-17,19045,18359,686,3.6
CN4008700000000,40,087,McClain County, OK,Sep-17,19180,18538,642,3.3
CN4008700000000,40,087,McClain County, OK,Oct-17,19285,18657,628,3.3
CN4008700000000,40,087,McClain County, OK,Nov-17,19382,18776,606,3.1
CN4008700000000,40,087,McClain County, OK,Dec-17,19151,18546,605,3.2
CN4008700000000,40,087,McClain County, OK,Jan-18,18963,18285,678,3.6
CN4008700000000,40,087,McClain County, OK,Feb-18,19250,18599,651,3.4
CN4008700000000,40,087,McClain County, OK,Mar-18,19326,18675,651,3.4
CN4008700000000,40,087,McClain County, OK,Apr-18(p),19202,18588,614,3.2
CN4904700000000,49,047,Uintah County, UT,Mar-17,13842,12854,988,7.1
CN4904700000000,49,047,Uintah County, UT,Apr-17,13781,12880,901,6.5
CN4904700000000,49,047,Uintah County, UT,May-17,13923,13072,851,6.1
CN4904700000000,49,047,Uintah County, UT,Jun-17,14287,13390,897,6.3
CN4904700000000,49,047,Uintah County, UT,Jul-17,14213,13382,831,5.8
CN4904700000000,49,047,Uintah County, UT,Aug-17,14039,13242,797,5.7
CN4904700000000,49,047,Uintah County, UT,Sep-17,13875,13174,701,5.1
CN4904700000000,49,047,Uintah County, UT,Oct-17,13973,13284,689,4.9
CN4904700000000,49,047,Uintah County, UT,Nov-17,13973,13315,658,4.7
CN4904700000000,49,047,Uintah County, UT,Dec-17,14024,13351,673,4.8
CN4904700000000,49,047,Uintah County, UT,Jan-18,13858,13146,712,5.1
CN4904700000000,49,047,Uintah County, UT,Feb-18,13765,13028,737,5.4
CN4904700000000,49,047,Uintah County, UT,Mar-18,13915,13161,754,5.4
CN4904700000000,49,047,Uintah County, UT,Apr-18(p),13849,13184,665,4.8
CN5506300000000,55,063,La Crosse County, WI,Mar-17,68392,66231,2161,3.2
CN5506300000000,55,063,La Crosse County, WI,Apr-17,68444,66620,1824,2.7
CN5506300000000,55,063,La Crosse County, WI,May-17,68228,66334,1894,2.8
CN5506300000000,55,063,La Crosse County, WI,Jun-17,68319,65997,2322,3.4
CN5506300000000,55,063,La Crosse County, WI,Jul-17,67768,65601,2167,3.2
CN5506300000000,55,063,La Crosse County, WI,Aug-17,67228,65273,1955,2.9
CN5506300000000,55,063,La Crosse County, WI,Sep-17,68432,66654,1778,2.6
CN5506300000000,55,063,La Crosse County, WI,Oct-17,68777,67118,1659,2.4
CN5506300000000,55,063,La Crosse County, WI,Nov-17,68901,67260,1641,2.4
CN5506300000000,55,063,La Crosse County, WI,Dec-17,68275,66716,1559,2.3
CN5506300000000,55,063,La Crosse County, WI,Jan-18,67465,65593,1872,2.8
CN5506300000000,55,063,La Crosse County, WI,Feb-18,69468,67459,2009,2.9
CN5506300000000,55,063,La Crosse County, WI,Mar-18,68756,66842,1914,2.8
CN5506300000000,55,063,La Crosse County, WI,Apr-18(p),69362,67824,1538,2.2
CN2612300000000,26,123,Newaygo County, MI,Mar-17,23566,22297,1269,5.4
CN2612300000000,26,123,Newaygo County, MI,Apr-17,23334,22301,1033,4.4
CN2612300000000,26,123,Newaygo County, MI,May-17,23475,22470,1005,4.3
CN2612300000000,26,123,Newaygo County, MI,Jun-17,23760,22628,1132,4.8
CN2612300000000,26,123,Newaygo County, MI,Jul-17,23652,22302,1350,5.7
CN2612300000000,26,123,Newaygo County, MI,Aug-17,23414,22208,1206,5.2
CN2612300000000,26,123,Newaygo County, MI,Sep-17,23423,22390,1033,4.4
CN2612300000000,26,123,Newaygo County, MI,Oct-17,23300,22325,975,4.2
CN2612300000000,26,123,Newaygo County, MI,Nov-17,23353,22320,1033,4.4
CN2612300000000,26,123,Newaygo County, MI,Dec-17,23409,22205,1204,5.1
CN2612300000000,26,123,Newaygo County, MI,Jan-18,23430,22009,1421,6.1
CN2612300000000,26,123,Newaygo County, MI,Feb-18,23776,22297,1479,6.2
CN2612300000000,26,123,Newaygo County, MI,Mar-18,23776,22491,1285,5.4
CN2612300000000,26,123,Newaygo County, MI,Apr-18(p),23596,22565,1031,4.4
CN4501900000000,45,019,Charleston County, SC,Mar-17,203868,197175,6693,3.3
CN4501900000000,45,019,Charleston County, SC,Apr-17,204409,198146,6263,3.1
CN4501900000000,45,019,Charleston County, SC,May-17,205627,199197,6430,3.1
CN4501900000000,45,019,Charleston County, SC,Jun-17,207687,199988,7699,3.7
CN4501900000000,45,019,Charleston County, SC,Jul-17,208490,200932,7558,3.6
CN4501900000000,45,019,Charleston County, SC,Aug-17,206610,198644,7966,3.9
CN4501900000000,45,019,Charleston County, SC,Sep-17,205205,198091,7114,3.5
CN4501900000000,45,019,Charleston County, SC,Oct-17,205140,198235,6905,3.4
CN4501900000000,45,019,Charleston County, SC,Nov-17,204512,197980,6532,3.2
CN4501900000000,45,019,Charleston County, SC,Dec-17,202672,195975,6697,3.3
CN4501900000000,45,019,Charleston County, SC,Jan-18,202700,194511,8189,4.0
CN4501900000000,45,019,Charleston County, SC,Feb-18,204882,197281,7601,3.7
CN4501900000000,45,019,Charleston County, SC,Mar-18,205545,198739,6806,3.3
CN4501900000000,45,019,Charleston County, SC,Apr-18(p),202662,198172,4490,2.2
CN1305900000000,13,059,Clarke County, GA,Mar-17,60340,57471,2869,4.8
CN1305900000000,13,059,Clarke County, GA,Apr-17,61231,58502,2729,4.5
CN1305900000000,13,059,Clarke County, GA,May-17,60760,57995,2765,4.6
CN1305900000000,13,059,Clarke County, GA,Jun-17,61629,58329,3300,5.4
CN1305900000000,13,059,Clarke County, GA,Jul-17,61221,57979,3242,5.3
CN1305900000000,13,059,Clarke County, GA,Aug-17,60810,57785,3025,5.0
CN1305900000000,13,059,Clarke County, GA,Sep-17,61787,59013,2774,4.5
CN1305900000000,13,059,Clarke County, GA,Oct-17,61624,58946,2678,4.3
CN1305900000000,13,059,Clarke County, GA,Nov-17,61843,59220,2623,4.2
CN1305900000000,13,059,Clarke County, GA,Dec-17,60911,58343,2568,4.2
CN1305900000000,13,059,Clarke County, GA,Jan-18,61620,58979,2641,4.3
CN1305900000000,13,059,Clarke County, GA,Feb-18,62957,60147,2810,4.5
CN1305900000000,13,059,Clarke County, GA,Mar-18,62740,60232,2508,4.0
CN1305900000000,13,059,Clarke County, GA,Apr-18(p),62690,60416,2274,3.6
CN1718500000000,17,185,Wabash County, IL,Mar-17,5637,5353,284,5.0
CN1718500000000,17,185,Wabash County, IL,Apr-17,5587,5334,253,4.5
CN1718500000000,17,185,Wabash County, IL,May-17,5530,5283,247,4.5
CN1718500000000,17,185,Wabash County, IL,Jun-17,5728,5456,272,4.7
CN1718500000000,17,185,Wabash County, IL,Jul-17,5670,5383,287,5.1
CN1718500000000,17,185,Wabash County, IL,Aug-17,5581,5289,292,5.2
CN1718500000000,17,185,Wabash County, IL,Sep-17,5599,5355,244,4.4
CN1718500000000,17,185,Wabash County, IL,Oct-17,5509,5288,221,4.0
CN1718500000000,17,185,Wabash County, IL,Nov-17,5548,5311,237,4.3
CN1718500000000,17,185,Wabash County, IL,Dec-17,5555,5313,242,4.4
CN1718500000000,17,185,Wabash County, IL,Jan-18,5436,5200,236,4.3
CN1718500000000,17,185,Wabash County, IL,Feb-18,5458,5235,223,4.1
CN1718500000000,17,185,Wabash County, IL,Mar-18,5583,5361,222,4.0
CN1718500000000,17,185,Wabash County, IL,Apr-18(p),5627,5450,177,3.1
CN5114100000000,51,141,Patrick County, VA,Mar-17,7376,7034,342,4.6
CN5114100000000,51,141,Patrick County, VA,Apr-17,7370,7071,299,4.1
CN5114100000000,51,141,Patrick County, VA,May-17,7437,7111,326,4.4
CN5114100000000,51,141,Patrick County, VA,Jun-17,7537,7190,347,4.6
CN5114100000000,51,141,Patrick County, VA,Jul-17,7467,7109,358,4.8
CN5114100000000,51,141,Patrick County, VA,Aug-17,7466,7126,340,4.6
CN5114100000000,51,141,Patrick County, VA,Sep-17,7428,7118,310,4.2
CN5114100000000,51,141,Patrick County, VA,Oct-17,7510,7188,322,4.3
CN5114100000000,51,141,Patrick County, VA,Nov-17,7456,7136,320,4.3
CN5114100000000,51,141,Patrick County, VA,Dec-17,7418,7117,301,4.1
CN5114100000000,51,141,Patrick County, VA,Jan-18,7360,6933,427,5.8
CN5114100000000,51,141,Patrick County, VA,Feb-18,7317,6941,376,5.1
CN5114100000000,51,141,Patrick County, VA,Mar-18,7324,6962,362,4.9
CN5114100000000,51,141,Patrick County, VA,Apr-18(p),7365,7074,291,4.0
CN7215300000000,72,153,Yauco Municipio, PR,Mar-17,10618,8563,2055,19.4
CN7215300000000,72,153,Yauco Municipio, PR,Apr-17,10430,8352,2078,19.9
CN7215300000000,72,153,Yauco Municipio, PR,May-17,10365,8507,1858,17.9
CN7215300000000,72,153,Yauco Municipio, PR,Jun-17,10018,8523,1495,14.9
CN7215300000000,72,153,Yauco Municipio, PR,Jul-17,10100,8577,1523,15.1
CN7215300000000,72,153,Yauco Municipio, PR,Aug-17,10130,8431,1699,16.8
CN7215300000000,72,153,Yauco Municipio, PR,Sep-17(y),9856,8338,1518,15.4
CN7215300000000,72,153,Yauco Municipio, PR,Oct-17,9772,8118,1654,16.9
CN7215300000000,72,153,Yauco Municipio, PR,Nov-17,10156,8622,1534,15.1
CN7215300000000,72,153,Yauco Municipio, PR,Dec-17,10280,8682,1598,15.5
CN7215300000000,72,153,Yauco Municipio, PR,Jan-18,10251,8461,1790,17.5
CN7215300000000,72,153,Yauco Municipio, PR,Feb-18,9988,8305,1683,16.9
CN7215300000000,72,153,Yauco Municipio, PR,Mar-18,10012,8345,1667,16.7
CN7215300000000,72,153,Yauco Municipio, PR,Apr-18(p),9900,8360,1540,15.6
CN3809900000000,38,099,Walsh County, ND,Mar-17,5564,5327,237,4.3
CN3809900000000,38,099,Walsh County, ND,Apr-17,5630,5454,176,3.1
CN3809900000000,38,099,Walsh County, ND,May-17,5643,5499,144,2.6
CN3809900000000,38,099,Walsh County, ND,Jun-17,6039,5807,232,3.8
CN3809900000000,38,099,Walsh County, ND,Jul-17,5828,5634,194,3.3
CN3809900000000,38,099,Walsh County, ND,Aug-17,5778,5590,188,3.3
CN3809900000000,38,099,Walsh County, ND,Sep-17,5714,5584,130,2.3
CN3809900000000,38,099,Walsh County, ND,Oct-17,5685,5572,113,2.0
CN3809900000000,38,099,Walsh County, ND,Nov-17,5472,5323,149,2.7
CN3809900000000,38,099,Walsh County, ND,Dec-17,5431,5255,176,3.2
CN3809900000000,38,099,Walsh County, ND,Jan-18,5409,5187,222,4.1
CN3809900000000,38,099,Walsh County, ND,Feb-18,5342,5125,217,4.1
CN3809900000000,38,099,Walsh County, ND,Mar-18,5371,5172,199,3.7
CN3809900000000,38,099,Walsh County, ND,Apr-18(p),5455,5269,186,3.4
CN1210900000000,12,109,St. Johns County, FL,Mar-17,121346,117271,4075,3.4
CN1210900000000,12,109,St. Johns County, FL,Apr-17,121808,117949,3859,3.2
CN1210900000000,12,109,St. Johns County, FL,May-17,122878,118973,3905,3.2
CN1210900000000,12,109,St. Johns County, FL,Jun-17,123759,119492,4267,3.4
CN1210900000000,12,109,St. Johns County, FL,Jul-17,124423,120108,4315,3.5
CN1210900000000,12,109,St. Johns County, FL,Aug-17,123770,119534,4236,3.4
CN1210900000000,12,109,St. Johns County, FL,Sep-17,125747,121809,3938,3.1
CN1210900000000,12,109,St. Johns County, FL,Oct-17,124365,120611,3754,3.0
CN1210900000000,12,109,St. Johns County, FL,Nov-17,124055,120228,3827,3.1
CN1210900000000,12,109,St. Johns County, FL,Dec-17,123445,119935,3510,2.8
CN1210900000000,12,109,St. Johns County, FL,Jan-18,123384,119243,4141,3.4
CN1210900000000,12,109,St. Johns County, FL,Feb-18,124377,120604,3773,3.0
CN1210900000000,12,109,St. Johns County, FL,Mar-18,124877,121144,3733,3.0
CN1210900000000,12,109,St. Johns County, FL,Apr-18(p),124359,120998,3361,2.7
CN2908300000000,29,083,Henry County, MO,Mar-17,9793,9361,432,4.4
CN2908300000000,29,083,Henry County, MO,Apr-17,9847,9480,367,3.7
CN2908300000000,29,083,Henry County, MO,May-17,9784,9392,392,4.0
CN2908300000000,29,083,Henry County, MO,Jun-17,9871,9440,431,4.4
CN2908300000000,29,083,Henry County, MO,Jul-17,9617,9126,491,5.1
CN2908300000000,29,083,Henry County, MO,Aug-17,9384,8918,466,5.0
CN2908300000000,29,083,Henry County, MO,Sep-17,9600,9268,332,3.5
CN2908300000000,29,083,Henry County, MO,Oct-17,9522,9253,269,2.8
CN2908300000000,29,083,Henry County, MO,Nov-17,9510,9204,306,3.2
CN2908300000000,29,083,Henry County, MO,Dec-17,9498,9166,332,3.5
CN2908300000000,29,083,Henry County, MO,Jan-18,9498,9057,441,4.6
CN2908300000000,29,083,Henry County, MO,Feb-18,9607,9189,418,4.4
CN2908300000000,29,083,Henry County, MO,Mar-18,9615,9223,392,4.1
CN2908300000000,29,083,Henry County, MO,Apr-18(p),9642,9282,360,3.7
CN1713500000000,17,135,Montgomery County, IL,Mar-17,11972,11256,716,6.0
CN1713500000000,17,135,Montgomery County, IL,Apr-17,11967,11407,560,4.7
CN1713500000000,17,135,Montgomery County, IL,May-17,11968,11401,567,4.7
CN1713500000000,17,135,Montgomery County, IL,Jun-17,12116,11496,620,5.1
CN1713500000000,17,135,Montgomery County, IL,Jul-17,11978,11330,648,5.4
CN1713500000000,17,135,Montgomery County, IL,Aug-17,11926,11272,654,5.5
CN1713500000000,17,135,Montgomery County, IL,Sep-17,11805,11205,600,5.1
CN1713500000000,17,135,Montgomery County, IL,Oct-17,11743,11171,572,4.9
CN1713500000000,17,135,Montgomery County, IL,Nov-17,11716,11107,609,5.2
CN1713500000000,17,135,Montgomery County, IL,Dec-17,11557,10946,611,5.3
CN1713500000000,17,135,Montgomery County, IL,Jan-18,11646,10912,734,6.3
CN1713500000000,17,135,Montgomery County, IL,Feb-18,11655,10983,672,5.8
CN1713500000000,17,135,Montgomery County, IL,Mar-18,11911,11269,642,5.4
CN1713500000000,17,135,Montgomery County, IL,Apr-18(p),12098,11568,530,4.4
CN1914500000000,19,145,Page County, IA,Mar-17,6309,6020,289,4.6
CN1914500000000,19,145,Page County, IA,Apr-17,6328,6052,276,4.4
CN1914500000000,19,145,Page County, IA,May-17,6316,6061,255,4.0
CN1914500000000,19,145,Page County, IA,Jun-17,6404,6147,257,4.0
CN1914500000000,19,145,Page County, IA,Jul-17,6451,6214,237,3.7
CN1914500000000,19,145,Page County, IA,Aug-17,6249,6005,244,3.9
CN1914500000000,19,145,Page County, IA,Sep-17,6219,6012,207,3.3
CN1914500000000,19,145,Page County, IA,Oct-17,6213,6023,190,3.1
CN1914500000000,19,145,Page County, IA,Nov-17,6148,5962,186,3.0
CN1914500000000,19,145,Page County, IA,Dec-17,6127,5929,198,3.2
CN1914500000000,19,145,Page County, IA,Jan-18,6107,5876,231,3.8
CN1914500000000,19,145,Page County, IA,Feb-18,6114,5904,210,3.4
CN1914500000000,19,145,Page County, IA,Mar-18,6069,5890,179,2.9
CN1914500000000,19,145,Page County, IA,Apr-18(p),6036,5877,159,2.6
CN5400700000000,54,007,Braxton County, WV,Mar-17,5373,4906,467,8.7
CN5400700000000,54,007,Braxton County, WV,Apr-17,5373,5006,367,6.8
CN5400700000000,54,007,Braxton County, WV,May-17,5268,4943,325,6.2
CN5400700000000,54,007,Braxton County, WV,Jun-17,5416,5060,356,6.6
CN5400700000000,54,007,Braxton County, WV,Jul-17,5337,5005,332,6.2
CN5400700000000,54,007,Braxton County, WV,Aug-17,5314,4971,343,6.5
CN5400700000000,54,007,Braxton County, WV,Sep-17,5409,5101,308,5.7
CN5400700000000,54,007,Braxton County, WV,Oct-17,5380,5064,316,5.9
CN5400700000000,54,007,Braxton County, WV,Nov-17,5340,4964,376,7.0
CN5400700000000,54,007,Braxton County, WV,Dec-17,5292,4869,423,8.0
CN5400700000000,54,007,Braxton County, WV,Jan-18,5421,4929,492,9.1
CN5400700000000,54,007,Braxton County, WV,Feb-18,5462,4956,506,9.3
CN5400700000000,54,007,Braxton County, WV,Mar-18,5412,4946,466,8.6
CN5400700000000,54,007,Braxton County, WV,Apr-18(p),5444,5074,370,6.8
CN5511100000000,55,111,Sauk County, WI,Mar-17,34922,33711,1211,3.5
CN5511100000000,55,111,Sauk County, WI,Apr-17,35118,34125,993,2.8
CN5511100000000,55,111,Sauk County, WI,May-17,35594,34636,958,2.7
CN5511100000000,55,111,Sauk County, WI,Jun-17,37570,36443,1127,3.0
CN5511100000000,55,111,Sauk County, WI,Jul-17,37480,36493,987,2.6
CN5511100000000,55,111,Sauk County, WI,Aug-17,36740,35809,931,2.5
CN5511100000000,55,111,Sauk County, WI,Sep-17,35914,35034,880,2.5
CN5511100000000,55,111,Sauk County, WI,Oct-17,35458,34596,862,2.4
CN5511100000000,55,111,Sauk County, WI,Nov-17,35350,34453,897,2.5
CN5511100000000,55,111,Sauk County, WI,Dec-17,35187,34287,900,2.6
CN5511100000000,55,111,Sauk County, WI,Jan-18,35197,34198,999,2.8
CN5511100000000,55,111,Sauk County, WI,Feb-18,35183,34042,1141,3.2
CN5511100000000,55,111,Sauk County, WI,Mar-18,35492,34448,1044,2.9
CN5511100000000,55,111,Sauk County, WI,Apr-18(p),35497,34656,841,2.4
CN1321300000000,13,213,Murray County, GA,Mar-17,15892,14857,1035,6.5
CN1321300000000,13,213,Murray County, GA,Apr-17,15744,14851,893,5.7
CN1321300000000,13,213,Murray County, GA,May-17,15755,14857,898,5.7
CN1321300000000,13,213,Murray County, GA,Jun-17,15766,14835,931,5.9
CN1321300000000,13,213,Murray County, GA,Jul-17,15875,14932,943,5.9
CN1321300000000,13,213,Murray County, GA,Aug-17,15725,14797,928,5.9
CN1321300000000,13,213,Murray County, GA,Sep-17,15912,14964,948,6.0
CN1321300000000,13,213,Murray County, GA,Oct-17,15689,14796,893,5.7
CN1321300000000,13,213,Murray County, GA,Nov-17,15727,14800,927,5.9
CN1321300000000,13,213,Murray County, GA,Dec-17,15807,14834,973,6.2
CN1321300000000,13,213,Murray County, GA,Jan-18,16110,14977,1133,7.0
CN1321300000000,13,213,Murray County, GA,Feb-18,16123,15142,981,6.1
CN1321300000000,13,213,Murray County, GA,Mar-18,16091,15206,885,5.5
CN1321300000000,13,213,Murray County, GA,Apr-18(p),15910,15164,746,4.7
CN3109900000000,31,099,Kearney County, NE,Mar-17,3720,3641,79,2.1
CN3109900000000,31,099,Kearney County, NE,Apr-17,3785,3707,78,2.1
CN3109900000000,31,099,Kearney County, NE,May-17,3801,3716,85,2.2
CN3109900000000,31,099,Kearney County, NE,Jun-17,3876,3789,87,2.2
CN3109900000000,31,099,Kearney County, NE,Jul-17,3793,3704,89,2.3
CN3109900000000,31,099,Kearney County, NE,Aug-17,3730,3643,87,2.3
CN3109900000000,31,099,Kearney County, NE,Sep-17,3686,3608,78,2.1
CN3109900000000,31,099,Kearney County, NE,Oct-17,3717,3642,75,2.0
CN3109900000000,31,099,Kearney County, NE,Nov-17,3691,3627,64,1.7
CN3109900000000,31,099,Kearney County, NE,Dec-17,3683,3602,81,2.2
CN3109900000000,31,099,Kearney County, NE,Jan-18,3719,3641,78,2.1
CN3109900000000,31,099,Kearney County, NE,Feb-18,3716,3641,75,2.0
CN3109900000000,31,099,Kearney County, NE,Mar-18,3725,3648,77,2.1
CN3109900000000,31,099,Kearney County, NE,Apr-18(p),3739,3658,81,2.2
CN3714900000000,37,149,Polk County, NC,Mar-17,8792,8416,376,4.3
CN3714900000000,37,149,Polk County, NC,Apr-17,8898,8567,331,3.7
CN3714900000000,37,149,Polk County, NC,May-17,8959,8602,357,4.0
CN3714900000000,37,149,Polk County, NC,Jun-17,9052,8670,382,4.2
CN3714900000000,37,149,Polk County, NC,Jul-17,9062,8649,413,4.6
CN3714900000000,37,149,Polk County, NC,Aug-17,9028,8617,411,4.6
CN3714900000000,37,149,Polk County, NC,Sep-17,9093,8741,352,3.9
CN3714900000000,37,149,Polk County, NC,Oct-17,9060,8714,346,3.8
CN3714900000000,37,149,Polk County, NC,Nov-17,9004,8635,369,4.1
CN3714900000000,37,149,Polk County, NC,Dec-17,8934,8571,363,4.1
CN3714900000000,37,149,Polk County, NC,Jan-18,8932,8534,398,4.5
CN3714900000000,37,149,Polk County, NC,Feb-18,8996,8611,385,4.3
CN3714900000000,37,149,Polk County, NC,Mar-18,8971,8605,366,4.1
CN3714900000000,37,149,Polk County, NC,Apr-18(p),9026,8708,318,3.5
CN4204700000000,42,047,Elk County, PA,Mar-17,16164,15327,837,5.2
CN4204700000000,42,047,Elk County, PA,Apr-17,15895,15181,714,4.5
CN4204700000000,42,047,Elk County, PA,May-17,16029,15284,745,4.6
CN4204700000000,42,047,Elk County, PA,Jun-17,16336,15507,829,5.1
CN4204700000000,42,047,Elk County, PA,Jul-17,16430,15560,870,5.3
CN4204700000000,42,047,Elk County, PA,Aug-17,16237,15394,843,5.2
CN4204700000000,42,047,Elk County, PA,Sep-17,15821,15164,657,4.2
CN4204700000000,42,047,Elk County, PA,Oct-17,15626,14989,637,4.1
CN4204700000000,42,047,Elk County, PA,Nov-17,15615,14959,656,4.2
CN4204700000000,42,047,Elk County, PA,Dec-17,15538,14883,655,4.2
CN4204700000000,42,047,Elk County, PA,Jan-18,15758,15026,732,4.6
CN4204700000000,42,047,Elk County, PA,Feb-18,15617,14903,714,4.6
CN4204700000000,42,047,Elk County, PA,Mar-18,15536,14916,620,4.0
CN4204700000000,42,047,Elk County, PA,Apr-18(p),15501,14961,540,3.5
CN5103500000000,51,035,Carroll County, VA,Mar-17,13106,12355,751,5.7
CN5103500000000,51,035,Carroll County, VA,Apr-17,13006,12446,560,4.3
CN5103500000000,51,035,Carroll County, VA,May-17,13187,12623,564,4.3
CN5103500000000,51,035,Carroll County, VA,Jun-17,13294,12730,564,4.2
CN5103500000000,51,035,Carroll County, VA,Jul-17,12990,12408,582,4.5
CN5103500000000,51,035,Carroll County, VA,Aug-17,12878,12281,597,4.6
CN5103500000000,51,035,Carroll County, VA,Sep-17,13002,12484,518,4.0
CN5103500000000,51,035,Carroll County, VA,Oct-17,12858,12367,491,3.8
CN5103500000000,51,035,Carroll County, VA,Nov-17,12900,12377,523,4.1
CN5103500000000,51,035,Carroll County, VA,Dec-17,12897,12359,538,4.2
CN5103500000000,51,035,Carroll County, VA,Jan-18,13043,12446,597,4.6
CN5103500000000,51,035,Carroll County, VA,Feb-18,13034,12475,559,4.3
CN5103500000000,51,035,Carroll County, VA,Mar-18,13136,12585,551,4.2
CN5103500000000,51,035,Carroll County, VA,Apr-18(p),13153,12708,445,3.4
CN3910900000000,39,109,Miami County, OH,Mar-17,53328,50993,2335,4.4
CN3910900000000,39,109,Miami County, OH,Apr-17,53223,51155,2068,3.9
CN3910900000000,39,109,Miami County, OH,May-17,53329,51240,2089,3.9
CN3910900000000,39,109,Miami County, OH,Jun-17,53749,51385,2364,4.4
CN3910900000000,39,109,Miami County, OH,Jul-17,54410,52005,2405,4.4
CN3910900000000,39,109,Miami County, OH,Aug-17,54109,51738,2371,4.4
CN3910900000000,39,109,Miami County, OH,Sep-17,53577,51491,2086,3.9
CN3910900000000,39,109,Miami County, OH,Oct-17,53944,51962,1982,3.7
CN3910900000000,39,109,Miami County, OH,Nov-17,54209,52204,2005,3.7
CN3910900000000,39,109,Miami County, OH,Dec-17,54343,52211,2132,3.9
CN3910900000000,39,109,Miami County, OH,Jan-18,53094,50800,2294,4.3
CN3910900000000,39,109,Miami County, OH,Feb-18,54340,52154,2186,4.0
CN3910900000000,39,109,Miami County, OH,Mar-18,54717,52732,1985,3.6
CN3910900000000,39,109,Miami County, OH,Apr-18(p),54426,52565,1861,3.4
CN4506900000000,45,069,Marlboro County, SC,Mar-17,9124,8561,563,6.2
CN4506900000000,45,069,Marlboro County, SC,Apr-17,9042,8505,537,5.9
CN4506900000000,45,069,Marlboro County, SC,May-17,9104,8561,543,6.0
CN4506900000000,45,069,Marlboro County, SC,Jun-17,9370,8702,668,7.1
CN4506900000000,45,069,Marlboro County, SC,Jul-17,9364,8704,660,7.0
CN4506900000000,45,069,Marlboro County, SC,Aug-17,9327,8634,693,7.4
CN4506900000000,45,069,Marlboro County, SC,Sep-17,9270,8690,580,6.3
CN4506900000000,45,069,Marlboro County, SC,Oct-17,9326,8745,581,6.2
CN4506900000000,45,069,Marlboro County, SC,Nov-17,9319,8778,541,5.8
CN4506900000000,45,069,Marlboro County, SC,Dec-17,9395,8833,562,6.0
CN4506900000000,45,069,Marlboro County, SC,Jan-18,9422,8751,671,7.1
CN4506900000000,45,069,Marlboro County, SC,Feb-18,9470,8859,611,6.5
CN4506900000000,45,069,Marlboro County, SC,Mar-18,9361,8803,558,6.0
CN4506900000000,45,069,Marlboro County, SC,Apr-18(p),9201,8796,405,4.4
CN2813300000000,28,133,Sunflower County, MS,Mar-17,8289,7560,729,8.8
CN2813300000000,28,133,Sunflower County, MS,Apr-17,8279,7678,601,7.3
CN2813300000000,28,133,Sunflower County, MS,May-17,8240,7609,631,7.7
CN2813300000000,28,133,Sunflower County, MS,Jun-17,8220,7500,720,8.8
CN2813300000000,28,133,Sunflower County, MS,Jul-17,8079,7419,660,8.2
CN2813300000000,28,133,Sunflower County, MS,Aug-17,7964,7333,631,7.9
CN2813300000000,28,133,Sunflower County, MS,Sep-17,8133,7573,560,6.9
CN2813300000000,28,133,Sunflower County, MS,Oct-17,7911,7386,525,6.6
CN2813300000000,28,133,Sunflower County, MS,Nov-17,7826,7266,560,7.2
CN2813300000000,28,133,Sunflower County, MS,Dec-17,7885,7237,648,8.2
CN2813300000000,28,133,Sunflower County, MS,Jan-18,7714,7021,693,9.0
CN2813300000000,28,133,Sunflower County, MS,Feb-18,7834,7179,655,8.4
CN2813300000000,28,133,Sunflower County, MS,Mar-18,8000,7391,609,7.6
CN2813300000000,28,133,Sunflower County, MS,Apr-18(p),7964,7428,536,6.7
CN5304500000000,53,045,Mason County, WA,Mar-17,23530,21872,1658,7.0
CN5304500000000,53,045,Mason County, WA,Apr-17,23389,21850,1539,6.6
CN5304500000000,53,045,Mason County, WA,May-17,23442,21913,1529,6.5
CN5304500000000,53,045,Mason County, WA,Jun-17,23555,22074,1481,6.3
CN5304500000000,53,045,Mason County, WA,Jul-17,23879,22417,1462,6.1
CN5304500000000,53,045,Mason County, WA,Aug-17,23627,22189,1438,6.1
CN5304500000000,53,045,Mason County, WA,Sep-17,23596,22165,1431,6.1
CN5304500000000,53,045,Mason County, WA,Oct-17,24571,23176,1395,5.7
CN5304500000000,53,045,Mason County, WA,Nov-17,24728,23260,1468,5.9
CN5304500000000,53,045,Mason County, WA,Dec-17,24319,22688,1631,6.7
CN5304500000000,53,045,Mason County, WA,Jan-18,23794,22059,1735,7.3
CN5304500000000,53,045,Mason County, WA,Feb-18,23588,21791,1797,7.6
CN5304500000000,53,045,Mason County, WA,Mar-18,23772,22105,1667,7.0
CN5304500000000,53,045,Mason County, WA,Apr-18(p),23590,22029,1561,6.6
CN0400100000000,04,001,Apache County, AZ,Mar-17,20914,18661,2253,10.8
CN0400100000000,04,001,Apache County, AZ,Apr-17,20282,18290,1992,9.8
CN0400100000000,04,001,Apache County, AZ,May-17,20162,18246,1916,9.5
CN0400100000000,04,001,Apache County, AZ,Jun-17,20383,18139,2244,11.0
CN0400100000000,04,001,Apache County, AZ,Jul-17,19891,17599,2292,11.5
CN0400100000000,04,001,Apache County, AZ,Aug-17,20641,18497,2144,10.4
CN0400100000000,04,001,Apache County, AZ,Sep-17,20645,18676,1969,9.5
CN0400100000000,04,001,Apache County, AZ,Oct-17,20293,18308,1985,9.8
CN0400100000000,04,001,Apache County, AZ,Nov-17,20202,18282,1920,9.5
CN0400100000000,04,001,Apache County, AZ,Dec-17,20475,18420,2055,10.0
CN0400100000000,04,001,Apache County, AZ,Jan-18,20649,18346,2303,11.2
CN0400100000000,04,001,Apache County, AZ,Feb-18,20605,18359,2246,10.9
CN0400100000000,04,001,Apache County, AZ,Mar-18,20590,18472,2118,10.3
CN0400100000000,04,001,Apache County, AZ,Apr-18(p),20213,18353,1860,9.2
CN0809900000000,08,099,Prowers County, CO,Mar-17,5919,5761,158,2.7
CN0809900000000,08,099,Prowers County, CO,Apr-17,6125,5983,142,2.3
CN0809900000000,08,099,Prowers County, CO,May-17,6205,6061,144,2.3
CN0809900000000,08,099,Prowers County, CO,Jun-17,6212,6032,180,2.9
CN0809900000000,08,099,Prowers County, CO,Jul-17,6277,6109,168,2.7
CN0809900000000,08,099,Prowers County, CO,Aug-17,6228,6065,163,2.6
CN0809900000000,08,099,Prowers County, CO,Sep-17,6272,6115,157,2.5
CN0809900000000,08,099,Prowers County, CO,Oct-17,6565,6406,159,2.4
CN0809900000000,08,099,Prowers County, CO,Nov-17,6468,6313,155,2.4
CN0809900000000,08,099,Prowers County, CO,Dec-17,6328,6175,153,2.4
CN0809900000000,08,099,Prowers County, CO,Jan-18,6224,6047,177,2.8
CN0809900000000,08,099,Prowers County, CO,Feb-18,6107,5922,185,3.0
CN0809900000000,08,099,Prowers County, CO,Mar-18,6124,5948,176,2.9
CN0809900000000,08,099,Prowers County, CO,Apr-18(p),6276,6127,149,2.4
CN3400100000000,34,001,Atlantic County, NJ,Mar-17,120646,111483,9163,7.6
CN3400100000000,34,001,Atlantic County, NJ,Apr-17,119818,111551,8267,6.9
CN3400100000000,34,001,Atlantic County, NJ,May-17,120553,112442,8111,6.7
CN3400100000000,34,001,Atlantic County, NJ,Jun-17,122486,113963,8523,7.0
CN3400100000000,34,001,Atlantic County, NJ,Jul-17,124001,114971,9030,7.3
CN3400100000000,34,001,Atlantic County, NJ,Aug-17,123098,114421,8677,7.0
CN3400100000000,34,001,Atlantic County, NJ,Sep-17,121591,113556,8035,6.6
CN3400100000000,34,001,Atlantic County, NJ,Oct-17,120465,112638,7827,6.5
CN3400100000000,34,001,Atlantic County, NJ,Nov-17,120053,112015,8038,6.7
CN3400100000000,34,001,Atlantic County, NJ,Dec-17,120473,112363,8110,6.7
CN3400100000000,34,001,Atlantic County, NJ,Jan-18,119060,109762,9298,7.8
CN3400100000000,34,001,Atlantic County, NJ,Feb-18,120215,111081,9134,7.6
CN3400100000000,34,001,Atlantic County, NJ,Mar-18,119715,111143,8572,7.2
CN3400100000000,34,001,Atlantic County, NJ,Apr-18(p),119402,112217,7185,6.0
CN1607500000000,16,075,Payette County, ID,Mar-17,11376,10850,526,4.6
CN1607500000000,16,075,Payette County, ID,Apr-17,11408,10959,449,3.9
CN1607500000000,16,075,Payette County, ID,May-17,11451,11051,400,3.5
CN1607500000000,16,075,Payette County, ID,Jun-17,11590,11177,413,3.6
CN1607500000000,16,075,Payette County, ID,Jul-17,11619,11074,545,4.7
CN1607500000000,16,075,Payette County, ID,Aug-17,11564,11147,417,3.6
CN1607500000000,16,075,Payette County, ID,Sep-17,11761,11396,365,3.1
CN1607500000000,16,075,Payette County, ID,Oct-17,11681,11345,336,2.9
CN1607500000000,16,075,Payette County, ID,Nov-17,11616,11238,378,3.3
CN1607500000000,16,075,Payette County, ID,Dec-17,11524,11131,393,3.4
CN1607500000000,16,075,Payette County, ID,Jan-18,11399,10841,558,4.9
CN1607500000000,16,075,Payette County, ID,Feb-18,11352,10873,479,4.2
CN1607500000000,16,075,Payette County, ID,Mar-18,11401,10960,441,3.9
CN1607500000000,16,075,Payette County, ID,Apr-18(p),11365,10961,404,3.6
CN1311500000000,13,115,Floyd County, GA,Mar-17,44290,41958,2332,5.3
CN1311500000000,13,115,Floyd County, GA,Apr-17,44109,41954,2155,4.9
CN1311500000000,13,115,Floyd County, GA,May-17,43946,41747,2199,5.0
CN1311500000000,13,115,Floyd County, GA,Jun-17,44122,41732,2390,5.4
CN1311500000000,13,115,Floyd County, GA,Jul-17,44785,42013,2772,6.2
CN1311500000000,13,115,Floyd County, GA,Aug-17,44203,41831,2372,5.4
CN1311500000000,13,115,Floyd County, GA,Sep-17,44653,42509,2144,4.8
CN1311500000000,13,115,Floyd County, GA,Oct-17,44307,42251,2056,4.6
CN1311500000000,13,115,Floyd County, GA,Nov-17,44356,42370,1986,4.5
CN1311500000000,13,115,Floyd County, GA,Dec-17,44320,42328,1992,4.5
CN1311500000000,13,115,Floyd County, GA,Jan-18,44624,42515,2109,4.7
CN1311500000000,13,115,Floyd County, GA,Feb-18,45268,43108,2160,4.8
CN1311500000000,13,115,Floyd County, GA,Mar-18,45077,43163,1914,4.2
CN1311500000000,13,115,Floyd County, GA,Apr-18(p),44809,43106,1703,3.8
CN2210300000000,22,103,St. Tammany Parish, LA,Mar-17,116570,111421,5149,4.4
CN2210300000000,22,103,St. Tammany Parish, LA,Apr-17,117369,112513,4856,4.1
CN2210300000000,22,103,St. Tammany Parish, LA,May-17,117296,112359,4937,4.2
CN2210300000000,22,103,St. Tammany Parish, LA,Jun-17,118191,112447,5744,4.9
CN2210300000000,22,103,St. Tammany Parish, LA,Jul-17,118100,112520,5580,4.7
CN2210300000000,22,103,St. Tammany Parish, LA,Aug-17,117287,111677,5610,4.8
CN2210300000000,22,103,St. Tammany Parish, LA,Sep-17,117474,112476,4998,4.3
CN2210300000000,22,103,St. Tammany Parish, LA,Oct-17,117718,113458,4260,3.6
CN2210300000000,22,103,St. Tammany Parish, LA,Nov-17,117918,113693,4225,3.6
CN2210300000000,22,103,St. Tammany Parish, LA,Dec-17,117273,113352,3921,3.3
CN2210300000000,22,103,St. Tammany Parish, LA,Jan-18,117809,113469,4340,3.7
CN2210300000000,22,103,St. Tammany Parish, LA,Feb-18,118594,114617,3977,3.4
CN2210300000000,22,103,St. Tammany Parish, LA,Mar-18,118849,114528,4321,3.6
CN2210300000000,22,103,St. Tammany Parish, LA,Apr-18(p),119636,115299,4337,3.6
CN2602500000000,26,025,Calhoun County, MI,Mar-17,64013,60918,3095,4.8
CN2602500000000,26,025,Calhoun County, MI,Apr-17,63605,60934,2671,4.2
CN2602500000000,26,025,Calhoun County, MI,May-17,63925,61063,2862,4.5
CN2602500000000,26,025,Calhoun County, MI,Jun-17,64447,61151,3296,5.1
CN2602500000000,26,025,Calhoun County, MI,Jul-17,64578,60658,3920,6.1
CN2602500000000,26,025,Calhoun County, MI,Aug-17,64084,60544,3540,5.5
CN2602500000000,26,025,Calhoun County, MI,Sep-17,63017,59961,3056,4.8
CN2602500000000,26,025,Calhoun County, MI,Oct-17,62917,60058,2859,4.5
CN2602500000000,26,025,Calhoun County, MI,Nov-17,63476,60593,2883,4.5
CN2602500000000,26,025,Calhoun County, MI,Dec-17,63221,60093,3128,4.9
CN2602500000000,26,025,Calhoun County, MI,Jan-18,62690,59306,3384,5.4
CN2602500000000,26,025,Calhoun County, MI,Feb-18,63573,60021,3552,5.6
CN2602500000000,26,025,Calhoun County, MI,Mar-18,63791,60634,3157,4.9
CN2602500000000,26,025,Calhoun County, MI,Apr-18(p),63325,60538,2787,4.4
CN2008100000000,20,081,Haskell County, KS,Mar-17,2158,2110,48,2.2
CN2008100000000,20,081,Haskell County, KS,Apr-17,2157,2109,48,2.2
CN2008100000000,20,081,Haskell County, KS,May-17,2175,2124,51,2.3
CN2008100000000,20,081,Haskell County, KS,Jun-17,2302,2247,55,2.4
CN2008100000000,20,081,Haskell County, KS,Jul-17,2219,2161,58,2.6
CN2008100000000,20,081,Haskell County, KS,Aug-17,2218,2161,57,2.6
CN2008100000000,20,081,Haskell County, KS,Sep-17,2255,2203,52,2.3
CN2008100000000,20,081,Haskell County, KS,Oct-17,2281,2235,46,2.0
CN2008100000000,20,081,Haskell County, KS,Nov-17,2230,2186,44,2.0
CN2008100000000,20,081,Haskell County, KS,Dec-17,2217,2175,42,1.9
CN2008100000000,20,081,Haskell County, KS,Jan-18,2173,2130,43,2.0
CN2008100000000,20,081,Haskell County, KS,Feb-18,2177,2132,45,2.1
CN2008100000000,20,081,Haskell County, KS,Mar-18,2145,2099,46,2.1
CN2008100000000,20,081,Haskell County, KS,Apr-18(p),2035,1990,45,2.2
CN2501300000000,25,013,Hampden County, MA,Mar-17,224839,212464,12375,5.5
CN2501300000000,25,013,Hampden County, MA,Apr-17,223987,213278,10709,4.8
CN2501300000000,25,013,Hampden County, MA,May-17,222597,211668,10929,4.9
CN2501300000000,25,013,Hampden County, MA,Jun-17,224448,212197,12251,5.5
CN2501300000000,25,013,Hampden County, MA,Jul-17,223372,210925,12447,5.6
CN2501300000000,25,013,Hampden County, MA,Aug-17,222102,210788,11314,5.1
CN2501300000000,25,013,Hampden County, MA,Sep-17,221584,211229,10355,4.7
CN2501300000000,25,013,Hampden County, MA,Oct-17,221939,212848,9091,4.1
CN2501300000000,25,013,Hampden County, MA,Nov-17,223464,214403,9061,4.1
CN2501300000000,25,013,Hampden County, MA,Dec-17,222532,213357,9175,4.1
CN2501300000000,25,013,Hampden County, MA,Jan-18,222667,210723,11944,5.4
CN2501300000000,25,013,Hampden County, MA,Feb-18,227580,215448,12132,5.3
CN2501300000000,25,013,Hampden County, MA,Mar-18,229339,217572,11767,5.1
CN2501300000000,25,013,Hampden County, MA,Apr-18(p),229581,219344,10237,4.5
CN1703700000000,17,037,DeKalb County, IL,Mar-17,54603,51719,2884,5.3
CN1703700000000,17,037,DeKalb County, IL,Apr-17,54431,52126,2305,4.2
CN1703700000000,17,037,DeKalb County, IL,May-17,54367,52150,2217,4.1
CN1703700000000,17,037,DeKalb County, IL,Jun-17,55113,52701,2412,4.4
CN1703700000000,17,037,DeKalb County, IL,Jul-17,55279,52801,2478,4.5
CN1703700000000,17,037,DeKalb County, IL,Aug-17,54601,52216,2385,4.4
CN1703700000000,17,037,DeKalb County, IL,Sep-17,54381,52367,2014,3.7
CN1703700000000,17,037,DeKalb County, IL,Oct-17,54659,52620,2039,3.7
CN1703700000000,17,037,DeKalb County, IL,Nov-17,54842,52736,2106,3.8
CN1703700000000,17,037,DeKalb County, IL,Dec-17,54354,52285,2069,3.8
CN1703700000000,17,037,DeKalb County, IL,Jan-18,54017,51664,2353,4.4
CN1703700000000,17,037,DeKalb County, IL,Feb-18,54356,52182,2174,4.0
CN1703700000000,17,037,DeKalb County, IL,Mar-18,55372,53107,2265,4.1
CN1703700000000,17,037,DeKalb County, IL,Apr-18(p),55115,53342,1773,3.2
CN0107100000000,01,071,Jackson County, AL,Mar-17,23258,22021,1237,5.3
CN0107100000000,01,071,Jackson County, AL,Apr-17,23069,22049,1020,4.4
CN0107100000000,01,071,Jackson County, AL,May-17,22854,21817,1037,4.5
CN0107100000000,01,071,Jackson County, AL,Jun-17,23101,21882,1219,5.3
CN0107100000000,01,071,Jackson County, AL,Jul-17,22994,21856,1138,4.9
CN0107100000000,01,071,Jackson County, AL,Aug-17,22958,21897,1061,4.6
CN0107100000000,01,071,Jackson County, AL,Sep-17,23175,22287,888,3.8
CN0107100000000,01,071,Jackson County, AL,Oct-17,23137,22211,926,4.0
CN0107100000000,01,071,Jackson County, AL,Nov-17,22954,22117,837,3.6
CN0107100000000,01,071,Jackson County, AL,Dec-17,22728,21894,834,3.7
CN0107100000000,01,071,Jackson County, AL,Jan-18,22549,21550,999,4.4
CN0107100000000,01,071,Jackson County, AL,Feb-18,22839,21797,1042,4.6
CN0107100000000,01,071,Jackson County, AL,Mar-18,22927,21988,939,4.1
CN0107100000000,01,071,Jackson County, AL,Apr-18(p),23100,22251,849,3.7
CN1315700000000,13,157,Jackson County, GA,Mar-17,34739,33440,1299,3.7
CN1315700000000,13,157,Jackson County, GA,Apr-17,34299,33065,1234,3.6
CN1315700000000,13,157,Jackson County, GA,May-17,34408,33160,1248,3.6
CN1315700000000,13,157,Jackson County, GA,Jun-17,34874,33525,1349,3.9
CN1315700000000,13,157,Jackson County, GA,Jul-17,34966,33631,1335,3.8
CN1315700000000,13,157,Jackson County, GA,Aug-17,34783,33459,1324,3.8
CN1315700000000,13,157,Jackson County, GA,Sep-17,35261,34061,1200,3.4
CN1315700000000,13,157,Jackson County, GA,Oct-17,35491,34296,1195,3.4
CN1315700000000,13,157,Jackson County, GA,Nov-17,35717,34562,1155,3.2
CN1315700000000,13,157,Jackson County, GA,Dec-17,35634,34483,1151,3.2
CN1315700000000,13,157,Jackson County, GA,Jan-18,36069,34870,1199,3.3
CN1315700000000,13,157,Jackson County, GA,Feb-18,36280,35052,1228,3.4
CN1315700000000,13,157,Jackson County, GA,Mar-18,36231,35110,1121,3.1
CN1315700000000,13,157,Jackson County, GA,Apr-18(p),35876,34903,973,2.7
CN2401500000000,24,015,Cecil County, MD,Mar-17,53376,50654,2722,5.1
CN2401500000000,24,015,Cecil County, MD,Apr-17,53235,50889,2346,4.4
CN2401500000000,24,015,Cecil County, MD,May-17,52844,50488,2356,4.5
CN2401500000000,24,015,Cecil County, MD,Jun-17,53148,50542,2606,4.9
CN2401500000000,24,015,Cecil County, MD,Jul-17,53724,50991,2733,5.1
CN2401500000000,24,015,Cecil County, MD,Aug-17,52817,50125,2692,5.1
CN2401500000000,24,015,Cecil County, MD,Sep-17,52536,50262,2274,4.3
CN2401500000000,24,015,Cecil County, MD,Oct-17,53125,50824,2301,4.3
CN2401500000000,24,015,Cecil County, MD,Nov-17,53006,50673,2333,4.4
CN2401500000000,24,015,Cecil County, MD,Dec-17,53045,50746,2299,4.3
CN2401500000000,24,015,Cecil County, MD,Jan-18,53255,50355,2900,5.4
CN2401500000000,24,015,Cecil County, MD,Feb-18,53126,50246,2880,5.4
CN2401500000000,24,015,Cecil County, MD,Mar-18,53226,50470,2756,5.2
CN2401500000000,24,015,Cecil County, MD,Apr-18(p),53014,50709,2305,4.3
CN1707900000000,17,079,Jasper County, IL,Mar-17,4536,4293,243,5.4
CN1707900000000,17,079,Jasper County, IL,Apr-17,4628,4441,187,4.0
CN1707900000000,17,079,Jasper County, IL,May-17,4655,4479,176,3.8
CN1707900000000,17,079,Jasper County, IL,Jun-17,4747,4544,203,4.3
CN1707900000000,17,079,Jasper County, IL,Jul-17,4557,4340,217,4.8
CN1707900000000,17,079,Jasper County, IL,Aug-17,4441,4230,211,4.8
CN1707900000000,17,079,Jasper County, IL,Sep-17,4494,4307,187,4.2
CN1707900000000,17,079,Jasper County, IL,Oct-17,4438,4263,175,3.9
CN1707900000000,17,079,Jasper County, IL,Nov-17,4371,4188,183,4.2
CN1707900000000,17,079,Jasper County, IL,Dec-17,4332,4140,192,4.4
CN1707900000000,17,079,Jasper County, IL,Jan-18,4465,4234,231,5.2
CN1707900000000,17,079,Jasper County, IL,Feb-18,4460,4236,224,5.0
CN1707900000000,17,079,Jasper County, IL,Mar-18,4531,4321,210,4.6
CN1707900000000,17,079,Jasper County, IL,Apr-18(p),4625,4466,159,3.4
CN1903900000000,19,039,Clarke County, IA,Mar-17,4762,4585,177,3.7
CN1903900000000,19,039,Clarke County, IA,Apr-17,4753,4601,152,3.2
CN1903900000000,19,039,Clarke County, IA,May-17,4724,4583,141,3.0
CN1903900000000,19,039,Clarke County, IA,Jun-17,4799,4649,150,3.1
CN1903900000000,19,039,Clarke County, IA,Jul-17,4892,4755,137,2.8
CN1903900000000,19,039,Clarke County, IA,Aug-17,4807,4660,147,3.1
CN1903900000000,19,039,Clarke County, IA,Sep-17,4730,4600,130,2.7
CN1903900000000,19,039,Clarke County, IA,Oct-17,4714,4614,100,2.1
CN1903900000000,19,039,Clarke County, IA,Nov-17,4696,4585,111,2.4
CN1903900000000,19,039,Clarke County, IA,Dec-17,4706,4580,126,2.7
CN1903900000000,19,039,Clarke County, IA,Jan-18,4780,4570,210,4.4
CN1903900000000,19,039,Clarke County, IA,Feb-18,4812,4604,208,4.3
CN1903900000000,19,039,Clarke County, IA,Mar-18,4760,4595,165,3.5
CN1903900000000,19,039,Clarke County, IA,Apr-18(p),4735,4605,130,2.7
CN5505500000000,55,055,Jefferson County, WI,Mar-17,45841,44129,1712,3.7
CN5505500000000,55,055,Jefferson County, WI,Apr-17,45838,44420,1418,3.1
CN5505500000000,55,055,Jefferson County, WI,May-17,46010,44647,1363,3.0
CN5505500000000,55,055,Jefferson County, WI,Jun-17,46872,45285,1587,3.4
CN5505500000000,55,055,Jefferson County, WI,Jul-17,46346,44872,1474,3.2
CN5505500000000,55,055,Jefferson County, WI,Aug-17,45971,44584,1387,3.0
CN5505500000000,55,055,Jefferson County, WI,Sep-17,46079,44812,1267,2.7
CN5505500000000,55,055,Jefferson County, WI,Oct-17,45933,44740,1193,2.6
CN5505500000000,55,055,Jefferson County, WI,Nov-17,45897,44699,1198,2.6
CN5505500000000,55,055,Jefferson County, WI,Dec-17,45699,44553,1146,2.5
CN5505500000000,55,055,Jefferson County, WI,Jan-18,45634,44179,1455,3.2
CN5505500000000,55,055,Jefferson County, WI,Feb-18,46048,44425,1623,3.5
CN5505500000000,55,055,Jefferson County, WI,Mar-18,46207,44760,1447,3.1
CN5505500000000,55,055,Jefferson County, WI,Apr-18(p),46485,45333,1152,2.5
CN2802700000000,28,027,Coahoma County, MS,Mar-17,8950,8265,685,7.7
CN2802700000000,28,027,Coahoma County, MS,Apr-17,8970,8390,580,6.5
CN2802700000000,28,027,Coahoma County, MS,May-17,9005,8374,631,7.0
CN2802700000000,28,027,Coahoma County, MS,Jun-17,9111,8306,805,8.8
CN2802700000000,28,027,Coahoma County, MS,Jul-17,9051,8310,741,8.2
CN2802700000000,28,027,Coahoma County, MS,Aug-17,8871,8247,624,7.0
CN2802700000000,28,027,Coahoma County, MS,Sep-17,8932,8377,555,6.2
CN2802700000000,28,027,Coahoma County, MS,Oct-17,8917,8396,521,5.8
CN2802700000000,28,027,Coahoma County, MS,Nov-17,8851,8338,513,5.8
CN2802700000000,28,027,Coahoma County, MS,Dec-17,8760,8196,564,6.4
CN2802700000000,28,027,Coahoma County, MS,Jan-18,8555,7925,630,7.4
CN2802700000000,28,027,Coahoma County, MS,Feb-18,8659,8012,647,7.5
CN2802700000000,28,027,Coahoma County, MS,Mar-18,8759,8152,607,6.9
CN2802700000000,28,027,Coahoma County, MS,Apr-18(p),8782,8268,514,5.9
CN4205500000000,42,055,Franklin County, PA,Mar-17,76658,72988,3670,4.8
CN4205500000000,42,055,Franklin County, PA,Apr-17,76615,73479,3136,4.1
CN4205500000000,42,055,Franklin County, PA,May-17,76839,73292,3547,4.6
CN4205500000000,42,055,Franklin County, PA,Jun-17,77605,74043,3562,4.6
CN4205500000000,42,055,Franklin County, PA,Jul-17,77893,74147,3746,4.8
CN4205500000000,42,055,Franklin County, PA,Aug-17,77090,73418,3672,4.8
CN4205500000000,42,055,Franklin County, PA,Sep-17,76196,73250,2946,3.9
CN4205500000000,42,055,Franklin County, PA,Oct-17,75439,72611,2828,3.7
CN4205500000000,42,055,Franklin County, PA,Nov-17,75658,72771,2887,3.8
CN4205500000000,42,055,Franklin County, PA,Dec-17,75954,73087,2867,3.8
CN4205500000000,42,055,Franklin County, PA,Jan-18,76690,73192,3498,4.6
CN4205500000000,42,055,Franklin County, PA,Feb-18,76734,73248,3486,4.5
CN4205500000000,42,055,Franklin County, PA,Mar-18,75697,72696,3001,4.0
CN4205500000000,42,055,Franklin County, PA,Apr-18(p),74842,72272,2570,3.4
CN4606700000000,46,067,Hutchinson County, SD,Mar-17,3619,3496,123,3.4
CN4606700000000,46,067,Hutchinson County, SD,Apr-17,3628,3508,120,3.3
CN4606700000000,46,067,Hutchinson County, SD,May-17,3672,3566,106,2.9
CN4606700000000,46,067,Hutchinson County, SD,Jun-17,3786,3683,103,2.7
CN4606700000000,46,067,Hutchinson County, SD,Jul-17,3689,3592,97,2.6
CN4606700000000,46,067,Hutchinson County, SD,Aug-17,3579,3470,109,3.0
CN4606700000000,46,067,Hutchinson County, SD,Sep-17,3533,3431,102,2.9
CN4606700000000,46,067,Hutchinson County, SD,Oct-17,3524,3428,96,2.7
CN4606700000000,46,067,Hutchinson County, SD,Nov-17,3487,3386,101,2.9
CN4606700000000,46,067,Hutchinson County, SD,Dec-17,3572,3445,127,3.6
CN4606700000000,46,067,Hutchinson County, SD,Jan-18,3617,3471,146,4.0
CN4606700000000,46,067,Hutchinson County, SD,Feb-18,3636,3492,144,4.0
CN4606700000000,46,067,Hutchinson County, SD,Mar-18,3695,3563,132,3.6
CN4606700000000,46,067,Hutchinson County, SD,Apr-18(p),3620,3509,111,3.1
CN1306700000000,13,067,Cobb County, GA,Mar-17,421499,403769,17730,4.2
CN1306700000000,13,067,Cobb County, GA,Apr-17,421521,404895,16626,3.9
CN1306700000000,13,067,Cobb County, GA,May-17,422461,405525,16936,4.0
CN1306700000000,13,067,Cobb County, GA,Jun-17,423161,405087,18074,4.3
CN1306700000000,13,067,Cobb County, GA,Jul-17,426294,408016,18278,4.3
CN1306700000000,13,067,Cobb County, GA,Aug-17,423805,405877,17928,4.2
CN1306700000000,13,067,Cobb County, GA,Sep-17,427715,411511,16204,3.8
CN1306700000000,13,067,Cobb County, GA,Oct-17,425701,409719,15982,3.8
CN1306700000000,13,067,Cobb County, GA,Nov-17,426513,411003,15510,3.6
CN1306700000000,13,067,Cobb County, GA,Dec-17,426572,410812,15760,3.7
CN1306700000000,13,067,Cobb County, GA,Jan-18,426479,410142,16337,3.8
CN1306700000000,13,067,Cobb County, GA,Feb-18,433703,417083,16620,3.8
CN1306700000000,13,067,Cobb County, GA,Mar-18,433884,418460,15424,3.6
CN1306700000000,13,067,Cobb County, GA,Apr-18(p),431206,417564,13642,3.2
CN2909100000000,29,091,Howell County, MO,Mar-17,15526,14725,801,5.2
CN2909100000000,29,091,Howell County, MO,Apr-17,15533,14820,713,4.6
CN2909100000000,29,091,Howell County, MO,May-17,15564,14622,942,6.1
CN2909100000000,29,091,Howell County, MO,Jun-17,15675,14905,770,4.9
CN2909100000000,29,091,Howell County, MO,Jul-17,15537,14706,831,5.3
CN2909100000000,29,091,Howell County, MO,Aug-17,15454,14629,825,5.3
CN2909100000000,29,091,Howell County, MO,Sep-17,15518,14855,663,4.3
CN2909100000000,29,091,Howell County, MO,Oct-17,15154,14681,473,3.1
CN2909100000000,29,091,Howell County, MO,Nov-17,15143,14557,586,3.9
CN2909100000000,29,091,Howell County, MO,Dec-17,15182,14566,616,4.1
CN2909100000000,29,091,Howell County, MO,Jan-18,15078,14380,698,4.6
CN2909100000000,29,091,Howell County, MO,Feb-18,15236,14568,668,4.4
CN2909100000000,29,091,Howell County, MO,Mar-18,15273,14622,651,4.3
CN2909100000000,29,091,Howell County, MO,Apr-18(p),15284,14705,579,3.8
CN2613100000000,26,131,Ontonagon County, MI,Mar-17,2196,1962,234,10.7
CN2613100000000,26,131,Ontonagon County, MI,Apr-17,2123,1898,225,10.6
CN2613100000000,26,131,Ontonagon County, MI,May-17,2141,1946,195,9.1
CN2613100000000,26,131,Ontonagon County, MI,Jun-17,2212,2019,193,8.7
CN2613100000000,26,131,Ontonagon County, MI,Jul-17,2170,1977,193,8.9
CN2613100000000,26,131,Ontonagon County, MI,Aug-17,2158,1981,177,8.2
CN2613100000000,26,131,Ontonagon County, MI,Sep-17,2161,2003,158,7.3
CN2613100000000,26,131,Ontonagon County, MI,Oct-17,2139,1998,141,6.6
CN2613100000000,26,131,Ontonagon County, MI,Nov-17,2120,1933,187,8.8
CN2613100000000,26,131,Ontonagon County, MI,Dec-17,2162,1944,218,10.1
CN2613100000000,26,131,Ontonagon County, MI,Jan-18,2151,1953,198,9.2
CN2613100000000,26,131,Ontonagon County, MI,Feb-18,2188,1970,218,10.0
CN2613100000000,26,131,Ontonagon County, MI,Mar-18,2189,1964,225,10.3
CN2613100000000,26,131,Ontonagon County, MI,Apr-18(p),2119,1894,225,10.6
CN5113300000000,51,133,Northumberland County, VA,Mar-17,5288,4912,376,7.1
CN5113300000000,51,133,Northumberland County, VA,Apr-17,5310,5007,303,5.7
CN5113300000000,51,133,Northumberland County, VA,May-17,5379,5098,281,5.2
CN5113300000000,51,133,Northumberland County, VA,Jun-17,5566,5322,244,4.4
CN5113300000000,51,133,Northumberland County, VA,Jul-17,5521,5261,260,4.7
CN5113300000000,51,133,Northumberland County, VA,Aug-17,5428,5172,256,4.7
CN5113300000000,51,133,Northumberland County, VA,Sep-17,5360,5134,226,4.2
CN5113300000000,51,133,Northumberland County, VA,Oct-17,5275,5066,209,4.0
CN5113300000000,51,133,Northumberland County, VA,Nov-17,5301,5085,216,4.1
CN5113300000000,51,133,Northumberland County, VA,Dec-17,5388,5148,240,4.5
CN5113300000000,51,133,Northumberland County, VA,Jan-18,5160,4747,413,8.0
CN5113300000000,51,133,Northumberland County, VA,Feb-18,5217,4844,373,7.1
CN5113300000000,51,133,Northumberland County, VA,Mar-18,5287,4934,353,6.7
CN5113300000000,51,133,Northumberland County, VA,Apr-18(p),5363,5096,267,5.0
CN5104300000000,51,043,Clarke County, VA,Mar-17,7466,7186,280,3.8
CN5104300000000,51,043,Clarke County, VA,Apr-17,7527,7291,236,3.1
CN5104300000000,51,043,Clarke County, VA,May-17,7550,7285,265,3.5
CN5104300000000,51,043,Clarke County, VA,Jun-17,7660,7386,274,3.6
CN5104300000000,51,043,Clarke County, VA,Jul-17,7686,7415,271,3.5
CN5104300000000,51,043,Clarke County, VA,Aug-17,7522,7249,273,3.6
CN5104300000000,51,043,Clarke County, VA,Sep-17,7548,7306,242,3.2
CN5104300000000,51,043,Clarke County, VA,Oct-17,7483,7254,229,3.1
CN5104300000000,51,043,Clarke County, VA,Nov-17,7480,7250,230,3.1
CN5104300000000,51,043,Clarke County, VA,Dec-17,7524,7299,225,3.0
CN5104300000000,51,043,Clarke County, VA,Jan-18,7475,7226,249,3.3
CN5104300000000,51,043,Clarke County, VA,Feb-18,7580,7336,244,3.2
CN5104300000000,51,043,Clarke County, VA,Mar-18,7554,7310,244,3.2
CN5104300000000,51,043,Clarke County, VA,Apr-18(p),7616,7410,206,2.7
CN5300300000000,53,003,Asotin County, WA,Mar-17,10226,9747,479,4.7
CN5300300000000,53,003,Asotin County, WA,Apr-17,10126,9729,397,3.9
CN5300300000000,53,003,Asotin County, WA,May-17,10202,9801,401,3.9
CN5300300000000,53,003,Asotin County, WA,Jun-17,10257,9862,395,3.9
CN5300300000000,53,003,Asotin County, WA,Jul-17,10197,9793,404,4.0
CN5300300000000,53,003,Asotin County, WA,Aug-17,10176,9805,371,3.6
CN5300300000000,53,003,Asotin County, WA,Sep-17,10267,9877,390,3.8
CN5300300000000,53,003,Asotin County, WA,Oct-17,10351,9991,360,3.5
CN5300300000000,53,003,Asotin County, WA,Nov-17,10441,10026,415,4.0
CN5300300000000,53,003,Asotin County, WA,Dec-17,10458,9986,472,4.5
CN5300300000000,53,003,Asotin County, WA,Jan-18,10355,9816,539,5.2
CN5300300000000,53,003,Asotin County, WA,Feb-18,10292,9759,533,5.2
CN5300300000000,53,003,Asotin County, WA,Mar-18,10351,9867,484,4.7
CN5300300000000,53,003,Asotin County, WA,Apr-18(p),10260,9818,442,4.3
CN1322100000000,13,221,Oglethorpe County, GA,Mar-17,7140,6819,321,4.5
CN1322100000000,13,221,Oglethorpe County, GA,Apr-17,7230,6934,296,4.1
CN1322100000000,13,221,Oglethorpe County, GA,May-17,7195,6895,300,4.2
CN1322100000000,13,221,Oglethorpe County, GA,Jun-17,7299,6958,341,4.7
CN1322100000000,13,221,Oglethorpe County, GA,Jul-17,7210,6880,330,4.6
CN1322100000000,13,221,Oglethorpe County, GA,Aug-17,7193,6860,333,4.6
CN1322100000000,13,221,Oglethorpe County, GA,Sep-17,7283,6978,305,4.2
CN1322100000000,13,221,Oglethorpe County, GA,Oct-17,7297,7007,290,4.0
CN1322100000000,13,221,Oglethorpe County, GA,Nov-17,7320,7040,280,3.8
CN1322100000000,13,221,Oglethorpe County, GA,Dec-17,7229,6952,277,3.8
CN1322100000000,13,221,Oglethorpe County, GA,Jan-18,7354,7045,309,4.2
CN1322100000000,13,221,Oglethorpe County, GA,Feb-18,7386,7093,293,4.0
CN1322100000000,13,221,Oglethorpe County, GA,Mar-18,7377,7101,276,3.7
CN1322100000000,13,221,Oglethorpe County, GA,Apr-18(p),7367,7128,239,3.2
CN2918100000000,29,181,Ripley County, MO,Mar-17,5215,4884,331,6.3
CN2918100000000,29,181,Ripley County, MO,Apr-17,5207,4917,290,5.6
CN2918100000000,29,181,Ripley County, MO,May-17,5187,4879,308,5.9
CN2918100000000,29,181,Ripley County, MO,Jun-17,5202,4894,308,5.9
CN2918100000000,29,181,Ripley County, MO,Jul-17,4955,4628,327,6.6
CN2918100000000,29,181,Ripley County, MO,Aug-17,5110,4752,358,7.0
CN2918100000000,29,181,Ripley County, MO,Sep-17,5160,4923,237,4.6
CN2918100000000,29,181,Ripley County, MO,Oct-17,5051,4858,193,3.8
CN2918100000000,29,181,Ripley County, MO,Nov-17,5036,4816,220,4.4
CN2918100000000,29,181,Ripley County, MO,Dec-17,5028,4789,239,4.8
CN2918100000000,29,181,Ripley County, MO,Jan-18,5068,4744,324,6.4
CN2918100000000,29,181,Ripley County, MO,Feb-18,5153,4876,277,5.4
CN2918100000000,29,181,Ripley County, MO,Mar-18,5147,4886,261,5.1
CN2918100000000,29,181,Ripley County, MO,Apr-18(p),5269,4941,328,6.2
CN3916700000000,39,167,Washington County, OH,Mar-17,27684,25782,1902,6.9
CN3916700000000,39,167,Washington County, OH,Apr-17,27532,25883,1649,6.0
CN3916700000000,39,167,Washington County, OH,May-17,27624,26113,1511,5.5
CN3916700000000,39,167,Washington County, OH,Jun-17,27959,26217,1742,6.2
CN3916700000000,39,167,Washington County, OH,Jul-17,28016,26251,1765,6.3
CN3916700000000,39,167,Washington County, OH,Aug-17,27887,26197,1690,6.1
CN3916700000000,39,167,Washington County, OH,Sep-17,27668,26167,1501,5.4
CN3916700000000,39,167,Washington County, OH,Oct-17,27577,26134,1443,5.2
CN3916700000000,39,167,Washington County, OH,Nov-17,27398,25968,1430,5.2
CN3916700000000,39,167,Washington County, OH,Dec-17,27261,25707,1554,5.7
CN3916700000000,39,167,Washington County, OH,Jan-18,26859,25064,1795,6.7
CN3916700000000,39,167,Washington County, OH,Feb-18,27053,25275,1778,6.6
CN3916700000000,39,167,Washington County, OH,Mar-18,27442,25895,1547,5.6
CN3916700000000,39,167,Washington County, OH,Apr-18(p),27240,25869,1371,5.0
CN5501300000000,55,013,Burnett County, WI,Mar-17,7195,6722,473,6.6
CN5501300000000,55,013,Burnett County, WI,Apr-17,7232,6864,368,5.1
CN5501300000000,55,013,Burnett County, WI,May-17,7316,7012,304,4.2
CN5501300000000,55,013,Burnett County, WI,Jun-17,7700,7331,369,4.8
CN5501300000000,55,013,Burnett County, WI,Jul-17,7731,7424,307,4.0
CN5501300000000,55,013,Burnett County, WI,Aug-17,7579,7250,329,4.3
CN5501300000000,55,013,Burnett County, WI,Sep-17,7366,7083,283,3.8
CN5501300000000,55,013,Burnett County, WI,Oct-17,7363,7098,265,3.6
CN5501300000000,55,013,Burnett County, WI,Nov-17,7343,7035,308,4.2
CN5501300000000,55,013,Burnett County, WI,Dec-17,7292,6959,333,4.6
CN5501300000000,55,013,Burnett County, WI,Jan-18,7203,6825,378,5.2
CN5501300000000,55,013,Burnett County, WI,Feb-18,7238,6803,435,6.0
CN5501300000000,55,013,Burnett County, WI,Mar-18,7293,6884,409,5.6
CN5501300000000,55,013,Burnett County, WI,Apr-18(p),7346,6970,376,5.1
CN1807700000000,18,077,Jefferson County, IN,Mar-17,15138,14558,580,3.8
CN1807700000000,18,077,Jefferson County, IN,Apr-17,15182,14693,489,3.2
CN1807700000000,18,077,Jefferson County, IN,May-17,15341,14812,529,3.4
CN1807700000000,18,077,Jefferson County, IN,Jun-17,15349,14778,571,3.7
CN1807700000000,18,077,Jefferson County, IN,Jul-17,14988,14397,591,3.9
CN1807700000000,18,077,Jefferson County, IN,Aug-17,14919,14291,628,4.2
CN1807700000000,18,077,Jefferson County, IN,Sep-17,14948,14428,520,3.5
CN1807700000000,18,077,Jefferson County, IN,Oct-17,14813,14344,469,3.2
CN1807700000000,18,077,Jefferson County, IN,Nov-17,14814,14319,495,3.3
CN1807700000000,18,077,Jefferson County, IN,Dec-17,14687,14218,469,3.2
CN1807700000000,18,077,Jefferson County, IN,Jan-18,14481,13961,520,3.6
CN1807700000000,18,077,Jefferson County, IN,Feb-18,14812,14264,548,3.7
CN1807700000000,18,077,Jefferson County, IN,Mar-18,14970,14486,484,3.2
CN1807700000000,18,077,Jefferson County, IN,Apr-18(p),15005,14578,427,2.8
CN1818300000000,18,183,Whitley County, IN,Mar-17,17108,16580,528,3.1
CN1818300000000,18,183,Whitley County, IN,Apr-17,17177,16747,430,2.5
CN1818300000000,18,183,Whitley County, IN,May-17,17389,16914,475,2.7
CN1818300000000,18,183,Whitley County, IN,Jun-17,17466,16964,502,2.9
CN1818300000000,18,183,Whitley County, IN,Jul-17,17399,16893,506,2.9
CN1818300000000,18,183,Whitley County, IN,Aug-17,17225,16671,554,3.2
CN1818300000000,18,183,Whitley County, IN,Sep-17,17185,16741,444,2.6
CN1818300000000,18,183,Whitley County, IN,Oct-17,17137,16708,429,2.5
CN1818300000000,18,183,Whitley County, IN,Nov-17,17170,16718,452,2.6
CN1818300000000,18,183,Whitley County, IN,Dec-17,16999,16587,412,2.4
CN1818300000000,18,183,Whitley County, IN,Jan-18,16950,16442,508,3.0
CN1818300000000,18,183,Whitley County, IN,Feb-18,17286,16759,527,3.0
CN1818300000000,18,183,Whitley County, IN,Mar-18,17385,16915,470,2.7
CN1818300000000,18,183,Whitley County, IN,Apr-18(p),17494,17076,418,2.4
CN3608900000000,36,089,St. Lawrence County, NY,Mar-17,44308,41140,3168,7.1
CN3608900000000,36,089,St. Lawrence County, NY,Apr-17,44213,41303,2910,6.6
CN3608900000000,36,089,St. Lawrence County, NY,May-17,43495,40801,2694,6.2
CN3608900000000,36,089,St. Lawrence County, NY,Jun-17,43356,40353,3003,6.9
CN3608900000000,36,089,St. Lawrence County, NY,Jul-17,43000,40015,2985,6.9
CN3608900000000,36,089,St. Lawrence County, NY,Aug-17,42549,39715,2834,6.7
CN3608900000000,36,089,St. Lawrence County, NY,Sep-17,43628,41047,2581,5.9
CN3608900000000,36,089,St. Lawrence County, NY,Oct-17,43692,41185,2507,5.7
CN3608900000000,36,089,St. Lawrence County, NY,Nov-17,43893,41170,2723,6.2
CN3608900000000,36,089,St. Lawrence County, NY,Dec-17,43508,40611,2897,6.7
CN3608900000000,36,089,St. Lawrence County, NY,Jan-18,43633,40100,3533,8.1
CN3608900000000,36,089,St. Lawrence County, NY,Feb-18,44001,40450,3551,8.1
CN3608900000000,36,089,St. Lawrence County, NY,Mar-18,43307,40101,3206,7.4
CN3608900000000,36,089,St. Lawrence County, NY,Apr-18(p),43304,40485,2819,6.5
CN2706500000000,27,065,Kanabec County, MN,Mar-17,9195,8348,847,9.2
CN2706500000000,27,065,Kanabec County, MN,Apr-17,9037,8425,612,6.8
CN2706500000000,27,065,Kanabec County, MN,May-17,8993,8593,400,4.4
CN2706500000000,27,065,Kanabec County, MN,Jun-17,9047,8660,387,4.3
CN2706500000000,27,065,Kanabec County, MN,Jul-17,8916,8554,362,4.1
CN2706500000000,27,065,Kanabec County, MN,Aug-17,8937,8556,381,4.3
CN2706500000000,27,065,Kanabec County, MN,Sep-17,8780,8481,299,3.4
CN2706500000000,27,065,Kanabec County, MN,Oct-17,8780,8508,272,3.1
CN2706500000000,27,065,Kanabec County, MN,Nov-17,8965,8489,476,5.3
CN2706500000000,27,065,Kanabec County, MN,Dec-17,9126,8446,680,7.5
CN2706500000000,27,065,Kanabec County, MN,Jan-18,9391,8476,915,9.7
CN2706500000000,27,065,Kanabec County, MN,Feb-18,9340,8519,821,8.8
CN2706500000000,27,065,Kanabec County, MN,Mar-18,9353,8521,832,8.9
CN2706500000000,27,065,Kanabec County, MN,Apr-18(p),9264,8610,654,7.1
CN3102100000000,31,021,Burt County, NE,Mar-17,3511,3356,155,4.4
CN3102100000000,31,021,Burt County, NE,Apr-17,3564,3433,131,3.7
CN3102100000000,31,021,Burt County, NE,May-17,3568,3455,113,3.2
CN3102100000000,31,021,Burt County, NE,Jun-17,3678,3551,127,3.5
CN3102100000000,31,021,Burt County, NE,Jul-17,3547,3430,117,3.3
CN3102100000000,31,021,Burt County, NE,Aug-17,3455,3342,113,3.3
CN3102100000000,31,021,Burt County, NE,Sep-17,3336,3235,101,3.0
CN3102100000000,31,021,Burt County, NE,Oct-17,3362,3265,97,2.9
CN3102100000000,31,021,Burt County, NE,Nov-17,3369,3268,101,3.0
CN3102100000000,31,021,Burt County, NE,Dec-17,3372,3245,127,3.8
CN3102100000000,31,021,Burt County, NE,Jan-18,3413,3262,151,4.4
CN3102100000000,31,021,Burt County, NE,Feb-18,3408,3259,149,4.4
CN3102100000000,31,021,Burt County, NE,Mar-18,3421,3299,122,3.6
CN3102100000000,31,021,Burt County, NE,Apr-18(p),3421,3311,110,3.2
CN2717100000000,27,171,Wright County, MN,Mar-17,74191,70861,3330,4.5
CN2717100000000,27,171,Wright County, MN,Apr-17,73927,71383,2544,3.4
CN2717100000000,27,171,Wright County, MN,May-17,73884,71686,2198,3.0
CN2717100000000,27,171,Wright County, MN,Jun-17,74485,72002,2483,3.3
CN2717100000000,27,171,Wright County, MN,Jul-17,75257,72874,2383,3.2
CN2717100000000,27,171,Wright County, MN,Aug-17,74948,72527,2421,3.2
CN2717100000000,27,171,Wright County, MN,Sep-17,74624,72550,2074,2.8
CN2717100000000,27,171,Wright County, MN,Oct-17,74113,72366,1747,2.4
CN2717100000000,27,171,Wright County, MN,Nov-17,74256,72216,2040,2.7
CN2717100000000,27,171,Wright County, MN,Dec-17,74340,71651,2689,3.6
CN2717100000000,27,171,Wright County, MN,Jan-18,75359,72032,3327,4.4
CN2717100000000,27,171,Wright County, MN,Feb-18,75722,72498,3224,4.3
CN2717100000000,27,171,Wright County, MN,Mar-18,75512,72368,3144,4.2
CN2717100000000,27,171,Wright County, MN,Apr-18(p),75369,72817,2552,3.4
CN4820300000000,48,203,Harrison County, TX,Mar-17,29537,27840,1697,5.7
CN4820300000000,48,203,Harrison County, TX,Apr-17,29616,28105,1511,5.1
CN4820300000000,48,203,Harrison County, TX,May-17,29462,27966,1496,5.1
CN4820300000000,48,203,Harrison County, TX,Jun-17,29565,27962,1603,5.4
CN4820300000000,48,203,Harrison County, TX,Jul-17,29373,27819,1554,5.3
CN4820300000000,48,203,Harrison County, TX,Aug-17,29264,27722,1542,5.3
CN4820300000000,48,203,Harrison County, TX,Sep-17,29464,28095,1369,4.6
CN4820300000000,48,203,Harrison County, TX,Oct-17,29274,28019,1255,4.3
CN4820300000000,48,203,Harrison County, TX,Nov-17,29243,27926,1317,4.5
CN4820300000000,48,203,Harrison County, TX,Dec-17,28973,27708,1265,4.4
CN4820300000000,48,203,Harrison County, TX,Jan-18,29000,27592,1408,4.9
CN4820300000000,48,203,Harrison County, TX,Feb-18,29385,27992,1393,4.7
CN4820300000000,48,203,Harrison County, TX,Mar-18,29232,27815,1417,4.8
CN4820300000000,48,203,Harrison County, TX,Apr-18(p),29600,28324,1276,4.3
CN0504100000000,05,041,Desha County, AR,Mar-17,5391,5127,264,4.9
CN0504100000000,05,041,Desha County, AR,Apr-17,5430,5194,236,4.3
CN0504100000000,05,041,Desha County, AR,May-17,5546,5288,258,4.7
CN0504100000000,05,041,Desha County, AR,Jun-17,5652,5361,291,5.1
CN0504100000000,05,041,Desha County, AR,Jul-17,5458,5160,298,5.5
CN0504100000000,05,041,Desha County, AR,Aug-17,5515,5267,248,4.5
CN0504100000000,05,041,Desha County, AR,Sep-17,5519,5284,235,4.3
CN0504100000000,05,041,Desha County, AR,Oct-17,5507,5298,209,3.8
CN0504100000000,05,041,Desha County, AR,Nov-17,5406,5189,217,4.0
CN0504100000000,05,041,Desha County, AR,Dec-17,5363,5110,253,4.7
CN0504100000000,05,041,Desha County, AR,Jan-18,5206,4902,304,5.8
CN0504100000000,05,041,Desha County, AR,Feb-18,5292,5002,290,5.5
CN0504100000000,05,041,Desha County, AR,Mar-18,5321,5045,276,5.2
CN0504100000000,05,041,Desha County, AR,Apr-18(p),5330,5093,237,4.4
CN0600300000000,06,003,Alpine County, CA,Mar-17,637,602,35,5.5
CN0600300000000,06,003,Alpine County, CA,Apr-17,598,569,29,4.8
CN0600300000000,06,003,Alpine County, CA,May-17,468,433,35,7.5
CN0600300000000,06,003,Alpine County, CA,Jun-17,483,441,42,8.7
CN0600300000000,06,003,Alpine County, CA,Jul-17,503,464,39,7.8
CN0600300000000,06,003,Alpine County, CA,Aug-17,494,459,35,7.1
CN0600300000000,06,003,Alpine County, CA,Sep-17,485,453,32,6.6
CN0600300000000,06,003,Alpine County, CA,Oct-17,472,442,30,6.4
CN0600300000000,06,003,Alpine County, CA,Nov-17,483,455,28,5.8
CN0600300000000,06,003,Alpine County, CA,Dec-17,540,515,25,4.6
CN0600300000000,06,003,Alpine County, CA,Jan-18,555,528,27,4.9
CN0600300000000,06,003,Alpine County, CA,Feb-18,545,522,23,4.2
CN0600300000000,06,003,Alpine County, CA,Mar-18,532,511,21,3.9
CN0600300000000,06,003,Alpine County, CA,Apr-18(p),495,477,18,3.6
CN0801300000000,08,013,Boulder County, CO,Mar-17,185793,181503,4290,2.3
CN0801300000000,08,013,Boulder County, CO,Apr-17,186231,182193,4038,2.2
CN0801300000000,08,013,Boulder County, CO,May-17,186617,182506,4111,2.2
CN0801300000000,08,013,Boulder County, CO,Jun-17,186055,181196,4859,2.6
CN0801300000000,08,013,Boulder County, CO,Jul-17,186734,182133,4601,2.5
CN0801300000000,08,013,Boulder County, CO,Aug-17,187198,182656,4542,2.4
CN0801300000000,08,013,Boulder County, CO,Sep-17,190292,185863,4429,2.3
CN0801300000000,08,013,Boulder County, CO,Oct-17,188209,183609,4600,2.4
CN0801300000000,08,013,Boulder County, CO,Nov-17,190120,185439,4681,2.5
CN0801300000000,08,013,Boulder County, CO,Dec-17,189048,184248,4800,2.5
CN0801300000000,08,013,Boulder County, CO,Jan-18,185882,180565,5317,2.9
CN0801300000000,08,013,Boulder County, CO,Feb-18,191740,186213,5527,2.9
CN0801300000000,08,013,Boulder County, CO,Mar-18,192425,187566,4859,2.5
CN0801300000000,08,013,Boulder County, CO,Apr-18(p),192211,187829,4382,2.3
CN2007300000000,20,073,Greenwood County, KS,Mar-17,3195,3057,138,4.3
CN2007300000000,20,073,Greenwood County, KS,Apr-17,3282,3149,133,4.1
CN2007300000000,20,073,Greenwood County, KS,May-17,3201,3071,130,4.1
CN2007300000000,20,073,Greenwood County, KS,Jun-17,3262,3118,144,4.4
CN2007300000000,20,073,Greenwood County, KS,Jul-17,3159,3011,148,4.7
CN2007300000000,20,073,Greenwood County, KS,Aug-17,3032,2890,142,4.7
CN2007300000000,20,073,Greenwood County, KS,Sep-17,3173,3055,118,3.7
CN2007300000000,20,073,Greenwood County, KS,Oct-17,3254,3135,119,3.7
CN2007300000000,20,073,Greenwood County, KS,Nov-17,3216,3097,119,3.7
CN2007300000000,20,073,Greenwood County, KS,Dec-17,3292,3178,114,3.5
CN2007300000000,20,073,Greenwood County, KS,Jan-18,3145,3016,129,4.1
CN2007300000000,20,073,Greenwood County, KS,Feb-18,3123,3003,120,3.8
CN2007300000000,20,073,Greenwood County, KS,Mar-18,3167,3048,119,3.8
CN2007300000000,20,073,Greenwood County, KS,Apr-18(p),3178,3063,115,3.6
CN4819100000000,48,191,Hall County, TX,Mar-17,1170,1089,81,6.9
CN4819100000000,48,191,Hall County, TX,Apr-17,1177,1097,80,6.8
CN4819100000000,48,191,Hall County, TX,May-17,1179,1107,72,6.1
CN4819100000000,48,191,Hall County, TX,Jun-17,1163,1093,70,6.0
CN4819100000000,48,191,Hall County, TX,Jul-17,1112,1044,68,6.1
CN4819100000000,48,191,Hall County, TX,Aug-17,1128,1057,71,6.3
CN4819100000000,48,191,Hall County, TX,Sep-17,1111,1049,62,5.6
CN4819100000000,48,191,Hall County, TX,Oct-17,1112,1056,56,5.0
CN4819100000000,48,191,Hall County, TX,Nov-17,1084,1029,55,5.1
CN4819100000000,48,191,Hall County, TX,Dec-17,1082,1030,52,4.8
CN4819100000000,48,191,Hall County, TX,Jan-18,1096,1043,53,4.8
CN4819100000000,48,191,Hall County, TX,Feb-18,1123,1067,56,5.0
CN4819100000000,48,191,Hall County, TX,Mar-18,1169,1107,62,5.3
CN4819100000000,48,191,Hall County, TX,Apr-18(p),1165,1107,58,5.0
CN4004500000000,40,045,Ellis County, OK,Mar-17,2243,2165,78,3.5
CN4004500000000,40,045,Ellis County, OK,Apr-17,2241,2171,70,3.1
CN4004500000000,40,045,Ellis County, OK,May-17,2228,2154,74,3.3
CN4004500000000,40,045,Ellis County, OK,Jun-17,2178,2097,81,3.7
CN4004500000000,40,045,Ellis County, OK,Jul-17,2127,2051,76,3.6
CN4004500000000,40,045,Ellis County, OK,Aug-17,2270,2197,73,3.2
CN4004500000000,40,045,Ellis County, OK,Sep-17,2222,2153,69,3.1
CN4004500000000,40,045,Ellis County, OK,Oct-17,2271,2202,69,3.0
CN4004500000000,40,045,Ellis County, OK,Nov-17,2280,2214,66,2.9
CN4004500000000,40,045,Ellis County, OK,Dec-17,2226,2168,58,2.6
CN4004500000000,40,045,Ellis County, OK,Jan-18,2205,2141,64,2.9
CN4004500000000,40,045,Ellis County, OK,Feb-18,2217,2155,62,2.8
CN4004500000000,40,045,Ellis County, OK,Mar-18,2184,2124,60,2.7
CN4004500000000,40,045,Ellis County, OK,Apr-18(p),2156,2097,59,2.7
CN4209700000000,42,097,Northumberland County, PA,Mar-17,43626,40801,2825,6.5
CN4209700000000,42,097,Northumberland County, PA,Apr-17,43743,41289,2454,5.6
CN4209700000000,42,097,Northumberland County, PA,May-17,44437,42101,2336,5.3
CN4209700000000,42,097,Northumberland County, PA,Jun-17,44964,42560,2404,5.3
CN4209700000000,42,097,Northumberland County, PA,Jul-17,45075,42499,2576,5.7
CN4209700000000,42,097,Northumberland County, PA,Aug-17,44389,41967,2422,5.5
CN4209700000000,42,097,Northumberland County, PA,Sep-17,43869,41792,2077,4.7
CN4209700000000,42,097,Northumberland County, PA,Oct-17,43142,41081,2061,4.8
CN4209700000000,42,097,Northumberland County, PA,Nov-17,42479,40259,2220,5.2
CN4209700000000,42,097,Northumberland County, PA,Dec-17,42400,40015,2385,5.6
CN4209700000000,42,097,Northumberland County, PA,Jan-18,42421,39536,2885,6.8
CN4209700000000,42,097,Northumberland County, PA,Feb-18,42950,40104,2846,6.6
CN4209700000000,42,097,Northumberland County, PA,Mar-18,42496,39986,2510,5.9
CN4209700000000,42,097,Northumberland County, PA,Apr-18(p),42373,40319,2054,4.8
CN1700100000000,17,001,Adams County, IL,Mar-17,31973,30729,1244,3.9
CN1700100000000,17,001,Adams County, IL,Apr-17,32097,31046,1051,3.3
CN1700100000000,17,001,Adams County, IL,May-17,31922,30850,1072,3.4
CN1700100000000,17,001,Adams County, IL,Jun-17,32263,31104,1159,3.6
CN1700100000000,17,001,Adams County, IL,Jul-17,32781,31539,1242,3.8
CN1700100000000,17,001,Adams County, IL,Aug-17,32401,31105,1296,4.0
CN1700100000000,17,001,Adams County, IL,Sep-17,32348,31183,1165,3.6
CN1700100000000,17,001,Adams County, IL,Oct-17,32245,31116,1129,3.5
CN1700100000000,17,001,Adams County, IL,Nov-17,32369,31225,1144,3.5
CN1700100000000,17,001,Adams County, IL,Dec-17,32168,31059,1109,3.4
CN1700100000000,17,001,Adams County, IL,Jan-18,32183,30914,1269,3.9
CN1700100000000,17,001,Adams County, IL,Feb-18,32336,31173,1163,3.6
CN1700100000000,17,001,Adams County, IL,Mar-18,32834,31632,1202,3.7
CN1700100000000,17,001,Adams County, IL,Apr-18(p),32891,31926,965,2.9
CN1326300000000,13,263,Talbot County, GA,Mar-17,2764,2592,172,6.2
CN1326300000000,13,263,Talbot County, GA,Apr-17,2738,2588,150,5.5
CN1326300000000,13,263,Talbot County, GA,May-17,2767,2609,158,5.7
CN1326300000000,13,263,Talbot County, GA,Jun-17,2812,2639,173,6.2
CN1326300000000,13,263,Talbot County, GA,Jul-17,2853,2653,200,7.0
CN1326300000000,13,263,Talbot County, GA,Aug-17,2806,2637,169,6.0
CN1326300000000,13,263,Talbot County, GA,Sep-17,2817,2670,147,5.2
CN1326300000000,13,263,Talbot County, GA,Oct-17,2816,2659,157,5.6
CN1326300000000,13,263,Talbot County, GA,Nov-17,2803,2664,139,5.0
CN1326300000000,13,263,Talbot County, GA,Dec-17,2799,2666,133,4.8
CN1326300000000,13,263,Talbot County, GA,Jan-18,2844,2668,176,6.2
CN1326300000000,13,263,Talbot County, GA,Feb-18,2827,2673,154,5.4
CN1326300000000,13,263,Talbot County, GA,Mar-18,2825,2679,146,5.2
CN1326300000000,13,263,Talbot County, GA,Apr-18(p),2792,2669,123,4.4
CN4702900000000,47,029,Cocke County, TN,Mar-17,14576,13675,901,6.2
CN4702900000000,47,029,Cocke County, TN,Apr-17,14736,13953,783,5.3
CN4702900000000,47,029,Cocke County, TN,May-17,14668,14079,589,4.0
CN4702900000000,47,029,Cocke County, TN,Jun-17,14811,14087,724,4.9
CN4702900000000,47,029,Cocke County, TN,Jul-17,14907,14202,705,4.7
CN4702900000000,47,029,Cocke County, TN,Aug-17,14902,14227,675,4.5
CN4702900000000,47,029,Cocke County, TN,Sep-17,14746,14132,614,4.2
CN4702900000000,47,029,Cocke County, TN,Oct-17,14468,13891,577,4.0
CN4702900000000,47,029,Cocke County, TN,Nov-17,14288,13713,575,4.0
CN4702900000000,47,029,Cocke County, TN,Dec-17,14266,13669,597,4.2
CN4702900000000,47,029,Cocke County, TN,Jan-18,14428,13489,939,6.5
CN4702900000000,47,029,Cocke County, TN,Feb-18,14476,13540,936,6.5
CN4702900000000,47,029,Cocke County, TN,Mar-18,14492,13771,721,5.0
CN4702900000000,47,029,Cocke County, TN,Apr-18(p),14688,14133,555,3.8
CN5601700000000,56,017,Hot Springs County, WY,Mar-17,2348,2241,107,4.6
CN5601700000000,56,017,Hot Springs County, WY,Apr-17,2350,2259,91,3.9
CN5601700000000,56,017,Hot Springs County, WY,May-17,2334,2243,91,3.9
CN5601700000000,56,017,Hot Springs County, WY,Jun-17,2408,2320,88,3.7
CN5601700000000,56,017,Hot Springs County, WY,Jul-17,2395,2311,84,3.5
CN5601700000000,56,017,Hot Springs County, WY,Aug-17,2321,2244,77,3.3
CN5601700000000,56,017,Hot Springs County, WY,Sep-17,2301,2226,75,3.3
CN5601700000000,56,017,Hot Springs County, WY,Oct-17,2249,2174,75,3.3
CN5601700000000,56,017,Hot Springs County, WY,Nov-17,2282,2202,80,3.5
CN5601700000000,56,017,Hot Springs County, WY,Dec-17,2261,2184,77,3.4
CN5601700000000,56,017,Hot Springs County, WY,Jan-18,2260,2168,92,4.1
CN5601700000000,56,017,Hot Springs County, WY,Feb-18,2273,2179,94,4.1
CN5601700000000,56,017,Hot Springs County, WY,Mar-18,2278,2186,92,4.0
CN5601700000000,56,017,Hot Springs County, WY,Apr-18(p),2254,2164,90,4.0
CN2611500000000,26,115,Monroe County, MI,Mar-17,76638,73220,3418,4.5
CN2611500000000,26,115,Monroe County, MI,Apr-17,76131,73223,2908,3.8
CN2611500000000,26,115,Monroe County, MI,May-17,76345,73043,3302,4.3
CN2611500000000,26,115,Monroe County, MI,Jun-17,77227,73445,3782,4.9
CN2611500000000,26,115,Monroe County, MI,Jul-17,76741,71821,4920,6.4
CN2611500000000,26,115,Monroe County, MI,Aug-17,76139,71807,4332,5.7
CN2611500000000,26,115,Monroe County, MI,Sep-17,77123,72905,4218,5.5
CN2611500000000,26,115,Monroe County, MI,Oct-17,76820,73072,3748,4.9
CN2611500000000,26,115,Monroe County, MI,Nov-17,76660,73602,3058,4.0
CN2611500000000,26,115,Monroe County, MI,Dec-17,75868,72743,3125,4.1
CN2611500000000,26,115,Monroe County, MI,Jan-18,75571,71551,4020,5.3
CN2611500000000,26,115,Monroe County, MI,Feb-18,76582,72509,4073,5.3
CN2611500000000,26,115,Monroe County, MI,Mar-18,76558,73313,3245,4.2
CN2611500000000,26,115,Monroe County, MI,Apr-18(p),76550,73711,2839,3.7
CN0229000000000,02,290,Yukon-Koyukuk Census Area, AK,Mar-17,2506,2003,503,20.1
CN0229000000000,02,290,Yukon-Koyukuk Census Area, AK,Apr-17,2494,2020,474,19.0
CN0229000000000,02,290,Yukon-Koyukuk Census Area, AK,May-17,2623,2172,451,17.2
CN0229000000000,02,290,Yukon-Koyukuk Census Area, AK,Jun-17,2513,2056,457,18.2
CN0229000000000,02,290,Yukon-Koyukuk Census Area, AK,Jul-17,2369,1935,434,18.3
CN0229000000000,02,290,Yukon-Koyukuk Census Area, AK,Aug-17,2479,2059,420,16.9
CN0229000000000,02,290,Yukon-Koyukuk Census Area, AK,Sep-17,2442,2067,375,15.4
CN0229000000000,02,290,Yukon-Koyukuk Census Area, AK,Oct-17,2456,2061,395,16.1
CN0229000000000,02,290,Yukon-Koyukuk Census Area, AK,Nov-17,2486,2049,437,17.6
CN0229000000000,02,290,Yukon-Koyukuk Census Area, AK,Dec-17,2485,2039,446,17.9
CN0229000000000,02,290,Yukon-Koyukuk Census Area, AK,Jan-18,2473,1960,513,20.7
CN0229000000000,02,290,Yukon-Koyukuk Census Area, AK,Feb-18,2465,1936,529,21.5
CN0229000000000,02,290,Yukon-Koyukuk Census Area, AK,Mar-18,2499,1998,501,20.0
CN0229000000000,02,290,Yukon-Koyukuk Census Area, AK,Apr-18(p),2454,1990,464,18.9
CN2209100000000,22,091,St. Helena Parish, LA,Mar-17,4370,4088,282,6.5
CN2209100000000,22,091,St. Helena Parish, LA,Apr-17,4358,4095,263,6.0
CN2209100000000,22,091,St. Helena Parish, LA,May-17,4359,4085,274,6.3
CN2209100000000,22,091,St. Helena Parish, LA,Jun-17,4448,4105,343,7.7
CN2209100000000,22,091,St. Helena Parish, LA,Jul-17,4455,4120,335,7.5
CN2209100000000,22,091,St. Helena Parish, LA,Aug-17,4430,4098,332,7.5
CN2209100000000,22,091,St. Helena Parish, LA,Sep-17,4405,4123,282,6.4
CN2209100000000,22,091,St. Helena Parish, LA,Oct-17,4384,4131,253,5.8
CN2209100000000,22,091,St. Helena Parish, LA,Nov-17,4397,4151,246,5.6
CN2209100000000,22,091,St. Helena Parish, LA,Dec-17,4363,4118,245,5.6
CN2209100000000,22,091,St. Helena Parish, LA,Jan-18,4375,4112,263,6.0
CN2209100000000,22,091,St. Helena Parish, LA,Feb-18,4431,4180,251,5.7
CN2209100000000,22,091,St. Helena Parish, LA,Mar-18,4436,4195,241,5.4
CN2209100000000,22,091,St. Helena Parish, LA,Apr-18(p),4450,4207,243,5.5
CN2118300000000,21,183,Ohio County, KY,Mar-17,9874,9155,719,7.3
CN2118300000000,21,183,Ohio County, KY,Apr-17,9901,9283,618,6.2
CN2118300000000,21,183,Ohio County, KY,May-17,9866,9246,620,6.3
CN2118300000000,21,183,Ohio County, KY,Jun-17,9984,9288,696,7.0
CN2118300000000,21,183,Ohio County, KY,Jul-17,9717,9071,646,6.6
CN2118300000000,21,183,Ohio County, KY,Aug-17,9871,9263,608,6.2
CN2118300000000,21,183,Ohio County, KY,Sep-17,9798,9282,516,5.3
CN2118300000000,21,183,Ohio County, KY,Oct-17,9697,9202,495,5.1
CN2118300000000,21,183,Ohio County, KY,Nov-17,9711,9223,488,5.0
CN2118300000000,21,183,Ohio County, KY,Dec-17,9634,9162,472,4.9
CN2118300000000,21,183,Ohio County, KY,Jan-18,9783,9180,603,6.2
CN2118300000000,21,183,Ohio County, KY,Feb-18,9837,9168,669,6.8
CN2118300000000,21,183,Ohio County, KY,Mar-18,9860,9203,657,6.7
CN2118300000000,21,183,Ohio County, KY,Apr-18(p),9845,9296,549,5.6
CN5102700000000,51,027,Buchanan County, VA,Mar-17,6786,6207,579,8.5
CN5102700000000,51,027,Buchanan County, VA,Apr-17,6676,6173,503,7.5
CN5102700000000,51,027,Buchanan County, VA,May-17,6654,6169,485,7.3
CN5102700000000,51,027,Buchanan County, VA,Jun-17,6750,6234,516,7.6
CN5102700000000,51,027,Buchanan County, VA,Jul-17,6830,6302,528,7.7
CN5102700000000,51,027,Buchanan County, VA,Aug-17,6719,6234,485,7.2
CN5102700000000,51,027,Buchanan County, VA,Sep-17,6734,6293,441,6.5
CN5102700000000,51,027,Buchanan County, VA,Oct-17,6570,6148,422,6.4
CN5102700000000,51,027,Buchanan County, VA,Nov-17,6557,6137,420,6.4
CN5102700000000,51,027,Buchanan County, VA,Dec-17,6539,6112,427,6.5
CN5102700000000,51,027,Buchanan County, VA,Jan-18,6598,6130,468,7.1
CN5102700000000,51,027,Buchanan County, VA,Feb-18,6752,6300,452,6.7
CN5102700000000,51,027,Buchanan County, VA,Mar-18,6813,6340,473,6.9
CN5102700000000,51,027,Buchanan County, VA,Apr-18(p),6726,6320,406,6.0
CN5409300000000,54,093,Tucker County, WV,Mar-17,3461,3275,186,5.4
CN5409300000000,54,093,Tucker County, WV,Apr-17,3287,3112,175,5.3
CN5409300000000,54,093,Tucker County, WV,May-17,3277,3113,164,5.0
CN5409300000000,54,093,Tucker County, WV,Jun-17,3428,3261,167,4.9
CN5409300000000,54,093,Tucker County, WV,Jul-17,3448,3284,164,4.8
CN5409300000000,54,093,Tucker County, WV,Aug-17,3447,3273,174,5.0
CN5409300000000,54,093,Tucker County, WV,Sep-17,3325,3179,146,4.4
CN5409300000000,54,093,Tucker County, WV,Oct-17,3326,3179,147,4.4
CN5409300000000,54,093,Tucker County, WV,Nov-17,3282,3116,166,5.1
CN5409300000000,54,093,Tucker County, WV,Dec-17,3306,3130,176,5.3
CN5409300000000,54,093,Tucker County, WV,Jan-18,3464,3272,192,5.5
CN5409300000000,54,093,Tucker County, WV,Feb-18,3490,3272,218,6.2
CN5409300000000,54,093,Tucker County, WV,Mar-18,3433,3221,212,6.2
CN5409300000000,54,093,Tucker County, WV,Apr-18(p),3317,3114,203,6.1
CN2907500000000,29,075,Gentry County, MO,Mar-17,3594,3488,106,2.9
CN2907500000000,29,075,Gentry County, MO,Apr-17,3755,3665,90,2.4
CN2907500000000,29,075,Gentry County, MO,May-17,3670,3569,101,2.8
CN2907500000000,29,075,Gentry County, MO,Jun-17,3718,3605,113,3.0
CN2907500000000,29,075,Gentry County, MO,Jul-17,3542,3406,136,3.8
CN2907500000000,29,075,Gentry County, MO,Aug-17,3500,3373,127,3.6
CN2907500000000,29,075,Gentry County, MO,Sep-17,3453,3371,82,2.4
CN2907500000000,29,075,Gentry County, MO,Oct-17,3547,3479,68,1.9
CN2907500000000,29,075,Gentry County, MO,Nov-17,3538,3455,83,2.3
CN2907500000000,29,075,Gentry County, MO,Dec-17,3473,3395,78,2.2
CN2907500000000,29,075,Gentry County, MO,Jan-18,3516,3418,98,2.8
CN2907500000000,29,075,Gentry County, MO,Feb-18,3585,3474,111,3.1
CN2907500000000,29,075,Gentry County, MO,Mar-18,3572,3467,105,2.9
CN2907500000000,29,075,Gentry County, MO,Apr-18(p),3657,3564,93,2.5
CN1712700000000,17,127,Massac County, IL,Mar-17,5907,5544,363,6.1
CN1712700000000,17,127,Massac County, IL,Apr-17,5884,5549,335,5.7
CN1712700000000,17,127,Massac County, IL,May-17,5864,5527,337,5.7
CN1712700000000,17,127,Massac County, IL,Jun-17,5936,5532,404,6.8
CN1712700000000,17,127,Massac County, IL,Jul-17,5956,5524,432,7.3
CN1712700000000,17,127,Massac County, IL,Aug-17,5909,5487,422,7.1
CN1712700000000,17,127,Massac County, IL,Sep-17,5830,5493,337,5.8
CN1712700000000,17,127,Massac County, IL,Oct-17,5771,5475,296,5.1
CN1712700000000,17,127,Massac County, IL,Nov-17,5780,5456,324,5.6
CN1712700000000,17,127,Massac County, IL,Dec-17,5777,5458,319,5.5
CN1712700000000,17,127,Massac County, IL,Jan-18,5729,5402,327,5.7
CN1712700000000,17,127,Massac County, IL,Feb-18,5748,5422,326,5.7
CN1712700000000,17,127,Massac County, IL,Mar-18,5867,5529,338,5.8
CN1712700000000,17,127,Massac County, IL,Apr-18(p),5860,5544,316,5.4
CN3715700000000,37,157,Rockingham County, NC,Mar-17,41109,39043,2066,5.0
CN3715700000000,37,157,Rockingham County, NC,Apr-17,41164,39189,1975,4.8
CN3715700000000,37,157,Rockingham County, NC,May-17,41151,39062,2089,5.1
CN3715700000000,37,157,Rockingham County, NC,Jun-17,40971,38863,2108,5.1
CN3715700000000,37,157,Rockingham County, NC,Jul-17,41261,38959,2302,5.6
CN3715700000000,37,157,Rockingham County, NC,Aug-17,40906,38663,2243,5.5
CN3715700000000,37,157,Rockingham County, NC,Sep-17,41402,39365,2037,4.9
CN3715700000000,37,157,Rockingham County, NC,Oct-17,41234,39186,2048,5.0
CN3715700000000,37,157,Rockingham County, NC,Nov-17,41305,39132,2173,5.3
CN3715700000000,37,157,Rockingham County, NC,Dec-17,40907,38850,2057,5.0
CN3715700000000,37,157,Rockingham County, NC,Jan-18,41000,38756,2244,5.5
CN3715700000000,37,157,Rockingham County, NC,Feb-18,41507,39335,2172,5.2
CN3715700000000,37,157,Rockingham County, NC,Mar-18,41448,39407,2041,4.9
CN3715700000000,37,157,Rockingham County, NC,Apr-18(p),41364,39592,1772,4.3
CN2123100000000,21,231,Wayne County, KY,Mar-17,7639,6977,662,8.7
CN2123100000000,21,231,Wayne County, KY,Apr-17,7785,7225,560,7.2
CN2123100000000,21,231,Wayne County, KY,May-17,7843,7174,669,8.5
CN2123100000000,21,231,Wayne County, KY,Jun-17,8007,7325,682,8.5
CN2123100000000,21,231,Wayne County, KY,Jul-17,7587,6983,604,8.0
CN2123100000000,21,231,Wayne County, KY,Aug-17,7508,6962,546,7.3
CN2123100000000,21,231,Wayne County, KY,Sep-17,7468,6972,496,6.6
CN2123100000000,21,231,Wayne County, KY,Oct-17,7381,6936,445,6.0
CN2123100000000,21,231,Wayne County, KY,Nov-17,7444,7008,436,5.9
CN2123100000000,21,231,Wayne County, KY,Dec-17,7369,6939,430,5.8
CN2123100000000,21,231,Wayne County, KY,Jan-18,7442,6987,455,6.1
CN2123100000000,21,231,Wayne County, KY,Feb-18,7551,6942,609,8.1
CN2123100000000,21,231,Wayne County, KY,Mar-18,7605,7002,603,7.9
CN2123100000000,21,231,Wayne County, KY,Apr-18(p),7662,7132,530,6.9
CN7208900000000,72,089,Luquillo Municipio, PR,Mar-17,6309,5522,787,12.5
CN7208900000000,72,089,Luquillo Municipio, PR,Apr-17,6291,5480,811,12.9
CN7208900000000,72,089,Luquillo Municipio, PR,May-17,6174,5438,736,11.9
CN7208900000000,72,089,Luquillo Municipio, PR,Jun-17,6053,5404,649,10.7
CN7208900000000,72,089,Luquillo Municipio, PR,Jul-17,6091,5375,716,11.8
CN7208900000000,72,089,Luquillo Municipio, PR,Aug-17,6089,5304,785,12.9
CN7208900000000,72,089,Luquillo Municipio, PR,Sep-17(y),6184,5375,809,13.1
CN7208900000000,72,089,Luquillo Municipio, PR,Oct-17,6082,5156,926,15.2
CN7208900000000,72,089,Luquillo Municipio, PR,Nov-17,6385,5470,915,14.3
CN7208900000000,72,089,Luquillo Municipio, PR,Dec-17,6419,5518,901,14.0
CN7208900000000,72,089,Luquillo Municipio, PR,Jan-18,6403,5415,988,15.4
CN7208900000000,72,089,Luquillo Municipio, PR,Feb-18,6384,5429,955,15.0
CN7208900000000,72,089,Luquillo Municipio, PR,Mar-18,6419,5434,985,15.3
CN7208900000000,72,089,Luquillo Municipio, PR,Apr-18(p),6414,5478,936,14.6
CN1809300000000,18,093,Lawrence County, IN,Mar-17,20836,19869,967,4.6
CN1809300000000,18,093,Lawrence County, IN,Apr-17,20952,20173,779,3.7
CN1809300000000,18,093,Lawrence County, IN,May-17,20776,19956,820,3.9
CN1809300000000,18,093,Lawrence County, IN,Jun-17,20923,20058,865,4.1
CN1809300000000,18,093,Lawrence County, IN,Jul-17,20560,19665,895,4.4
CN1809300000000,18,093,Lawrence County, IN,Aug-17,20558,19585,973,4.7
CN1809300000000,18,093,Lawrence County, IN,Sep-17,20813,19991,822,3.9
CN1809300000000,18,093,Lawrence County, IN,Oct-17,20910,20155,755,3.6
CN1809300000000,18,093,Lawrence County, IN,Nov-17,20804,19968,836,4.0
CN1809300000000,18,093,Lawrence County, IN,Dec-17,20599,19797,802,3.9
CN1809300000000,18,093,Lawrence County, IN,Jan-18,20440,19494,946,4.6
CN1809300000000,18,093,Lawrence County, IN,Feb-18,20581,19623,958,4.7
CN1809300000000,18,093,Lawrence County, IN,Mar-18,20649,19832,817,4.0
CN1809300000000,18,093,Lawrence County, IN,Apr-18(p),20891,20197,694,3.3
CN2708100000000,27,081,Lincoln County, MN,Mar-17,3325,3161,164,4.9
CN2708100000000,27,081,Lincoln County, MN,Apr-17,3346,3233,113,3.4
CN2708100000000,27,081,Lincoln County, MN,May-17,3322,3238,84,2.5
CN2708100000000,27,081,Lincoln County, MN,Jun-17,3346,3257,89,2.7
CN2708100000000,27,081,Lincoln County, MN,Jul-17,3296,3214,82,2.5
CN2708100000000,27,081,Lincoln County, MN,Aug-17,3171,3086,85,2.7
CN2708100000000,27,081,Lincoln County, MN,Sep-17,3193,3114,79,2.5
CN2708100000000,27,081,Lincoln County, MN,Oct-17,3390,3329,61,1.8
CN2708100000000,27,081,Lincoln County, MN,Nov-17,3335,3263,72,2.2
CN2708100000000,27,081,Lincoln County, MN,Dec-17,3367,3241,126,3.7
CN2708100000000,27,081,Lincoln County, MN,Jan-18,3327,3151,176,5.3
CN2708100000000,27,081,Lincoln County, MN,Feb-18,3322,3155,167,5.0
CN2708100000000,27,081,Lincoln County, MN,Mar-18,3324,3158,166,5.0
CN2708100000000,27,081,Lincoln County, MN,Apr-18(p),3358,3240,118,3.5
CN4100700000000,41,007,Clatsop County, OR,Mar-17,18709,17902,807,4.3
CN4100700000000,41,007,Clatsop County, OR,Apr-17,19118,18383,735,3.8
CN4100700000000,41,007,Clatsop County, OR,May-17,19287,18592,695,3.6
CN4100700000000,41,007,Clatsop County, OR,Jun-17,19831,19034,797,4.0
CN4100700000000,41,007,Clatsop County, OR,Jul-17,20146,19321,825,4.1
CN4100700000000,41,007,Clatsop County, OR,Aug-17,20050,19238,812,4.0
CN4100700000000,41,007,Clatsop County, OR,Sep-17,19772,19007,765,3.9
CN4100700000000,41,007,Clatsop County, OR,Oct-17,19430,18645,785,4.0
CN4100700000000,41,007,Clatsop County, OR,Nov-17,19095,18302,793,4.2
CN4100700000000,41,007,Clatsop County, OR,Dec-17,18536,17738,798,4.3
CN4100700000000,41,007,Clatsop County, OR,Jan-18,18619,17754,865,4.6
CN4100700000000,41,007,Clatsop County, OR,Feb-18,18863,18018,845,4.5
CN4100700000000,41,007,Clatsop County, OR,Mar-18,19176,18309,867,4.5
CN4100700000000,41,007,Clatsop County, OR,Apr-18(p),19265,18523,742,3.9
CN4717700000000,47,177,Warren County, TN,Mar-17,17345,16633,712,4.1
CN4717700000000,47,177,Warren County, TN,Apr-17,17296,16712,584,3.4
CN4717700000000,47,177,Warren County, TN,May-17,17189,16613,576,3.4
CN4717700000000,47,177,Warren County, TN,Jun-17,17174,16382,792,4.6
CN4717700000000,47,177,Warren County, TN,Jul-17,17160,16393,767,4.5
CN4717700000000,47,177,Warren County, TN,Aug-17,17311,16637,674,3.9
CN4717700000000,47,177,Warren County, TN,Sep-17,17166,16581,585,3.4
CN4717700000000,47,177,Warren County, TN,Oct-17,16976,16351,625,3.7
CN4717700000000,47,177,Warren County, TN,Nov-17,16790,16231,559,3.3
CN4717700000000,47,177,Warren County, TN,Dec-17,16739,16202,537,3.2
CN4717700000000,47,177,Warren County, TN,Jan-18,16712,16030,682,4.1
CN4717700000000,47,177,Warren County, TN,Feb-18,16845,16181,664,3.9
CN4717700000000,47,177,Warren County, TN,Mar-18,16713,16075,638,3.8
CN4717700000000,47,177,Warren County, TN,Apr-18(p),16751,16240,511,3.1
CN4847700000000,48,477,Washington County, TX,Mar-17,14992,14276,716,4.8
CN4847700000000,48,477,Washington County, TX,Apr-17,14966,14367,599,4.0
CN4847700000000,48,477,Washington County, TX,May-17,15023,14430,593,3.9
CN4847700000000,48,477,Washington County, TX,Jun-17,15002,14323,679,4.5
CN4847700000000,48,477,Washington County, TX,Jul-17,14941,14254,687,4.6
CN4847700000000,48,477,Washington County, TX,Aug-17,14804,14146,658,4.4
CN4847700000000,48,477,Washington County, TX,Sep-17,14831,14271,560,3.8
CN4847700000000,48,477,Washington County, TX,Oct-17,14712,14196,516,3.5
CN4847700000000,48,477,Washington County, TX,Nov-17,14706,14157,549,3.7
CN4847700000000,48,477,Washington County, TX,Dec-17,14702,14182,520,3.5
CN4847700000000,48,477,Washington County, TX,Jan-18,14537,13950,587,4.0
CN4847700000000,48,477,Washington County, TX,Feb-18,14891,14297,594,4.0
CN4847700000000,48,477,Washington County, TX,Mar-18,15042,14412,630,4.2
CN4847700000000,48,477,Washington County, TX,Apr-18(p),15002,14480,522,3.5
CN1905500000000,19,055,Delaware County, IA,Mar-17,10459,10092,367,3.5
CN1905500000000,19,055,Delaware County, IA,Apr-17,10466,10194,272,2.6
CN1905500000000,19,055,Delaware County, IA,May-17,10567,10315,252,2.4
CN1905500000000,19,055,Delaware County, IA,Jun-17,10801,10536,265,2.5
CN1905500000000,19,055,Delaware County, IA,Jul-17,10737,10496,241,2.2
CN1905500000000,19,055,Delaware County, IA,Aug-17,10560,10315,245,2.3
CN1905500000000,19,055,Delaware County, IA,Sep-17,10457,10238,219,2.1
CN1905500000000,19,055,Delaware County, IA,Oct-17,10471,10284,187,1.8
CN1905500000000,19,055,Delaware County, IA,Nov-17,10324,10142,182,1.8
CN1905500000000,19,055,Delaware County, IA,Dec-17,10439,10187,252,2.4
CN1905500000000,19,055,Delaware County, IA,Jan-18,10326,9981,345,3.3
CN1905500000000,19,055,Delaware County, IA,Feb-18,10387,10073,314,3.0
CN1905500000000,19,055,Delaware County, IA,Mar-18,10286,10021,265,2.6
CN1905500000000,19,055,Delaware County, IA,Apr-18(p),10251,10039,212,2.1
CN0514700000000,05,147,Woodruff County, AR,Mar-17,2966,2817,149,5.0
CN0514700000000,05,147,Woodruff County, AR,Apr-17,2975,2837,138,4.6
CN0514700000000,05,147,Woodruff County, AR,May-17,3004,2863,141,4.7
CN0514700000000,05,147,Woodruff County, AR,Jun-17,3041,2898,143,4.7
CN0514700000000,05,147,Woodruff County, AR,Jul-17,2889,2741,148,5.1
CN0514700000000,05,147,Woodruff County, AR,Aug-17,2950,2816,134,4.5
CN0514700000000,05,147,Woodruff County, AR,Sep-17,2932,2800,132,4.5
CN0514700000000,05,147,Woodruff County, AR,Oct-17,2968,2843,125,4.2
CN0514700000000,05,147,Woodruff County, AR,Nov-17,2912,2782,130,4.5
CN0514700000000,05,147,Woodruff County, AR,Dec-17,2899,2766,133,4.6
CN0514700000000,05,147,Woodruff County, AR,Jan-18,2823,2663,160,5.7
CN0514700000000,05,147,Woodruff County, AR,Feb-18,2818,2663,155,5.5
CN0514700000000,05,147,Woodruff County, AR,Mar-18,2830,2686,144,5.1
CN0514700000000,05,147,Woodruff County, AR,Apr-18(p),2843,2719,124,4.4
CN0222000000000,02,220,Sitka Borough/city, AK,Mar-17,4260,4048,212,5.0
CN0222000000000,02,220,Sitka Borough/city, AK,Apr-17,4321,4136,185,4.3
CN0222000000000,02,220,Sitka Borough/city, AK,May-17,4556,4352,204,4.5
CN0222000000000,02,220,Sitka Borough/city, AK,Jun-17,4618,4396,222,4.8
CN0222000000000,02,220,Sitka Borough/city, AK,Jul-17,5114,4909,205,4.0
CN0222000000000,02,220,Sitka Borough/city, AK,Aug-17,5264,5068,196,3.7
CN0222000000000,02,220,Sitka Borough/city, AK,Sep-17,4757,4551,206,4.3
CN0222000000000,02,220,Sitka Borough/city, AK,Oct-17,4147,3950,197,4.8
CN0222000000000,02,220,Sitka Borough/city, AK,Nov-17,4129,3935,194,4.7
CN0222000000000,02,220,Sitka Borough/city, AK,Dec-17,4136,3934,202,4.9
CN0222000000000,02,220,Sitka Borough/city, AK,Jan-18,4028,3804,224,5.6
CN0222000000000,02,220,Sitka Borough/city, AK,Feb-18,4056,3842,214,5.3
CN0222000000000,02,220,Sitka Borough/city, AK,Mar-18,4300,4085,215,5.0
CN0222000000000,02,220,Sitka Borough/city, AK,Apr-18(p),4329,4115,214,4.9
CN3710700000000,37,107,Lenoir County, NC,Mar-17,28366,27094,1272,4.5
CN3710700000000,37,107,Lenoir County, NC,Apr-17,28274,27115,1159,4.1
CN3710700000000,37,107,Lenoir County, NC,May-17,28220,27020,1200,4.3
CN3710700000000,37,107,Lenoir County, NC,Jun-17,28134,26881,1253,4.5
CN3710700000000,37,107,Lenoir County, NC,Jul-17,28495,27191,1304,4.6
CN3710700000000,37,107,Lenoir County, NC,Aug-17,27943,26638,1305,4.7
CN3710700000000,37,107,Lenoir County, NC,Sep-17,28221,27020,1201,4.3
CN3710700000000,37,107,Lenoir County, NC,Oct-17,28225,26990,1235,4.4
CN3710700000000,37,107,Lenoir County, NC,Nov-17,28018,26731,1287,4.6
CN3710700000000,37,107,Lenoir County, NC,Dec-17,28064,26843,1221,4.4
CN3710700000000,37,107,Lenoir County, NC,Jan-18,28131,26818,1313,4.7
CN3710700000000,37,107,Lenoir County, NC,Feb-18,28232,26914,1318,4.7
CN3710700000000,37,107,Lenoir County, NC,Mar-18,28192,26949,1243,4.4
CN3710700000000,37,107,Lenoir County, NC,Apr-18(p),28119,27068,1051,3.7
CN3805700000000,38,057,Mercer County, ND,Mar-17,4420,4198,222,5.0
CN3805700000000,38,057,Mercer County, ND,Apr-17,4675,4515,160,3.4
CN3805700000000,38,057,Mercer County, ND,May-17,4723,4594,129,2.7
CN3805700000000,38,057,Mercer County, ND,Jun-17,4655,4485,170,3.7
CN3805700000000,38,057,Mercer County, ND,Jul-17,4664,4513,151,3.2
CN3805700000000,38,057,Mercer County, ND,Aug-17,4659,4492,167,3.6
CN3805700000000,38,057,Mercer County, ND,Sep-17,4438,4308,130,2.9
CN3805700000000,38,057,Mercer County, ND,Oct-17,4402,4268,134,3.0
CN3805700000000,38,057,Mercer County, ND,Nov-17,4382,4200,182,4.2
CN3805700000000,38,057,Mercer County, ND,Dec-17,4304,4105,199,4.6
CN3805700000000,38,057,Mercer County, ND,Jan-18,4261,4018,243,5.7
CN3805700000000,38,057,Mercer County, ND,Feb-18,4199,3961,238,5.7
CN3805700000000,38,057,Mercer County, ND,Mar-18,4284,4086,198,4.6
CN3805700000000,38,057,Mercer County, ND,Apr-18(p),4485,4314,171,3.8
CN4704500000000,47,045,Dyer County, TN,Mar-17,16191,15308,883,5.5
CN4704500000000,47,045,Dyer County, TN,Apr-17,16081,15371,710,4.4
CN4704500000000,47,045,Dyer County, TN,May-17,16040,15379,661,4.1
CN4704500000000,47,045,Dyer County, TN,Jun-17,16159,15350,809,5.0
CN4704500000000,47,045,Dyer County, TN,Jul-17,16117,15340,777,4.8
CN4704500000000,47,045,Dyer County, TN,Aug-17,16157,15401,756,4.7
CN4704500000000,47,045,Dyer County, TN,Sep-17,16204,15515,689,4.3
CN4704500000000,47,045,Dyer County, TN,Oct-17,16042,15371,671,4.2
CN4704500000000,47,045,Dyer County, TN,Nov-17,16080,15415,665,4.1
CN4704500000000,47,045,Dyer County, TN,Dec-17,16079,15421,658,4.1
CN4704500000000,47,045,Dyer County, TN,Jan-18,15917,15103,814,5.1
CN4704500000000,47,045,Dyer County, TN,Feb-18,16163,15375,788,4.9
CN4704500000000,47,045,Dyer County, TN,Mar-18,16127,15378,749,4.6
CN4704500000000,47,045,Dyer County, TN,Apr-18(p),16192,15564,628,3.9
CN5502100000000,55,021,Columbia County, WI,Mar-17,31882,30787,1095,3.4
CN5502100000000,55,021,Columbia County, WI,Apr-17,31872,30972,900,2.8
CN5502100000000,55,021,Columbia County, WI,May-17,31770,30912,858,2.7
CN5502100000000,55,021,Columbia County, WI,Jun-17,32376,31339,1037,3.2
CN5502100000000,55,021,Columbia County, WI,Jul-17,32359,31420,939,2.9
CN5502100000000,55,021,Columbia County, WI,Aug-17,32036,31135,901,2.8
CN5502100000000,55,021,Columbia County, WI,Sep-17,31992,31183,809,2.5
CN5502100000000,55,021,Columbia County, WI,Oct-17,32203,31435,768,2.4
CN5502100000000,55,021,Columbia County, WI,Nov-17,32342,31549,793,2.5
CN5502100000000,55,021,Columbia County, WI,Dec-17,32125,31356,769,2.4
CN5502100000000,55,021,Columbia County, WI,Jan-18,32024,31085,939,2.9
CN5502100000000,55,021,Columbia County, WI,Feb-18,32479,31443,1036,3.2
CN5502100000000,55,021,Columbia County, WI,Mar-18,32661,31689,972,3.0
CN5502100000000,55,021,Columbia County, WI,Apr-18(p),32477,31715,762,2.3
CN5306100000000,53,061,Snohomish County, WA,Mar-17,419703,403081,16622,4.0
CN5306100000000,53,061,Snohomish County, WA,Apr-17,420089,405582,14507,3.5
CN5306100000000,53,061,Snohomish County, WA,May-17,420413,404498,15915,3.8
CN5306100000000,53,061,Snohomish County, WA,Jun-17,421440,403384,18056,4.3
CN5306100000000,53,061,Snohomish County, WA,Jul-17,422361,403816,18545,4.4
CN5306100000000,53,061,Snohomish County, WA,Aug-17,423492,404444,19048,4.5
CN5306100000000,53,061,Snohomish County, WA,Sep-17,425897,407387,18510,4.3
CN5306100000000,53,061,Snohomish County, WA,Oct-17,422772,405131,17641,4.2
CN5306100000000,53,061,Snohomish County, WA,Nov-17,424128,405500,18628,4.4
CN5306100000000,53,061,Snohomish County, WA,Dec-17,424072,407257,16815,4.0
CN5306100000000,53,061,Snohomish County, WA,Jan-18,429458,409813,19645,4.6
CN5306100000000,53,061,Snohomish County, WA,Feb-18,435957,417760,18197,4.2
CN5306100000000,53,061,Snohomish County, WA,Mar-18,432613,416332,16281,3.8
CN5306100000000,53,061,Snohomish County, WA,Apr-18(p),429225,414994,14231,3.3
CN2615900000000,26,159,Van Buren County, MI,Mar-17,36016,33764,2252,6.3
CN2615900000000,26,159,Van Buren County, MI,Apr-17,35428,33695,1733,4.9
CN2615900000000,26,159,Van Buren County, MI,May-17,35095,33310,1785,5.1
CN2615900000000,26,159,Van Buren County, MI,Jun-17,35257,33286,1971,5.6
CN2615900000000,26,159,Van Buren County, MI,Jul-17,35312,33120,2192,6.2
CN2615900000000,26,159,Van Buren County, MI,Aug-17,35014,32971,2043,5.8
CN2615900000000,26,159,Van Buren County, MI,Sep-17,35111,33397,1714,4.9
CN2615900000000,26,159,Van Buren County, MI,Oct-17,35332,33694,1638,4.6
CN2615900000000,26,159,Van Buren County, MI,Nov-17,35283,33515,1768,5.0
CN2615900000000,26,159,Van Buren County, MI,Dec-17,35749,33496,2253,6.3
CN2615900000000,26,159,Van Buren County, MI,Jan-18,35702,33069,2633,7.4
CN2615900000000,26,159,Van Buren County, MI,Feb-18,36543,33788,2755,7.5
CN2615900000000,26,159,Van Buren County, MI,Mar-18,36183,33917,2266,6.3
CN2615900000000,26,159,Van Buren County, MI,Apr-18(p),35633,33845,1788,5.0
CN1918700000000,19,187,Webster County, IA,Mar-17,19271,18439,832,4.3
CN1918700000000,19,187,Webster County, IA,Apr-17,19546,18808,738,3.8
CN1918700000000,19,187,Webster County, IA,May-17,19416,18761,655,3.4
CN1918700000000,19,187,Webster County, IA,Jun-17,19802,18998,804,4.1
CN1918700000000,19,187,Webster County, IA,Jul-17,19671,18898,773,3.9
CN1918700000000,19,187,Webster County, IA,Aug-17,19483,18688,795,4.1
CN1918700000000,19,187,Webster County, IA,Sep-17,19180,18540,640,3.3
CN1918700000000,19,187,Webster County, IA,Oct-17,19167,18616,551,2.9
CN1918700000000,19,187,Webster County, IA,Nov-17,19123,18540,583,3.0
CN1918700000000,19,187,Webster County, IA,Dec-17,19027,18364,663,3.5
CN1918700000000,19,187,Webster County, IA,Jan-18,19100,18320,780,4.1
CN1918700000000,19,187,Webster County, IA,Feb-18,19104,18322,782,4.1
CN1918700000000,19,187,Webster County, IA,Mar-18,19065,18340,725,3.8
CN1918700000000,19,187,Webster County, IA,Apr-18(p),19290,18635,655,3.4
CN3609700000000,36,097,Schuyler County, NY,Mar-17,8212,7633,579,7.1
CN3609700000000,36,097,Schuyler County, NY,Apr-17,8246,7766,480,5.8
CN3609700000000,36,097,Schuyler County, NY,May-17,8276,7861,415,5.0
CN3609700000000,36,097,Schuyler County, NY,Jun-17,8499,8105,394,4.6
CN3609700000000,36,097,Schuyler County, NY,Jul-17,8548,8154,394,4.6
CN3609700000000,36,097,Schuyler County, NY,Aug-17,8424,8030,394,4.7
CN3609700000000,36,097,Schuyler County, NY,Sep-17,8440,8053,387,4.6
CN3609700000000,36,097,Schuyler County, NY,Oct-17,8284,7888,396,4.8
CN3609700000000,36,097,Schuyler County, NY,Nov-17,8149,7648,501,6.1
CN3609700000000,36,097,Schuyler County, NY,Dec-17,8085,7485,600,7.4
CN3609700000000,36,097,Schuyler County, NY,Jan-18,8274,7598,676,8.2
CN3609700000000,36,097,Schuyler County, NY,Feb-18,8233,7549,684,8.3
CN3609700000000,36,097,Schuyler County, NY,Mar-18,8081,7444,637,7.9
CN3609700000000,36,097,Schuyler County, NY,Apr-18(p),8196,7692,504,6.1
CN1000100000000,10,001,Kent County, DE,Mar-17,79004,75061,3943,5.0
CN1000100000000,10,001,Kent County, DE,Apr-17,78607,74813,3794,4.8
CN1000100000000,10,001,Kent County, DE,May-17,78005,74312,3693,4.7
CN1000100000000,10,001,Kent County, DE,Jun-17,78402,74016,4386,5.6
CN1000100000000,10,001,Kent County, DE,Jul-17,77315,72977,4338,5.6
CN1000100000000,10,001,Kent County, DE,Aug-17,76803,72560,4243,5.5
CN1000100000000,10,001,Kent County, DE,Sep-17,77121,73389,3732,4.8
CN1000100000000,10,001,Kent County, DE,Oct-17,78118,74486,3632,4.6
CN1000100000000,10,001,Kent County, DE,Nov-17,78499,75192,3307,4.2
CN1000100000000,10,001,Kent County, DE,Dec-17,78421,75153,3268,4.2
CN1000100000000,10,001,Kent County, DE,Jan-18,79591,75612,3979,5.0
CN1000100000000,10,001,Kent County, DE,Feb-18,78986,75184,3802,4.8
CN1000100000000,10,001,Kent County, DE,Mar-18,79834,76279,3555,4.5
CN1000100000000,10,001,Kent County, DE,Apr-18(p),79427,76235,3192,4.0
CN2600900000000,26,009,Antrim County, MI,Mar-17,9884,9077,807,8.2
CN2600900000000,26,009,Antrim County, MI,Apr-17,9692,9027,665,6.9
CN2600900000000,26,009,Antrim County, MI,May-17,10073,9474,599,5.9
CN2600900000000,26,009,Antrim County, MI,Jun-17,10729,10141,588,5.5
CN2600900000000,26,009,Antrim County, MI,Jul-17,11194,10487,707,6.3
CN2600900000000,26,009,Antrim County, MI,Aug-17,10883,10249,634,5.8
CN2600900000000,26,009,Antrim County, MI,Sep-17,10207,9680,527,5.2
CN2600900000000,26,009,Antrim County, MI,Oct-17,9944,9446,498,5.0
CN2600900000000,26,009,Antrim County, MI,Nov-17,9664,9073,591,6.1
CN2600900000000,26,009,Antrim County, MI,Dec-17,9877,9097,780,7.9
CN2600900000000,26,009,Antrim County, MI,Jan-18,9915,9069,846,8.5
CN2600900000000,26,009,Antrim County, MI,Feb-18,10085,9188,897,8.9
CN2600900000000,26,009,Antrim County, MI,Mar-18,9991,9209,782,7.8
CN2600900000000,26,009,Antrim County, MI,Apr-18(p),9893,9201,692,7.0
CN4821100000000,48,211,Hemphill County, TX,Mar-17,2335,2272,63,2.7
CN4821100000000,48,211,Hemphill County, TX,Apr-17,2351,2296,55,2.3
CN4821100000000,48,211,Hemphill County, TX,May-17,2327,2269,58,2.5
CN4821100000000,48,211,Hemphill County, TX,Jun-17,2309,2245,64,2.8
CN4821100000000,48,211,Hemphill County, TX,Jul-17,2382,2319,63,2.6
CN4821100000000,48,211,Hemphill County, TX,Aug-17,2263,2203,60,2.7
CN4821100000000,48,211,Hemphill County, TX,Sep-17,2406,2352,54,2.2
CN4821100000000,48,211,Hemphill County, TX,Oct-17,2397,2352,45,1.9
CN4821100000000,48,211,Hemphill County, TX,Nov-17,2363,2314,49,2.1
CN4821100000000,48,211,Hemphill County, TX,Dec-17,2366,2324,42,1.8
CN4821100000000,48,211,Hemphill County, TX,Jan-18,2365,2312,53,2.2
CN4821100000000,48,211,Hemphill County, TX,Feb-18,2388,2335,53,2.2
CN4821100000000,48,211,Hemphill County, TX,Mar-18,2406,2348,58,2.4
CN4821100000000,48,211,Hemphill County, TX,Apr-18(p),2378,2327,51,2.1
CN3906100000000,39,061,Hamilton County, OH,Mar-17,406838,389626,17212,4.2
CN3906100000000,39,061,Hamilton County, OH,Apr-17,407561,391635,15926,3.9
CN3906100000000,39,061,Hamilton County, OH,May-17,412176,395398,16778,4.1
CN3906100000000,39,061,Hamilton County, OH,Jun-17,417652,397980,19672,4.7
CN3906100000000,39,061,Hamilton County, OH,Jul-17,419229,399488,19741,4.7
CN3906100000000,39,061,Hamilton County, OH,Aug-17,416452,396851,19601,4.7
CN3906100000000,39,061,Hamilton County, OH,Sep-17,413433,395878,17555,4.2
CN3906100000000,39,061,Hamilton County, OH,Oct-17,412811,395794,17017,4.1
CN3906100000000,39,061,Hamilton County, OH,Nov-17,410589,394018,16571,4.0
CN3906100000000,39,061,Hamilton County, OH,Dec-17,409410,393063,16347,4.0
CN3906100000000,39,061,Hamilton County, OH,Jan-18,403108,386167,16941,4.2
CN3906100000000,39,061,Hamilton County, OH,Feb-18,407731,391503,16228,4.0
CN3906100000000,39,061,Hamilton County, OH,Mar-18,411881,396636,15245,3.7
CN3906100000000,39,061,Hamilton County, OH,Apr-18(p),411470,396676,14794,3.6
CN0610100000000,06,101,Sutter County, CA,Mar-17,45258,40132,5126,11.3
CN0610100000000,06,101,Sutter County, CA,Apr-17,45435,40878,4557,10.0
CN0610100000000,06,101,Sutter County, CA,May-17,46034,42183,3851,8.4
CN0610100000000,06,101,Sutter County, CA,Jun-17,47051,43268,3783,8.0
CN0610100000000,06,101,Sutter County, CA,Jul-17,47235,43622,3613,7.6
CN0610100000000,06,101,Sutter County, CA,Aug-17,47571,44307,3264,6.9
CN0610100000000,06,101,Sutter County, CA,Sep-17,46234,43422,2812,6.1
CN0610100000000,06,101,Sutter County, CA,Oct-17,45350,42502,2848,6.3
CN0610100000000,06,101,Sutter County, CA,Nov-17,45069,41766,3303,7.3
CN0610100000000,06,101,Sutter County, CA,Dec-17,45093,41305,3788,8.4
CN0610100000000,06,101,Sutter County, CA,Jan-18,45035,40829,4206,9.3
CN0610100000000,06,101,Sutter County, CA,Feb-18,45242,40837,4405,9.7
CN0610100000000,06,101,Sutter County, CA,Mar-18,45605,41293,4312,9.5
CN0610100000000,06,101,Sutter County, CA,Apr-18(p),45199,41591,3608,8.0
CN3610100000000,36,101,Steuben County, NY,Mar-17,43182,40516,2666,6.2
CN3610100000000,36,101,Steuben County, NY,Apr-17,42927,40575,2352,5.5
CN3610100000000,36,101,Steuben County, NY,May-17,42824,40505,2319,5.4
CN3610100000000,36,101,Steuben County, NY,Jun-17,43724,41389,2335,5.3
CN3610100000000,36,101,Steuben County, NY,Jul-17,43041,40735,2306,5.4
CN3610100000000,36,101,Steuben County, NY,Aug-17,43094,40824,2270,5.3
CN3610100000000,36,101,Steuben County, NY,Sep-17,43145,40823,2322,5.4
CN3610100000000,36,101,Steuben County, NY,Oct-17,42966,40676,2290,5.3
CN3610100000000,36,101,Steuben County, NY,Nov-17,43233,40759,2474,5.7
CN3610100000000,36,101,Steuben County, NY,Dec-17,42624,39965,2659,6.2
CN3610100000000,36,101,Steuben County, NY,Jan-18,43509,40330,3179,7.3
CN3610100000000,36,101,Steuben County, NY,Feb-18,42752,39596,3156,7.4
CN3610100000000,36,101,Steuben County, NY,Mar-18,42119,39262,2857,6.8
CN3610100000000,36,101,Steuben County, NY,Apr-18(p),42071,39629,2442,5.8
CN0811100000000,08,111,San Juan County, CO,Mar-17,475,462,13,2.7
CN0811100000000,08,111,San Juan County, CO,Apr-17,471,456,15,3.2
CN0811100000000,08,111,San Juan County, CO,May-17,503,491,12,2.4
CN0811100000000,08,111,San Juan County, CO,Jun-17,638,625,13,2.0
CN0811100000000,08,111,San Juan County, CO,Jul-17,674,664,10,1.5
CN0811100000000,08,111,San Juan County, CO,Aug-17,651,643,8,1.2
CN0811100000000,08,111,San Juan County, CO,Sep-17,619,611,8,1.3
CN0811100000000,08,111,San Juan County, CO,Oct-17,545,536,9,1.7
CN0811100000000,08,111,San Juan County, CO,Nov-17,425,415,10,2.4
CN0811100000000,08,111,San Juan County, CO,Dec-17,497,483,14,2.8
CN0811100000000,08,111,San Juan County, CO,Jan-18,502,488,14,2.8
CN0811100000000,08,111,San Juan County, CO,Feb-18,531,511,20,3.8
CN0811100000000,08,111,San Juan County, CO,Mar-18,511,491,20,3.9
CN0811100000000,08,111,San Juan County, CO,Apr-18(p),505,487,18,3.6
CN1329900000000,13,299,Ware County, GA,Mar-17,16029,15318,711,4.4
CN1329900000000,13,299,Ware County, GA,Apr-17,15873,15214,659,4.2
CN1329900000000,13,299,Ware County, GA,May-17,15826,15145,681,4.3
CN1329900000000,13,299,Ware County, GA,Jun-17,16034,15249,785,4.9
CN1329900000000,13,299,Ware County, GA,Jul-17,16025,15234,791,4.9
CN1329900000000,13,299,Ware County, GA,Aug-17,15906,15136,770,4.8
CN1329900000000,13,299,Ware County, GA,Sep-17,16022,15296,726,4.5
CN1329900000000,13,299,Ware County, GA,Oct-17,16028,15326,702,4.4
CN1329900000000,13,299,Ware County, GA,Nov-17,15963,15290,673,4.2
CN1329900000000,13,299,Ware County, GA,Dec-17,16062,15373,689,4.3
CN1329900000000,13,299,Ware County, GA,Jan-18,16266,15563,703,4.3
CN1329900000000,13,299,Ware County, GA,Feb-18,16031,15328,703,4.4
CN1329900000000,13,299,Ware County, GA,Mar-18,16055,15404,651,4.1
CN1329900000000,13,299,Ware County, GA,Apr-18(p),15979,15407,572,3.6
CN3705100000000,37,051,Cumberland County, NC,Mar-17,128378,121186,7192,5.6
CN3705100000000,37,051,Cumberland County, NC,Apr-17,127925,121306,6619,5.2
CN3705100000000,37,051,Cumberland County, NC,May-17,127841,120956,6885,5.4
CN3705100000000,37,051,Cumberland County, NC,Jun-17,127827,120493,7334,5.7
CN3705100000000,37,051,Cumberland County, NC,Jul-17,126464,118722,7742,6.1
CN3705100000000,37,051,Cumberland County, NC,Aug-17,126240,118530,7710,6.1
CN3705100000000,37,051,Cumberland County, NC,Sep-17,128053,121087,6966,5.4
CN3705100000000,37,051,Cumberland County, NC,Oct-17,127423,120450,6973,5.5
CN3705100000000,37,051,Cumberland County, NC,Nov-17,127949,120595,7354,5.7
CN3705100000000,37,051,Cumberland County, NC,Dec-17,127558,120483,7075,5.5
CN3705100000000,37,051,Cumberland County, NC,Jan-18,127991,120401,7590,5.9
CN3705100000000,37,051,Cumberland County, NC,Feb-18,128427,120969,7458,5.8
CN3705100000000,37,051,Cumberland County, NC,Mar-18,128885,121882,7003,5.4
CN3705100000000,37,051,Cumberland County, NC,Apr-18(p),128434,122320,6114,4.8
CN0509100000000,05,091,Miller County, AR,Mar-17,19880,19063,817,4.1
CN0509100000000,05,091,Miller County, AR,Apr-17,19853,19103,750,3.8
CN0509100000000,05,091,Miller County, AR,May-17,19898,19060,838,4.2
CN0509100000000,05,091,Miller County, AR,Jun-17,20280,19311,969,4.8
CN0509100000000,05,091,Miller County, AR,Jul-17,20188,19209,979,4.8
CN0509100000000,05,091,Miller County, AR,Aug-17,19808,18882,926,4.7
CN0509100000000,05,091,Miller County, AR,Sep-17,19810,18962,848,4.3
CN0509100000000,05,091,Miller County, AR,Oct-17,19725,18955,770,3.9
CN0509100000000,05,091,Miller County, AR,Nov-17,19798,19043,755,3.8
CN0509100000000,05,091,Miller County, AR,Dec-17,19672,18888,784,4.0
CN0509100000000,05,091,Miller County, AR,Jan-18,19520,18539,981,5.0
CN0509100000000,05,091,Miller County, AR,Feb-18,19740,18748,992,5.0
CN0509100000000,05,091,Miller County, AR,Mar-18,19874,18921,953,4.8
CN0509100000000,05,091,Miller County, AR,Apr-18(p),19774,18966,808,4.1
CN4838700000000,48,387,Red River County, TX,Mar-17,5261,4978,283,5.4
CN4838700000000,48,387,Red River County, TX,Apr-17,5252,4997,255,4.9
CN4838700000000,48,387,Red River County, TX,May-17,5207,4954,253,4.9
CN4838700000000,48,387,Red River County, TX,Jun-17,5307,5026,281,5.3
CN4838700000000,48,387,Red River County, TX,Jul-17,5205,4921,284,5.5
CN4838700000000,48,387,Red River County, TX,Aug-17,5136,4852,284,5.5
CN4838700000000,48,387,Red River County, TX,Sep-17,5180,4934,246,4.7
CN4838700000000,48,387,Red River County, TX,Oct-17,5171,4936,235,4.5
CN4838700000000,48,387,Red River County, TX,Nov-17,5168,4932,236,4.6
CN4838700000000,48,387,Red River County, TX,Dec-17,5233,4988,245,4.7
CN4838700000000,48,387,Red River County, TX,Jan-18,5296,5018,278,5.2
CN4838700000000,48,387,Red River County, TX,Feb-18,5358,5070,288,5.4
CN4838700000000,48,387,Red River County, TX,Mar-18,5373,5098,275,5.1
CN4838700000000,48,387,Red River County, TX,Apr-18(p),5305,5039,266,5.0
CN5509900000000,55,099,Price County, WI,Mar-17,6742,6445,297,4.4
CN5509900000000,55,099,Price County, WI,Apr-17,6773,6508,265,3.9
CN5509900000000,55,099,Price County, WI,May-17,6758,6535,223,3.3
CN5509900000000,55,099,Price County, WI,Jun-17,7075,6791,284,4.0
CN5509900000000,55,099,Price County, WI,Jul-17,6901,6650,251,3.6
CN5509900000000,55,099,Price County, WI,Aug-17,6789,6543,246,3.6
CN5509900000000,55,099,Price County, WI,Sep-17,6734,6512,222,3.3
CN5509900000000,55,099,Price County, WI,Oct-17,6914,6714,200,2.9
CN5509900000000,55,099,Price County, WI,Nov-17,6904,6685,219,3.2
CN5509900000000,55,099,Price County, WI,Dec-17,6827,6588,239,3.5
CN5509900000000,55,099,Price County, WI,Jan-18,6775,6533,242,3.6
CN5509900000000,55,099,Price County, WI,Feb-18,6718,6438,280,4.2
CN5509900000000,55,099,Price County, WI,Mar-18,6767,6489,278,4.1
CN5509900000000,55,099,Price County, WI,Apr-18(p),6806,6542,264,3.9
CN2200500000000,22,005,Ascension Parish, LA,Mar-17,62223,59504,2719,4.4
CN2200500000000,22,005,Ascension Parish, LA,Apr-17,62138,59502,2636,4.2
CN2200500000000,22,005,Ascension Parish, LA,May-17,61702,59054,2648,4.3
CN2200500000000,22,005,Ascension Parish, LA,Jun-17,62197,59158,3039,4.9
CN2200500000000,22,005,Ascension Parish, LA,Jul-17,62495,59579,2916,4.7
CN2200500000000,22,005,Ascension Parish, LA,Aug-17,62466,59560,2906,4.7
CN2200500000000,22,005,Ascension Parish, LA,Sep-17,62825,60201,2624,4.2
CN2200500000000,22,005,Ascension Parish, LA,Oct-17,62599,60343,2256,3.6
CN2200500000000,22,005,Ascension Parish, LA,Nov-17,62886,60649,2237,3.6
CN2200500000000,22,005,Ascension Parish, LA,Dec-17,62261,60146,2115,3.4
CN2200500000000,22,005,Ascension Parish, LA,Jan-18,62259,59889,2370,3.8
CN2200500000000,22,005,Ascension Parish, LA,Feb-18,63098,60914,2184,3.5
CN2200500000000,22,005,Ascension Parish, LA,Mar-18,63379,61042,2337,3.7
CN2200500000000,22,005,Ascension Parish, LA,Apr-18(p),63599,61256,2343,3.7
CN1301700000000,13,017,Ben Hill County, GA,Mar-17,5552,5110,442,8.0
CN1301700000000,13,017,Ben Hill County, GA,Apr-17,5551,5130,421,7.6
CN1301700000000,13,017,Ben Hill County, GA,May-17,5494,5086,408,7.4
CN1301700000000,13,017,Ben Hill County, GA,Jun-17,5544,5115,429,7.7
CN1301700000000,13,017,Ben Hill County, GA,Jul-17,5571,5083,488,8.8
CN1301700000000,13,017,Ben Hill County, GA,Aug-17,5454,5034,420,7.7
CN1301700000000,13,017,Ben Hill County, GA,Sep-17,5485,5105,380,6.9
CN1301700000000,13,017,Ben Hill County, GA,Oct-17,5442,5063,379,7.0
CN1301700000000,13,017,Ben Hill County, GA,Nov-17,5414,5036,378,7.0
CN1301700000000,13,017,Ben Hill County, GA,Dec-17,5434,5053,381,7.0
CN1301700000000,13,017,Ben Hill County, GA,Jan-18,5478,5059,419,7.6
CN1301700000000,13,017,Ben Hill County, GA,Feb-18,5397,5020,377,7.0
CN1301700000000,13,017,Ben Hill County, GA,Mar-18,5406,5054,352,6.5
CN1301700000000,13,017,Ben Hill County, GA,Apr-18(p),5393,5081,312,5.8
CN1810500000000,18,105,Monroe County, IN,Mar-17,68998,66350,2648,3.8
CN1810500000000,18,105,Monroe County, IN,Apr-17,68705,66715,1990,2.9
CN1810500000000,18,105,Monroe County, IN,May-17,66585,64380,2205,3.3
CN1810500000000,18,105,Monroe County, IN,Jun-17,66651,64063,2588,3.9
CN1810500000000,18,105,Monroe County, IN,Jul-17,65405,62749,2656,4.1
CN1810500000000,18,105,Monroe County, IN,Aug-17,66157,63222,2935,4.4
CN1810500000000,18,105,Monroe County, IN,Sep-17,68159,65954,2205,3.2
CN1810500000000,18,105,Monroe County, IN,Oct-17,68378,66235,2143,3.1
CN1810500000000,18,105,Monroe County, IN,Nov-17,68029,65667,2362,3.5
CN1810500000000,18,105,Monroe County, IN,Dec-17,66542,64562,1980,3.0
CN1810500000000,18,105,Monroe County, IN,Jan-18,65638,63239,2399,3.7
CN1810500000000,18,105,Monroe County, IN,Feb-18,68082,65456,2626,3.9
CN1810500000000,18,105,Monroe County, IN,Mar-18,67711,65413,2298,3.4
CN1810500000000,18,105,Monroe County, IN,Apr-18(p),68562,66494,2068,3.0
CN3504100000000,35,041,Roosevelt County, NM,Mar-17,8015,7615,400,5.0
CN3504100000000,35,041,Roosevelt County, NM,Apr-17,8059,7699,360,4.5
CN3504100000000,35,041,Roosevelt County, NM,May-17,8032,7638,394,4.9
CN3504100000000,35,041,Roosevelt County, NM,Jun-17,7728,7223,505,6.5
CN3504100000000,35,041,Roosevelt County, NM,Jul-17,7839,7320,519,6.6
CN3504100000000,35,041,Roosevelt County, NM,Aug-17,7759,7303,456,5.9
CN3504100000000,35,041,Roosevelt County, NM,Sep-17,7951,7521,430,5.4
CN3504100000000,35,041,Roosevelt County, NM,Oct-17,8023,7627,396,4.9
CN3504100000000,35,041,Roosevelt County, NM,Nov-17,8071,7684,387,4.8
CN3504100000000,35,041,Roosevelt County, NM,Dec-17,7869,7510,359,4.6
CN3504100000000,35,041,Roosevelt County, NM,Jan-18,7850,7482,368,4.7
CN3504100000000,35,041,Roosevelt County, NM,Feb-18,8132,7784,348,4.3
CN3504100000000,35,041,Roosevelt County, NM,Mar-18,8045,7724,321,4.0
CN3504100000000,35,041,Roosevelt County, NM,Apr-18(p),8046,7771,275,3.4
CN4849300000000,48,493,Wilson County, TX,Mar-17,24121,23224,897,3.7
CN4849300000000,48,493,Wilson County, TX,Apr-17,24110,23316,794,3.3
CN4849300000000,48,493,Wilson County, TX,May-17,24078,23252,826,3.4
CN4849300000000,48,493,Wilson County, TX,Jun-17,24198,23300,898,3.7
CN4849300000000,48,493,Wilson County, TX,Jul-17,24268,23375,893,3.7
CN4849300000000,48,493,Wilson County, TX,Aug-17,24178,23302,876,3.6
CN4849300000000,48,493,Wilson County, TX,Sep-17,24359,23594,765,3.1
CN4849300000000,48,493,Wilson County, TX,Oct-17,24172,23475,697,2.9
CN4849300000000,48,493,Wilson County, TX,Nov-17,24199,23471,728,3.0
CN4849300000000,48,493,Wilson County, TX,Dec-17,24246,23546,700,2.9
CN4849300000000,48,493,Wilson County, TX,Jan-18,24208,23424,784,3.2
CN4849300000000,48,493,Wilson County, TX,Feb-18,24563,23784,779,3.2
CN4849300000000,48,493,Wilson County, TX,Mar-18,24596,23813,783,3.2
CN4849300000000,48,493,Wilson County, TX,Apr-18(p),24575,23868,707,2.9
CN4810500000000,48,105,Crockett County, TX,Mar-17,1696,1616,80,4.7
CN4810500000000,48,105,Crockett County, TX,Apr-17,1713,1646,67,3.9
CN4810500000000,48,105,Crockett County, TX,May-17,1702,1633,69,4.1
CN4810500000000,48,105,Crockett County, TX,Jun-17,1726,1655,71,4.1
CN4810500000000,48,105,Crockett County, TX,Jul-17,1716,1649,67,3.9
CN4810500000000,48,105,Crockett County, TX,Aug-17,1717,1651,66,3.8
CN4810500000000,48,105,Crockett County, TX,Sep-17,1706,1643,63,3.7
CN4810500000000,48,105,Crockett County, TX,Oct-17,1638,1583,55,3.4
CN4810500000000,48,105,Crockett County, TX,Nov-17,1635,1581,54,3.3
CN4810500000000,48,105,Crockett County, TX,Dec-17,1656,1604,52,3.1
CN4810500000000,48,105,Crockett County, TX,Jan-18,1673,1615,58,3.5
CN4810500000000,48,105,Crockett County, TX,Feb-18,1699,1643,56,3.3
CN4810500000000,48,105,Crockett County, TX,Mar-18,1710,1654,56,3.3
CN4810500000000,48,105,Crockett County, TX,Apr-18(p),1676,1625,51,3.0
CN4807700000000,48,077,Clay County, TX,Mar-17,4876,4686,190,3.9
CN4807700000000,48,077,Clay County, TX,Apr-17,4862,4697,165,3.4
CN4807700000000,48,077,Clay County, TX,May-17,4854,4686,168,3.5
CN4807700000000,48,077,Clay County, TX,Jun-17,4831,4656,175,3.6
CN4807700000000,48,077,Clay County, TX,Jul-17,4778,4601,177,3.7
CN4807700000000,48,077,Clay County, TX,Aug-17,4772,4593,179,3.8
CN4807700000000,48,077,Clay County, TX,Sep-17,4748,4598,150,3.2
CN4807700000000,48,077,Clay County, TX,Oct-17,4770,4631,139,2.9
CN4807700000000,48,077,Clay County, TX,Nov-17,4758,4602,156,3.3
CN4807700000000,48,077,Clay County, TX,Dec-17,4758,4612,146,3.1
CN4807700000000,48,077,Clay County, TX,Jan-18,4755,4585,170,3.6
CN4807700000000,48,077,Clay County, TX,Feb-18,4829,4660,169,3.5
CN4807700000000,48,077,Clay County, TX,Mar-18,4892,4713,179,3.7
CN4807700000000,48,077,Clay County, TX,Apr-18(p),4842,4694,148,3.1
CN4828900000000,48,289,Leon County, TX,Mar-17,6387,5968,419,6.6
CN4828900000000,48,289,Leon County, TX,Apr-17,6232,5842,390,6.3
CN4828900000000,48,289,Leon County, TX,May-17,6127,5750,377,6.2
CN4828900000000,48,289,Leon County, TX,Jun-17,6172,5770,402,6.5
CN4828900000000,48,289,Leon County, TX,Jul-17,6001,5608,393,6.5
CN4828900000000,48,289,Leon County, TX,Aug-17,6083,5675,408,6.7
CN4828900000000,48,289,Leon County, TX,Sep-17,6090,5742,348,5.7
CN4828900000000,48,289,Leon County, TX,Oct-17,6072,5747,325,5.4
CN4828900000000,48,289,Leon County, TX,Nov-17,5986,5656,330,5.5
CN4828900000000,48,289,Leon County, TX,Dec-17,6009,5677,332,5.5
CN4828900000000,48,289,Leon County, TX,Jan-18,6029,5672,357,5.9
CN4828900000000,48,289,Leon County, TX,Feb-18,6074,5714,360,5.9
CN4828900000000,48,289,Leon County, TX,Mar-18,6144,5778,366,6.0
CN4828900000000,48,289,Leon County, TX,Apr-18(p),6106,5777,329,5.4
CN3911700000000,39,117,Morrow County, OH,Mar-17,17014,16127,887,5.2
CN3911700000000,39,117,Morrow County, OH,Apr-17,16951,16187,764,4.5
CN3911700000000,39,117,Morrow County, OH,May-17,16977,16252,725,4.3
CN3911700000000,39,117,Morrow County, OH,Jun-17,17156,16320,836,4.9
CN3911700000000,39,117,Morrow County, OH,Jul-17,17233,16395,838,4.9
CN3911700000000,39,117,Morrow County, OH,Aug-17,17241,16435,806,4.7
CN3911700000000,39,117,Morrow County, OH,Sep-17,17065,16309,756,4.4
CN3911700000000,39,117,Morrow County, OH,Oct-17,17019,16294,725,4.3
CN3911700000000,39,117,Morrow County, OH,Nov-17,17040,16301,739,4.3
CN3911700000000,39,117,Morrow County, OH,Dec-17,17059,16262,797,4.7
CN3911700000000,39,117,Morrow County, OH,Jan-18,16847,15947,900,5.3
CN3911700000000,39,117,Morrow County, OH,Feb-18,17054,16226,828,4.9
CN3911700000000,39,117,Morrow County, OH,Mar-18,17225,16484,741,4.3
CN3911700000000,39,117,Morrow County, OH,Apr-18(p),17100,16433,667,3.9
CN2801900000000,28,019,Choctaw County, MS,Mar-17,3669,3497,172,4.7
CN2801900000000,28,019,Choctaw County, MS,Apr-17,3672,3526,146,4.0
CN2801900000000,28,019,Choctaw County, MS,May-17,3717,3534,183,4.9
CN2801900000000,28,019,Choctaw County, MS,Jun-17,3667,3457,210,5.7
CN2801900000000,28,019,Choctaw County, MS,Jul-17,3783,3583,200,5.3
CN2801900000000,28,019,Choctaw County, MS,Aug-17,3698,3520,178,4.8
CN2801900000000,28,019,Choctaw County, MS,Sep-17,3767,3594,173,4.6
CN2801900000000,28,019,Choctaw County, MS,Oct-17,3673,3513,160,4.4
CN2801900000000,28,019,Choctaw County, MS,Nov-17,3642,3482,160,4.4
CN2801900000000,28,019,Choctaw County, MS,Dec-17,3663,3483,180,4.9
CN2801900000000,28,019,Choctaw County, MS,Jan-18,3483,3278,205,5.9
CN2801900000000,28,019,Choctaw County, MS,Feb-18,3586,3407,179,5.0
CN2801900000000,28,019,Choctaw County, MS,Mar-18,3639,3468,171,4.7
CN2801900000000,28,019,Choctaw County, MS,Apr-18(p),3710,3551,159,4.3
CN5100100000000,51,001,Accomack County, VA,Mar-17,15290,14463,827,5.4
CN5100100000000,51,001,Accomack County, VA,Apr-17,16086,15375,711,4.4
CN5100100000000,51,001,Accomack County, VA,May-17,16212,15502,710,4.4
CN5100100000000,51,001,Accomack County, VA,Jun-17,16711,15998,713,4.3
CN5100100000000,51,001,Accomack County, VA,Jul-17,16875,16136,739,4.4
CN5100100000000,51,001,Accomack County, VA,Aug-17,16372,15628,744,4.5
CN5100100000000,51,001,Accomack County, VA,Sep-17,16121,15439,682,4.2
CN5100100000000,51,001,Accomack County, VA,Oct-17,15977,15312,665,4.2
CN5100100000000,51,001,Accomack County, VA,Nov-17,15701,15027,674,4.3
CN5100100000000,51,001,Accomack County, VA,Dec-17,15767,14982,785,5.0
CN5100100000000,51,001,Accomack County, VA,Jan-18,15357,14489,868,5.7
CN5100100000000,51,001,Accomack County, VA,Feb-18,15386,14552,834,5.4
CN5100100000000,51,001,Accomack County, VA,Mar-18,15434,14644,790,5.1
CN5100100000000,51,001,Accomack County, VA,Apr-18(p),15844,15230,614,3.9
CN1913700000000,19,137,Montgomery County, IA,Mar-17,4952,4793,159,3.2
CN1913700000000,19,137,Montgomery County, IA,Apr-17,4994,4840,154,3.1
CN1913700000000,19,137,Montgomery County, IA,May-17,5029,4880,149,3.0
CN1913700000000,19,137,Montgomery County, IA,Jun-17,5086,4917,169,3.3
CN1913700000000,19,137,Montgomery County, IA,Jul-17,5094,4935,159,3.1
CN1913700000000,19,137,Montgomery County, IA,Aug-17,5041,4868,173,3.4
CN1913700000000,19,137,Montgomery County, IA,Sep-17,4929,4792,137,2.8
CN1913700000000,19,137,Montgomery County, IA,Oct-17,4918,4796,122,2.5
CN1913700000000,19,137,Montgomery County, IA,Nov-17,4894,4773,121,2.5
CN1913700000000,19,137,Montgomery County, IA,Dec-17,4923,4785,138,2.8
CN1913700000000,19,137,Montgomery County, IA,Jan-18,4868,4720,148,3.0
CN1913700000000,19,137,Montgomery County, IA,Feb-18,4899,4747,152,3.1
CN1913700000000,19,137,Montgomery County, IA,Mar-18,4835,4706,129,2.7
CN1913700000000,19,137,Montgomery County, IA,Apr-18(p),4844,4729,115,2.4
CN2812500000000,28,125,Sharkey County, MS,Mar-17,1743,1601,142,8.1
CN2812500000000,28,125,Sharkey County, MS,Apr-17,1736,1622,114,6.6
CN2812500000000,28,125,Sharkey County, MS,May-17,1725,1608,117,6.8
CN2812500000000,28,125,Sharkey County, MS,Jun-17,1750,1605,145,8.3
CN2812500000000,28,125,Sharkey County, MS,Jul-17,1763,1618,145,8.2
CN2812500000000,28,125,Sharkey County, MS,Aug-17,1706,1591,115,6.7
CN2812500000000,28,125,Sharkey County, MS,Sep-17,1711,1603,108,6.3
CN2812500000000,28,125,Sharkey County, MS,Oct-17,1683,1576,107,6.4
CN2812500000000,28,125,Sharkey County, MS,Nov-17,1647,1535,112,6.8
CN2812500000000,28,125,Sharkey County, MS,Dec-17,1633,1513,120,7.3
CN2812500000000,28,125,Sharkey County, MS,Jan-18,1597,1456,141,8.8
CN2812500000000,28,125,Sharkey County, MS,Feb-18,1644,1512,132,8.0
CN2812500000000,28,125,Sharkey County, MS,Mar-18,1701,1578,123,7.2
CN2812500000000,28,125,Sharkey County, MS,Apr-18(p),1697,1598,99,5.8
CN0604500000000,06,045,Mendocino County, CA,Mar-17,40014,37898,2116,5.3
CN0604500000000,06,045,Mendocino County, CA,Apr-17,39873,37968,1905,4.8
CN0604500000000,06,045,Mendocino County, CA,May-17,39985,38445,1540,3.9
CN0604500000000,06,045,Mendocino County, CA,Jun-17,40508,38805,1703,4.2
CN0604500000000,06,045,Mendocino County, CA,Jul-17,40187,38389,1798,4.5
CN0604500000000,06,045,Mendocino County, CA,Aug-17,40512,38785,1727,4.3
CN0604500000000,06,045,Mendocino County, CA,Sep-17,40390,38919,1471,3.6
CN0604500000000,06,045,Mendocino County, CA,Oct-17,40226,38724,1502,3.7
CN0604500000000,06,045,Mendocino County, CA,Nov-17,39509,37942,1567,4.0
CN0604500000000,06,045,Mendocino County, CA,Dec-17,39536,37867,1669,4.2
CN0604500000000,06,045,Mendocino County, CA,Jan-18,39679,37809,1870,4.7
CN0604500000000,06,045,Mendocino County, CA,Feb-18,40005,38169,1836,4.6
CN0604500000000,06,045,Mendocino County, CA,Mar-18,39967,38222,1745,4.4
CN0604500000000,06,045,Mendocino County, CA,Apr-18(p),39641,38135,1506,3.8
CN2904100000000,29,041,Chariton County, MO,Mar-17,3847,3701,146,3.8
CN2904100000000,29,041,Chariton County, MO,Apr-17,3932,3808,124,3.2
CN2904100000000,29,041,Chariton County, MO,May-17,3845,3726,119,3.1
CN2904100000000,29,041,Chariton County, MO,Jun-17,3881,3738,143,3.7
CN2904100000000,29,041,Chariton County, MO,Jul-17,3644,3491,153,4.2
CN2904100000000,29,041,Chariton County, MO,Aug-17,3568,3425,143,4.0
CN2904100000000,29,041,Chariton County, MO,Sep-17,3693,3586,107,2.9
CN2904100000000,29,041,Chariton County, MO,Oct-17,3793,3711,82,2.2
CN2904100000000,29,041,Chariton County, MO,Nov-17,3795,3682,113,3.0
CN2904100000000,29,041,Chariton County, MO,Dec-17,3743,3622,121,3.2
CN2904100000000,29,041,Chariton County, MO,Jan-18,3744,3605,139,3.7
CN2904100000000,29,041,Chariton County, MO,Feb-18,3771,3630,141,3.7
CN2904100000000,29,041,Chariton County, MO,Mar-18,3771,3641,130,3.4
CN2904100000000,29,041,Chariton County, MO,Apr-18(p),3819,3718,101,2.6
CN0504900000000,05,049,Fulton County, AR,Mar-17,4739,4555,184,3.9
CN0504900000000,05,049,Fulton County, AR,Apr-17,4761,4584,177,3.7
CN0504900000000,05,049,Fulton County, AR,May-17,4828,4638,190,3.9
CN0504900000000,05,049,Fulton County, AR,Jun-17,4969,4767,202,4.1
CN0504900000000,05,049,Fulton County, AR,Jul-17,4691,4466,225,4.8
CN0504900000000,05,049,Fulton County, AR,Aug-17,4614,4411,203,4.4
CN0504900000000,05,049,Fulton County, AR,Sep-17,4808,4627,181,3.8
CN0504900000000,05,049,Fulton County, AR,Oct-17,4648,4487,161,3.5
CN0504900000000,05,049,Fulton County, AR,Nov-17,4689,4517,172,3.7
CN0504900000000,05,049,Fulton County, AR,Dec-17,4678,4474,204,4.4
CN0504900000000,05,049,Fulton County, AR,Jan-18,4634,4386,248,5.4
CN0504900000000,05,049,Fulton County, AR,Feb-18,4726,4494,232,4.9
CN0504900000000,05,049,Fulton County, AR,Mar-18,4747,4548,199,4.2
CN0504900000000,05,049,Fulton County, AR,Apr-18(p),4761,4594,167,3.5
CN2105100000000,21,051,Clay County, KY,Mar-17,5782,5231,551,9.5
CN2105100000000,21,051,Clay County, KY,Apr-17,5663,5182,481,8.5
CN2105100000000,21,051,Clay County, KY,May-17,5665,5145,520,9.2
CN2105100000000,21,051,Clay County, KY,Jun-17,5721,5171,550,9.6
CN2105100000000,21,051,Clay County, KY,Jul-17,5733,5208,525,9.2
CN2105100000000,21,051,Clay County, KY,Aug-17,5663,5199,464,8.2
CN2105100000000,21,051,Clay County, KY,Sep-17,5606,5185,421,7.5
CN2105100000000,21,051,Clay County, KY,Oct-17,5493,5129,364,6.6
CN2105100000000,21,051,Clay County, KY,Nov-17,5460,5103,357,6.5
CN2105100000000,21,051,Clay County, KY,Dec-17,5436,5105,331,6.1
CN2105100000000,21,051,Clay County, KY,Jan-18,5517,5144,373,6.8
CN2105100000000,21,051,Clay County, KY,Feb-18,5571,5163,408,7.3
CN2105100000000,21,051,Clay County, KY,Mar-18,5622,5236,386,6.9
CN2105100000000,21,051,Clay County, KY,Apr-18(p),5526,5196,330,6.0
CN1206300000000,12,063,Jackson County, FL,Mar-17,17349,16584,765,4.4
CN1206300000000,12,063,Jackson County, FL,Apr-17,17271,16531,740,4.3
CN1206300000000,12,063,Jackson County, FL,May-17,17427,16680,747,4.3
CN1206300000000,12,063,Jackson County, FL,Jun-17,17087,16253,834,4.9
CN1206300000000,12,063,Jackson County, FL,Jul-17,16972,16135,837,4.9
CN1206300000000,12,063,Jackson County, FL,Aug-17,17092,16298,794,4.6
CN1206300000000,12,063,Jackson County, FL,Sep-17,17860,17139,721,4.0
CN1206300000000,12,063,Jackson County, FL,Oct-17,17528,16850,678,3.9
CN1206300000000,12,063,Jackson County, FL,Nov-17,17356,16654,702,4.0
CN1206300000000,12,063,Jackson County, FL,Dec-17,17253,16581,672,3.9
CN1206300000000,12,063,Jackson County, FL,Jan-18,17356,16596,760,4.4
CN1206300000000,12,063,Jackson County, FL,Feb-18,17306,16617,689,4.0
CN1206300000000,12,063,Jackson County, FL,Mar-18,17402,16710,692,4.0
CN1206300000000,12,063,Jackson County, FL,Apr-18(p),17310,16687,623,3.6
CN1811300000000,18,113,Noble County, IN,Mar-17,22970,22218,752,3.3
CN1811300000000,18,113,Noble County, IN,Apr-17,23088,22469,619,2.7
CN1811300000000,18,113,Noble County, IN,May-17,23565,22863,702,3.0
CN1811300000000,18,113,Noble County, IN,Jun-17,23691,22971,720,3.0
CN1811300000000,18,113,Noble County, IN,Jul-17,23443,22705,738,3.1
CN1811300000000,18,113,Noble County, IN,Aug-17,23199,22385,814,3.5
CN1811300000000,18,113,Noble County, IN,Sep-17,22986,22326,660,2.9
CN1811300000000,18,113,Noble County, IN,Oct-17,22802,22190,612,2.7
CN1811300000000,18,113,Noble County, IN,Nov-17,22814,22183,631,2.8
CN1811300000000,18,113,Noble County, IN,Dec-17,22583,21993,590,2.6
CN1811300000000,18,113,Noble County, IN,Jan-18,22336,21642,694,3.1
CN1811300000000,18,113,Noble County, IN,Feb-18,22716,22011,705,3.1
CN1811300000000,18,113,Noble County, IN,Mar-18,22955,22332,623,2.7
CN1811300000000,18,113,Noble County, IN,Apr-18(p),23098,22526,572,2.5
CN5105100000000,51,051,Dickenson County, VA,Mar-17,4450,4103,347,7.8
CN5105100000000,51,051,Dickenson County, VA,Apr-17,4449,4139,310,7.0
CN5105100000000,51,051,Dickenson County, VA,May-17,4482,4166,316,7.1
CN5105100000000,51,051,Dickenson County, VA,Jun-17,4505,4172,333,7.4
CN5105100000000,51,051,Dickenson County, VA,Jul-17,4401,4074,327,7.4
CN5105100000000,51,051,Dickenson County, VA,Aug-17,4345,4036,309,7.1
CN5105100000000,51,051,Dickenson County, VA,Sep-17,4371,4085,286,6.5
CN5105100000000,51,051,Dickenson County, VA,Oct-17,4353,4088,265,6.1
CN5105100000000,51,051,Dickenson County, VA,Nov-17,4308,4040,268,6.2
CN5105100000000,51,051,Dickenson County, VA,Dec-17,4320,4035,285,6.6
CN5105100000000,51,051,Dickenson County, VA,Jan-18,4285,3970,315,7.4
CN5105100000000,51,051,Dickenson County, VA,Feb-18,4265,3963,302,7.1
CN5105100000000,51,051,Dickenson County, VA,Mar-18,4258,3977,281,6.6
CN5105100000000,51,051,Dickenson County, VA,Apr-18(p),4281,4056,225,5.3
CN1608300000000,16,083,Twin Falls County, ID,Mar-17,40703,39396,1307,3.2
CN1608300000000,16,083,Twin Falls County, ID,Apr-17,41228,39973,1255,3.0
CN1608300000000,16,083,Twin Falls County, ID,May-17,41177,40098,1079,2.6
CN1608300000000,16,083,Twin Falls County, ID,Jun-17,41542,40390,1152,2.8
CN1608300000000,16,083,Twin Falls County, ID,Jul-17,41525,40368,1157,2.8
CN1608300000000,16,083,Twin Falls County, ID,Aug-17,41699,40561,1138,2.7
CN1608300000000,16,083,Twin Falls County, ID,Sep-17,41793,40773,1020,2.4
CN1608300000000,16,083,Twin Falls County, ID,Oct-17,41616,40631,985,2.4
CN1608300000000,16,083,Twin Falls County, ID,Nov-17,41926,40832,1094,2.6
CN1608300000000,16,083,Twin Falls County, ID,Dec-17,41843,40806,1037,2.5
CN1608300000000,16,083,Twin Falls County, ID,Jan-18,41353,39934,1419,3.4
CN1608300000000,16,083,Twin Falls County, ID,Feb-18,41417,40217,1200,2.9
CN1608300000000,16,083,Twin Falls County, ID,Mar-18,41676,40544,1132,2.7
CN1608300000000,16,083,Twin Falls County, ID,Apr-18(p),41709,40669,1040,2.5
CN1800700000000,18,007,Benton County, IN,Mar-17,4577,4408,169,3.7
CN1800700000000,18,007,Benton County, IN,Apr-17,4495,4368,127,2.8
CN1800700000000,18,007,Benton County, IN,May-17,4600,4463,137,3.0
CN1800700000000,18,007,Benton County, IN,Jun-17,4483,4339,144,3.2
CN1800700000000,18,007,Benton County, IN,Jul-17,4436,4283,153,3.4
CN1800700000000,18,007,Benton County, IN,Aug-17,4575,4403,172,3.8
CN1800700000000,18,007,Benton County, IN,Sep-17,4469,4338,131,2.9
CN1800700000000,18,007,Benton County, IN,Oct-17,4525,4401,124,2.7
CN1800700000000,18,007,Benton County, IN,Nov-17,4616,4486,130,2.8
CN1800700000000,18,007,Benton County, IN,Dec-17,4445,4311,134,3.0
CN1800700000000,18,007,Benton County, IN,Jan-18,4399,4243,156,3.5
CN1800700000000,18,007,Benton County, IN,Feb-18,4564,4399,165,3.6
CN1800700000000,18,007,Benton County, IN,Mar-18,4601,4444,157,3.4
CN1800700000000,18,007,Benton County, IN,Apr-18(p),4568,4449,119,2.6
CN2211100000000,22,111,Union Parish, LA,Mar-17,9130,8592,538,5.9
CN2211100000000,22,111,Union Parish, LA,Apr-17,9143,8634,509,5.6
CN2211100000000,22,111,Union Parish, LA,May-17,9213,8696,517,5.6
CN2211100000000,22,111,Union Parish, LA,Jun-17,9371,8812,559,6.0
CN2211100000000,22,111,Union Parish, LA,Jul-17,9314,8771,543,5.8
CN2211100000000,22,111,Union Parish, LA,Aug-17,9127,8590,537,5.9
CN2211100000000,22,111,Union Parish, LA,Sep-17,9081,8588,493,5.4
CN2211100000000,22,111,Union Parish, LA,Oct-17,9113,8680,433,4.8
CN2211100000000,22,111,Union Parish, LA,Nov-17,9107,8688,419,4.6
CN2211100000000,22,111,Union Parish, LA,Dec-17,9068,8660,408,4.5
CN2211100000000,22,111,Union Parish, LA,Jan-18,9148,8672,476,5.2
CN2211100000000,22,111,Union Parish, LA,Feb-18,9209,8775,434,4.7
CN2211100000000,22,111,Union Parish, LA,Mar-18,9282,8834,448,4.8
CN2211100000000,22,111,Union Parish, LA,Apr-18(p),9228,8772,456,4.9
CN2502100000000,25,021,Norfolk County, MA,Mar-17,378495,365371,13124,3.5
CN2502100000000,25,021,Norfolk County, MA,Apr-17,377770,365846,11924,3.2
CN2502100000000,25,021,Norfolk County, MA,May-17,376548,363768,12780,3.4
CN2502100000000,25,021,Norfolk County, MA,Jun-17,381561,367520,14041,3.7
CN2502100000000,25,021,Norfolk County, MA,Jul-17,382033,368193,13840,3.6
CN2502100000000,25,021,Norfolk County, MA,Aug-17,379919,367352,12567,3.3
CN2502100000000,25,021,Norfolk County, MA,Sep-17,375787,363576,12211,3.2
CN2502100000000,25,021,Norfolk County, MA,Oct-17,376685,365888,10797,2.9
CN2502100000000,25,021,Norfolk County, MA,Nov-17,377430,366956,10474,2.8
CN2502100000000,25,021,Norfolk County, MA,Dec-17,376343,366164,10179,2.7
CN2502100000000,25,021,Norfolk County, MA,Jan-18,377423,364959,12464,3.3
CN2502100000000,25,021,Norfolk County, MA,Feb-18,382982,369946,13036,3.4
CN2502100000000,25,021,Norfolk County, MA,Mar-18,385624,373179,12445,3.2
CN2502100000000,25,021,Norfolk County, MA,Apr-18(p),389078,377867,11211,2.9
CN3112700000000,31,127,Nemaha County, NE,Mar-17,3610,3471,139,3.9
CN3112700000000,31,127,Nemaha County, NE,Apr-17,3597,3466,131,3.6
CN3112700000000,31,127,Nemaha County, NE,May-17,3660,3509,151,4.1
CN3112700000000,31,127,Nemaha County, NE,Jun-17,3612,3442,170,4.7
CN3112700000000,31,127,Nemaha County, NE,Jul-17,3577,3411,166,4.6
CN3112700000000,31,127,Nemaha County, NE,Aug-17,3493,3351,142,4.1
CN3112700000000,31,127,Nemaha County, NE,Sep-17,3574,3448,126,3.5
CN3112700000000,31,127,Nemaha County, NE,Oct-17,3568,3460,108,3.0
CN3112700000000,31,127,Nemaha County, NE,Nov-17,3577,3465,112,3.1
CN3112700000000,31,127,Nemaha County, NE,Dec-17,3565,3447,118,3.3
CN3112700000000,31,127,Nemaha County, NE,Jan-18,3529,3406,123,3.5
CN3112700000000,31,127,Nemaha County, NE,Feb-18,3621,3499,122,3.4
CN3112700000000,31,127,Nemaha County, NE,Mar-18,3621,3499,122,3.4
CN3112700000000,31,127,Nemaha County, NE,Apr-18(p),3602,3479,123,3.4
CN1312300000000,13,123,Gilmer County, GA,Mar-17,11988,11352,636,5.3
CN1312300000000,13,123,Gilmer County, GA,Apr-17,11977,11388,589,4.9
CN1312300000000,13,123,Gilmer County, GA,May-17,12050,11464,586,4.9
CN1312300000000,13,123,Gilmer County, GA,Jun-17,12036,11410,626,5.2
CN1312300000000,13,123,Gilmer County, GA,Jul-17,12082,11454,628,5.2
CN1312300000000,13,123,Gilmer County, GA,Aug-17,11975,11358,617,5.2
CN1312300000000,13,123,Gilmer County, GA,Sep-17,12101,11545,556,4.6
CN1312300000000,13,123,Gilmer County, GA,Oct-17,12051,11492,559,4.6
CN1312300000000,13,123,Gilmer County, GA,Nov-17,11957,11425,532,4.4
CN1312300000000,13,123,Gilmer County, GA,Dec-17,11926,11383,543,4.6
CN1312300000000,13,123,Gilmer County, GA,Jan-18,12041,11416,625,5.2
CN1312300000000,13,123,Gilmer County, GA,Feb-18,12025,11450,575,4.8
CN1312300000000,13,123,Gilmer County, GA,Mar-18,11989,11461,528,4.4
CN1312300000000,13,123,Gilmer County, GA,Apr-18(p),12024,11567,457,3.8
CN4206300000000,42,063,Indiana County, PA,Mar-17,39842,37215,2627,6.6
CN4206300000000,42,063,Indiana County, PA,Apr-17,39612,37501,2111,5.3
CN4206300000000,42,063,Indiana County, PA,May-17,39510,37325,2185,5.5
CN4206300000000,42,063,Indiana County, PA,Jun-17,38932,36423,2509,6.4
CN4206300000000,42,063,Indiana County, PA,Jul-17,39111,36552,2559,6.5
CN4206300000000,42,063,Indiana County, PA,Aug-17,38656,36150,2506,6.5
CN4206300000000,42,063,Indiana County, PA,Sep-17,39472,37576,1896,4.8
CN4206300000000,42,063,Indiana County, PA,Oct-17,39125,37316,1809,4.6
CN4206300000000,42,063,Indiana County, PA,Nov-17,38976,37120,1856,4.8
CN4206300000000,42,063,Indiana County, PA,Dec-17,38834,36906,1928,5.0
CN4206300000000,42,063,Indiana County, PA,Jan-18,38135,35574,2561,6.7
CN4206300000000,42,063,Indiana County, PA,Feb-18,39257,36781,2476,6.3
CN4206300000000,42,063,Indiana County, PA,Mar-18,38583,36420,2163,5.6
CN4206300000000,42,063,Indiana County, PA,Apr-18(p),38366,36652,1714,4.5
CN4715100000000,47,151,Scott County, TN,Mar-17,8080,7617,463,5.7
CN4715100000000,47,151,Scott County, TN,Apr-17,8084,7689,395,4.9
CN4715100000000,47,151,Scott County, TN,May-17,8073,7703,370,4.6
CN4715100000000,47,151,Scott County, TN,Jun-17,8146,7694,452,5.5
CN4715100000000,47,151,Scott County, TN,Jul-17,8230,7803,427,5.2
CN4715100000000,47,151,Scott County, TN,Aug-17,8289,7897,392,4.7
CN4715100000000,47,151,Scott County, TN,Sep-17,8332,7981,351,4.2
CN4715100000000,47,151,Scott County, TN,Oct-17,8225,7897,328,4.0
CN4715100000000,47,151,Scott County, TN,Nov-17,8194,7874,320,3.9
CN4715100000000,47,151,Scott County, TN,Dec-17,8179,7876,303,3.7
CN4715100000000,47,151,Scott County, TN,Jan-18,8237,7845,392,4.8
CN4715100000000,47,151,Scott County, TN,Feb-18,8316,7928,388,4.7
CN4715100000000,47,151,Scott County, TN,Mar-18,8302,7938,364,4.4
CN4715100000000,47,151,Scott County, TN,Apr-18(p),8358,8060,298,3.6
CN2609500000000,26,095,Luce County, MI,Mar-17,2410,2226,184,7.6
CN2609500000000,26,095,Luce County, MI,Apr-17,2374,2189,185,7.8
CN2609500000000,26,095,Luce County, MI,May-17,2393,2234,159,6.6
CN2609500000000,26,095,Luce County, MI,Jun-17,2493,2327,166,6.7
CN2609500000000,26,095,Luce County, MI,Jul-17,2549,2383,166,6.5
CN2609500000000,26,095,Luce County, MI,Aug-17,2525,2373,152,6.0
CN2609500000000,26,095,Luce County, MI,Sep-17,2456,2330,126,5.1
CN2609500000000,26,095,Luce County, MI,Oct-17,2395,2270,125,5.2
CN2609500000000,26,095,Luce County, MI,Nov-17,2350,2205,145,6.2
CN2609500000000,26,095,Luce County, MI,Dec-17,2388,2190,198,8.3
CN2609500000000,26,095,Luce County, MI,Jan-18,2429,2237,192,7.9
CN2609500000000,26,095,Luce County, MI,Feb-18,2468,2263,205,8.3
CN2609500000000,26,095,Luce County, MI,Mar-18,2447,2258,189,7.7
CN2609500000000,26,095,Luce County, MI,Apr-18(p),2401,2217,184,7.7
CN2208300000000,22,083,Richland Parish, LA,Mar-17,8307,7742,565,6.8
CN2208300000000,22,083,Richland Parish, LA,Apr-17,8296,7790,506,6.1
CN2208300000000,22,083,Richland Parish, LA,May-17,8386,7890,496,5.9
CN2208300000000,22,083,Richland Parish, LA,Jun-17,8646,8069,577,6.7
CN2208300000000,22,083,Richland Parish, LA,Jul-17,8597,8051,546,6.4
CN2208300000000,22,083,Richland Parish, LA,Aug-17,8362,7846,516,6.2
CN2208300000000,22,083,Richland Parish, LA,Sep-17,8261,7811,450,5.4
CN2208300000000,22,083,Richland Parish, LA,Oct-17,8316,7919,397,4.8
CN2208300000000,22,083,Richland Parish, LA,Nov-17,8327,7903,424,5.1
CN2208300000000,22,083,Richland Parish, LA,Dec-17,8315,7873,442,5.3
CN2208300000000,22,083,Richland Parish, LA,Jan-18,8328,7843,485,5.8
CN2208300000000,22,083,Richland Parish, LA,Feb-18,8298,7832,466,5.6
CN2208300000000,22,083,Richland Parish, LA,Mar-18,8360,7861,499,6.0
CN2208300000000,22,083,Richland Parish, LA,Apr-18(p),8308,7838,470,5.7
CN3107100000000,31,071,Garfield County, NE,Mar-17,1139,1110,29,2.5
CN3107100000000,31,071,Garfield County, NE,Apr-17,1156,1126,30,2.6
CN3107100000000,31,071,Garfield County, NE,May-17,1188,1156,32,2.7
CN3107100000000,31,071,Garfield County, NE,Jun-17,1217,1185,32,2.6
CN3107100000000,31,071,Garfield County, NE,Jul-17,1195,1162,33,2.8
CN3107100000000,31,071,Garfield County, NE,Aug-17,1172,1143,29,2.5
CN3107100000000,31,071,Garfield County, NE,Sep-17,1111,1086,25,2.3
CN3107100000000,31,071,Garfield County, NE,Oct-17,1128,1100,28,2.5
CN3107100000000,31,071,Garfield County, NE,Nov-17,1123,1101,22,2.0
CN3107100000000,31,071,Garfield County, NE,Dec-17,1118,1092,26,2.3
CN3107100000000,31,071,Garfield County, NE,Jan-18,1137,1111,26,2.3
CN3107100000000,31,071,Garfield County, NE,Feb-18,1139,1110,29,2.5
CN3107100000000,31,071,Garfield County, NE,Mar-18,1140,1107,33,2.9
CN3107100000000,31,071,Garfield County, NE,Apr-18(p),1141,1112,29,2.5
CN4716900000000,47,169,Trousdale County, TN,Mar-17,3934,3787,147,3.7
CN4716900000000,47,169,Trousdale County, TN,Apr-17,3928,3811,117,3.0
CN4716900000000,47,169,Trousdale County, TN,May-17,3925,3814,111,2.8
CN4716900000000,47,169,Trousdale County, TN,Jun-17,4002,3854,148,3.7
CN4716900000000,47,169,Trousdale County, TN,Jul-17,4028,3877,151,3.7
CN4716900000000,47,169,Trousdale County, TN,Aug-17,3988,3851,137,3.4
CN4716900000000,47,169,Trousdale County, TN,Sep-17,4016,3899,117,2.9
CN4716900000000,47,169,Trousdale County, TN,Oct-17,4002,3890,112,2.8
CN4716900000000,47,169,Trousdale County, TN,Nov-17,3991,3878,113,2.8
CN4716900000000,47,169,Trousdale County, TN,Dec-17,3991,3872,119,3.0
CN4716900000000,47,169,Trousdale County, TN,Jan-18,3991,3840,151,3.8
CN4716900000000,47,169,Trousdale County, TN,Feb-18,4047,3894,153,3.8
CN4716900000000,47,169,Trousdale County, TN,Mar-18,4031,3899,132,3.3
CN4716900000000,47,169,Trousdale County, TN,Apr-18(p),4064,3945,119,2.9
CN2113300000000,21,133,Letcher County, KY,Mar-17,6687,5976,711,10.6
CN2113300000000,21,133,Letcher County, KY,Apr-17,6601,5971,630,9.5
CN2113300000000,21,133,Letcher County, KY,May-17,6633,5985,648,9.8
CN2113300000000,21,133,Letcher County, KY,Jun-17,6660,5965,695,10.4
CN2113300000000,21,133,Letcher County, KY,Jul-17,6395,5761,634,9.9
CN2113300000000,21,133,Letcher County, KY,Aug-17,6439,5868,571,8.9
CN2113300000000,21,133,Letcher County, KY,Sep-17,6473,5961,512,7.9
CN2113300000000,21,133,Letcher County, KY,Oct-17,6517,6057,460,7.1
CN2113300000000,21,133,Letcher County, KY,Nov-17,6455,6027,428,6.6
CN2113300000000,21,133,Letcher County, KY,Dec-17,6434,6025,409,6.4
CN2113300000000,21,133,Letcher County, KY,Jan-18,6207,5809,398,6.4
CN2113300000000,21,133,Letcher County, KY,Feb-18,6244,5799,445,7.1
CN2113300000000,21,133,Letcher County, KY,Mar-18,6321,5884,437,6.9
CN2113300000000,21,133,Letcher County, KY,Apr-18(p),6279,5877,402,6.4
CN5302900000000,53,029,Island County, WA,Mar-17,33745,32021,1724,5.1
CN5302900000000,53,029,Island County, WA,Apr-17,33713,32055,1658,4.9
CN5302900000000,53,029,Island County, WA,May-17,33986,32285,1701,5.0
CN5302900000000,53,029,Island County, WA,Jun-17,34290,32596,1694,4.9
CN5302900000000,53,029,Island County, WA,Jul-17,34488,32747,1741,5.0
CN5302900000000,53,029,Island County, WA,Aug-17,34210,32463,1747,5.1
CN5302900000000,53,029,Island County, WA,Sep-17,34416,32636,1780,5.2
CN5302900000000,53,029,Island County, WA,Oct-17,34753,33034,1719,4.9
CN5302900000000,53,029,Island County, WA,Nov-17,35047,33282,1765,5.0
CN5302900000000,53,029,Island County, WA,Dec-17,35023,33111,1912,5.5
CN5302900000000,53,029,Island County, WA,Jan-18,34542,32495,2047,5.9
CN5302900000000,53,029,Island County, WA,Feb-18,34343,32235,2108,6.1
CN5302900000000,53,029,Island County, WA,Mar-18,34202,32228,1974,5.8
CN5302900000000,53,029,Island County, WA,Apr-18(p),34001,32106,1895,5.6
CN1906300000000,19,063,Emmet County, IA,Mar-17,5390,5193,197,3.7
CN1906300000000,19,063,Emmet County, IA,Apr-17,5401,5236,165,3.1
CN1906300000000,19,063,Emmet County, IA,May-17,5490,5324,166,3.0
CN1906300000000,19,063,Emmet County, IA,Jun-17,5588,5429,159,2.8
CN1906300000000,19,063,Emmet County, IA,Jul-17,5527,5376,151,2.7
CN1906300000000,19,063,Emmet County, IA,Aug-17,5468,5307,161,2.9
CN1906300000000,19,063,Emmet County, IA,Sep-17,5441,5301,140,2.6
CN1906300000000,19,063,Emmet County, IA,Oct-17,5449,5323,126,2.3
CN1906300000000,19,063,Emmet County, IA,Nov-17,5360,5224,136,2.5
CN1906300000000,19,063,Emmet County, IA,Dec-17,5404,5179,225,4.2
CN1906300000000,19,063,Emmet County, IA,Jan-18,5310,5103,207,3.9
CN1906300000000,19,063,Emmet County, IA,Feb-18,5347,5146,201,3.8
CN1906300000000,19,063,Emmet County, IA,Mar-18,5300,5127,173,3.3
CN1906300000000,19,063,Emmet County, IA,Apr-18(p),5322,5170,152,2.9
CN1327100000000,13,271,Telfair County, GA,Mar-17,4924,4588,336,6.8
CN1327100000000,13,271,Telfair County, GA,Apr-17,4879,4559,320,6.6
CN1327100000000,13,271,Telfair County, GA,May-17,4812,4492,320,6.7
CN1327100000000,13,271,Telfair County, GA,Jun-17,4710,4346,364,7.7
CN1327100000000,13,271,Telfair County, GA,Jul-17,4720,4322,398,8.4
CN1327100000000,13,271,Telfair County, GA,Aug-17,4710,4358,352,7.5
CN1327100000000,13,271,Telfair County, GA,Sep-17,4737,4374,363,7.7
CN1327100000000,13,271,Telfair County, GA,Oct-17,4902,4293,609,12.4
CN1327100000000,13,271,Telfair County, GA,Nov-17,4565,4268,297,6.5
CN1327100000000,13,271,Telfair County, GA,Dec-17,4804,4445,359,7.5
CN1327100000000,13,271,Telfair County, GA,Jan-18,5008,4701,307,6.1
CN1327100000000,13,271,Telfair County, GA,Feb-18,5044,4745,299,5.9
CN1327100000000,13,271,Telfair County, GA,Mar-18,5020,4731,289,5.8
CN1327100000000,13,271,Telfair County, GA,Apr-18(p),4923,4688,235,4.8
CN4839500000000,48,395,Robertson County, TX,Mar-17,7498,7135,363,4.8
CN4839500000000,48,395,Robertson County, TX,Apr-17,7425,7103,322,4.3
CN4839500000000,48,395,Robertson County, TX,May-17,7390,7056,334,4.5
CN4839500000000,48,395,Robertson County, TX,Jun-17,7109,6737,372,5.2
CN4839500000000,48,395,Robertson County, TX,Jul-17,7108,6744,364,5.1
CN4839500000000,48,395,Robertson County, TX,Aug-17,7068,6700,368,5.2
CN4839500000000,48,395,Robertson County, TX,Sep-17,7453,7147,306,4.1
CN4839500000000,48,395,Robertson County, TX,Oct-17,7549,7263,286,3.8
CN4839500000000,48,395,Robertson County, TX,Nov-17,7540,7230,310,4.1
CN4839500000000,48,395,Robertson County, TX,Dec-17,7483,7181,302,4.0
CN4839500000000,48,395,Robertson County, TX,Jan-18,7448,7105,343,4.6
CN4839500000000,48,395,Robertson County, TX,Feb-18,7660,7338,322,4.2
CN4839500000000,48,395,Robertson County, TX,Mar-18,7750,7429,321,4.1
CN4839500000000,48,395,Robertson County, TX,Apr-18(p),7629,7332,297,3.9
CN4009500000000,40,095,Marshall County, OK,Mar-17,6585,6278,307,4.7
CN4009500000000,40,095,Marshall County, OK,Apr-17,6581,6297,284,4.3
CN4009500000000,40,095,Marshall County, OK,May-17,6583,6270,313,4.8
CN4009500000000,40,095,Marshall County, OK,Jun-17,6693,6358,335,5.0
CN4009500000000,40,095,Marshall County, OK,Jul-17,6362,6056,306,4.8
CN4009500000000,40,095,Marshall County, OK,Aug-17,6416,6119,297,4.6
CN4009500000000,40,095,Marshall County, OK,Sep-17,6589,6299,290,4.4
CN4009500000000,40,095,Marshall County, OK,Oct-17,6553,6260,293,4.5
CN4009500000000,40,095,Marshall County, OK,Nov-17,6564,6278,286,4.4
CN4009500000000,40,095,Marshall County, OK,Dec-17,6502,6207,295,4.5
CN4009500000000,40,095,Marshall County, OK,Jan-18,6467,6157,310,4.8
CN4009500000000,40,095,Marshall County, OK,Feb-18,6529,6242,287,4.4
CN4009500000000,40,095,Marshall County, OK,Mar-18,6564,6278,286,4.4
CN4009500000000,40,095,Marshall County, OK,Apr-18(p),6515,6248,267,4.1
CN5410500000000,54,105,Wirt County, WV,Mar-17,2218,2007,211,9.5
CN5410500000000,54,105,Wirt County, WV,Apr-17,2200,2029,171,7.8
CN5410500000000,54,105,Wirt County, WV,May-17,2174,2028,146,6.7
CN5410500000000,54,105,Wirt County, WV,Jun-17,2201,2046,155,7.0
CN5410500000000,54,105,Wirt County, WV,Jul-17,2193,2041,152,6.9
CN5410500000000,54,105,Wirt County, WV,Aug-17,2186,2029,157,7.2
CN5410500000000,54,105,Wirt County, WV,Sep-17,2181,2048,133,6.1
CN5410500000000,54,105,Wirt County, WV,Oct-17,2181,2037,144,6.6
CN5410500000000,54,105,Wirt County, WV,Nov-17,2165,2013,152,7.0
CN5410500000000,54,105,Wirt County, WV,Dec-17,2165,1987,178,8.2
CN5410500000000,54,105,Wirt County, WV,Jan-18,2209,1997,212,9.6
CN5410500000000,54,105,Wirt County, WV,Feb-18,2216,2006,210,9.5
CN5410500000000,54,105,Wirt County, WV,Mar-18,2171,1999,172,7.9
CN5410500000000,54,105,Wirt County, WV,Apr-18(p),2172,2019,153,7.0
CN5181000000000,51,810,Virginia Beach city, VA,Mar-17,232358,223832,8526,3.7
CN5181000000000,51,810,Virginia Beach city, VA,Apr-17,233038,225298,7740,3.3
CN5181000000000,51,810,Virginia Beach city, VA,May-17,233532,225266,8266,3.5
CN5181000000000,51,810,Virginia Beach city, VA,Jun-17,235496,226822,8674,3.7
CN5181000000000,51,810,Virginia Beach city, VA,Jul-17,237387,228556,8831,3.7
CN5181000000000,51,810,Virginia Beach city, VA,Aug-17,235133,226272,8861,3.8
CN5181000000000,51,810,Virginia Beach city, VA,Sep-17,233790,225669,8121,3.5
CN5181000000000,51,810,Virginia Beach city, VA,Oct-17,231766,224018,7748,3.3
CN5181000000000,51,810,Virginia Beach city, VA,Nov-17,230289,222613,7676,3.3
CN5181000000000,51,810,Virginia Beach city, VA,Dec-17,228851,221361,7490,3.3
CN5181000000000,51,810,Virginia Beach city, VA,Jan-18,228396,220468,7928,3.5
CN5181000000000,51,810,Virginia Beach city, VA,Feb-18,231206,224039,7167,3.1
CN5181000000000,51,810,Virginia Beach city, VA,Mar-18,233103,225829,7274,3.1
CN5181000000000,51,810,Virginia Beach city, VA,Apr-18(p),233253,226963,6290,2.7
CN0806500000000,08,065,Lake County, CO,Mar-17,4902,4800,102,2.1
CN0806500000000,08,065,Lake County, CO,Apr-17,4769,4675,94,2.0
CN0806500000000,08,065,Lake County, CO,May-17,4380,4262,118,2.7
CN0806500000000,08,065,Lake County, CO,Jun-17,4645,4538,107,2.3
CN0806500000000,08,065,Lake County, CO,Jul-17,4692,4604,88,1.9
CN0806500000000,08,065,Lake County, CO,Aug-17,4688,4595,93,2.0
CN0806500000000,08,065,Lake County, CO,Sep-17,4642,4551,91,2.0
CN0806500000000,08,065,Lake County, CO,Oct-17,4644,4534,110,2.4
CN0806500000000,08,065,Lake County, CO,Nov-17,4645,4543,102,2.2
CN0806500000000,08,065,Lake County, CO,Dec-17,4980,4890,90,1.8
CN0806500000000,08,065,Lake County, CO,Jan-18,5015,4903,112,2.2
CN0806500000000,08,065,Lake County, CO,Feb-18,5124,5009,115,2.2
CN0806500000000,08,065,Lake County, CO,Mar-18,5090,4983,107,2.1
CN0806500000000,08,065,Lake County, CO,Apr-18(p),4948,4855,93,1.9
CN1705300000000,17,053,Ford County, IL,Mar-17,6570,6228,342,5.2
CN1705300000000,17,053,Ford County, IL,Apr-17,6678,6401,277,4.1
CN1705300000000,17,053,Ford County, IL,May-17,6607,6339,268,4.1
CN1705300000000,17,053,Ford County, IL,Jun-17,6481,6184,297,4.6
CN1705300000000,17,053,Ford County, IL,Jul-17,6435,6129,306,4.8
CN1705300000000,17,053,Ford County, IL,Aug-17,6289,5981,308,4.9
CN1705300000000,17,053,Ford County, IL,Sep-17,6535,6283,252,3.9
CN1705300000000,17,053,Ford County, IL,Oct-17,6519,6276,243,3.7
CN1705300000000,17,053,Ford County, IL,Nov-17,6452,6199,253,3.9
CN1705300000000,17,053,Ford County, IL,Dec-17,6333,6063,270,4.3
CN1705300000000,17,053,Ford County, IL,Jan-18,6306,6001,305,4.8
CN1705300000000,17,053,Ford County, IL,Feb-18,6424,6143,281,4.4
CN1705300000000,17,053,Ford County, IL,Mar-18,6608,6329,279,4.2
CN1705300000000,17,053,Ford County, IL,Apr-18(p),6675,6449,226,3.4
CN4818300000000,48,183,Gregg County, TX,Mar-17,57863,54560,3303,5.7
CN4818300000000,48,183,Gregg County, TX,Apr-17,57724,54722,3002,5.2
CN4818300000000,48,183,Gregg County, TX,May-17,57238,54360,2878,5.0
CN4818300000000,48,183,Gregg County, TX,Jun-17,57672,54572,3100,5.4
CN4818300000000,48,183,Gregg County, TX,Jul-17,57798,54790,3008,5.2
CN4818300000000,48,183,Gregg County, TX,Aug-17,57508,54559,2949,5.1
CN4818300000000,48,183,Gregg County, TX,Sep-17,57742,55153,2589,4.5
CN4818300000000,48,183,Gregg County, TX,Oct-17,57358,54919,2439,4.3
CN4818300000000,48,183,Gregg County, TX,Nov-17,57599,55149,2450,4.3
CN4818300000000,48,183,Gregg County, TX,Dec-17,57398,55060,2338,4.1
CN4818300000000,48,183,Gregg County, TX,Jan-18,57560,54944,2616,4.5
CN4818300000000,48,183,Gregg County, TX,Feb-18,57908,55307,2601,4.5
CN4818300000000,48,183,Gregg County, TX,Mar-18,57789,55215,2574,4.5
CN4818300000000,48,183,Gregg County, TX,Apr-18(p),57709,55344,2365,4.1
CN5305300000000,53,053,Pierce County, WA,Mar-17,415703,392535,23168,5.6
CN5305300000000,53,053,Pierce County, WA,Apr-17,412177,390602,21575,5.2
CN5305300000000,53,053,Pierce County, WA,May-17,412965,391200,21765,5.3
CN5305300000000,53,053,Pierce County, WA,Jun-17,413562,391944,21618,5.2
CN5305300000000,53,053,Pierce County, WA,Jul-17,413383,391520,21863,5.3
CN5305300000000,53,053,Pierce County, WA,Aug-17,415182,392976,22206,5.3
CN5305300000000,53,053,Pierce County, WA,Sep-17,417422,396466,20956,5.0
CN5305300000000,53,053,Pierce County, WA,Oct-17,421179,400540,20639,4.9
CN5305300000000,53,053,Pierce County, WA,Nov-17,425246,403910,21336,5.0
CN5305300000000,53,053,Pierce County, WA,Dec-17,426660,403511,23149,5.4
CN5305300000000,53,053,Pierce County, WA,Jan-18,420546,395950,24596,5.8
CN5305300000000,53,053,Pierce County, WA,Feb-18,419105,393739,25366,6.1
CN5305300000000,53,053,Pierce County, WA,Mar-18,420593,396383,24210,5.8
CN5305300000000,53,053,Pierce County, WA,Apr-18(p),418620,395820,22800,5.4
CN7205500000000,72,055,Guanica Municipio, PR,Mar-17,4195,3404,791,18.9
CN7205500000000,72,055,Guanica Municipio, PR,Apr-17,4087,3286,801,19.6
CN7205500000000,72,055,Guanica Municipio, PR,May-17,4083,3370,713,17.5
CN7205500000000,72,055,Guanica Municipio, PR,Jun-17,4011,3379,632,15.8
CN7205500000000,72,055,Guanica Municipio, PR,Jul-17,4065,3397,668,16.4
CN7205500000000,72,055,Guanica Municipio, PR,Aug-17,4118,3348,770,18.7
CN7205500000000,72,055,Guanica Municipio, PR,Sep-17(y),4018,3292,726,18.1
CN7205500000000,72,055,Guanica Municipio, PR,Oct-17,4040,3171,869,21.5
CN7205500000000,72,055,Guanica Municipio, PR,Nov-17,4107,3385,722,17.6
CN7205500000000,72,055,Guanica Municipio, PR,Dec-17,4102,3409,693,16.9
CN7205500000000,72,055,Guanica Municipio, PR,Jan-18,4085,3345,740,18.1
CN7205500000000,72,055,Guanica Municipio, PR,Feb-18,3974,3278,696,17.5
CN7205500000000,72,055,Guanica Municipio, PR,Mar-18,3999,3296,703,17.6
CN7205500000000,72,055,Guanica Municipio, PR,Apr-18(p),3960,3327,633,16.0
CN1702900000000,17,029,Coles County, IL,Mar-17,25018,23828,1190,4.8
CN1702900000000,17,029,Coles County, IL,Apr-17,24655,23701,954,3.9
CN1702900000000,17,029,Coles County, IL,May-17,23432,22461,971,4.1
CN1702900000000,17,029,Coles County, IL,Jun-17,23463,22310,1153,4.9
CN1702900000000,17,029,Coles County, IL,Jul-17,23334,22117,1217,5.2
CN1702900000000,17,029,Coles County, IL,Aug-17,23564,22425,1139,4.8
CN1702900000000,17,029,Coles County, IL,Sep-17,24848,23833,1015,4.1
CN1702900000000,17,029,Coles County, IL,Oct-17,24905,23881,1024,4.1
CN1702900000000,17,029,Coles County, IL,Nov-17,24943,23916,1027,4.1
CN1702900000000,17,029,Coles County, IL,Dec-17,24625,23646,979,4.0
CN1702900000000,17,029,Coles County, IL,Jan-18,24682,23603,1079,4.4
CN1702900000000,17,029,Coles County, IL,Feb-18,25067,24058,1009,4.0
CN1702900000000,17,029,Coles County, IL,Mar-18,25405,24346,1059,4.2
CN1702900000000,17,029,Coles County, IL,Apr-18(p),25332,24472,860,3.4
CN2601700000000,26,017,Bay County, MI,Mar-17,51024,47970,3054,6.0
CN2601700000000,26,017,Bay County, MI,Apr-17,50755,48157,2598,5.1
CN2601700000000,26,017,Bay County, MI,May-17,50691,48040,2651,5.2
CN2601700000000,26,017,Bay County, MI,Jun-17,51448,48574,2874,5.6
CN2601700000000,26,017,Bay County, MI,Jul-17,51465,48143,3322,6.5
CN2601700000000,26,017,Bay County, MI,Aug-17,51119,48052,3067,6.0
CN2601700000000,26,017,Bay County, MI,Sep-17,50832,48358,2474,4.9
CN2601700000000,26,017,Bay County, MI,Oct-17,50477,48180,2297,4.6
CN2601700000000,26,017,Bay County, MI,Nov-17,50922,48568,2354,4.6
CN2601700000000,26,017,Bay County, MI,Dec-17,50683,47906,2777,5.5
CN2601700000000,26,017,Bay County, MI,Jan-18,50824,47376,3448,6.8
CN2601700000000,26,017,Bay County, MI,Feb-18,51193,47682,3511,6.9
CN2601700000000,26,017,Bay County, MI,Mar-18,51150,48033,3117,6.1
CN2601700000000,26,017,Bay County, MI,Apr-18(p),50731,48083,2648,5.2
CN2102700000000,21,027,Breckinridge County, KY,Mar-17,8296,7728,568,6.8
CN2102700000000,21,027,Breckinridge County, KY,Apr-17,8252,7800,452,5.5
CN2102700000000,21,027,Breckinridge County, KY,May-17,8356,7894,462,5.5
CN2102700000000,21,027,Breckinridge County, KY,Jun-17,8456,7964,492,5.8
CN2102700000000,21,027,Breckinridge County, KY,Jul-17,8240,7710,530,6.4
CN2102700000000,21,027,Breckinridge County, KY,Aug-17,8136,7691,445,5.5
CN2102700000000,21,027,Breckinridge County, KY,Sep-17,8113,7684,429,5.3
CN2102700000000,21,027,Breckinridge County, KY,Oct-17,8134,7759,375,4.6
CN2102700000000,21,027,Breckinridge County, KY,Nov-17,8143,7768,375,4.6
CN2102700000000,21,027,Breckinridge County, KY,Dec-17,8128,7746,382,4.7
CN2102700000000,21,027,Breckinridge County, KY,Jan-18,8152,7700,452,5.5
CN2102700000000,21,027,Breckinridge County, KY,Feb-18,8223,7728,495,6.0
CN2102700000000,21,027,Breckinridge County, KY,Mar-18,8359,7895,464,5.6
CN2102700000000,21,027,Breckinridge County, KY,Apr-18(p),8373,7976,397,4.7
CN3001500000000,30,015,Chouteau County, MT,Mar-17,2464,2365,99,4.0
CN3001500000000,30,015,Chouteau County, MT,Apr-17,2520,2441,79,3.1
CN3001500000000,30,015,Chouteau County, MT,May-17,2564,2500,64,2.5
CN3001500000000,30,015,Chouteau County, MT,Jun-17,2571,2483,88,3.4
CN3001500000000,30,015,Chouteau County, MT,Jul-17,2551,2469,82,3.2
CN3001500000000,30,015,Chouteau County, MT,Aug-17,2554,2476,78,3.1
CN3001500000000,30,015,Chouteau County, MT,Sep-17,2457,2382,75,3.1
CN3001500000000,30,015,Chouteau County, MT,Oct-17,2503,2425,78,3.1
CN3001500000000,30,015,Chouteau County, MT,Nov-17,2501,2425,76,3.0
CN3001500000000,30,015,Chouteau County, MT,Dec-17,2443,2367,76,3.1
CN3001500000000,30,015,Chouteau County, MT,Jan-18,2456,2363,93,3.8
CN3001500000000,30,015,Chouteau County, MT,Feb-18,2458,2369,89,3.6
CN3001500000000,30,015,Chouteau County, MT,Mar-18,2420,2332,88,3.6
CN3001500000000,30,015,Chouteau County, MT,Apr-18(p),2442,2367,75,3.1
CN4846900000000,48,469,Victoria County, TX,Mar-17,43208,41011,2197,5.1
CN4846900000000,48,469,Victoria County, TX,Apr-17,43258,41232,2026,4.7
CN4846900000000,48,469,Victoria County, TX,May-17,43049,41093,1956,4.5
CN4846900000000,48,469,Victoria County, TX,Jun-17,43110,40984,2126,4.9
CN4846900000000,48,469,Victoria County, TX,Jul-17,42948,40841,2107,4.9
CN4846900000000,48,469,Victoria County, TX,Aug-17,42654,40576,2078,4.9
CN4846900000000,48,469,Victoria County, TX,Sep-17,42739,40702,2037,4.8
CN4846900000000,48,469,Victoria County, TX,Oct-17,42591,40764,1827,4.3
CN4846900000000,48,469,Victoria County, TX,Nov-17,42674,40849,1825,4.3
CN4846900000000,48,469,Victoria County, TX,Dec-17,42572,40890,1682,4.0
CN4846900000000,48,469,Victoria County, TX,Jan-18,42249,40371,1878,4.4
CN4846900000000,48,469,Victoria County, TX,Feb-18,42615,40770,1845,4.3
CN4846900000000,48,469,Victoria County, TX,Mar-18,42532,40704,1828,4.3
CN4846900000000,48,469,Victoria County, TX,Apr-18(p),42387,40722,1665,3.9
CN7209700000000,72,097,Mayaguez Municipio, PR,Mar-17,23362,20127,3235,13.8
CN7209700000000,72,097,Mayaguez Municipio, PR,Apr-17,23315,19911,3404,14.6
CN7209700000000,72,097,Mayaguez Municipio, PR,May-17,22931,19833,3098,13.5
CN7209700000000,72,097,Mayaguez Municipio, PR,Jun-17,22623,19903,2720,12.0
CN7209700000000,72,097,Mayaguez Municipio, PR,Jul-17,22245,19340,2905,13.1
CN7209700000000,72,097,Mayaguez Municipio, PR,Aug-17,22192,18913,3279,14.8
CN7209700000000,72,097,Mayaguez Municipio, PR,Sep-17(y),22013,18944,3069,13.9
CN7209700000000,72,097,Mayaguez Municipio, PR,Oct-17,21542,18430,3112,14.4
CN7209700000000,72,097,Mayaguez Municipio, PR,Nov-17,22168,19469,2699,12.2
CN7209700000000,72,097,Mayaguez Municipio, PR,Dec-17,22272,19759,2513,11.3
CN7209700000000,72,097,Mayaguez Municipio, PR,Jan-18,21774,19063,2711,12.5
CN7209700000000,72,097,Mayaguez Municipio, PR,Feb-18,21413,18978,2435,11.4
CN7209700000000,72,097,Mayaguez Municipio, PR,Mar-18,21388,19003,2385,11.2
CN7209700000000,72,097,Mayaguez Municipio, PR,Apr-18(p),21512,19132,2380,11.1
CN0205000000000,02,050,Bethel Census Area, AK,Mar-17,7400,6386,1014,13.7
CN0205000000000,02,050,Bethel Census Area, AK,Apr-17,7325,6321,1004,13.7
CN0205000000000,02,050,Bethel Census Area, AK,May-17,7314,6250,1064,14.5
CN0205000000000,02,050,Bethel Census Area, AK,Jun-17,7862,6654,1208,15.4
CN0205000000000,02,050,Bethel Census Area, AK,Jul-17,7525,6414,1111,14.8
CN0205000000000,02,050,Bethel Census Area, AK,Aug-17,7417,6335,1082,14.6
CN0205000000000,02,050,Bethel Census Area, AK,Sep-17,7369,6405,964,13.1
CN0205000000000,02,050,Bethel Census Area, AK,Oct-17,7413,6487,926,12.5
CN0205000000000,02,050,Bethel Census Area, AK,Nov-17,7576,6632,944,12.5
CN0205000000000,02,050,Bethel Census Area, AK,Dec-17,7584,6629,955,12.6
CN0205000000000,02,050,Bethel Census Area, AK,Jan-18,7445,6382,1063,14.3
CN0205000000000,02,050,Bethel Census Area, AK,Feb-18,7464,6373,1091,14.6
CN0205000000000,02,050,Bethel Census Area, AK,Mar-18,7478,6442,1036,13.9
CN0205000000000,02,050,Bethel Census Area, AK,Apr-18(p),7504,6511,993,13.2
CN3402700000000,34,027,Morris County, NJ,Mar-17,260726,251426,9300,3.6
CN3402700000000,34,027,Morris County, NJ,Apr-17,260655,252085,8570,3.3
CN3402700000000,34,027,Morris County, NJ,May-17,260652,251392,9260,3.6
CN3402700000000,34,027,Morris County, NJ,Jun-17,262806,253213,9593,3.7
CN3402700000000,34,027,Morris County, NJ,Jul-17,263581,252863,10718,4.1
CN3402700000000,34,027,Morris County, NJ,Aug-17,260527,250246,10281,3.9
CN3402700000000,34,027,Morris County, NJ,Sep-17,258561,248861,9700,3.8
CN3402700000000,34,027,Morris County, NJ,Oct-17,258390,249291,9099,3.5
CN3402700000000,34,027,Morris County, NJ,Nov-17,256923,248392,8531,3.3
CN3402700000000,34,027,Morris County, NJ,Dec-17,256302,248269,8033,3.1
CN3402700000000,34,027,Morris County, NJ,Jan-18,255741,246253,9488,3.7
CN3402700000000,34,027,Morris County, NJ,Feb-18,258807,248944,9863,3.8
CN3402700000000,34,027,Morris County, NJ,Mar-18,256471,247106,9365,3.7
CN3402700000000,34,027,Morris County, NJ,Apr-18(p),254052,246068,7984,3.1
CN3810300000000,38,103,Wells County, ND,Mar-17,2143,2050,93,4.3
CN3810300000000,38,103,Wells County, ND,Apr-17,2198,2111,87,4.0
CN3810300000000,38,103,Wells County, ND,May-17,2211,2146,65,2.9
CN3810300000000,38,103,Wells County, ND,Jun-17,2283,2210,73,3.2
CN3810300000000,38,103,Wells County, ND,Jul-17,2264,2207,57,2.5
CN3810300000000,38,103,Wells County, ND,Aug-17,2250,2194,56,2.5
CN3810300000000,38,103,Wells County, ND,Sep-17,2227,2171,56,2.5
CN3810300000000,38,103,Wells County, ND,Oct-17,2212,2164,48,2.2
CN3810300000000,38,103,Wells County, ND,Nov-17,2117,2064,53,2.5
CN3810300000000,38,103,Wells County, ND,Dec-17,2097,2036,61,2.9
CN3810300000000,38,103,Wells County, ND,Jan-18,2066,1977,89,4.3
CN3810300000000,38,103,Wells County, ND,Feb-18,2046,1951,95,4.6
CN3810300000000,38,103,Wells County, ND,Mar-18,2051,1975,76,3.7
CN3810300000000,38,103,Wells County, ND,Apr-18(p),2099,2020,79,3.8
CN4905500000000,49,055,Wayne County, UT,Mar-17,1426,1292,134,9.4
CN4905500000000,49,055,Wayne County, UT,Apr-17,1489,1386,103,6.9
CN4905500000000,49,055,Wayne County, UT,May-17,1500,1404,96,6.4
CN4905500000000,49,055,Wayne County, UT,Jun-17,1610,1515,95,5.9
CN4905500000000,49,055,Wayne County, UT,Jul-17,1614,1534,80,5.0
CN4905500000000,49,055,Wayne County, UT,Aug-17,1614,1535,79,4.9
CN4905500000000,49,055,Wayne County, UT,Sep-17,1539,1473,66,4.3
CN4905500000000,49,055,Wayne County, UT,Oct-17,1499,1436,63,4.2
CN4905500000000,49,055,Wayne County, UT,Nov-17,1390,1303,87,6.3
CN4905500000000,49,055,Wayne County, UT,Dec-17,1328,1190,138,10.4
CN4905500000000,49,055,Wayne County, UT,Jan-18,1326,1174,152,11.5
CN4905500000000,49,055,Wayne County, UT,Feb-18,1320,1189,131,9.9
CN4905500000000,49,055,Wayne County, UT,Mar-18,1414,1302,112,7.9
CN4905500000000,49,055,Wayne County, UT,Apr-18(p),1478,1403,75,5.1
CN3605500000000,36,055,Monroe County, NY,Mar-17,364105,346445,17660,4.9
CN3605500000000,36,055,Monroe County, NY,Apr-17,366047,349333,16714,4.6
CN3605500000000,36,055,Monroe County, NY,May-17,365700,348410,17290,4.7
CN3605500000000,36,055,Monroe County, NY,Jun-17,369351,351019,18332,5.0
CN3605500000000,36,055,Monroe County, NY,Jul-17,368139,348905,19234,5.2
CN3605500000000,36,055,Monroe County, NY,Aug-17,364676,345683,18993,5.2
CN3605500000000,36,055,Monroe County, NY,Sep-17,366034,347848,18186,5.0
CN3605500000000,36,055,Monroe County, NY,Oct-17,364397,346966,17431,4.8
CN3605500000000,36,055,Monroe County, NY,Nov-17,360813,342850,17963,5.0
CN3605500000000,36,055,Monroe County, NY,Dec-17,359225,341432,17793,5.0
CN3605500000000,36,055,Monroe County, NY,Jan-18,360319,340700,19619,5.4
CN3605500000000,36,055,Monroe County, NY,Feb-18,360536,340010,20526,5.7
CN3605500000000,36,055,Monroe County, NY,Mar-18,359549,340767,18782,5.2
CN3605500000000,36,055,Monroe County, NY,Apr-18(p),362316,345212,17104,4.7
CN4504300000000,45,043,Georgetown County, SC,Mar-17,24387,23060,1327,5.4
CN4504300000000,45,043,Georgetown County, SC,Apr-17,24802,23578,1224,4.9
CN4504300000000,45,043,Georgetown County, SC,May-17,25221,23998,1223,4.8
CN4504300000000,45,043,Georgetown County, SC,Jun-17,26120,24725,1395,5.3
CN4504300000000,45,043,Georgetown County, SC,Jul-17,26070,24700,1370,5.3
CN4504300000000,45,043,Georgetown County, SC,Aug-17,25861,24410,1451,5.6
CN4504300000000,45,043,Georgetown County, SC,Sep-17,25645,24325,1320,5.1
CN4504300000000,45,043,Georgetown County, SC,Oct-17,25619,24289,1330,5.2
CN4504300000000,45,043,Georgetown County, SC,Nov-17,25552,24261,1291,5.1
CN4504300000000,45,043,Georgetown County, SC,Dec-17,25760,24315,1445,5.6
CN4504300000000,45,043,Georgetown County, SC,Jan-18,25934,24143,1791,6.9
CN4504300000000,45,043,Georgetown County, SC,Feb-18,26106,24454,1652,6.3
CN4504300000000,45,043,Georgetown County, SC,Mar-18,25807,24402,1405,5.4
CN4504300000000,45,043,Georgetown County, SC,Apr-18(p),25514,24566,948,3.7
CN0800500000000,08,005,Arapahoe County, CO,Mar-17,346090,336748,9342,2.7
CN0800500000000,08,005,Arapahoe County, CO,Apr-17,346540,337791,8749,2.5
CN0800500000000,08,005,Arapahoe County, CO,May-17,348648,340038,8610,2.5
CN0800500000000,08,005,Arapahoe County, CO,Jun-17,353548,343457,10091,2.9
CN0800500000000,08,005,Arapahoe County, CO,Jul-17,354958,345172,9786,2.8
CN0800500000000,08,005,Arapahoe County, CO,Aug-17,355036,345134,9902,2.8
CN0800500000000,08,005,Arapahoe County, CO,Sep-17,356934,347051,9883,2.8
CN0800500000000,08,005,Arapahoe County, CO,Oct-17,355814,345910,9904,2.8
CN0800500000000,08,005,Arapahoe County, CO,Nov-17,356302,346156,10146,2.8
CN0800500000000,08,005,Arapahoe County, CO,Dec-17,355038,344697,10341,2.9
CN0800500000000,08,005,Arapahoe County, CO,Jan-18,353877,342385,11492,3.2
CN0800500000000,08,005,Arapahoe County, CO,Feb-18,359220,347728,11492,3.2
CN0800500000000,08,005,Arapahoe County, CO,Mar-18,359227,349090,10137,2.8
CN0800500000000,08,005,Arapahoe County, CO,Apr-18(p),358822,349623,9199,2.6
CN5101900000000,51,019,Bedford County, VA,Mar-17,38310,36773,1537,4.0
CN5101900000000,51,019,Bedford County, VA,Apr-17,38243,36889,1354,3.5
CN5101900000000,51,019,Bedford County, VA,May-17,38081,36603,1478,3.9
CN5101900000000,51,019,Bedford County, VA,Jun-17,38232,36662,1570,4.1
CN5101900000000,51,019,Bedford County, VA,Jul-17,38615,37045,1570,4.1
CN5101900000000,51,019,Bedford County, VA,Aug-17,38373,36797,1576,4.1
CN5101900000000,51,019,Bedford County, VA,Sep-17,38469,37040,1429,3.7
CN5101900000000,51,019,Bedford County, VA,Oct-17,38134,36784,1350,3.5
CN5101900000000,51,019,Bedford County, VA,Nov-17,38190,36842,1348,3.5
CN5101900000000,51,019,Bedford County, VA,Dec-17,38127,36786,1341,3.5
CN5101900000000,51,019,Bedford County, VA,Jan-18,37973,36483,1490,3.9
CN5101900000000,51,019,Bedford County, VA,Feb-18,38639,37271,1368,3.5
CN5101900000000,51,019,Bedford County, VA,Mar-18,38831,37481,1350,3.5
CN5101900000000,51,019,Bedford County, VA,Apr-18(p),38974,37848,1126,2.9
CN4901300000000,49,013,Duchesne County, UT,Mar-17,8116,7526,590,7.3
CN4901300000000,49,013,Duchesne County, UT,Apr-17,8133,7638,495,6.1
CN4901300000000,49,013,Duchesne County, UT,May-17,8150,7698,452,5.5
CN4901300000000,49,013,Duchesne County, UT,Jun-17,8299,7819,480,5.8
CN4901300000000,49,013,Duchesne County, UT,Jul-17,8059,7629,430,5.3
CN4901300000000,49,013,Duchesne County, UT,Aug-17,7988,7575,413,5.2
CN4901300000000,49,013,Duchesne County, UT,Sep-17,8081,7703,378,4.7
CN4901300000000,49,013,Duchesne County, UT,Oct-17,8141,7781,360,4.4
CN4901300000000,49,013,Duchesne County, UT,Nov-17,8096,7758,338,4.2
CN4901300000000,49,013,Duchesne County, UT,Dec-17,8138,7758,380,4.7
CN4901300000000,49,013,Duchesne County, UT,Jan-18,8099,7688,411,5.1
CN4901300000000,49,013,Duchesne County, UT,Feb-18,7994,7578,416,5.2
CN4901300000000,49,013,Duchesne County, UT,Mar-18,8048,7646,402,5.0
CN4901300000000,49,013,Duchesne County, UT,Apr-18(p),8045,7684,361,4.5
CN1717700000000,17,177,Stephenson County, IL,Mar-17,21300,20148,1152,5.4
CN1717700000000,17,177,Stephenson County, IL,Apr-17,21633,20708,925,4.3
CN1717700000000,17,177,Stephenson County, IL,May-17,21553,20685,868,4.0
CN1717700000000,17,177,Stephenson County, IL,Jun-17,22128,21172,956,4.3
CN1717700000000,17,177,Stephenson County, IL,Jul-17,21833,20860,973,4.5
CN1717700000000,17,177,Stephenson County, IL,Aug-17,21708,20738,970,4.5
CN1717700000000,17,177,Stephenson County, IL,Sep-17,21679,20805,874,4.0
CN1717700000000,17,177,Stephenson County, IL,Oct-17,21573,20775,798,3.7
CN1717700000000,17,177,Stephenson County, IL,Nov-17,21413,20571,842,3.9
CN1717700000000,17,177,Stephenson County, IL,Dec-17,21244,20395,849,4.0
CN1717700000000,17,177,Stephenson County, IL,Jan-18,21243,20264,979,4.6
CN1717700000000,17,177,Stephenson County, IL,Feb-18,21262,20349,913,4.3
CN1717700000000,17,177,Stephenson County, IL,Mar-18,21776,20826,950,4.4
CN1717700000000,17,177,Stephenson County, IL,Apr-18(p),21987,21198,789,3.6
CN4712700000000,47,127,Moore County, TN,Mar-17,3471,3363,108,3.1
CN4712700000000,47,127,Moore County, TN,Apr-17,3477,3384,93,2.7
CN4712700000000,47,127,Moore County, TN,May-17,3484,3379,105,3.0
CN4712700000000,47,127,Moore County, TN,Jun-17,3391,3265,126,3.7
CN4712700000000,47,127,Moore County, TN,Jul-17,3423,3302,121,3.5
CN4712700000000,47,127,Moore County, TN,Aug-17,3498,3388,110,3.1
CN4712700000000,47,127,Moore County, TN,Sep-17,3605,3505,100,2.8
CN4712700000000,47,127,Moore County, TN,Oct-17,3543,3454,89,2.5
CN4712700000000,47,127,Moore County, TN,Nov-17,3536,3445,91,2.6
CN4712700000000,47,127,Moore County, TN,Dec-17,3533,3446,87,2.5
CN4712700000000,47,127,Moore County, TN,Jan-18,3387,3285,102,3.0
CN4712700000000,47,127,Moore County, TN,Feb-18,3549,3446,103,2.9
CN4712700000000,47,127,Moore County, TN,Mar-18,3538,3429,109,3.1
CN4712700000000,47,127,Moore County, TN,Apr-18(p),3563,3471,92,2.6
CN5600900000000,56,009,Converse County, WY,Mar-17,7531,7153,378,5.0
CN5600900000000,56,009,Converse County, WY,Apr-17,7552,7233,319,4.2
CN5600900000000,56,009,Converse County, WY,May-17,7473,7177,296,4.0
CN5600900000000,56,009,Converse County, WY,Jun-17,7594,7273,321,4.2
CN5600900000000,56,009,Converse County, WY,Jul-17,7426,7105,321,4.3
CN5600900000000,56,009,Converse County, WY,Aug-17,7401,7099,302,4.1
CN5600900000000,56,009,Converse County, WY,Sep-17,7391,7103,288,3.9
CN5600900000000,56,009,Converse County, WY,Oct-17,7445,7156,289,3.9
CN5600900000000,56,009,Converse County, WY,Nov-17,7468,7177,291,3.9
CN5600900000000,56,009,Converse County, WY,Dec-17,7360,7063,297,4.0
CN5600900000000,56,009,Converse County, WY,Jan-18,7368,7047,321,4.4
CN5600900000000,56,009,Converse County, WY,Feb-18,7313,7039,274,3.7
CN5600900000000,56,009,Converse County, WY,Mar-18,7473,7193,280,3.7
CN5600900000000,56,009,Converse County, WY,Apr-18(p),7354,7100,254,3.5
CN4005300000000,40,053,Grant County, OK,Mar-17,2851,2766,85,3.0
CN4005300000000,40,053,Grant County, OK,Apr-17,2906,2832,74,2.5
CN4005300000000,40,053,Grant County, OK,May-17,2884,2801,83,2.9
CN4005300000000,40,053,Grant County, OK,Jun-17,2858,2775,83,2.9
CN4005300000000,40,053,Grant County, OK,Jul-17,2872,2794,78,2.7
CN4005300000000,40,053,Grant County, OK,Aug-17,2982,2911,71,2.4
CN4005300000000,40,053,Grant County, OK,Sep-17,2878,2809,69,2.4
CN4005300000000,40,053,Grant County, OK,Oct-17,2950,2888,62,2.1
CN4005300000000,40,053,Grant County, OK,Nov-17,2974,2909,65,2.2
CN4005300000000,40,053,Grant County, OK,Dec-17,2888,2823,65,2.3
CN4005300000000,40,053,Grant County, OK,Jan-18,2898,2818,80,2.8
CN4005300000000,40,053,Grant County, OK,Feb-18,2888,2813,75,2.6
CN4005300000000,40,053,Grant County, OK,Mar-18,2836,2767,69,2.4
CN4005300000000,40,053,Grant County, OK,Apr-18(p),2768,2703,65,2.3
CN1200300000000,12,003,Baker County, FL,Mar-17,11660,11162,498,4.3
CN1200300000000,12,003,Baker County, FL,Apr-17,11686,11226,460,3.9
CN1200300000000,12,003,Baker County, FL,May-17,11772,11318,454,3.9
CN1200300000000,12,003,Baker County, FL,Jun-17,11878,11356,522,4.4
CN1200300000000,12,003,Baker County, FL,Jul-17,11955,11448,507,4.2
CN1200300000000,12,003,Baker County, FL,Aug-17,11870,11385,485,4.1
CN1200300000000,12,003,Baker County, FL,Sep-17,12050,11604,446,3.7
CN1200300000000,12,003,Baker County, FL,Oct-17,11901,11478,423,3.6
CN1200300000000,12,003,Baker County, FL,Nov-17,11883,11435,448,3.8
CN1200300000000,12,003,Baker County, FL,Dec-17,11830,11421,409,3.5
CN1200300000000,12,003,Baker County, FL,Jan-18,11822,11331,491,4.2
CN1200300000000,12,003,Baker County, FL,Feb-18,11888,11462,426,3.6
CN1200300000000,12,003,Baker County, FL,Mar-18,11907,11496,411,3.5
CN1200300000000,12,003,Baker County, FL,Apr-18(p),11837,11478,359,3.0
CN2106900000000,21,069,Fleming County, KY,Mar-17,6316,5871,445,7.0
CN2106900000000,21,069,Fleming County, KY,Apr-17,6346,5982,364,5.7
CN2106900000000,21,069,Fleming County, KY,May-17,6345,5987,358,5.6
CN2106900000000,21,069,Fleming County, KY,Jun-17,6295,5887,408,6.5
CN2106900000000,21,069,Fleming County, KY,Jul-17,5957,5573,384,6.4
CN2106900000000,21,069,Fleming County, KY,Aug-17,5906,5558,348,5.9
CN2106900000000,21,069,Fleming County, KY,Sep-17,6055,5753,302,5.0
CN2106900000000,21,069,Fleming County, KY,Oct-17,6032,5753,279,4.6
CN2106900000000,21,069,Fleming County, KY,Nov-17,6047,5760,287,4.7
CN2106900000000,21,069,Fleming County, KY,Dec-17,6027,5723,304,5.0
CN2106900000000,21,069,Fleming County, KY,Jan-18,6168,5807,361,5.9
CN2106900000000,21,069,Fleming County, KY,Feb-18,6226,5825,401,6.4
CN2106900000000,21,069,Fleming County, KY,Mar-18,6238,5886,352,5.6
CN2106900000000,21,069,Fleming County, KY,Apr-18(p),6245,5950,295,4.7
CN2117500000000,21,175,Morgan County, KY,Mar-17,4685,4245,440,9.4
CN2117500000000,21,175,Morgan County, KY,Apr-17,4649,4307,342,7.4
CN2117500000000,21,175,Morgan County, KY,May-17,4692,4364,328,7.0
CN2117500000000,21,175,Morgan County, KY,Jun-17,4728,4365,363,7.7
CN2117500000000,21,175,Morgan County, KY,Jul-17,4646,4325,321,6.9
CN2117500000000,21,175,Morgan County, KY,Aug-17,4632,4346,286,6.2
CN2117500000000,21,175,Morgan County, KY,Sep-17,4641,4379,262,5.6
CN2117500000000,21,175,Morgan County, KY,Oct-17,4584,4356,228,5.0
CN2117500000000,21,175,Morgan County, KY,Nov-17,4575,4339,236,5.2
CN2117500000000,21,175,Morgan County, KY,Dec-17,4572,4304,268,5.9
CN2117500000000,21,175,Morgan County, KY,Jan-18,4616,4263,353,7.6
CN2117500000000,21,175,Morgan County, KY,Feb-18,4593,4207,386,8.4
CN2117500000000,21,175,Morgan County, KY,Mar-18,4548,4216,332,7.3
CN2117500000000,21,175,Morgan County, KY,Apr-18(p),4545,4277,268,5.9
CN3709300000000,37,093,Hoke County, NC,Mar-17,20084,18953,1131,5.6
CN3709300000000,37,093,Hoke County, NC,Apr-17,20000,18949,1051,5.3
CN3709300000000,37,093,Hoke County, NC,May-17,19974,18850,1124,5.6
CN3709300000000,37,093,Hoke County, NC,Jun-17,19899,18756,1143,5.7
CN3709300000000,37,093,Hoke County, NC,Jul-17,19781,18567,1214,6.1
CN3709300000000,37,093,Hoke County, NC,Aug-17,19702,18484,1218,6.2
CN3709300000000,37,093,Hoke County, NC,Sep-17,19978,18882,1096,5.5
CN3709300000000,37,093,Hoke County, NC,Oct-17,19855,18785,1070,5.4
CN3709300000000,37,093,Hoke County, NC,Nov-17,19894,18770,1124,5.6
CN3709300000000,37,093,Hoke County, NC,Dec-17,19865,18774,1091,5.5
CN3709300000000,37,093,Hoke County, NC,Jan-18,19917,18757,1160,5.8
CN3709300000000,37,093,Hoke County, NC,Feb-18,20037,18906,1131,5.6
CN3709300000000,37,093,Hoke County, NC,Mar-18,20070,19003,1067,5.3
CN3709300000000,37,093,Hoke County, NC,Apr-18(p),20007,19081,926,4.6
CN5301100000000,53,011,Clark County, WA,Mar-17,227034,214977,12057,5.3
CN5301100000000,53,011,Clark County, WA,Apr-17,225730,214557,11173,4.9
CN5301100000000,53,011,Clark County, WA,May-17,225371,214249,11122,4.9
CN5301100000000,53,011,Clark County, WA,Jun-17,226106,214891,11215,5.0
CN5301100000000,53,011,Clark County, WA,Jul-17,225561,214115,11446,5.1
CN5301100000000,53,011,Clark County, WA,Aug-17,226266,214650,11616,5.1
CN5301100000000,53,011,Clark County, WA,Sep-17,226474,215807,10667,4.7
CN5301100000000,53,011,Clark County, WA,Oct-17,229237,218766,10471,4.6
CN5301100000000,53,011,Clark County, WA,Nov-17,231232,220356,10876,4.7
CN5301100000000,53,011,Clark County, WA,Dec-17,232199,220606,11593,5.0
CN5301100000000,53,011,Clark County, WA,Jan-18,227452,215189,12263,5.4
CN5301100000000,53,011,Clark County, WA,Feb-18,226724,214008,12716,5.6
CN5301100000000,53,011,Clark County, WA,Mar-18,227727,215559,12168,5.3
CN5301100000000,53,011,Clark County, WA,Apr-18(p),225680,214270,11410,5.1
CN2913900000000,29,139,Montgomery County, MO,Mar-17,5645,5441,204,3.6
CN2913900000000,29,139,Montgomery County, MO,Apr-17,5744,5559,185,3.2
CN2913900000000,29,139,Montgomery County, MO,May-17,5681,5500,181,3.2
CN2913900000000,29,139,Montgomery County, MO,Jun-17,5648,5459,189,3.3
CN2913900000000,29,139,Montgomery County, MO,Jul-17,5524,5324,200,3.6
CN2913900000000,29,139,Montgomery County, MO,Aug-17,5585,5375,210,3.8
CN2913900000000,29,139,Montgomery County, MO,Sep-17,5545,5391,154,2.8
CN2913900000000,29,139,Montgomery County, MO,Oct-17,5505,5389,116,2.1
CN2913900000000,29,139,Montgomery County, MO,Nov-17,5489,5329,160,2.9
CN2913900000000,29,139,Montgomery County, MO,Dec-17,5441,5263,178,3.3
CN2913900000000,29,139,Montgomery County, MO,Jan-18,5425,5223,202,3.7
CN2913900000000,29,139,Montgomery County, MO,Feb-18,5566,5358,208,3.7
CN2913900000000,29,139,Montgomery County, MO,Mar-18,5548,5364,184,3.3
CN2913900000000,29,139,Montgomery County, MO,Apr-18(p),5640,5469,171,3.0
CN5408500000000,54,085,Ritchie County, WV,Mar-17,4405,4113,292,6.6
CN5408500000000,54,085,Ritchie County, WV,Apr-17,4413,4195,218,4.9
CN5408500000000,54,085,Ritchie County, WV,May-17,4414,4211,203,4.6
CN5408500000000,54,085,Ritchie County, WV,Jun-17,4549,4322,227,5.0
CN5408500000000,54,085,Ritchie County, WV,Jul-17,4450,4235,215,4.8
CN5408500000000,54,085,Ritchie County, WV,Aug-17,4424,4189,235,5.3
CN5408500000000,54,085,Ritchie County, WV,Sep-17,4433,4236,197,4.4
CN5408500000000,54,085,Ritchie County, WV,Oct-17,4398,4201,197,4.5
CN5408500000000,54,085,Ritchie County, WV,Nov-17,4340,4124,216,5.0
CN5408500000000,54,085,Ritchie County, WV,Dec-17,4367,4120,247,5.7
CN5408500000000,54,085,Ritchie County, WV,Jan-18,4453,4178,275,6.2
CN5408500000000,54,085,Ritchie County, WV,Feb-18,4475,4137,338,7.6
CN5408500000000,54,085,Ritchie County, WV,Mar-18,4430,4154,276,6.2
CN5408500000000,54,085,Ritchie County, WV,Apr-18(p),4479,4253,226,5.0
CN2010100000000,20,101,Lane County, KS,Mar-17,767,739,28,3.7
CN2010100000000,20,101,Lane County, KS,Apr-17,771,747,24,3.1
CN2010100000000,20,101,Lane County, KS,May-17,777,751,26,3.3
CN2010100000000,20,101,Lane County, KS,Jun-17,832,801,31,3.7
CN2010100000000,20,101,Lane County, KS,Jul-17,800,767,33,4.1
CN2010100000000,20,101,Lane County, KS,Aug-17,800,766,34,4.3
CN2010100000000,20,101,Lane County, KS,Sep-17,816,789,27,3.3
CN2010100000000,20,101,Lane County, KS,Oct-17,841,817,24,2.9
CN2010100000000,20,101,Lane County, KS,Nov-17,814,790,24,2.9
CN2010100000000,20,101,Lane County, KS,Dec-17,816,795,21,2.6
CN2010100000000,20,101,Lane County, KS,Jan-18,768,747,21,2.7
CN2010100000000,20,101,Lane County, KS,Feb-18,765,744,21,2.7
CN2010100000000,20,101,Lane County, KS,Mar-18,761,739,22,2.9
CN2010100000000,20,101,Lane County, KS,Apr-18(p),709,684,25,3.5
CN2703100000000,27,031,Cook County, MN,Mar-17,2907,2743,164,5.6
CN2703100000000,27,031,Cook County, MN,Apr-17,2904,2761,143,4.9
CN2703100000000,27,031,Cook County, MN,May-17,3017,2918,99,3.3
CN2703100000000,27,031,Cook County, MN,Jun-17,3309,3223,86,2.6
CN2703100000000,27,031,Cook County, MN,Jul-17,3447,3369,78,2.3
CN2703100000000,27,031,Cook County, MN,Aug-17,3444,3369,75,2.2
CN2703100000000,27,031,Cook County, MN,Sep-17,3319,3253,66,2.0
CN2703100000000,27,031,Cook County, MN,Oct-17,3325,3263,62,1.9
CN2703100000000,27,031,Cook County, MN,Nov-17,3378,3250,128,3.8
CN2703100000000,27,031,Cook County, MN,Dec-17,3408,3249,159,4.7
CN2703100000000,27,031,Cook County, MN,Jan-18,3381,3204,177,5.2
CN2703100000000,27,031,Cook County, MN,Feb-18,3370,3197,173,5.1
CN2703100000000,27,031,Cook County, MN,Mar-18,3334,3171,163,4.9
CN2703100000000,27,031,Cook County, MN,Apr-18(p),3408,3269,139,4.1
CN5112500000000,51,125,Nelson County, VA,Mar-17,7322,7080,242,3.3
CN5112500000000,51,125,Nelson County, VA,Apr-17,7398,7170,228,3.1
CN5112500000000,51,125,Nelson County, VA,May-17,7378,7118,260,3.5
CN5112500000000,51,125,Nelson County, VA,Jun-17,7471,7186,285,3.8
CN5112500000000,51,125,Nelson County, VA,Jul-17,7362,7076,286,3.9
CN5112500000000,51,125,Nelson County, VA,Aug-17,7223,6943,280,3.9
CN5112500000000,51,125,Nelson County, VA,Sep-17,7474,7229,245,3.3
CN5112500000000,51,125,Nelson County, VA,Oct-17,7343,7103,240,3.3
CN5112500000000,51,125,Nelson County, VA,Nov-17,7415,7172,243,3.3
CN5112500000000,51,125,Nelson County, VA,Dec-17,7443,7204,239,3.2
CN5112500000000,51,125,Nelson County, VA,Jan-18,7295,7020,275,3.8
CN5112500000000,51,125,Nelson County, VA,Feb-18,7531,7282,249,3.3
CN5112500000000,51,125,Nelson County, VA,Mar-18,7562,7311,251,3.3
CN5112500000000,51,125,Nelson County, VA,Apr-18(p),7675,7457,218,2.8
CN2017900000000,20,179,Sheridan County, KS,Mar-17,1369,1338,31,2.3
CN2017900000000,20,179,Sheridan County, KS,Apr-17,1291,1261,30,2.3
CN2017900000000,20,179,Sheridan County, KS,May-17,1298,1265,33,2.5
CN2017900000000,20,179,Sheridan County, KS,Jun-17,1398,1363,35,2.5
CN2017900000000,20,179,Sheridan County, KS,Jul-17,1361,1326,35,2.6
CN2017900000000,20,179,Sheridan County, KS,Aug-17,1370,1336,34,2.5
CN2017900000000,20,179,Sheridan County, KS,Sep-17,1374,1347,27,2.0
CN2017900000000,20,179,Sheridan County, KS,Oct-17,1415,1388,27,1.9
CN2017900000000,20,179,Sheridan County, KS,Nov-17,1383,1353,30,2.2
CN2017900000000,20,179,Sheridan County, KS,Dec-17,1371,1342,29,2.1
CN2017900000000,20,179,Sheridan County, KS,Jan-18,1332,1302,30,2.3
CN2017900000000,20,179,Sheridan County, KS,Feb-18,1334,1299,35,2.6
CN2017900000000,20,179,Sheridan County, KS,Mar-18,1330,1298,32,2.4
CN2017900000000,20,179,Sheridan County, KS,Apr-18(p),1229,1200,29,2.4
CN1303300000000,13,033,Burke County, GA,Mar-17,9454,8790,664,7.0
CN1303300000000,13,033,Burke County, GA,Apr-17,9463,8842,621,6.6
CN1303300000000,13,033,Burke County, GA,May-17,9407,8757,650,6.9
CN1303300000000,13,033,Burke County, GA,Jun-17,9409,8746,663,7.0
CN1303300000000,13,033,Burke County, GA,Jul-17,9495,8728,767,8.1
CN1303300000000,13,033,Burke County, GA,Aug-17,9413,8731,682,7.2
CN1303300000000,13,033,Burke County, GA,Sep-17,9406,8824,582,6.2
CN1303300000000,13,033,Burke County, GA,Oct-17,9542,8888,654,6.9
CN1303300000000,13,033,Burke County, GA,Nov-17,9531,8953,578,6.1
CN1303300000000,13,033,Burke County, GA,Dec-17,9635,9036,599,6.2
CN1303300000000,13,033,Burke County, GA,Jan-18,9855,9112,743,7.5
CN1303300000000,13,033,Burke County, GA,Feb-18,9711,9113,598,6.2
CN1303300000000,13,033,Burke County, GA,Mar-18,9757,9164,593,6.1
CN1303300000000,13,033,Burke County, GA,Apr-18(p),9724,9208,516,5.3
CN4006100000000,40,061,Haskell County, OK,Mar-17,4364,4064,300,6.9
CN4006100000000,40,061,Haskell County, OK,Apr-17,4370,4094,276,6.3
CN4006100000000,40,061,Haskell County, OK,May-17,4360,4064,296,6.8
CN4006100000000,40,061,Haskell County, OK,Jun-17,4296,3985,311,7.2
CN4006100000000,40,061,Haskell County, OK,Jul-17,4194,3907,287,6.8
CN4006100000000,40,061,Haskell County, OK,Aug-17,4368,4079,289,6.6
CN4006100000000,40,061,Haskell County, OK,Sep-17,4434,4182,252,5.7
CN4006100000000,40,061,Haskell County, OK,Oct-17,4428,4158,270,6.1
CN4006100000000,40,061,Haskell County, OK,Nov-17,4438,4188,250,5.6
CN4006100000000,40,061,Haskell County, OK,Dec-17,4378,4111,267,6.1
CN4006100000000,40,061,Haskell County, OK,Jan-18,4380,4079,301,6.9
CN4006100000000,40,061,Haskell County, OK,Feb-18,4400,4140,260,5.9
CN4006100000000,40,061,Haskell County, OK,Mar-18,4409,4153,256,5.8
CN4006100000000,40,061,Haskell County, OK,Apr-18(p),4348,4106,242,5.6
CN0603700000000,06,037,Los Angeles County, CA,Mar-17,5115208,4876046,239162,4.7
CN0603700000000,06,037,Los Angeles County, CA,Apr-17,5106537,4879789,226748,4.4
CN0603700000000,06,037,Los Angeles County, CA,May-17,5092293,4866683,225610,4.4
CN0603700000000,06,037,Los Angeles County, CA,Jun-17,5101231,4856626,244605,4.8
CN0603700000000,06,037,Los Angeles County, CA,Jul-17,5152986,4879558,273428,5.3
CN0603700000000,06,037,Los Angeles County, CA,Aug-17,5137893,4875390,262503,5.1
CN0603700000000,06,037,Los Angeles County, CA,Sep-17,5171660,4934660,237000,4.6
CN0603700000000,06,037,Los Angeles County, CA,Oct-17,5146520,4922026,224494,4.4
CN0603700000000,06,037,Los Angeles County, CA,Nov-17,5151157,4929929,221228,4.3
CN0603700000000,06,037,Los Angeles County, CA,Dec-17,5129929,4918856,211073,4.1
CN0603700000000,06,037,Los Angeles County, CA,Jan-18,5113770,4871063,242707,4.7
CN0603700000000,06,037,Los Angeles County, CA,Feb-18,5148961,4915553,233408,4.5
CN0603700000000,06,037,Los Angeles County, CA,Mar-18,5151959,4937283,214676,4.2
CN0603700000000,06,037,Los Angeles County, CA,Apr-18(p),5136298,4929832,206466,4.0
CN2606900000000,26,069,Iosco County, MI,Mar-17,9866,8972,894,9.1
CN2606900000000,26,069,Iosco County, MI,Apr-17,9833,9145,688,7.0
CN2606900000000,26,069,Iosco County, MI,May-17,10159,9513,646,6.4
CN2606900000000,26,069,Iosco County, MI,Jun-17,10463,9738,725,6.9
CN2606900000000,26,069,Iosco County, MI,Jul-17,10668,9830,838,7.9
CN2606900000000,26,069,Iosco County, MI,Aug-17,10556,9801,755,7.2
CN2606900000000,26,069,Iosco County, MI,Sep-17,10318,9705,613,5.9
CN2606900000000,26,069,Iosco County, MI,Oct-17,10063,9482,581,5.8
CN2606900000000,26,069,Iosco County, MI,Nov-17,10169,9506,663,6.5
CN2606900000000,26,069,Iosco County, MI,Dec-17,10097,9297,800,7.9
CN2606900000000,26,069,Iosco County, MI,Jan-18,9979,9025,954,9.6
CN2606900000000,26,069,Iosco County, MI,Feb-18,10014,9012,1002,10.0
CN2606900000000,26,069,Iosco County, MI,Mar-18,9981,9089,892,8.9
CN2606900000000,26,069,Iosco County, MI,Apr-18(p),9994,9273,721,7.2
CN2704900000000,27,049,Goodhue County, MN,Mar-17,26963,25885,1078,4.0
CN2704900000000,27,049,Goodhue County, MN,Apr-17,26878,26023,855,3.2
CN2704900000000,27,049,Goodhue County, MN,May-17,26917,26152,765,2.8
CN2704900000000,27,049,Goodhue County, MN,Jun-17,27081,26203,878,3.2
CN2704900000000,27,049,Goodhue County, MN,Jul-17,27041,26224,817,3.0
CN2704900000000,27,049,Goodhue County, MN,Aug-17,26807,25976,831,3.1
CN2704900000000,27,049,Goodhue County, MN,Sep-17,26656,25971,685,2.6
CN2704900000000,27,049,Goodhue County, MN,Oct-17,26853,26287,566,2.1
CN2704900000000,27,049,Goodhue County, MN,Nov-17,26790,26157,633,2.4
CN2704900000000,27,049,Goodhue County, MN,Dec-17,26874,26018,856,3.2
CN2704900000000,27,049,Goodhue County, MN,Jan-18,27214,26079,1135,4.2
CN2704900000000,27,049,Goodhue County, MN,Feb-18,27212,26138,1074,3.9
CN2704900000000,27,049,Goodhue County, MN,Mar-18,27177,26182,995,3.7
CN2704900000000,27,049,Goodhue County, MN,Apr-18(p),27077,26279,798,2.9
CN3701700000000,37,017,Bladen County, NC,Mar-17,14865,14044,821,5.5
CN3701700000000,37,017,Bladen County, NC,Apr-17,14594,13823,771,5.3
CN3701700000000,37,017,Bladen County, NC,May-17,14552,13745,807,5.5
CN3701700000000,37,017,Bladen County, NC,Jun-17,14273,13415,858,6.0
CN3701700000000,37,017,Bladen County, NC,Jul-17,14692,13803,889,6.1
CN3701700000000,37,017,Bladen County, NC,Aug-17,14389,13501,888,6.2
CN3701700000000,37,017,Bladen County, NC,Sep-17,14513,13686,827,5.7
CN3701700000000,37,017,Bladen County, NC,Oct-17,14375,13530,845,5.9
CN3701700000000,37,017,Bladen County, NC,Nov-17,14136,13237,899,6.4
CN3701700000000,37,017,Bladen County, NC,Dec-17,14250,13420,830,5.8
CN3701700000000,37,017,Bladen County, NC,Jan-18,14272,13356,916,6.4
CN3701700000000,37,017,Bladen County, NC,Feb-18,14699,13795,904,6.2
CN3701700000000,37,017,Bladen County, NC,Mar-18,14549,13713,836,5.7
CN3701700000000,37,017,Bladen County, NC,Apr-18(p),14513,13771,742,5.1
CN3913300000000,39,133,Portage County, OH,Mar-17,87490,82544,4946,5.7
CN3913300000000,39,133,Portage County, OH,Apr-17,87422,83357,4065,4.6
CN3913300000000,39,133,Portage County, OH,May-17,88025,84169,3856,4.4
CN3913300000000,39,133,Portage County, OH,Jun-17,87857,83423,4434,5.0
CN3913300000000,39,133,Portage County, OH,Jul-17,88382,83838,4544,5.1
CN3913300000000,39,133,Portage County, OH,Aug-17,87503,83197,4306,4.9
CN3913300000000,39,133,Portage County, OH,Sep-17,87839,83776,4063,4.6
CN3913300000000,39,133,Portage County, OH,Oct-17,88128,84386,3742,4.2
CN3913300000000,39,133,Portage County, OH,Nov-17,87815,83966,3849,4.4
CN3913300000000,39,133,Portage County, OH,Dec-17,87631,83554,4077,4.7
CN3913300000000,39,133,Portage County, OH,Jan-18,86325,81693,4632,5.4
CN3913300000000,39,133,Portage County, OH,Feb-18,87712,83356,4356,5.0
CN3913300000000,39,133,Portage County, OH,Mar-18,88595,84597,3998,4.5
CN3913300000000,39,133,Portage County, OH,Apr-18(p),87787,84194,3593,4.1
CN2116700000000,21,167,Mercer County, KY,Mar-17,10190,9631,559,5.5
CN2116700000000,21,167,Mercer County, KY,Apr-17,10261,9786,475,4.6
CN2116700000000,21,167,Mercer County, KY,May-17,10215,9706,509,5.0
CN2116700000000,21,167,Mercer County, KY,Jun-17,10312,9768,544,5.3
CN2116700000000,21,167,Mercer County, KY,Jul-17,9976,9446,530,5.3
CN2116700000000,21,167,Mercer County, KY,Aug-17,10116,9647,469,4.6
CN2116700000000,21,167,Mercer County, KY,Sep-17,10158,9700,458,4.5
CN2116700000000,21,167,Mercer County, KY,Oct-17,10082,9667,415,4.1
CN2116700000000,21,167,Mercer County, KY,Nov-17,10036,9638,398,4.0
CN2116700000000,21,167,Mercer County, KY,Dec-17,9971,9586,385,3.9
CN2116700000000,21,167,Mercer County, KY,Jan-18,9901,9461,440,4.4
CN2116700000000,21,167,Mercer County, KY,Feb-18,9913,9434,479,4.8
CN2116700000000,21,167,Mercer County, KY,Mar-18,10060,9597,463,4.6
CN2116700000000,21,167,Mercer County, KY,Apr-18(p),10124,9731,393,3.9
CN3719100000000,37,191,Wayne County, NC,Mar-17,54328,51597,2731,5.0
CN3719100000000,37,191,Wayne County, NC,Apr-17,54351,51786,2565,4.7
CN3719100000000,37,191,Wayne County, NC,May-17,53913,51277,2636,4.9
CN3719100000000,37,191,Wayne County, NC,Jun-17,53490,50743,2747,5.1
CN3719100000000,37,191,Wayne County, NC,Jul-17,53675,50763,2912,5.4
CN3719100000000,37,191,Wayne County, NC,Aug-17,52720,49874,2846,5.4
CN3719100000000,37,191,Wayne County, NC,Sep-17,53549,51031,2518,4.7
CN3719100000000,37,191,Wayne County, NC,Oct-17,53260,50744,2516,4.7
CN3719100000000,37,191,Wayne County, NC,Nov-17,52806,50132,2674,5.1
CN3719100000000,37,191,Wayne County, NC,Dec-17,52799,50232,2567,4.9
CN3719100000000,37,191,Wayne County, NC,Jan-18,52856,50155,2701,5.1
CN3719100000000,37,191,Wayne County, NC,Feb-18,53632,50963,2669,5.0
CN3719100000000,37,191,Wayne County, NC,Mar-18,53436,50872,2564,4.8
CN3719100000000,37,191,Wayne County, NC,Apr-18(p),53141,50920,2221,4.2
CN7210100000000,72,101,Morovis Municipio, PR,Mar-17,8120,7144,976,12.0
CN7210100000000,72,101,Morovis Municipio, PR,Apr-17,8118,7038,1080,13.3
CN7210100000000,72,101,Morovis Municipio, PR,May-17,7941,7045,896,11.3
CN7210100000000,72,101,Morovis Municipio, PR,Jun-17,7919,7021,898,11.3
CN7210100000000,72,101,Morovis Municipio, PR,Jul-17,8073,6999,1074,13.3
CN7210100000000,72,101,Morovis Municipio, PR,Aug-17,8082,6891,1191,14.7
CN7210100000000,72,101,Morovis Municipio, PR,Sep-17(y),8023,6943,1080,13.5
CN7210100000000,72,101,Morovis Municipio, PR,Oct-17,7737,6667,1070,13.8
CN7210100000000,72,101,Morovis Municipio, PR,Nov-17,8009,7049,960,12.0
CN7210100000000,72,101,Morovis Municipio, PR,Dec-17,7953,7091,862,10.8
CN7210100000000,72,101,Morovis Municipio, PR,Jan-18,7891,6955,936,11.9
CN7210100000000,72,101,Morovis Municipio, PR,Feb-18,7809,6962,847,10.8
CN7210100000000,72,101,Morovis Municipio, PR,Mar-18,7765,6979,786,10.1
CN7210100000000,72,101,Morovis Municipio, PR,Apr-18(p),7767,7007,760,9.8
CN2810900000000,28,109,Pearl River County, MS,Mar-17,23277,21987,1290,5.5
CN2810900000000,28,109,Pearl River County, MS,Apr-17,23054,21912,1142,5.0
CN2810900000000,28,109,Pearl River County, MS,May-17,23293,21961,1332,5.7
CN2810900000000,28,109,Pearl River County, MS,Jun-17,23665,22198,1467,6.2
CN2810900000000,28,109,Pearl River County, MS,Jul-17,23640,22285,1355,5.7
CN2810900000000,28,109,Pearl River County, MS,Aug-17,23102,21924,1178,5.1
CN2810900000000,28,109,Pearl River County, MS,Sep-17,23106,21986,1120,4.8
CN2810900000000,28,109,Pearl River County, MS,Oct-17,22988,21961,1027,4.5
CN2810900000000,28,109,Pearl River County, MS,Nov-17,23051,22040,1011,4.4
CN2810900000000,28,109,Pearl River County, MS,Dec-17,23054,22031,1023,4.4
CN2810900000000,28,109,Pearl River County, MS,Jan-18,22879,21880,999,4.4
CN2810900000000,28,109,Pearl River County, MS,Feb-18,23040,22048,992,4.3
CN2810900000000,28,109,Pearl River County, MS,Mar-18,23019,22059,960,4.2
CN2810900000000,28,109,Pearl River County, MS,Apr-18(p),23194,22205,989,4.3
CN5116700000000,51,167,Russell County, VA,Mar-17,11328,10648,680,6.0
CN5116700000000,51,167,Russell County, VA,Apr-17,11170,10593,577,5.2
CN5116700000000,51,167,Russell County, VA,May-17,11082,10505,577,5.2
CN5116700000000,51,167,Russell County, VA,Jun-17,11121,10517,604,5.4
CN5116700000000,51,167,Russell County, VA,Jul-17,11000,10383,617,5.6
CN5116700000000,51,167,Russell County, VA,Aug-17,10853,10251,602,5.5
CN5116700000000,51,167,Russell County, VA,Sep-17,11072,10524,548,4.9
CN5116700000000,51,167,Russell County, VA,Oct-17,10908,10384,524,4.8
CN5116700000000,51,167,Russell County, VA,Nov-17,10808,10293,515,4.8
CN5116700000000,51,167,Russell County, VA,Dec-17,10767,10258,509,4.7
CN5116700000000,51,167,Russell County, VA,Jan-18,10882,10286,596,5.5
CN5116700000000,51,167,Russell County, VA,Feb-18,11009,10444,565,5.1
CN5116700000000,51,167,Russell County, VA,Mar-18,11036,10469,567,5.1
CN5116700000000,51,167,Russell County, VA,Apr-18(p),11044,10569,475,4.3
CN1207100000000,12,071,Lee County, FL,Mar-17,342564,329219,13345,3.9
CN1207100000000,12,071,Lee County, FL,Apr-17,338237,325701,12536,3.7
CN1207100000000,12,071,Lee County, FL,May-17,337515,324484,13031,3.9
CN1207100000000,12,071,Lee County, FL,Jun-17,335329,321323,14006,4.2
CN1207100000000,12,071,Lee County, FL,Jul-17,334546,320340,14206,4.2
CN1207100000000,12,071,Lee County, FL,Aug-17,333807,319974,13833,4.1
CN1207100000000,12,071,Lee County, FL,Sep-17,328669,315205,13464,4.1
CN1207100000000,12,071,Lee County, FL,Oct-17,331914,319546,12368,3.7
CN1207100000000,12,071,Lee County, FL,Nov-17,334075,321837,12238,3.7
CN1207100000000,12,071,Lee County, FL,Dec-17,334489,323111,11378,3.4
CN1207100000000,12,071,Lee County, FL,Jan-18,338768,325728,13040,3.8
CN1207100000000,12,071,Lee County, FL,Feb-18,342224,330338,11886,3.5
CN1207100000000,12,071,Lee County, FL,Mar-18,342485,330777,11708,3.4
CN1207100000000,12,071,Lee County, FL,Apr-18(p),338188,327525,10663,3.2
CN4832700000000,48,327,Menard County, TX,Mar-17,806,771,35,4.3
CN4832700000000,48,327,Menard County, TX,Apr-17,801,773,28,3.5
CN4832700000000,48,327,Menard County, TX,May-17,815,765,50,6.1
CN4832700000000,48,327,Menard County, TX,Jun-17,818,769,49,6.0
CN4832700000000,48,327,Menard County, TX,Jul-17,809,763,46,5.7
CN4832700000000,48,327,Menard County, TX,Aug-17,813,772,41,5.0
CN4832700000000,48,327,Menard County, TX,Sep-17,802,764,38,4.7
CN4832700000000,48,327,Menard County, TX,Oct-17,815,778,37,4.5
CN4832700000000,48,327,Menard County, TX,Nov-17,816,778,38,4.7
CN4832700000000,48,327,Menard County, TX,Dec-17,812,777,35,4.3
CN4832700000000,48,327,Menard County, TX,Jan-18,788,753,35,4.4
CN4832700000000,48,327,Menard County, TX,Feb-18,803,761,42,5.2
CN4832700000000,48,327,Menard County, TX,Mar-18,825,784,41,5.0
CN4832700000000,48,327,Menard County, TX,Apr-18(p),813,775,38,4.7
CN0500700000000,05,007,Benton County, AR,Mar-17,131299,127876,3423,2.6
CN0500700000000,05,007,Benton County, AR,Apr-17,132056,128821,3235,2.4
CN0500700000000,05,007,Benton County, AR,May-17,132763,129004,3759,2.8
CN0500700000000,05,007,Benton County, AR,Jun-17,133523,129288,4235,3.2
CN0500700000000,05,007,Benton County, AR,Jul-17,134889,130377,4512,3.3
CN0500700000000,05,007,Benton County, AR,Aug-17,133371,129215,4156,3.1
CN0500700000000,05,007,Benton County, AR,Sep-17,134052,130111,3941,2.9
CN0500700000000,05,007,Benton County, AR,Oct-17,134525,130944,3581,2.7
CN0500700000000,05,007,Benton County, AR,Nov-17,133324,129775,3549,2.7
CN0500700000000,05,007,Benton County, AR,Dec-17,131452,127614,3838,2.9
CN0500700000000,05,007,Benton County, AR,Jan-18,130194,125774,4420,3.4
CN0500700000000,05,007,Benton County, AR,Feb-18,132552,128331,4221,3.2
CN0500700000000,05,007,Benton County, AR,Mar-18,133230,129252,3978,3.0
CN0500700000000,05,007,Benton County, AR,Apr-18(p),133964,130428,3536,2.6
CN4843300000000,48,433,Stonewall County, TX,Mar-17,632,611,21,3.3
CN4843300000000,48,433,Stonewall County, TX,Apr-17,620,601,19,3.1
CN4843300000000,48,433,Stonewall County, TX,May-17,642,619,23,3.6
CN4843300000000,48,433,Stonewall County, TX,Jun-17,642,620,22,3.4
CN4843300000000,48,433,Stonewall County, TX,Jul-17,629,605,24,3.8
CN4843300000000,48,433,Stonewall County, TX,Aug-17,639,615,24,3.8
CN4843300000000,48,433,Stonewall County, TX,Sep-17,616,595,21,3.4
CN4843300000000,48,433,Stonewall County, TX,Oct-17,608,590,18,3.0
CN4843300000000,48,433,Stonewall County, TX,Nov-17,594,575,19,3.2
CN4843300000000,48,433,Stonewall County, TX,Dec-17,601,584,17,2.8
CN4843300000000,48,433,Stonewall County, TX,Jan-18,608,588,20,3.3
CN4843300000000,48,433,Stonewall County, TX,Feb-18,621,598,23,3.7
CN4843300000000,48,433,Stonewall County, TX,Mar-18,631,610,21,3.3
CN4843300000000,48,433,Stonewall County, TX,Apr-18(p),608,589,19,3.1
CN1902100000000,19,021,Buena Vista County, IA,Mar-17,11410,11089,321,2.8
CN1902100000000,19,021,Buena Vista County, IA,Apr-17,11376,11083,293,2.6
CN1902100000000,19,021,Buena Vista County, IA,May-17,11600,11318,282,2.4
CN1902100000000,19,021,Buena Vista County, IA,Jun-17,11683,11321,362,3.1
CN1902100000000,19,021,Buena Vista County, IA,Jul-17,11535,11182,353,3.1
CN1902100000000,19,021,Buena Vista County, IA,Aug-17,11208,10854,354,3.2
CN1902100000000,19,021,Buena Vista County, IA,Sep-17,11290,11018,272,2.4
CN1902100000000,19,021,Buena Vista County, IA,Oct-17,11510,11279,231,2.0
CN1902100000000,19,021,Buena Vista County, IA,Nov-17,11610,11363,247,2.1
CN1902100000000,19,021,Buena Vista County, IA,Dec-17,11448,11198,250,2.2
CN1902100000000,19,021,Buena Vista County, IA,Jan-18,11291,10997,294,2.6
CN1902100000000,19,021,Buena Vista County, IA,Feb-18,11400,11101,299,2.6
CN1902100000000,19,021,Buena Vista County, IA,Mar-18,11449,11185,264,2.3
CN1902100000000,19,021,Buena Vista County, IA,Apr-18(p),11319,11070,249,2.2
CN3007500000000,30,075,Powder River County, MT,Mar-17,989,957,32,3.2
CN3007500000000,30,075,Powder River County, MT,Apr-17,1025,1001,24,2.3
CN3007500000000,30,075,Powder River County, MT,May-17,1042,1023,19,1.8
CN3007500000000,30,075,Powder River County, MT,Jun-17,1042,1019,23,2.2
CN3007500000000,30,075,Powder River County, MT,Jul-17,1038,1018,20,1.9
CN3007500000000,30,075,Powder River County, MT,Aug-17,1016,994,22,2.2
CN3007500000000,30,075,Powder River County, MT,Sep-17,999,974,25,2.5
CN3007500000000,30,075,Powder River County, MT,Oct-17,1027,1003,24,2.3
CN3007500000000,30,075,Powder River County, MT,Nov-17,1008,983,25,2.5
CN3007500000000,30,075,Powder River County, MT,Dec-17,990,956,34,3.4
CN3007500000000,30,075,Powder River County, MT,Jan-18,996,960,36,3.6
CN3007500000000,30,075,Powder River County, MT,Feb-18,989,952,37,3.7
CN3007500000000,30,075,Powder River County, MT,Mar-18,962,925,37,3.8
CN3007500000000,30,075,Powder River County, MT,Apr-18(p),966,934,32,3.3
CN0102900000000,01,029,Cleburne County, AL,Mar-17,5750,5462,288,5.0
CN0102900000000,01,029,Cleburne County, AL,Apr-17,5726,5492,234,4.1
CN0102900000000,01,029,Cleburne County, AL,May-17,5719,5486,233,4.1
CN0102900000000,01,029,Cleburne County, AL,Jun-17,5798,5517,281,4.8
CN0102900000000,01,029,Cleburne County, AL,Jul-17,5890,5622,268,4.6
CN0102900000000,01,029,Cleburne County, AL,Aug-17,5788,5539,249,4.3
CN0102900000000,01,029,Cleburne County, AL,Sep-17,5823,5614,209,3.6
CN0102900000000,01,029,Cleburne County, AL,Oct-17,5722,5514,208,3.6
CN0102900000000,01,029,Cleburne County, AL,Nov-17,5648,5453,195,3.5
CN0102900000000,01,029,Cleburne County, AL,Dec-17,5630,5431,199,3.5
CN0102900000000,01,029,Cleburne County, AL,Jan-18,5544,5290,254,4.6
CN0102900000000,01,029,Cleburne County, AL,Feb-18,5567,5314,253,4.5
CN0102900000000,01,029,Cleburne County, AL,Mar-18,5579,5353,226,4.1
CN0102900000000,01,029,Cleburne County, AL,Apr-18(p),5617,5399,218,3.9
CN3105500000000,31,055,Douglas County, NE,Mar-17,287410,277844,9566,3.3
CN3105500000000,31,055,Douglas County, NE,Apr-17,287043,278284,8759,3.1
CN3105500000000,31,055,Douglas County, NE,May-17,287411,278700,8711,3.0
CN3105500000000,31,055,Douglas County, NE,Jun-17,288849,278999,9850,3.4
CN3105500000000,31,055,Douglas County, NE,Jul-17,292409,282193,10216,3.5
CN3105500000000,31,055,Douglas County, NE,Aug-17,289291,280158,9133,3.2
CN3105500000000,31,055,Douglas County, NE,Sep-17,287530,279037,8493,3.0
CN3105500000000,31,055,Douglas County, NE,Oct-17,289849,281796,8053,2.8
CN3105500000000,31,055,Douglas County, NE,Nov-17,290027,281993,8034,2.8
CN3105500000000,31,055,Douglas County, NE,Dec-17,288668,279996,8672,3.0
CN3105500000000,31,055,Douglas County, NE,Jan-18,285966,276623,9343,3.3
CN3105500000000,31,055,Douglas County, NE,Feb-18,289962,280728,9234,3.2
CN3105500000000,31,055,Douglas County, NE,Mar-18,290374,281024,9350,3.2
CN3105500000000,31,055,Douglas County, NE,Apr-18(p),291758,282728,9030,3.1
CN1804100000000,18,041,Fayette County, IN,Mar-17,9101,8633,468,5.1
CN1804100000000,18,041,Fayette County, IN,Apr-17,9108,8723,385,4.2
CN1804100000000,18,041,Fayette County, IN,May-17,9029,8608,421,4.7
CN1804100000000,18,041,Fayette County, IN,Jun-17,9056,8600,456,5.0
CN1804100000000,18,041,Fayette County, IN,Jul-17,8900,8405,495,5.6
CN1804100000000,18,041,Fayette County, IN,Aug-17,8975,8467,508,5.7
CN1804100000000,18,041,Fayette County, IN,Sep-17,8876,8445,431,4.9
CN1804100000000,18,041,Fayette County, IN,Oct-17,9129,8721,408,4.5
CN1804100000000,18,041,Fayette County, IN,Nov-17,9043,8624,419,4.6
CN1804100000000,18,041,Fayette County, IN,Dec-17,8970,8590,380,4.2
CN1804100000000,18,041,Fayette County, IN,Jan-18,8828,8408,420,4.8
CN1804100000000,18,041,Fayette County, IN,Feb-18,8842,8403,439,5.0
CN1804100000000,18,041,Fayette County, IN,Mar-18,8876,8482,394,4.4
CN1804100000000,18,041,Fayette County, IN,Apr-18(p),8887,8527,360,4.1
CN5108700000000,51,087,Henrico County, VA,Mar-17,182190,175319,6871,3.8
CN5108700000000,51,087,Henrico County, VA,Apr-17,182001,175683,6318,3.5
CN5108700000000,51,087,Henrico County, VA,May-17,182393,175905,6488,3.6
CN5108700000000,51,087,Henrico County, VA,Jun-17,183179,176376,6803,3.7
CN5108700000000,51,087,Henrico County, VA,Jul-17,184592,177655,6937,3.8
CN5108700000000,51,087,Henrico County, VA,Aug-17,182873,175891,6982,3.8
CN5108700000000,51,087,Henrico County, VA,Sep-17,183176,176726,6450,3.5
CN5108700000000,51,087,Henrico County, VA,Oct-17,182387,176271,6116,3.4
CN5108700000000,51,087,Henrico County, VA,Nov-17,181020,174876,6144,3.4
CN5108700000000,51,087,Henrico County, VA,Dec-17,180140,174096,6044,3.4
CN5108700000000,51,087,Henrico County, VA,Jan-18,180663,174228,6435,3.6
CN5108700000000,51,087,Henrico County, VA,Feb-18,182583,176632,5951,3.3
CN5108700000000,51,087,Henrico County, VA,Mar-18,183874,177870,6004,3.3
CN5108700000000,51,087,Henrico County, VA,Apr-18(p),183760,178534,5226,2.8
CN3500700000000,35,007,Colfax County, NM,Mar-17,5506,5174,332,6.0
CN3500700000000,35,007,Colfax County, NM,Apr-17,5170,4816,354,6.8
CN3500700000000,35,007,Colfax County, NM,May-17,5461,5125,336,6.2
CN3500700000000,35,007,Colfax County, NM,Jun-17,6494,6128,366,5.6
CN3500700000000,35,007,Colfax County, NM,Jul-17,6566,6200,366,5.6
CN3500700000000,35,007,Colfax County, NM,Aug-17,6370,6026,344,5.4
CN3500700000000,35,007,Colfax County, NM,Sep-17,5331,5002,329,6.2
CN3500700000000,35,007,Colfax County, NM,Oct-17,5298,4970,328,6.2
CN3500700000000,35,007,Colfax County, NM,Nov-17,5211,4875,336,6.4
CN3500700000000,35,007,Colfax County, NM,Dec-17,5409,5099,310,5.7
CN3500700000000,35,007,Colfax County, NM,Jan-18,5540,5225,315,5.7
CN3500700000000,35,007,Colfax County, NM,Feb-18,5387,5094,293,5.4
CN3500700000000,35,007,Colfax County, NM,Mar-18,5367,5099,268,5.0
CN3500700000000,35,007,Colfax County, NM,Apr-18(p),5114,4852,262,5.1
CN2715500000000,27,155,Traverse County, MN,Mar-17,1774,1686,88,5.0
CN2715500000000,27,155,Traverse County, MN,Apr-17,1806,1745,61,3.4
CN2715500000000,27,155,Traverse County, MN,May-17,1802,1763,39,2.2
CN2715500000000,27,155,Traverse County, MN,Jun-17,1797,1752,45,2.5
CN2715500000000,27,155,Traverse County, MN,Jul-17,1758,1712,46,2.6
CN2715500000000,27,155,Traverse County, MN,Aug-17,1695,1647,48,2.8
CN2715500000000,27,155,Traverse County, MN,Sep-17,1708,1663,45,2.6
CN2715500000000,27,155,Traverse County, MN,Oct-17,1836,1800,36,2.0
CN2715500000000,27,155,Traverse County, MN,Nov-17,1813,1761,52,2.9
CN2715500000000,27,155,Traverse County, MN,Dec-17,1834,1745,89,4.9
CN2715500000000,27,155,Traverse County, MN,Jan-18,1818,1721,97,5.3
CN2715500000000,27,155,Traverse County, MN,Feb-18,1803,1714,89,4.9
CN2715500000000,27,155,Traverse County, MN,Mar-18,1814,1730,84,4.6
CN2715500000000,27,155,Traverse County, MN,Apr-18(p),1852,1777,75,4.0
CN1917900000000,19,179,Wapello County, IA,Mar-17,17775,16980,795,4.5
CN1917900000000,19,179,Wapello County, IA,Apr-17,17548,16826,722,4.1
CN1917900000000,19,179,Wapello County, IA,May-17,17447,16747,700,4.0
CN1917900000000,19,179,Wapello County, IA,Jun-17,17753,16947,806,4.5
CN1917900000000,19,179,Wapello County, IA,Jul-17,17961,17158,803,4.5
CN1917900000000,19,179,Wapello County, IA,Aug-17,17650,16789,861,4.9
CN1917900000000,19,179,Wapello County, IA,Sep-17,17631,16756,875,5.0
CN1917900000000,19,179,Wapello County, IA,Oct-17,17526,16735,791,4.5
CN1917900000000,19,179,Wapello County, IA,Nov-17,17555,16875,680,3.9
CN1917900000000,19,179,Wapello County, IA,Dec-17,17453,16712,741,4.2
CN1917900000000,19,179,Wapello County, IA,Jan-18,17498,16677,821,4.7
CN1917900000000,19,179,Wapello County, IA,Feb-18,17575,16805,770,4.4
CN1917900000000,19,179,Wapello County, IA,Mar-18,17611,16954,657,3.7
CN1917900000000,19,179,Wapello County, IA,Apr-18(p),17510,16955,555,3.2
CN3806500000000,38,065,Oliver County, ND,Mar-17,884,839,45,5.1
CN3806500000000,38,065,Oliver County, ND,Apr-17,896,855,41,4.6
CN3806500000000,38,065,Oliver County, ND,May-17,881,855,26,3.0
CN3806500000000,38,065,Oliver County, ND,Jun-17,914,879,35,3.8
CN3806500000000,38,065,Oliver County, ND,Jul-17,906,877,29,3.2
CN3806500000000,38,065,Oliver County, ND,Aug-17,901,866,35,3.9
CN3806500000000,38,065,Oliver County, ND,Sep-17,888,857,31,3.5
CN3806500000000,38,065,Oliver County, ND,Oct-17,895,866,29,3.2
CN3806500000000,38,065,Oliver County, ND,Nov-17,880,842,38,4.3
CN3806500000000,38,065,Oliver County, ND,Dec-17,873,830,43,4.9
CN3806500000000,38,065,Oliver County, ND,Jan-18,870,817,53,6.1
CN3806500000000,38,065,Oliver County, ND,Feb-18,858,812,46,5.4
CN3806500000000,38,065,Oliver County, ND,Mar-18,862,816,46,5.3
CN3806500000000,38,065,Oliver County, ND,Apr-18(p),857,819,38,4.4
CN3200900000000,32,009,Esmeralda County, NV,Mar-17,605,585,20,3.3
CN3200900000000,32,009,Esmeralda County, NV,Apr-17,544,523,21,3.9
CN3200900000000,32,009,Esmeralda County, NV,May-17,546,528,18,3.3
CN3200900000000,32,009,Esmeralda County, NV,Jun-17,538,522,16,3.0
CN3200900000000,32,009,Esmeralda County, NV,Jul-17,503,484,19,3.8
CN3200900000000,32,009,Esmeralda County, NV,Aug-17,507,487,20,3.9
CN3200900000000,32,009,Esmeralda County, NV,Sep-17,503,484,19,3.8
CN3200900000000,32,009,Esmeralda County, NV,Oct-17,483,467,16,3.3
CN3200900000000,32,009,Esmeralda County, NV,Nov-17,501,479,22,4.4
CN3200900000000,32,009,Esmeralda County, NV,Dec-17,513,488,25,4.9
CN3200900000000,32,009,Esmeralda County, NV,Jan-18,510,488,22,4.3
CN3200900000000,32,009,Esmeralda County, NV,Feb-18,520,499,21,4.0
CN3200900000000,32,009,Esmeralda County, NV,Mar-18,557,537,20,3.6
CN3200900000000,32,009,Esmeralda County, NV,Apr-18(p),505,481,24,4.8
CN3902700000000,39,027,Clinton County, OH,Mar-17,17747,16758,989,5.6
CN3902700000000,39,027,Clinton County, OH,Apr-17,17657,16800,857,4.9
CN3902700000000,39,027,Clinton County, OH,May-17,17653,16800,853,4.8
CN3902700000000,39,027,Clinton County, OH,Jun-17,17635,16627,1008,5.7
CN3902700000000,39,027,Clinton County, OH,Jul-17,17543,16538,1005,5.7
CN3902700000000,39,027,Clinton County, OH,Aug-17,17648,16684,964,5.5
CN3902700000000,39,027,Clinton County, OH,Sep-17,17596,16702,894,5.1
CN3902700000000,39,027,Clinton County, OH,Oct-17,17606,16756,850,4.8
CN3902700000000,39,027,Clinton County, OH,Nov-17,17620,16752,868,4.9
CN3902700000000,39,027,Clinton County, OH,Dec-17,17487,16605,882,5.0
CN3902700000000,39,027,Clinton County, OH,Jan-18,17321,16325,996,5.8
CN3902700000000,39,027,Clinton County, OH,Feb-18,17711,16744,967,5.5
CN3902700000000,39,027,Clinton County, OH,Mar-18,17939,17029,910,5.1
CN3902700000000,39,027,Clinton County, OH,Apr-18(p),17760,16916,844,4.8
CN4207100000000,42,071,Lancaster County, PA,Mar-17,280042,269352,10690,3.8
CN4207100000000,42,071,Lancaster County, PA,Apr-17,281361,271905,9456,3.4
CN4207100000000,42,071,Lancaster County, PA,May-17,281974,271392,10582,3.8
CN4207100000000,42,071,Lancaster County, PA,Jun-17,285369,273823,11546,4.0
CN4207100000000,42,071,Lancaster County, PA,Jul-17,287544,275252,12292,4.3
CN4207100000000,42,071,Lancaster County, PA,Aug-17,284252,272074,12178,4.3
CN4207100000000,42,071,Lancaster County, PA,Sep-17,279976,270253,9723,3.5
CN4207100000000,42,071,Lancaster County, PA,Oct-17,276882,267543,9339,3.4
CN4207100000000,42,071,Lancaster County, PA,Nov-17,275553,266211,9342,3.4
CN4207100000000,42,071,Lancaster County, PA,Dec-17,276098,266984,9114,3.3
CN4207100000000,42,071,Lancaster County, PA,Jan-18,276386,265024,11362,4.1
CN4207100000000,42,071,Lancaster County, PA,Feb-18,277708,266573,11135,4.0
CN4207100000000,42,071,Lancaster County, PA,Mar-18,274442,265050,9392,3.4
CN4207100000000,42,071,Lancaster County, PA,Apr-18(p),275099,266738,8361,3.0
CN3115300000000,31,153,Sarpy County, NE,Mar-17,91654,89167,2487,2.7
CN3115300000000,31,153,Sarpy County, NE,Apr-17,91768,89319,2449,2.7
CN3115300000000,31,153,Sarpy County, NE,May-17,91926,89438,2488,2.7
CN3115300000000,31,153,Sarpy County, NE,Jun-17,92272,89491,2781,3.0
CN3115300000000,31,153,Sarpy County, NE,Jul-17,93398,90550,2848,3.0
CN3115300000000,31,153,Sarpy County, NE,Aug-17,92535,89910,2625,2.8
CN3115300000000,31,153,Sarpy County, NE,Sep-17,92023,89552,2471,2.7
CN3115300000000,31,153,Sarpy County, NE,Oct-17,92846,90482,2364,2.5
CN3115300000000,31,153,Sarpy County, NE,Nov-17,92805,90530,2275,2.5
CN3115300000000,31,153,Sarpy County, NE,Dec-17,92308,89867,2441,2.6
CN3115300000000,31,153,Sarpy County, NE,Jan-18,91307,88742,2565,2.8
CN3115300000000,31,153,Sarpy County, NE,Feb-18,92567,90082,2485,2.7
CN3115300000000,31,153,Sarpy County, NE,Mar-18,92657,90131,2526,2.7
CN3115300000000,31,153,Sarpy County, NE,Apr-18(p),93279,90725,2554,2.7
CN1313100000000,13,131,Grady County, GA,Mar-17,10859,10291,568,5.2
CN1313100000000,13,131,Grady County, GA,Apr-17,10797,10282,515,4.8
CN1313100000000,13,131,Grady County, GA,May-17,10807,10281,526,4.9
CN1313100000000,13,131,Grady County, GA,Jun-17,10795,10247,548,5.1
CN1313100000000,13,131,Grady County, GA,Jul-17,10628,10077,551,5.2
CN1313100000000,13,131,Grady County, GA,Aug-17,10597,10064,533,5.0
CN1313100000000,13,131,Grady County, GA,Sep-17,10703,10208,495,4.6
CN1313100000000,13,131,Grady County, GA,Oct-17,10702,10222,480,4.5
CN1313100000000,13,131,Grady County, GA,Nov-17,10690,10231,459,4.3
CN1313100000000,13,131,Grady County, GA,Dec-17,10718,10256,462,4.3
CN1313100000000,13,131,Grady County, GA,Jan-18,10868,10397,471,4.3
CN1313100000000,13,131,Grady County, GA,Feb-18,10769,10288,481,4.5
CN1313100000000,13,131,Grady County, GA,Mar-18,10772,10342,430,4.0
CN1313100000000,13,131,Grady County, GA,Apr-18(p),10675,10297,378,3.5
CN1803300000000,18,033,DeKalb County, IN,Mar-17,22137,21449,688,3.1
CN1803300000000,18,033,DeKalb County, IN,Apr-17,22137,21589,548,2.5
CN1803300000000,18,033,DeKalb County, IN,May-17,22363,21770,593,2.7
CN1803300000000,18,033,DeKalb County, IN,Jun-17,22641,21971,670,3.0
CN1803300000000,18,033,DeKalb County, IN,Jul-17,22647,21955,692,3.1
CN1803300000000,18,033,DeKalb County, IN,Aug-17,22431,21698,733,3.3
CN1803300000000,18,033,DeKalb County, IN,Sep-17,22082,21489,593,2.7
CN1803300000000,18,033,DeKalb County, IN,Oct-17,22030,21472,558,2.5
CN1803300000000,18,033,DeKalb County, IN,Nov-17,22036,21457,579,2.6
CN1803300000000,18,033,DeKalb County, IN,Dec-17,21890,21357,533,2.4
CN1803300000000,18,033,DeKalb County, IN,Jan-18,21877,21246,631,2.9
CN1803300000000,18,033,DeKalb County, IN,Feb-18,22118,21482,636,2.9
CN1803300000000,18,033,DeKalb County, IN,Mar-18,22304,21740,564,2.5
CN1803300000000,18,033,DeKalb County, IN,Apr-18(p),22449,21934,515,2.3
CN4835300000000,48,353,Nolan County, TX,Mar-17,6829,6521,308,4.5
CN4835300000000,48,353,Nolan County, TX,Apr-17,6794,6521,273,4.0
CN4835300000000,48,353,Nolan County, TX,May-17,6769,6493,276,4.1
CN4835300000000,48,353,Nolan County, TX,Jun-17,6832,6529,303,4.4
CN4835300000000,48,353,Nolan County, TX,Jul-17,6821,6534,287,4.2
CN4835300000000,48,353,Nolan County, TX,Aug-17,6838,6561,277,4.1
CN4835300000000,48,353,Nolan County, TX,Sep-17,6772,6528,244,3.6
CN4835300000000,48,353,Nolan County, TX,Oct-17,6707,6484,223,3.3
CN4835300000000,48,353,Nolan County, TX,Nov-17,6679,6459,220,3.3
CN4835300000000,48,353,Nolan County, TX,Dec-17,6665,6445,220,3.3
CN4835300000000,48,353,Nolan County, TX,Jan-18,6671,6433,238,3.6
CN4835300000000,48,353,Nolan County, TX,Feb-18,6754,6511,243,3.6
CN4835300000000,48,353,Nolan County, TX,Mar-18,6780,6541,239,3.5
CN4835300000000,48,353,Nolan County, TX,Apr-18(p),6792,6583,209,3.1
CN7207100000000,72,071,Isabela Municipio, PR,Mar-17,12905,11039,1866,14.5
CN7207100000000,72,071,Isabela Municipio, PR,Apr-17,12665,10769,1896,15.0
CN7207100000000,72,071,Isabela Municipio, PR,May-17,12592,10976,1616,12.8
CN7207100000000,72,071,Isabela Municipio, PR,Jun-17,12444,10978,1466,11.8
CN7207100000000,72,071,Isabela Municipio, PR,Jul-17,12708,11124,1584,12.5
CN7207100000000,72,071,Isabela Municipio, PR,Aug-17,12712,11013,1699,13.4
CN7207100000000,72,071,Isabela Municipio, PR,Sep-17(y),12416,10855,1561,12.6
CN7207100000000,72,071,Isabela Municipio, PR,Oct-17,12089,10423,1666,13.8
CN7207100000000,72,071,Isabela Municipio, PR,Nov-17,12848,11255,1593,12.4
CN7207100000000,72,071,Isabela Municipio, PR,Dec-17,12839,11365,1474,11.5
CN7207100000000,72,071,Isabela Municipio, PR,Jan-18,12774,11142,1632,12.8
CN7207100000000,72,071,Isabela Municipio, PR,Feb-18,12277,10772,1505,12.3
CN7207100000000,72,071,Isabela Municipio, PR,Mar-18,12333,10885,1448,11.7
CN7207100000000,72,071,Isabela Municipio, PR,Apr-18(p),12331,10984,1347,10.9
CN3006700000000,30,067,Park County, MT,Mar-17,8256,7837,419,5.1
CN3006700000000,30,067,Park County, MT,Apr-17,8385,8038,347,4.1
CN3006700000000,30,067,Park County, MT,May-17,8579,8292,287,3.3
CN3006700000000,30,067,Park County, MT,Jun-17,9108,8811,297,3.3
CN3006700000000,30,067,Park County, MT,Jul-17,9283,9000,283,3.0
CN3006700000000,30,067,Park County, MT,Aug-17,9173,8907,266,2.9
CN3006700000000,30,067,Park County, MT,Sep-17,8807,8530,277,3.1
CN3006700000000,30,067,Park County, MT,Oct-17,8735,8427,308,3.5
CN3006700000000,30,067,Park County, MT,Nov-17,8491,8084,407,4.8
CN3006700000000,30,067,Park County, MT,Dec-17,8419,7986,433,5.1
CN3006700000000,30,067,Park County, MT,Jan-18,8389,7931,458,5.5
CN3006700000000,30,067,Park County, MT,Feb-18,8369,7929,440,5.3
CN3006700000000,30,067,Park County, MT,Mar-18,8427,7981,446,5.3
CN3006700000000,30,067,Park County, MT,Apr-18(p),8513,8146,367,4.3
CN2712900000000,27,129,Renville County, MN,Mar-17,8946,8414,532,5.9
CN2712900000000,27,129,Renville County, MN,Apr-17,8957,8540,417,4.7
CN2712900000000,27,129,Renville County, MN,May-17,8837,8465,372,4.2
CN2712900000000,27,129,Renville County, MN,Jun-17,8771,8363,408,4.7
CN2712900000000,27,129,Renville County, MN,Jul-17,8721,8332,389,4.5
CN2712900000000,27,129,Renville County, MN,Aug-17,8673,8297,376,4.3
CN2712900000000,27,129,Renville County, MN,Sep-17,8694,8437,257,3.0
CN2712900000000,27,129,Renville County, MN,Oct-17,9109,8887,222,2.4
CN2712900000000,27,129,Renville County, MN,Nov-17,9038,8759,279,3.1
CN2712900000000,27,129,Renville County, MN,Dec-17,9088,8685,403,4.4
CN2712900000000,27,129,Renville County, MN,Jan-18,9463,8936,527,5.6
CN2712900000000,27,129,Renville County, MN,Feb-18,9458,8949,509,5.4
CN2712900000000,27,129,Renville County, MN,Mar-18,9548,9026,522,5.5
CN2712900000000,27,129,Renville County, MN,Apr-18(p),9471,9047,424,4.5
CN4824700000000,48,247,Jim Hogg County, TX,Mar-17,1913,1761,152,7.9
CN4824700000000,48,247,Jim Hogg County, TX,Apr-17,1907,1769,138,7.2
CN4824700000000,48,247,Jim Hogg County, TX,May-17,1888,1753,135,7.2
CN4824700000000,48,247,Jim Hogg County, TX,Jun-17,1920,1778,142,7.4
CN4824700000000,48,247,Jim Hogg County, TX,Jul-17,1885,1746,139,7.4
CN4824700000000,48,247,Jim Hogg County, TX,Aug-17,1876,1737,139,7.4
CN4824700000000,48,247,Jim Hogg County, TX,Sep-17,1919,1804,115,6.0
CN4824700000000,48,247,Jim Hogg County, TX,Oct-17,1863,1755,108,5.8
CN4824700000000,48,247,Jim Hogg County, TX,Nov-17,1860,1749,111,6.0
CN4824700000000,48,247,Jim Hogg County, TX,Dec-17,1870,1765,105,5.6
CN4824700000000,48,247,Jim Hogg County, TX,Jan-18,1849,1734,115,6.2
CN4824700000000,48,247,Jim Hogg County, TX,Feb-18,1860,1749,111,6.0
CN4824700000000,48,247,Jim Hogg County, TX,Mar-18,1868,1758,110,5.9
CN4824700000000,48,247,Jim Hogg County, TX,Apr-18(p),1889,1787,102,5.4
CN0507500000000,05,075,Lawrence County, AR,Mar-17,6970,6730,240,3.4
CN0507500000000,05,075,Lawrence County, AR,Apr-17,7003,6782,221,3.2
CN0507500000000,05,075,Lawrence County, AR,May-17,6987,6752,235,3.4
CN0507500000000,05,075,Lawrence County, AR,Jun-17,6917,6639,278,4.0
CN0507500000000,05,075,Lawrence County, AR,Jul-17,6639,6341,298,4.5
CN0507500000000,05,075,Lawrence County, AR,Aug-17,6749,6480,269,4.0
CN0507500000000,05,075,Lawrence County, AR,Sep-17,7004,6764,240,3.4
CN0507500000000,05,075,Lawrence County, AR,Oct-17,7041,6814,227,3.2
CN0507500000000,05,075,Lawrence County, AR,Nov-17,7003,6780,223,3.2
CN0507500000000,05,075,Lawrence County, AR,Dec-17,6931,6676,255,3.7
CN0507500000000,05,075,Lawrence County, AR,Jan-18,6812,6471,341,5.0
CN0507500000000,05,075,Lawrence County, AR,Feb-18,6861,6547,314,4.6
CN0507500000000,05,075,Lawrence County, AR,Mar-18,6874,6604,270,3.9
CN0507500000000,05,075,Lawrence County, AR,Apr-18(p),6871,6634,237,3.4
CN1910100000000,19,101,Jefferson County, IA,Mar-17,9129,8859,270,3.0
CN1910100000000,19,101,Jefferson County, IA,Apr-17,9069,8808,261,2.9
CN1910100000000,19,101,Jefferson County, IA,May-17,9067,8803,264,2.9
CN1910100000000,19,101,Jefferson County, IA,Jun-17,9316,9029,287,3.1
CN1910100000000,19,101,Jefferson County, IA,Jul-17,8859,8559,300,3.4
CN1910100000000,19,101,Jefferson County, IA,Aug-17,8805,8496,309,3.5
CN1910100000000,19,101,Jefferson County, IA,Sep-17,8881,8594,287,3.2
CN1910100000000,19,101,Jefferson County, IA,Oct-17,8830,8588,242,2.7
CN1910100000000,19,101,Jefferson County, IA,Nov-17,8802,8564,238,2.7
CN1910100000000,19,101,Jefferson County, IA,Dec-17,8943,8698,245,2.7
CN1910100000000,19,101,Jefferson County, IA,Jan-18,8841,8554,287,3.2
CN1910100000000,19,101,Jefferson County, IA,Feb-18,8879,8599,280,3.2
CN1910100000000,19,101,Jefferson County, IA,Mar-18,8821,8595,226,2.6
CN1910100000000,19,101,Jefferson County, IA,Apr-18(p),8801,8606,195,2.2
CN4804100000000,48,041,Brazos County, TX,Mar-17,114568,110993,3575,3.1
CN4804100000000,48,041,Brazos County, TX,Apr-17,113853,110747,3106,2.7
CN4804100000000,48,041,Brazos County, TX,May-17,113088,109784,3304,2.9
CN4804100000000,48,041,Brazos County, TX,Jun-17,108758,104846,3912,3.6
CN4804100000000,48,041,Brazos County, TX,Jul-17,110126,106271,3855,3.5
CN4804100000000,48,041,Brazos County, TX,Aug-17,108734,104968,3766,3.5
CN4804100000000,48,041,Brazos County, TX,Sep-17,116327,113089,3238,2.8
CN4804100000000,48,041,Brazos County, TX,Oct-17,117213,114222,2991,2.6
CN4804100000000,48,041,Brazos County, TX,Nov-17,117441,114311,3130,2.7
CN4804100000000,48,041,Brazos County, TX,Dec-17,116124,113161,2963,2.6
CN4804100000000,48,041,Brazos County, TX,Jan-18,115745,112316,3429,3.0
CN4804100000000,48,041,Brazos County, TX,Feb-18,119270,115831,3439,2.9
CN4804100000000,48,041,Brazos County, TX,Mar-18,119478,116016,3462,2.9
CN4804100000000,48,041,Brazos County, TX,Apr-18(p),118208,115141,3067,2.6
CN3201700000000,32,017,Lincoln County, NV,Mar-17,2280,2184,96,4.2
CN3201700000000,32,017,Lincoln County, NV,Apr-17,2066,1975,91,4.4
CN3201700000000,32,017,Lincoln County, NV,May-17,2111,2022,89,4.2
CN3201700000000,32,017,Lincoln County, NV,Jun-17,2157,2061,96,4.5
CN3201700000000,32,017,Lincoln County, NV,Jul-17,2051,1954,97,4.7
CN3201700000000,32,017,Lincoln County, NV,Aug-17,2025,1935,90,4.4
CN3201700000000,32,017,Lincoln County, NV,Sep-17,2018,1930,88,4.4
CN3201700000000,32,017,Lincoln County, NV,Oct-17,1959,1867,92,4.7
CN3201700000000,32,017,Lincoln County, NV,Nov-17,1991,1892,99,5.0
CN3201700000000,32,017,Lincoln County, NV,Dec-17,2043,1946,97,4.7
CN3201700000000,32,017,Lincoln County, NV,Jan-18,2009,1900,109,5.4
CN3201700000000,32,017,Lincoln County, NV,Feb-18,2077,1971,106,5.1
CN3201700000000,32,017,Lincoln County, NV,Mar-18,2182,2086,96,4.4
CN3201700000000,32,017,Lincoln County, NV,Apr-18(p),1993,1897,96,4.8
CN3116100000000,31,161,Sheridan County, NE,Mar-17,2667,2601,66,2.5
CN3116100000000,31,161,Sheridan County, NE,Apr-17,2727,2662,65,2.4
CN3116100000000,31,161,Sheridan County, NE,May-17,2753,2689,64,2.3
CN3116100000000,31,161,Sheridan County, NE,Jun-17,2843,2767,76,2.7
CN3116100000000,31,161,Sheridan County, NE,Jul-17,2763,2683,80,2.9
CN3116100000000,31,161,Sheridan County, NE,Aug-17,2699,2621,78,2.9
CN3116100000000,31,161,Sheridan County, NE,Sep-17,2591,2532,59,2.3
CN3116100000000,31,161,Sheridan County, NE,Oct-17,2617,2554,63,2.4
CN3116100000000,31,161,Sheridan County, NE,Nov-17,2629,2568,61,2.3
CN3116100000000,31,161,Sheridan County, NE,Dec-17,2624,2559,65,2.5
CN3116100000000,31,161,Sheridan County, NE,Jan-18,2690,2619,71,2.6
CN3116100000000,31,161,Sheridan County, NE,Feb-18,2640,2572,68,2.6
CN3116100000000,31,161,Sheridan County, NE,Mar-18,2689,2616,73,2.7
CN3116100000000,31,161,Sheridan County, NE,Apr-18(p),2710,2636,74,2.7
CN0105500000000,01,055,Etowah County, AL,Mar-17,43285,41018,2267,5.2
CN0105500000000,01,055,Etowah County, AL,Apr-17,43074,41209,1865,4.3
CN0105500000000,01,055,Etowah County, AL,May-17,43026,41234,1792,4.2
CN0105500000000,01,055,Etowah County, AL,Jun-17,43253,41089,2164,5.0
CN0105500000000,01,055,Etowah County, AL,Jul-17,42736,40728,2008,4.7
CN0105500000000,01,055,Etowah County, AL,Aug-17,42412,40524,1888,4.5
CN0105500000000,01,055,Etowah County, AL,Sep-17,42614,40978,1636,3.8
CN0105500000000,01,055,Etowah County, AL,Oct-17,42691,41062,1629,3.8
CN0105500000000,01,055,Etowah County, AL,Nov-17,42860,41330,1530,3.6
CN0105500000000,01,055,Etowah County, AL,Dec-17,42790,41287,1503,3.5
CN0105500000000,01,055,Etowah County, AL,Jan-18,42272,40460,1812,4.3
CN0105500000000,01,055,Etowah County, AL,Feb-18,42813,40904,1909,4.5
CN0105500000000,01,055,Etowah County, AL,Mar-18,43120,41385,1735,4.0
CN0105500000000,01,055,Etowah County, AL,Apr-18(p),43305,41726,1579,3.6
CN1324700000000,13,247,Rockdale County, GA,Mar-17,44434,42042,2392,5.4
CN1324700000000,13,247,Rockdale County, GA,Apr-17,44412,42146,2266,5.1
CN1324700000000,13,247,Rockdale County, GA,May-17,44508,42217,2291,5.1
CN1324700000000,13,247,Rockdale County, GA,Jun-17,44634,42174,2460,5.5
CN1324700000000,13,247,Rockdale County, GA,Jul-17,44945,42474,2471,5.5
CN1324700000000,13,247,Rockdale County, GA,Aug-17,44727,42263,2464,5.5
CN1324700000000,13,247,Rockdale County, GA,Sep-17,45095,42840,2255,5.0
CN1324700000000,13,247,Rockdale County, GA,Oct-17,44831,42663,2168,4.8
CN1324700000000,13,247,Rockdale County, GA,Nov-17,44943,42805,2138,4.8
CN1324700000000,13,247,Rockdale County, GA,Dec-17,44927,42785,2142,4.8
CN1324700000000,13,247,Rockdale County, GA,Jan-18,44949,42708,2241,5.0
CN1324700000000,13,247,Rockdale County, GA,Feb-18,45698,43426,2272,5.0
CN1324700000000,13,247,Rockdale County, GA,Mar-18,45664,43574,2090,4.6
CN1324700000000,13,247,Rockdale County, GA,Apr-18(p),45332,43463,1869,4.1
CN1814900000000,18,149,Starke County, IN,Mar-17,10424,9920,504,4.8
CN1814900000000,18,149,Starke County, IN,Apr-17,10392,10009,383,3.7
CN1814900000000,18,149,Starke County, IN,May-17,10638,10243,395,3.7
CN1814900000000,18,149,Starke County, IN,Jun-17,10745,10326,419,3.9
CN1814900000000,18,149,Starke County, IN,Jul-17,10565,10115,450,4.3
CN1814900000000,18,149,Starke County, IN,Aug-17,10540,10068,472,4.5
CN1814900000000,18,149,Starke County, IN,Sep-17,10394,9974,420,4.0
CN1814900000000,18,149,Starke County, IN,Oct-17,10418,10033,385,3.7
CN1814900000000,18,149,Starke County, IN,Nov-17,10367,9976,391,3.8
CN1814900000000,18,149,Starke County, IN,Dec-17,10232,9815,417,4.1
CN1814900000000,18,149,Starke County, IN,Jan-18,10095,9578,517,5.1
CN1814900000000,18,149,Starke County, IN,Feb-18,10222,9673,549,5.4
CN1814900000000,18,149,Starke County, IN,Mar-18,10365,9878,487,4.7
CN1814900000000,18,149,Starke County, IN,Apr-18(p),10414,10005,409,3.9
CN3606300000000,36,063,Niagara County, NY,Mar-17,101450,94599,6851,6.8
CN3606300000000,36,063,Niagara County, NY,Apr-17,100647,94593,6054,6.0
CN3606300000000,36,063,Niagara County, NY,May-17,100671,94918,5753,5.7
CN3606300000000,36,063,Niagara County, NY,Jun-17,101797,95983,5814,5.7
CN3606300000000,36,063,Niagara County, NY,Jul-17,102444,96329,6115,6.0
CN3606300000000,36,063,Niagara County, NY,Aug-17,101954,95810,6144,6.0
CN3606300000000,36,063,Niagara County, NY,Sep-17,101269,95757,5512,5.4
CN3606300000000,36,063,Niagara County, NY,Oct-17,100655,95293,5362,5.3
CN3606300000000,36,063,Niagara County, NY,Nov-17,100412,94478,5934,5.9
CN3606300000000,36,063,Niagara County, NY,Dec-17,100094,93530,6564,6.6
CN3606300000000,36,063,Niagara County, NY,Jan-18,101535,93897,7638,7.5
CN3606300000000,36,063,Niagara County, NY,Feb-18,100608,92911,7697,7.7
CN3606300000000,36,063,Niagara County, NY,Mar-18,100253,93226,7027,7.0
CN3606300000000,36,063,Niagara County, NY,Apr-18(p),99526,93594,5932,6.0
CN1716900000000,17,169,Schuyler County, IL,Mar-17,3289,3117,172,5.2
CN1716900000000,17,169,Schuyler County, IL,Apr-17,3331,3196,135,4.1
CN1716900000000,17,169,Schuyler County, IL,May-17,3318,3197,121,3.6
CN1716900000000,17,169,Schuyler County, IL,Jun-17,3388,3259,129,3.8
CN1716900000000,17,169,Schuyler County, IL,Jul-17,3318,3187,131,3.9
CN1716900000000,17,169,Schuyler County, IL,Aug-17,3251,3117,134,4.1
CN1716900000000,17,169,Schuyler County, IL,Sep-17,3324,3207,117,3.5
CN1716900000000,17,169,Schuyler County, IL,Oct-17,3298,3187,111,3.4
CN1716900000000,17,169,Schuyler County, IL,Nov-17,3233,3098,135,4.2
CN1716900000000,17,169,Schuyler County, IL,Dec-17,3197,3055,142,4.4
CN1716900000000,17,169,Schuyler County, IL,Jan-18,3220,3064,156,4.8
CN1716900000000,17,169,Schuyler County, IL,Feb-18,3216,3072,144,4.5
CN1716900000000,17,169,Schuyler County, IL,Mar-18,3280,3132,148,4.5
CN1716900000000,17,169,Schuyler County, IL,Apr-18(p),3315,3207,108,3.3
CN4609100000000,46,091,Marshall County, SD,Mar-17,2381,2231,150,6.3
CN4609100000000,46,091,Marshall County, SD,Apr-17,2420,2306,114,4.7
CN4609100000000,46,091,Marshall County, SD,May-17,2438,2344,94,3.9
CN4609100000000,46,091,Marshall County, SD,Jun-17,2551,2454,97,3.8
CN4609100000000,46,091,Marshall County, SD,Jul-17,2450,2361,89,3.6
CN4609100000000,46,091,Marshall County, SD,Aug-17,2380,2287,93,3.9
CN4609100000000,46,091,Marshall County, SD,Sep-17,2359,2268,91,3.9
CN4609100000000,46,091,Marshall County, SD,Oct-17,2297,2212,85,3.7
CN4609100000000,46,091,Marshall County, SD,Nov-17,2295,2181,114,5.0
CN4609100000000,46,091,Marshall County, SD,Dec-17,2337,2228,109,4.7
CN4609100000000,46,091,Marshall County, SD,Jan-18,2312,2188,124,5.4
CN4609100000000,46,091,Marshall County, SD,Feb-18,2340,2216,124,5.3
CN4609100000000,46,091,Marshall County, SD,Mar-18,2373,2251,122,5.1
CN4609100000000,46,091,Marshall County, SD,Apr-18(p),2348,2229,119,5.1
CN3909500000000,39,095,Lucas County, OH,Mar-17,211659,199728,11931,5.6
CN3909500000000,39,095,Lucas County, OH,Apr-17,210281,198417,11864,5.6
CN3909500000000,39,095,Lucas County, OH,May-17,212651,200036,12615,5.9
CN3909500000000,39,095,Lucas County, OH,Jun-17,213455,199452,14003,6.6
CN3909500000000,39,095,Lucas County, OH,Jul-17,213369,199070,14299,6.7
CN3909500000000,39,095,Lucas County, OH,Aug-17,211618,197673,13945,6.6
CN3909500000000,39,095,Lucas County, OH,Sep-17,212564,200107,12457,5.9
CN3909500000000,39,095,Lucas County, OH,Oct-17,211816,200776,11040,5.2
CN3909500000000,39,095,Lucas County, OH,Nov-17,211216,200691,10525,5.0
CN3909500000000,39,095,Lucas County, OH,Dec-17,210661,199887,10774,5.1
CN3909500000000,39,095,Lucas County, OH,Jan-18,207555,195853,11702,5.6
CN3909500000000,39,095,Lucas County, OH,Feb-18,208777,197748,11029,5.3
CN3909500000000,39,095,Lucas County, OH,Mar-18,209470,199428,10042,4.8
CN3909500000000,39,095,Lucas County, OH,Apr-18(p),209424,199934,9490,4.5
CN5119300000000,51,193,Westmoreland County, VA,Mar-17,8900,8440,460,5.2
CN5119300000000,51,193,Westmoreland County, VA,Apr-17,9089,8687,402,4.4
CN5119300000000,51,193,Westmoreland County, VA,May-17,9136,8746,390,4.3
CN5119300000000,51,193,Westmoreland County, VA,Jun-17,9253,8855,398,4.3
CN5119300000000,51,193,Westmoreland County, VA,Jul-17,9328,8925,403,4.3
CN5119300000000,51,193,Westmoreland County, VA,Aug-17,9084,8671,413,4.5
CN5119300000000,51,193,Westmoreland County, VA,Sep-17,9000,8627,373,4.1
CN5119300000000,51,193,Westmoreland County, VA,Oct-17,8838,8489,349,3.9
CN5119300000000,51,193,Westmoreland County, VA,Nov-17,8830,8459,371,4.2
CN5119300000000,51,193,Westmoreland County, VA,Dec-17,8920,8484,436,4.9
CN5119300000000,51,193,Westmoreland County, VA,Jan-18,8688,8223,465,5.4
CN5119300000000,51,193,Westmoreland County, VA,Feb-18,8892,8453,439,4.9
CN5119300000000,51,193,Westmoreland County, VA,Mar-18,8903,8484,419,4.7
CN5119300000000,51,193,Westmoreland County, VA,Apr-18(p),9120,8785,335,3.7
CN0508300000000,05,083,Logan County, AR,Mar-17,8913,8595,318,3.6
CN0508300000000,05,083,Logan County, AR,Apr-17,8954,8668,286,3.2
CN0508300000000,05,083,Logan County, AR,May-17,8981,8648,333,3.7
CN0508300000000,05,083,Logan County, AR,Jun-17,9180,8803,377,4.1
CN0508300000000,05,083,Logan County, AR,Jul-17,9142,8714,428,4.7
CN0508300000000,05,083,Logan County, AR,Aug-17,9021,8664,357,4.0
CN0508300000000,05,083,Logan County, AR,Sep-17,8939,8603,336,3.8
CN0508300000000,05,083,Logan County, AR,Oct-17,8894,8599,295,3.3
CN0508300000000,05,083,Logan County, AR,Nov-17,8833,8541,292,3.3
CN0508300000000,05,083,Logan County, AR,Dec-17,8807,8484,323,3.7
CN0508300000000,05,083,Logan County, AR,Jan-18,8695,8297,398,4.6
CN0508300000000,05,083,Logan County, AR,Feb-18,8796,8400,396,4.5
CN0508300000000,05,083,Logan County, AR,Mar-18,8846,8476,370,4.2
CN0508300000000,05,083,Logan County, AR,Apr-18(p),8827,8515,312,3.5
CN4842500000000,48,425,Somervell County, TX,Mar-17,4177,3994,183,4.4
CN4842500000000,48,425,Somervell County, TX,Apr-17,4179,4016,163,3.9
CN4842500000000,48,425,Somervell County, TX,May-17,4191,4008,183,4.4
CN4842500000000,48,425,Somervell County, TX,Jun-17,4236,4020,216,5.1
CN4842500000000,48,425,Somervell County, TX,Jul-17,4254,4038,216,5.1
CN4842500000000,48,425,Somervell County, TX,Aug-17,4242,4032,210,5.0
CN4842500000000,48,425,Somervell County, TX,Sep-17,4262,4082,180,4.2
CN4842500000000,48,425,Somervell County, TX,Oct-17,4213,4063,150,3.6
CN4842500000000,48,425,Somervell County, TX,Nov-17,4252,4077,175,4.1
CN4842500000000,48,425,Somervell County, TX,Dec-17,4247,4080,167,3.9
CN4842500000000,48,425,Somervell County, TX,Jan-18,4257,4058,199,4.7
CN4842500000000,48,425,Somervell County, TX,Feb-18,4305,4107,198,4.6
CN4842500000000,48,425,Somervell County, TX,Mar-18,4299,4117,182,4.2
CN4842500000000,48,425,Somervell County, TX,Apr-18(p),4319,4152,167,3.9
CN2800100000000,28,001,Adams County, MS,Mar-17,11257,10349,908,8.1
CN2800100000000,28,001,Adams County, MS,Apr-17,11118,10333,785,7.1
CN2800100000000,28,001,Adams County, MS,May-17,11247,10416,831,7.4
CN2800100000000,28,001,Adams County, MS,Jun-17,11450,10474,976,8.5
CN2800100000000,28,001,Adams County, MS,Jul-17,11307,10340,967,8.6
CN2800100000000,28,001,Adams County, MS,Aug-17,11103,10283,820,7.4
CN2800100000000,28,001,Adams County, MS,Sep-17,11114,10420,694,6.2
CN2800100000000,28,001,Adams County, MS,Oct-17,11074,10431,643,5.8
CN2800100000000,28,001,Adams County, MS,Nov-17,11081,10459,622,5.6
CN2800100000000,28,001,Adams County, MS,Dec-17,11158,10499,659,5.9
CN2800100000000,28,001,Adams County, MS,Jan-18,10973,10322,651,5.9
CN2800100000000,28,001,Adams County, MS,Feb-18,10940,10308,632,5.8
CN2800100000000,28,001,Adams County, MS,Mar-18,11030,10375,655,5.9
CN2800100000000,28,001,Adams County, MS,Apr-18(p),11040,10454,586,5.3
CN2003900000000,20,039,Decatur County, KS,Mar-17,1240,1202,38,3.1
CN2003900000000,20,039,Decatur County, KS,Apr-17,1210,1171,39,3.2
CN2003900000000,20,039,Decatur County, KS,May-17,1214,1175,39,3.2
CN2003900000000,20,039,Decatur County, KS,Jun-17,1313,1267,46,3.5
CN2003900000000,20,039,Decatur County, KS,Jul-17,1328,1280,48,3.6
CN2003900000000,20,039,Decatur County, KS,Aug-17,1319,1277,42,3.2
CN2003900000000,20,039,Decatur County, KS,Sep-17,1274,1241,33,2.6
CN2003900000000,20,039,Decatur County, KS,Oct-17,1270,1237,33,2.6
CN2003900000000,20,039,Decatur County, KS,Nov-17,1293,1259,34,2.6
CN2003900000000,20,039,Decatur County, KS,Dec-17,1291,1259,32,2.5
CN2003900000000,20,039,Decatur County, KS,Jan-18,1191,1161,30,2.5
CN2003900000000,20,039,Decatur County, KS,Feb-18,1188,1152,36,3.0
CN2003900000000,20,039,Decatur County, KS,Mar-18,1219,1184,35,2.9
CN2003900000000,20,039,Decatur County, KS,Apr-18(p),1151,1118,33,2.9
CN2009900000000,20,099,Labette County, KS,Mar-17,10420,9928,492,4.7
CN2009900000000,20,099,Labette County, KS,Apr-17,10363,9907,456,4.4
CN2009900000000,20,099,Labette County, KS,May-17,10310,9843,467,4.5
CN2009900000000,20,099,Labette County, KS,Jun-17,10422,9909,513,4.9
CN2009900000000,20,099,Labette County, KS,Jul-17,10400,9847,553,5.3
CN2009900000000,20,099,Labette County, KS,Aug-17,10199,9688,511,5.0
CN2009900000000,20,099,Labette County, KS,Sep-17,10304,9879,425,4.1
CN2009900000000,20,099,Labette County, KS,Oct-17,10295,9934,361,3.5
CN2009900000000,20,099,Labette County, KS,Nov-17,10313,9937,376,3.6
CN2009900000000,20,099,Labette County, KS,Dec-17,10316,9932,384,3.7
CN2009900000000,20,099,Labette County, KS,Jan-18,10135,9746,389,3.8
CN2009900000000,20,099,Labette County, KS,Feb-18,10230,9781,449,4.4
CN2009900000000,20,099,Labette County, KS,Mar-18,10250,9831,419,4.1
CN2009900000000,20,099,Labette County, KS,Apr-18(p),10208,9807,401,3.9
CN2002100000000,20,021,Cherokee County, KS,Mar-17,10066,9706,360,3.6
CN2002100000000,20,021,Cherokee County, KS,Apr-17,10043,9704,339,3.4
CN2002100000000,20,021,Cherokee County, KS,May-17,10004,9640,364,3.6
CN2002100000000,20,021,Cherokee County, KS,Jun-17,10200,9747,453,4.4
CN2002100000000,20,021,Cherokee County, KS,Jul-17,10314,9809,505,4.9
CN2002100000000,20,021,Cherokee County, KS,Aug-17,10148,9677,471,4.6
CN2002100000000,20,021,Cherokee County, KS,Sep-17,10263,9882,381,3.7
CN2002100000000,20,021,Cherokee County, KS,Oct-17,10244,9898,346,3.4
CN2002100000000,20,021,Cherokee County, KS,Nov-17,10271,9917,354,3.4
CN2002100000000,20,021,Cherokee County, KS,Dec-17,10271,9922,349,3.4
CN2002100000000,20,021,Cherokee County, KS,Jan-18,10222,9836,386,3.8
CN2002100000000,20,021,Cherokee County, KS,Feb-18,10282,9883,399,3.9
CN2002100000000,20,021,Cherokee County, KS,Mar-18,10116,9754,362,3.6
CN2002100000000,20,021,Cherokee County, KS,Apr-18(p),10085,9736,349,3.5
CN3401900000000,34,019,Hunterdon County, NJ,Mar-17,64874,62640,2234,3.4
CN3401900000000,34,019,Hunterdon County, NJ,Apr-17,64702,62703,1999,3.1
CN3401900000000,34,019,Hunterdon County, NJ,May-17,64977,62780,2197,3.4
CN3401900000000,34,019,Hunterdon County, NJ,Jun-17,65298,63031,2267,3.5
CN3401900000000,34,019,Hunterdon County, NJ,Jul-17,65495,62916,2579,3.9
CN3401900000000,34,019,Hunterdon County, NJ,Aug-17,64722,62231,2491,3.8
CN3401900000000,34,019,Hunterdon County, NJ,Sep-17,64397,62032,2365,3.7
CN3401900000000,34,019,Hunterdon County, NJ,Oct-17,64539,62345,2194,3.4
CN3401900000000,34,019,Hunterdon County, NJ,Nov-17,64188,62086,2102,3.3
CN3401900000000,34,019,Hunterdon County, NJ,Dec-17,64060,62073,1987,3.1
CN3401900000000,34,019,Hunterdon County, NJ,Jan-18,63803,61377,2426,3.8
CN3401900000000,34,019,Hunterdon County, NJ,Feb-18,64448,61930,2518,3.9
CN3401900000000,34,019,Hunterdon County, NJ,Mar-18,63829,61466,2363,3.7
CN3401900000000,34,019,Hunterdon County, NJ,Apr-18(p),63293,61315,1978,3.1
CN5115900000000,51,159,Richmond County, VA,Mar-17,3882,3712,170,4.4
CN5115900000000,51,159,Richmond County, VA,Apr-17,3898,3760,138,3.5
CN5115900000000,51,159,Richmond County, VA,May-17,3926,3789,137,3.5
CN5115900000000,51,159,Richmond County, VA,Jun-17,3985,3849,136,3.4
CN5115900000000,51,159,Richmond County, VA,Jul-17,3972,3831,141,3.5
CN5115900000000,51,159,Richmond County, VA,Aug-17,3904,3765,139,3.6
CN5115900000000,51,159,Richmond County, VA,Sep-17,3898,3767,131,3.4
CN5115900000000,51,159,Richmond County, VA,Oct-17,3854,3724,130,3.4
CN5115900000000,51,159,Richmond County, VA,Nov-17,3855,3714,141,3.7
CN5115900000000,51,159,Richmond County, VA,Dec-17,3875,3737,138,3.6
CN5115900000000,51,159,Richmond County, VA,Jan-18,3801,3632,169,4.4
CN5115900000000,51,159,Richmond County, VA,Feb-18,3889,3725,164,4.2
CN5115900000000,51,159,Richmond County, VA,Mar-18,3910,3759,151,3.9
CN5115900000000,51,159,Richmond County, VA,Apr-18(p),3955,3828,127,3.2
CN3702500000000,37,025,Cabarrus County, NC,Mar-17,103768,99480,4288,4.1
CN3702500000000,37,025,Cabarrus County, NC,Apr-17,103601,99660,3941,3.8
CN3702500000000,37,025,Cabarrus County, NC,May-17,104159,100032,4127,4.0
CN3702500000000,37,025,Cabarrus County, NC,Jun-17,104527,100178,4349,4.2
CN3702500000000,37,025,Cabarrus County, NC,Jul-17,105228,100641,4587,4.4
CN3702500000000,37,025,Cabarrus County, NC,Aug-17,104299,99694,4605,4.4
CN3702500000000,37,025,Cabarrus County, NC,Sep-17,105529,101391,4138,3.9
CN3702500000000,37,025,Cabarrus County, NC,Oct-17,105804,101684,4120,3.9
CN3702500000000,37,025,Cabarrus County, NC,Nov-17,105569,101224,4345,4.1
CN3702500000000,37,025,Cabarrus County, NC,Dec-17,105195,101081,4114,3.9
CN3702500000000,37,025,Cabarrus County, NC,Jan-18,105185,100777,4408,4.2
CN3702500000000,37,025,Cabarrus County, NC,Feb-18,105727,101418,4309,4.1
CN3702500000000,37,025,Cabarrus County, NC,Mar-18,106610,102438,4172,3.9
CN3702500000000,37,025,Cabarrus County, NC,Apr-18(p),106127,102544,3583,3.4
CN0511300000000,05,113,Polk County, AR,Mar-17,8086,7705,381,4.7
CN0511300000000,05,113,Polk County, AR,Apr-17,8057,7731,326,4.0
CN0511300000000,05,113,Polk County, AR,May-17,8108,7753,355,4.4
CN0511300000000,05,113,Polk County, AR,Jun-17,8318,7946,372,4.5
CN0511300000000,05,113,Polk County, AR,Jul-17,7991,7579,412,5.2
CN0511300000000,05,113,Polk County, AR,Aug-17,8117,7770,347,4.3
CN0511300000000,05,113,Polk County, AR,Sep-17,8064,7726,338,4.2
CN0511300000000,05,113,Polk County, AR,Oct-17,7905,7602,303,3.8
CN0511300000000,05,113,Polk County, AR,Nov-17,7959,7654,305,3.8
CN0511300000000,05,113,Polk County, AR,Dec-17,7905,7573,332,4.2
CN0511300000000,05,113,Polk County, AR,Jan-18,7713,7305,408,5.3
CN0511300000000,05,113,Polk County, AR,Feb-18,7983,7605,378,4.7
CN0511300000000,05,113,Polk County, AR,Mar-18,8036,7694,342,4.3
CN0511300000000,05,113,Polk County, AR,Apr-18(p),8033,7715,318,4.0
CN4612100000000,46,121,Todd County, SD,Mar-17,3096,2913,183,5.9
CN4612100000000,46,121,Todd County, SD,Apr-17,3149,2962,187,5.9
CN4612100000000,46,121,Todd County, SD,May-17,3138,2947,191,6.1
CN4612100000000,46,121,Todd County, SD,Jun-17,3218,2960,258,8.0
CN4612100000000,46,121,Todd County, SD,Jul-17,3236,2986,250,7.7
CN4612100000000,46,121,Todd County, SD,Aug-17,3262,3022,240,7.4
CN4612100000000,46,121,Todd County, SD,Sep-17,3158,2959,199,6.3
CN4612100000000,46,121,Todd County, SD,Oct-17,3215,2996,219,6.8
CN4612100000000,46,121,Todd County, SD,Nov-17,3205,2997,208,6.5
CN4612100000000,46,121,Todd County, SD,Dec-17,3175,2964,211,6.6
CN4612100000000,46,121,Todd County, SD,Jan-18,3220,3001,219,6.8
CN4612100000000,46,121,Todd County, SD,Feb-18,3187,2965,222,7.0
CN4612100000000,46,121,Todd County, SD,Mar-18,3207,2994,213,6.6
CN4612100000000,46,121,Todd County, SD,Apr-18(p),3198,2997,201,6.3
CN3602900000000,36,029,Erie County, NY,Mar-17,447659,424280,23379,5.2
CN3602900000000,36,029,Erie County, NY,Apr-17,445988,424159,21829,4.9
CN3602900000000,36,029,Erie County, NY,May-17,448259,426339,21920,4.9
CN3602900000000,36,029,Erie County, NY,Jun-17,453632,430730,22902,5.0
CN3602900000000,36,029,Erie County, NY,Jul-17,456445,432321,24124,5.3
CN3602900000000,36,029,Erie County, NY,Aug-17,453594,429927,23667,5.2
CN3602900000000,36,029,Erie County, NY,Sep-17,452018,429724,22294,4.9
CN3602900000000,36,029,Erie County, NY,Oct-17,448819,427438,21381,4.8
CN3602900000000,36,029,Erie County, NY,Nov-17,445254,422780,22474,5.0
CN3602900000000,36,029,Erie County, NY,Dec-17,442025,418858,23167,5.2
CN3602900000000,36,029,Erie County, NY,Jan-18,446179,420083,26096,5.8
CN3602900000000,36,029,Erie County, NY,Feb-18,442857,415895,26962,6.1
CN3602900000000,36,029,Erie County, NY,Mar-18,442808,418167,24641,5.6
CN3602900000000,36,029,Erie County, NY,Apr-18(p),441526,419814,21712,4.9
CN4701100000000,47,011,Bradley County, TN,Mar-17,49237,47208,2029,4.1
CN4701100000000,47,011,Bradley County, TN,Apr-17,48989,47325,1664,3.4
CN4701100000000,47,011,Bradley County, TN,May-17,49075,47489,1586,3.2
CN4701100000000,47,011,Bradley County, TN,Jun-17,49956,47819,2137,4.3
CN4701100000000,47,011,Bradley County, TN,Jul-17,50230,48223,2007,4.0
CN4701100000000,47,011,Bradley County, TN,Aug-17,50038,48177,1861,3.7
CN4701100000000,47,011,Bradley County, TN,Sep-17,50408,48793,1615,3.2
CN4701100000000,47,011,Bradley County, TN,Oct-17,50506,48955,1551,3.1
CN4701100000000,47,011,Bradley County, TN,Nov-17,51911,50357,1554,3.0
CN4701100000000,47,011,Bradley County, TN,Dec-17,52530,51039,1491,2.8
CN4701100000000,47,011,Bradley County, TN,Jan-18,49979,48150,1829,3.7
CN4701100000000,47,011,Bradley County, TN,Feb-18,50160,48367,1793,3.6
CN4701100000000,47,011,Bradley County, TN,Mar-18,49950,48218,1732,3.5
CN4701100000000,47,011,Bradley County, TN,Apr-18(p),50412,48947,1465,2.9
CN4902100000000,49,021,Iron County, UT,Mar-17,22532,21510,1022,4.5
CN4902100000000,49,021,Iron County, UT,Apr-17,22500,21558,942,4.2
CN4902100000000,49,021,Iron County, UT,May-17,21930,20939,991,4.5
CN4902100000000,49,021,Iron County, UT,Jun-17,21725,20656,1069,4.9
CN4902100000000,49,021,Iron County, UT,Jul-17,21870,20901,969,4.4
CN4902100000000,49,021,Iron County, UT,Aug-17,21931,21002,929,4.2
CN4902100000000,49,021,Iron County, UT,Sep-17,22816,21980,836,3.7
CN4902100000000,49,021,Iron County, UT,Oct-17,22896,22088,808,3.5
CN4902100000000,49,021,Iron County, UT,Nov-17,22741,21986,755,3.3
CN4902100000000,49,021,Iron County, UT,Dec-17,23006,22238,768,3.3
CN4902100000000,49,021,Iron County, UT,Jan-18,22633,21823,810,3.6
CN4902100000000,49,021,Iron County, UT,Feb-18,23126,22264,862,3.7
CN4902100000000,49,021,Iron County, UT,Mar-18,23176,22321,855,3.7
CN4902100000000,49,021,Iron County, UT,Apr-18(p),23019,22241,778,3.4
CN4708900000000,47,089,Jefferson County, TN,Mar-17,24074,23007,1067,4.4
CN4708900000000,47,089,Jefferson County, TN,Apr-17,23970,23097,873,3.6
CN4708900000000,47,089,Jefferson County, TN,May-17,23894,23086,808,3.4
CN4708900000000,47,089,Jefferson County, TN,Jun-17,23902,22872,1030,4.3
CN4708900000000,47,089,Jefferson County, TN,Jul-17,23963,22968,995,4.2
CN4708900000000,47,089,Jefferson County, TN,Aug-17,23748,22814,934,3.9
CN4708900000000,47,089,Jefferson County, TN,Sep-17,24009,23184,825,3.4
CN4708900000000,47,089,Jefferson County, TN,Oct-17,24052,23281,771,3.2
CN4708900000000,47,089,Jefferson County, TN,Nov-17,24031,23221,810,3.4
CN4708900000000,47,089,Jefferson County, TN,Dec-17,23893,23119,774,3.2
CN4708900000000,47,089,Jefferson County, TN,Jan-18,23948,22859,1089,4.5
CN4708900000000,47,089,Jefferson County, TN,Feb-18,24260,23204,1056,4.4
CN4708900000000,47,089,Jefferson County, TN,Mar-18,24206,23340,866,3.6
CN4708900000000,47,089,Jefferson County, TN,Apr-18(p),24174,23459,715,3.0
CN4813100000000,48,131,Duval County, TX,Mar-17,4884,4444,440,9.0
CN4813100000000,48,131,Duval County, TX,Apr-17,4834,4425,409,8.5
CN4813100000000,48,131,Duval County, TX,May-17,4847,4474,373,7.7
CN4813100000000,48,131,Duval County, TX,Jun-17,4847,4471,376,7.8
CN4813100000000,48,131,Duval County, TX,Jul-17,4752,4405,347,7.3
CN4813100000000,48,131,Duval County, TX,Aug-17,4729,4373,356,7.5
CN4813100000000,48,131,Duval County, TX,Sep-17,4783,4467,316,6.6
CN4813100000000,48,131,Duval County, TX,Oct-17,4763,4486,277,5.8
CN4813100000000,48,131,Duval County, TX,Nov-17,4734,4459,275,5.8
CN4813100000000,48,131,Duval County, TX,Dec-17,4681,4420,261,5.6
CN4813100000000,48,131,Duval County, TX,Jan-18,4737,4449,288,6.1
CN4813100000000,48,131,Duval County, TX,Feb-18,4802,4512,290,6.0
CN4813100000000,48,131,Duval County, TX,Mar-18,4803,4517,286,6.0
CN4813100000000,48,131,Duval County, TX,Apr-18(p),4764,4499,265,5.6
CN5405900000000,54,059,Mingo County, WV,Mar-17,6648,6062,586,8.8
CN5405900000000,54,059,Mingo County, WV,Apr-17,6745,6189,556,8.2
CN5405900000000,54,059,Mingo County, WV,May-17,6718,6174,544,8.1
CN5405900000000,54,059,Mingo County, WV,Jun-17,6901,6263,638,9.2
CN5405900000000,54,059,Mingo County, WV,Jul-17,6828,6209,619,9.1
CN5405900000000,54,059,Mingo County, WV,Aug-17,6815,6199,616,9.0
CN5405900000000,54,059,Mingo County, WV,Sep-17,6812,6296,516,7.6
CN5405900000000,54,059,Mingo County, WV,Oct-17,6819,6288,531,7.8
CN5405900000000,54,059,Mingo County, WV,Nov-17,6747,6211,536,7.9
CN5405900000000,54,059,Mingo County, WV,Dec-17,6676,6140,536,8.0
CN5405900000000,54,059,Mingo County, WV,Jan-18,6749,6203,546,8.1
CN5405900000000,54,059,Mingo County, WV,Feb-18,6841,6209,632,9.2
CN5405900000000,54,059,Mingo County, WV,Mar-18,6739,6160,579,8.6
CN5405900000000,54,059,Mingo County, WV,Apr-18(p),6778,6226,552,8.1
CN5503900000000,55,039,Fond du Lac County, WI,Mar-17,57030,55311,1719,3.0
CN5503900000000,55,039,Fond du Lac County, WI,Apr-17,57092,55649,1443,2.5
CN5503900000000,55,039,Fond du Lac County, WI,May-17,57165,55668,1497,2.6
CN5503900000000,55,039,Fond du Lac County, WI,Jun-17,58492,56541,1951,3.3
CN5503900000000,55,039,Fond du Lac County, WI,Jul-17,58395,56594,1801,3.1
CN5503900000000,55,039,Fond du Lac County, WI,Aug-17,57640,55891,1749,3.0
CN5503900000000,55,039,Fond du Lac County, WI,Sep-17,57959,56554,1405,2.4
CN5503900000000,55,039,Fond du Lac County, WI,Oct-17,57792,56438,1354,2.3
CN5503900000000,55,039,Fond du Lac County, WI,Nov-17,58016,56665,1351,2.3
CN5503900000000,55,039,Fond du Lac County, WI,Dec-17,57560,56278,1282,2.2
CN5503900000000,55,039,Fond du Lac County, WI,Jan-18,57243,55688,1555,2.7
CN5503900000000,55,039,Fond du Lac County, WI,Feb-18,57866,56148,1718,3.0
CN5503900000000,55,039,Fond du Lac County, WI,Mar-18,58332,56744,1588,2.7
CN5503900000000,55,039,Fond du Lac County, WI,Apr-18(p),58094,56770,1324,2.3
CN0807300000000,08,073,Lincoln County, CO,Mar-17,2266,2221,45,2.0
CN0807300000000,08,073,Lincoln County, CO,Apr-17,2345,2304,41,1.7
CN0807300000000,08,073,Lincoln County, CO,May-17,2384,2341,43,1.8
CN0807300000000,08,073,Lincoln County, CO,Jun-17,2488,2435,53,2.1
CN0807300000000,08,073,Lincoln County, CO,Jul-17,2465,2416,49,2.0
CN0807300000000,08,073,Lincoln County, CO,Aug-17,2442,2390,52,2.1
CN0807300000000,08,073,Lincoln County, CO,Sep-17,2417,2368,49,2.0
CN0807300000000,08,073,Lincoln County, CO,Oct-17,2523,2466,57,2.3
CN0807300000000,08,073,Lincoln County, CO,Nov-17,2491,2434,57,2.3
CN0807300000000,08,073,Lincoln County, CO,Dec-17,2474,2415,59,2.4
CN0807300000000,08,073,Lincoln County, CO,Jan-18,2420,2356,64,2.6
CN0807300000000,08,073,Lincoln County, CO,Feb-18,2369,2308,61,2.6
CN0807300000000,08,073,Lincoln County, CO,Mar-18,2389,2339,50,2.1
CN0807300000000,08,073,Lincoln County, CO,Apr-18(p),2447,2401,46,1.9
CN4102300000000,41,023,Grant County, OR,Mar-17,3071,2772,299,9.7
CN4102300000000,41,023,Grant County, OR,Apr-17,3074,2820,254,8.3
CN4102300000000,41,023,Grant County, OR,May-17,3103,2903,200,6.4
CN4102300000000,41,023,Grant County, OR,Jun-17,3297,3134,163,4.9
CN4102300000000,41,023,Grant County, OR,Jul-17,3335,3174,161,4.8
CN4102300000000,41,023,Grant County, OR,Aug-17,3394,3207,187,5.5
CN4102300000000,41,023,Grant County, OR,Sep-17,3287,3143,144,4.4
CN4102300000000,41,023,Grant County, OR,Oct-17,3186,3040,146,4.6
CN4102300000000,41,023,Grant County, OR,Nov-17,3095,2919,176,5.7
CN4102300000000,41,023,Grant County, OR,Dec-17,3098,2859,239,7.7
CN4102300000000,41,023,Grant County, OR,Jan-18,3094,2773,321,10.4
CN4102300000000,41,023,Grant County, OR,Feb-18,3101,2778,323,10.4
CN4102300000000,41,023,Grant County, OR,Mar-18,3054,2750,304,10.0
CN4102300000000,41,023,Grant County, OR,Apr-18(p),3025,2780,245,8.1
CN1602300000000,16,023,Butte County, ID,Mar-17,1273,1224,49,3.8
CN1602300000000,16,023,Butte County, ID,Apr-17,1298,1263,35,2.7
CN1602300000000,16,023,Butte County, ID,May-17,1325,1294,31,2.3
CN1602300000000,16,023,Butte County, ID,Jun-17,1340,1299,41,3.1
CN1602300000000,16,023,Butte County, ID,Jul-17,1342,1301,41,3.1
CN1602300000000,16,023,Butte County, ID,Aug-17,1335,1300,35,2.6
CN1602300000000,16,023,Butte County, ID,Sep-17,1311,1283,28,2.1
CN1602300000000,16,023,Butte County, ID,Oct-17,1368,1339,29,2.1
CN1602300000000,16,023,Butte County, ID,Nov-17,1325,1282,43,3.2
CN1602300000000,16,023,Butte County, ID,Dec-17,1312,1272,40,3.0
CN1602300000000,16,023,Butte County, ID,Jan-18,1319,1261,58,4.4
CN1602300000000,16,023,Butte County, ID,Feb-18,1327,1270,57,4.3
CN1602300000000,16,023,Butte County, ID,Mar-18,1334,1274,60,4.5
CN1602300000000,16,023,Butte County, ID,Apr-18(p),1358,1302,56,4.1
CN1201100000000,12,011,Broward County, FL,Mar-17,1024016,984259,39757,3.9
CN1201100000000,12,011,Broward County, FL,Apr-17,1020659,982750,37909,3.7
CN1201100000000,12,011,Broward County, FL,May-17,1029243,990130,39113,3.8
CN1201100000000,12,011,Broward County, FL,Jun-17,1033144,991391,41753,4.0
CN1201100000000,12,011,Broward County, FL,Jul-17,1033963,991944,42019,4.1
CN1201100000000,12,011,Broward County, FL,Aug-17,1028811,987655,41156,4.0
CN1201100000000,12,011,Broward County, FL,Sep-17,1035384,996974,38410,3.7
CN1201100000000,12,011,Broward County, FL,Oct-17,1031719,994779,36940,3.6
CN1201100000000,12,011,Broward County, FL,Nov-17,1028382,991379,37003,3.6
CN1201100000000,12,011,Broward County, FL,Dec-17,1022607,987871,34736,3.4
CN1201100000000,12,011,Broward County, FL,Jan-18,1028673,989144,39529,3.8
CN1201100000000,12,011,Broward County, FL,Feb-18,1036107,999578,36529,3.5
CN1201100000000,12,011,Broward County, FL,Mar-18,1036812,1000624,36188,3.5
CN1201100000000,12,011,Broward County, FL,Apr-18(p),1032334,999530,32804,3.2
CN3708500000000,37,085,Harnett County, NC,Mar-17,52837,50146,2691,5.1
CN3708500000000,37,085,Harnett County, NC,Apr-17,52493,50052,2441,4.7
CN3708500000000,37,085,Harnett County, NC,May-17,52404,49873,2531,4.8
CN3708500000000,37,085,Harnett County, NC,Jun-17,52552,49851,2701,5.1
CN3708500000000,37,085,Harnett County, NC,Jul-17,52533,49672,2861,5.4
CN3708500000000,37,085,Harnett County, NC,Aug-17,52136,49224,2912,5.6
CN3708500000000,37,085,Harnett County, NC,Sep-17,53146,50569,2577,4.8
CN3708500000000,37,085,Harnett County, NC,Oct-17,53015,50472,2543,4.8
CN3708500000000,37,085,Harnett County, NC,Nov-17,53059,50388,2671,5.0
CN3708500000000,37,085,Harnett County, NC,Dec-17,52499,49891,2608,5.0
CN3708500000000,37,085,Harnett County, NC,Jan-18,52895,50097,2798,5.3
CN3708500000000,37,085,Harnett County, NC,Feb-18,53297,50531,2766,5.2
CN3708500000000,37,085,Harnett County, NC,Mar-18,53534,50864,2670,5.0
CN3708500000000,37,085,Harnett County, NC,Apr-18(p),53309,51018,2291,4.3
CN2905900000000,29,059,Dallas County, MO,Mar-17,6933,6582,351,5.1
CN2905900000000,29,059,Dallas County, MO,Apr-17,7051,6719,332,4.7
CN2905900000000,29,059,Dallas County, MO,May-17,6964,6634,330,4.7
CN2905900000000,29,059,Dallas County, MO,Jun-17,6976,6643,333,4.8
CN2905900000000,29,059,Dallas County, MO,Jul-17,6970,6638,332,4.8
CN2905900000000,29,059,Dallas County, MO,Aug-17,6857,6492,365,5.3
CN2905900000000,29,059,Dallas County, MO,Sep-17,6905,6601,304,4.4
CN2905900000000,29,059,Dallas County, MO,Oct-17,6844,6632,212,3.1
CN2905900000000,29,059,Dallas County, MO,Nov-17,6888,6601,287,4.2
CN2905900000000,29,059,Dallas County, MO,Dec-17,6861,6573,288,4.2
CN2905900000000,29,059,Dallas County, MO,Jan-18,6862,6530,332,4.8
CN2905900000000,29,059,Dallas County, MO,Feb-18,6977,6618,359,5.1
CN2905900000000,29,059,Dallas County, MO,Mar-18,6918,6593,325,4.7
CN2905900000000,29,059,Dallas County, MO,Apr-18(p),6957,6671,286,4.1
CN2807900000000,28,079,Leake County, MS,Mar-17,7853,7403,450,5.7
CN2807900000000,28,079,Leake County, MS,Apr-17,7830,7426,404,5.2
CN2807900000000,28,079,Leake County, MS,May-17,7746,7279,467,6.0
CN2807900000000,28,079,Leake County, MS,Jun-17,7800,7309,491,6.3
CN2807900000000,28,079,Leake County, MS,Jul-17,7780,7289,491,6.3
CN2807900000000,28,079,Leake County, MS,Aug-17,7642,7225,417,5.5
CN2807900000000,28,079,Leake County, MS,Sep-17,7665,7280,385,5.0
CN2807900000000,28,079,Leake County, MS,Oct-17,7547,7180,367,4.9
CN2807900000000,28,079,Leake County, MS,Nov-17,7446,7096,350,4.7
CN2807900000000,28,079,Leake County, MS,Dec-17,7457,7093,364,4.9
CN2807900000000,28,079,Leake County, MS,Jan-18,7399,7036,363,4.9
CN2807900000000,28,079,Leake County, MS,Feb-18,7480,7108,372,5.0
CN2807900000000,28,079,Leake County, MS,Mar-18,7573,7232,341,4.5
CN2807900000000,28,079,Leake County, MS,Apr-18(p),7585,7248,337,4.4
CN7201100000000,72,011,Anasco Municipio, PR,Mar-17,9202,8003,1199,13.0
CN7201100000000,72,011,Anasco Municipio, PR,Apr-17,9160,7900,1260,13.8
CN7201100000000,72,011,Anasco Municipio, PR,May-17,9042,7897,1145,12.7
CN7201100000000,72,011,Anasco Municipio, PR,Jun-17,8830,7842,988,11.2
CN7201100000000,72,011,Anasco Municipio, PR,Jul-17,8818,7825,993,11.3
CN7201100000000,72,011,Anasco Municipio, PR,Aug-17,8860,7749,1111,12.5
CN7201100000000,72,011,Anasco Municipio, PR,Sep-17(y),8932,7778,1154,12.9
CN7201100000000,72,011,Anasco Municipio, PR,Oct-17,8704,7566,1138,13.1
CN7201100000000,72,011,Anasco Municipio, PR,Nov-17,9040,8010,1030,11.4
CN7201100000000,72,011,Anasco Municipio, PR,Dec-17,9066,8082,984,10.9
CN7201100000000,72,011,Anasco Municipio, PR,Jan-18,8968,7950,1018,11.4
CN7201100000000,72,011,Anasco Municipio, PR,Feb-18,8850,7919,931,10.5
CN7201100000000,72,011,Anasco Municipio, PR,Mar-18,8875,7958,917,10.3
CN7201100000000,72,011,Anasco Municipio, PR,Apr-18(p),8855,8008,847,9.6
CN3000700000000,30,007,Broadwater County, MT,Mar-17,2571,2422,149,5.8
CN3000700000000,30,007,Broadwater County, MT,Apr-17,2561,2440,121,4.7
CN3000700000000,30,007,Broadwater County, MT,May-17,2583,2481,102,3.9
CN3000700000000,30,007,Broadwater County, MT,Jun-17,2594,2480,114,4.4
CN3000700000000,30,007,Broadwater County, MT,Jul-17,2616,2511,105,4.0
CN3000700000000,30,007,Broadwater County, MT,Aug-17,2668,2559,109,4.1
CN3000700000000,30,007,Broadwater County, MT,Sep-17,2557,2450,107,4.2
CN3000700000000,30,007,Broadwater County, MT,Oct-17,2564,2458,106,4.1
CN3000700000000,30,007,Broadwater County, MT,Nov-17,2564,2448,116,4.5
CN3000700000000,30,007,Broadwater County, MT,Dec-17,2517,2396,121,4.8
CN3000700000000,30,007,Broadwater County, MT,Jan-18,2540,2403,137,5.4
CN3000700000000,30,007,Broadwater County, MT,Feb-18,2545,2404,141,5.5
CN3000700000000,30,007,Broadwater County, MT,Mar-18,2549,2421,128,5.0
CN3000700000000,30,007,Broadwater County, MT,Apr-18(p),2519,2423,96,3.8
CN2916500000000,29,165,Platte County, MO,Mar-17,56904,54668,2236,3.9
CN2916500000000,29,165,Platte County, MO,Apr-17,56519,54990,1529,2.7
CN2916500000000,29,165,Platte County, MO,May-17,56590,54967,1623,2.9
CN2916500000000,29,165,Platte County, MO,Jun-17,57140,55425,1715,3.0
CN2916500000000,29,165,Platte County, MO,Jul-17,57941,55936,2005,3.5
CN2916500000000,29,165,Platte County, MO,Aug-17,57388,55082,2306,4.0
CN2916500000000,29,165,Platte County, MO,Sep-17,57048,55560,1488,2.6
CN2916500000000,29,165,Platte County, MO,Oct-17,56967,55369,1598,2.8
CN2916500000000,29,165,Platte County, MO,Nov-17,56524,55091,1433,2.5
CN2916500000000,29,165,Platte County, MO,Dec-17,56399,54943,1456,2.6
CN2916500000000,29,165,Platte County, MO,Jan-18,56296,54294,2002,3.6
CN2916500000000,29,165,Platte County, MO,Feb-18,56418,54781,1637,2.9
CN2916500000000,29,165,Platte County, MO,Mar-18,56531,54901,1630,2.9
CN2916500000000,29,165,Platte County, MO,Apr-18(p),56595,55131,1464,2.6
CN3700900000000,37,009,Ashe County, NC,Mar-17,12636,12085,551,4.4
CN3700900000000,37,009,Ashe County, NC,Apr-17,12728,12271,457,3.6
CN3700900000000,37,009,Ashe County, NC,May-17,12769,12271,498,3.9
CN3700900000000,37,009,Ashe County, NC,Jun-17,12547,12033,514,4.1
CN3700900000000,37,009,Ashe County, NC,Jul-17,12712,12157,555,4.4
CN3700900000000,37,009,Ashe County, NC,Aug-17,12767,12221,546,4.3
CN3700900000000,37,009,Ashe County, NC,Sep-17,12914,12436,478,3.7
CN3700900000000,37,009,Ashe County, NC,Oct-17,12943,12465,478,3.7
CN3700900000000,37,009,Ashe County, NC,Nov-17,12950,12442,508,3.9
CN3700900000000,37,009,Ashe County, NC,Dec-17,12695,12191,504,4.0
CN3700900000000,37,009,Ashe County, NC,Jan-18,12601,12028,573,4.5
CN3700900000000,37,009,Ashe County, NC,Feb-18,12777,12177,600,4.7
CN3700900000000,37,009,Ashe County, NC,Mar-18,12679,12136,543,4.3
CN3700900000000,37,009,Ashe County, NC,Apr-18(p),12861,12419,442,3.4
CN3711500000000,37,115,Madison County, NC,Mar-17,9855,9410,445,4.5
CN3711500000000,37,115,Madison County, NC,Apr-17,9808,9425,383,3.9
CN3711500000000,37,115,Madison County, NC,May-17,9849,9445,404,4.1
CN3711500000000,37,115,Madison County, NC,Jun-17,9860,9427,433,4.4
CN3711500000000,37,115,Madison County, NC,Jul-17,9971,9514,457,4.6
CN3711500000000,37,115,Madison County, NC,Aug-17,9840,9382,458,4.7
CN3711500000000,37,115,Madison County, NC,Sep-17,9975,9584,391,3.9
CN3711500000000,37,115,Madison County, NC,Oct-17,9962,9574,388,3.9
CN3711500000000,37,115,Madison County, NC,Nov-17,9946,9544,402,4.0
CN3711500000000,37,115,Madison County, NC,Dec-17,9869,9479,390,4.0
CN3711500000000,37,115,Madison County, NC,Jan-18,9915,9477,438,4.4
CN3711500000000,37,115,Madison County, NC,Feb-18,9992,9537,455,4.6
CN3711500000000,37,115,Madison County, NC,Mar-18,9984,9558,426,4.3
CN3711500000000,37,115,Madison County, NC,Apr-18(p),9985,9623,362,3.6
CN3800500000000,38,005,Benson County, ND,Mar-17,2426,2308,118,4.9
CN3800500000000,38,005,Benson County, ND,Apr-17,2380,2285,95,4.0
CN3800500000000,38,005,Benson County, ND,May-17,2415,2341,74,3.1
CN3800500000000,38,005,Benson County, ND,Jun-17,2426,2338,88,3.6
CN3800500000000,38,005,Benson County, ND,Jul-17,2383,2311,72,3.0
CN3800500000000,38,005,Benson County, ND,Aug-17,2409,2342,67,2.8
CN3800500000000,38,005,Benson County, ND,Sep-17,2452,2388,64,2.6
CN3800500000000,38,005,Benson County, ND,Oct-17,2456,2398,58,2.4
CN3800500000000,38,005,Benson County, ND,Nov-17,2379,2312,67,2.8
CN3800500000000,38,005,Benson County, ND,Dec-17,2355,2271,84,3.6
CN3800500000000,38,005,Benson County, ND,Jan-18,2266,2160,106,4.7
CN3800500000000,38,005,Benson County, ND,Feb-18,2236,2123,113,5.1
CN3800500000000,38,005,Benson County, ND,Mar-18,2263,2153,110,4.9
CN3800500000000,38,005,Benson County, ND,Apr-18(p),2241,2137,104,4.6
CN1331900000000,13,319,Wilkinson County, GA,Mar-17,3742,3516,226,6.0
CN1331900000000,13,319,Wilkinson County, GA,Apr-17,3872,3644,228,5.9
CN1331900000000,13,319,Wilkinson County, GA,May-17,3828,3614,214,5.6
CN1331900000000,13,319,Wilkinson County, GA,Jun-17,3910,3686,224,5.7
CN1331900000000,13,319,Wilkinson County, GA,Jul-17,3887,3668,219,5.6
CN1331900000000,13,319,Wilkinson County, GA,Aug-17,3871,3658,213,5.5
CN1331900000000,13,319,Wilkinson County, GA,Sep-17,3895,3697,198,5.1
CN1331900000000,13,319,Wilkinson County, GA,Oct-17,3911,3707,204,5.2
CN1331900000000,13,319,Wilkinson County, GA,Nov-17,3894,3695,199,5.1
CN1331900000000,13,319,Wilkinson County, GA,Dec-17,3891,3688,203,5.2
CN1331900000000,13,319,Wilkinson County, GA,Jan-18,3965,3734,231,5.8
CN1331900000000,13,319,Wilkinson County, GA,Feb-18,3948,3755,193,4.9
CN1331900000000,13,319,Wilkinson County, GA,Mar-18,3942,3767,175,4.4
CN1331900000000,13,319,Wilkinson County, GA,Apr-18(p),3938,3783,155,3.9
CN4200300000000,42,003,Allegheny County, PA,Mar-17,644540,611957,32583,5.1
CN4200300000000,42,003,Allegheny County, PA,Apr-17,645042,616631,28411,4.4
CN4200300000000,42,003,Allegheny County, PA,May-17,647077,616207,30870,4.8
CN4200300000000,42,003,Allegheny County, PA,Jun-17,650199,618024,32175,4.9
CN4200300000000,42,003,Allegheny County, PA,Jul-17,654254,620895,33359,5.1
CN4200300000000,42,003,Allegheny County, PA,Aug-17,647267,614138,33129,5.1
CN4200300000000,42,003,Allegheny County, PA,Sep-17,646104,618544,27560,4.3
CN4200300000000,42,003,Allegheny County, PA,Oct-17,642634,616182,26452,4.1
CN4200300000000,42,003,Allegheny County, PA,Nov-17,646320,619371,26949,4.2
CN4200300000000,42,003,Allegheny County, PA,Dec-17,641889,615437,26452,4.1
CN4200300000000,42,003,Allegheny County, PA,Jan-18,639327,607944,31383,4.9
CN4200300000000,42,003,Allegheny County, PA,Feb-18,638850,607798,31052,4.9
CN4200300000000,42,003,Allegheny County, PA,Mar-18,633529,606180,27349,4.3
CN4200300000000,42,003,Allegheny County, PA,Apr-18(p),636381,612550,23831,3.7
CN4603100000000,46,031,Corson County, SD,Mar-17,1416,1369,47,3.3
CN4603100000000,46,031,Corson County, SD,Apr-17,1432,1380,52,3.6
CN4603100000000,46,031,Corson County, SD,May-17,1476,1420,56,3.8
CN4603100000000,46,031,Corson County, SD,Jun-17,1512,1429,83,5.5
CN4603100000000,46,031,Corson County, SD,Jul-17,1433,1355,78,5.4
CN4603100000000,46,031,Corson County, SD,Aug-17,1404,1325,79,5.6
CN4603100000000,46,031,Corson County, SD,Sep-17,1409,1350,59,4.2
CN4603100000000,46,031,Corson County, SD,Oct-17,1388,1333,55,4.0
CN4603100000000,46,031,Corson County, SD,Nov-17,1379,1325,54,3.9
CN4603100000000,46,031,Corson County, SD,Dec-17,1408,1357,51,3.6
CN4603100000000,46,031,Corson County, SD,Jan-18,1414,1363,51,3.6
CN4603100000000,46,031,Corson County, SD,Feb-18,1404,1349,55,3.9
CN4603100000000,46,031,Corson County, SD,Mar-18,1425,1372,53,3.7
CN4603100000000,46,031,Corson County, SD,Apr-18(p),1373,1318,55,4.0
CN0402700000000,04,027,Yuma County, AZ,Mar-17,94577,81975,12602,13.3
CN0402700000000,04,027,Yuma County, AZ,Apr-17,94052,78791,15261,16.2
CN0402700000000,04,027,Yuma County, AZ,May-17,94379,78151,16228,17.2
CN0402700000000,04,027,Yuma County, AZ,Jun-17,94927,76673,18254,19.2
CN0402700000000,04,027,Yuma County, AZ,Jul-17,96351,75625,20726,21.5
CN0402700000000,04,027,Yuma County, AZ,Aug-17,97508,75672,21836,22.4
CN0402700000000,04,027,Yuma County, AZ,Sep-17,96421,78150,18271,18.9
CN0402700000000,04,027,Yuma County, AZ,Oct-17,98069,81035,17034,17.4
CN0402700000000,04,027,Yuma County, AZ,Nov-17,95215,80849,14366,15.1
CN0402700000000,04,027,Yuma County, AZ,Dec-17,96283,82394,13889,14.4
CN0402700000000,04,027,Yuma County, AZ,Jan-18,93200,79543,13657,14.7
CN0402700000000,04,027,Yuma County, AZ,Feb-18,90617,78388,12229,13.5
CN0402700000000,04,027,Yuma County, AZ,Mar-18,93893,81131,12762,13.6
CN0402700000000,04,027,Yuma County, AZ,Apr-18(p),90527,76271,14256,15.7
CN0609700000000,06,097,Sonoma County, CA,Mar-17,261718,252180,9538,3.6
CN0609700000000,06,097,Sonoma County, CA,Apr-17,262094,253456,8638,3.3
CN0609700000000,06,097,Sonoma County, CA,May-17,262413,254449,7964,3.0
CN0609700000000,06,097,Sonoma County, CA,Jun-17,263195,254127,9068,3.4
CN0609700000000,06,097,Sonoma County, CA,Jul-17,263774,254140,9634,3.7
CN0609700000000,06,097,Sonoma County, CA,Aug-17,264707,255518,9189,3.5
CN0609700000000,06,097,Sonoma County, CA,Sep-17,267197,259473,7724,2.9
CN0609700000000,06,097,Sonoma County, CA,Oct-17,263884,255974,7910,3.0
CN0609700000000,06,097,Sonoma County, CA,Nov-17,262119,254309,7810,3.0
CN0609700000000,06,097,Sonoma County, CA,Dec-17,262817,255330,7487,2.8
CN0609700000000,06,097,Sonoma County, CA,Jan-18,262693,254297,8396,3.2
CN0609700000000,06,097,Sonoma County, CA,Feb-18,263847,255846,8001,3.0
CN0609700000000,06,097,Sonoma County, CA,Mar-18,262998,255603,7395,2.8
CN0609700000000,06,097,Sonoma County, CA,Apr-18(p),260819,254178,6641,2.5
CN1916100000000,19,161,Sac County, IA,Mar-17,5238,5030,208,4.0
CN1916100000000,19,161,Sac County, IA,Apr-17,5315,5174,141,2.7
CN1916100000000,19,161,Sac County, IA,May-17,5403,5276,127,2.4
CN1916100000000,19,161,Sac County, IA,Jun-17,5516,5381,135,2.4
CN1916100000000,19,161,Sac County, IA,Jul-17,5538,5402,136,2.5
CN1916100000000,19,161,Sac County, IA,Aug-17,5426,5284,142,2.6
CN1916100000000,19,161,Sac County, IA,Sep-17,5390,5259,131,2.4
CN1916100000000,19,161,Sac County, IA,Oct-17,5403,5295,108,2.0
CN1916100000000,19,161,Sac County, IA,Nov-17,5322,5217,105,2.0
CN1916100000000,19,161,Sac County, IA,Dec-17,5274,5155,119,2.3
CN1916100000000,19,161,Sac County, IA,Jan-18,5235,5028,207,4.0
CN1916100000000,19,161,Sac County, IA,Feb-18,5288,5085,203,3.8
CN1916100000000,19,161,Sac County, IA,Mar-18,5216,5045,171,3.3
CN1916100000000,19,161,Sac County, IA,Apr-18(p),5224,5087,137,2.6
CN4503500000000,45,035,Dorchester County, SC,Mar-17,73967,71304,2663,3.6
CN4503500000000,45,035,Dorchester County, SC,Apr-17,74079,71603,2476,3.3
CN4503500000000,45,035,Dorchester County, SC,May-17,74381,71819,2562,3.4
CN4503500000000,45,035,Dorchester County, SC,Jun-17,75145,72108,3037,4.0
CN4503500000000,45,035,Dorchester County, SC,Jul-17,75509,72545,2964,3.9
CN4503500000000,45,035,Dorchester County, SC,Aug-17,74854,71684,3170,4.2
CN4503500000000,45,035,Dorchester County, SC,Sep-17,74330,71470,2860,3.8
CN4503500000000,45,035,Dorchester County, SC,Oct-17,74397,71579,2818,3.8
CN4503500000000,45,035,Dorchester County, SC,Nov-17,74171,71490,2681,3.6
CN4503500000000,45,035,Dorchester County, SC,Dec-17,73413,70692,2721,3.7
CN4503500000000,45,035,Dorchester County, SC,Jan-18,73469,70203,3266,4.4
CN4503500000000,45,035,Dorchester County, SC,Feb-18,74089,71126,2963,4.0
CN4503500000000,45,035,Dorchester County, SC,Mar-18,74420,71746,2674,3.6
CN4503500000000,45,035,Dorchester County, SC,Apr-18(p),73324,71540,1784,2.4
CN1309300000000,13,093,Dooly County, GA,Mar-17,5044,4772,272,5.4
CN1309300000000,13,093,Dooly County, GA,Apr-17,5008,4761,247,4.9
CN1309300000000,13,093,Dooly County, GA,May-17,5066,4811,255,5.0
CN1309300000000,13,093,Dooly County, GA,Jun-17,5147,4875,272,5.3
CN1309300000000,13,093,Dooly County, GA,Jul-17,5097,4823,274,5.4
CN1309300000000,13,093,Dooly County, GA,Aug-17,5078,4805,273,5.4
CN1309300000000,13,093,Dooly County, GA,Sep-17,5082,4839,243,4.8
CN1309300000000,13,093,Dooly County, GA,Oct-17,5187,4913,274,5.3
CN1309300000000,13,093,Dooly County, GA,Nov-17,5134,4900,234,4.6
CN1309300000000,13,093,Dooly County, GA,Dec-17,5207,4980,227,4.4
CN1309300000000,13,093,Dooly County, GA,Jan-18,5249,4987,262,5.0
CN1309300000000,13,093,Dooly County, GA,Feb-18,5097,4856,241,4.7
CN1309300000000,13,093,Dooly County, GA,Mar-18,5067,4842,225,4.4
CN1309300000000,13,093,Dooly County, GA,Apr-18(p),5050,4855,195,3.9
CN5404100000000,54,041,Lewis County, WV,Mar-17,6442,5944,498,7.7
CN5404100000000,54,041,Lewis County, WV,Apr-17,6576,6129,447,6.8
CN5404100000000,54,041,Lewis County, WV,May-17,6557,6174,383,5.8
CN5404100000000,54,041,Lewis County, WV,Jun-17,6800,6392,408,6.0
CN5404100000000,54,041,Lewis County, WV,Jul-17,6623,6227,396,6.0
CN5404100000000,54,041,Lewis County, WV,Aug-17,6654,6243,411,6.2
CN5404100000000,54,041,Lewis County, WV,Sep-17,6531,6171,360,5.5
CN5404100000000,54,041,Lewis County, WV,Oct-17,6421,6055,366,5.7
CN5404100000000,54,041,Lewis County, WV,Nov-17,6345,5958,387,6.1
CN5404100000000,54,041,Lewis County, WV,Dec-17,6275,5857,418,6.7
CN5404100000000,54,041,Lewis County, WV,Jan-18,6298,5839,459,7.3
CN5404100000000,54,041,Lewis County, WV,Feb-18,6357,5877,480,7.6
CN5404100000000,54,041,Lewis County, WV,Mar-18,6272,5842,430,6.9
CN5404100000000,54,041,Lewis County, WV,Apr-18(p),6353,5970,383,6.0
CN4802500000000,48,025,Bee County, TX,Mar-17,10224,9530,694,6.8
CN4802500000000,48,025,Bee County, TX,Apr-17,10152,9499,653,6.4
CN4802500000000,48,025,Bee County, TX,May-17,10109,9484,625,6.2
CN4802500000000,48,025,Bee County, TX,Jun-17,9990,9352,638,6.4
CN4802500000000,48,025,Bee County, TX,Jul-17,9832,9185,647,6.6
CN4802500000000,48,025,Bee County, TX,Aug-17,9751,9097,654,6.7
CN4802500000000,48,025,Bee County, TX,Sep-17,9832,9243,589,6.0
CN4802500000000,48,025,Bee County, TX,Oct-17,9752,9188,564,5.8
CN4802500000000,48,025,Bee County, TX,Nov-17,9720,9153,567,5.8
CN4802500000000,48,025,Bee County, TX,Dec-17,9742,9205,537,5.5
CN4802500000000,48,025,Bee County, TX,Jan-18,9633,9046,587,6.1
CN4802500000000,48,025,Bee County, TX,Feb-18,9851,9282,569,5.8
CN4802500000000,48,025,Bee County, TX,Mar-18,9897,9335,562,5.7
CN4802500000000,48,025,Bee County, TX,Apr-18(p),9906,9388,518,5.2
CN3707700000000,37,077,Granville County, NC,Mar-17,30235,29096,1139,3.8
CN3707700000000,37,077,Granville County, NC,Apr-17,29920,28886,1034,3.5
CN3707700000000,37,077,Granville County, NC,May-17,30020,28947,1073,3.6
CN3707700000000,37,077,Granville County, NC,Jun-17,29991,28848,1143,3.8
CN3707700000000,37,077,Granville County, NC,Jul-17,30482,29263,1219,4.0
CN3707700000000,37,077,Granville County, NC,Aug-17,30079,28813,1266,4.2
CN3707700000000,37,077,Granville County, NC,Sep-17,30363,29216,1147,3.8
CN3707700000000,37,077,Granville County, NC,Oct-17,30154,29026,1128,3.7
CN3707700000000,37,077,Granville County, NC,Nov-17,29991,28821,1170,3.9
CN3707700000000,37,077,Granville County, NC,Dec-17,29832,28703,1129,3.8
CN3707700000000,37,077,Granville County, NC,Jan-18,30119,28898,1221,4.1
CN3707700000000,37,077,Granville County, NC,Feb-18,30574,29330,1244,4.1
CN3707700000000,37,077,Granville County, NC,Mar-18,30634,29486,1148,3.7
CN3707700000000,37,077,Granville County, NC,Apr-18(p),30487,29512,975,3.2
CN3005900000000,30,059,Meagher County, MT,Mar-17,925,884,41,4.4
CN3005900000000,30,059,Meagher County, MT,Apr-17,934,895,39,4.2
CN3005900000000,30,059,Meagher County, MT,May-17,901,862,39,4.3
CN3005900000000,30,059,Meagher County, MT,Jun-17,899,859,40,4.4
CN3005900000000,30,059,Meagher County, MT,Jul-17,1006,968,38,3.8
CN3005900000000,30,059,Meagher County, MT,Aug-17,909,873,36,4.0
CN3005900000000,30,059,Meagher County, MT,Sep-17,888,849,39,4.4
CN3005900000000,30,059,Meagher County, MT,Oct-17,879,842,37,4.2
CN3005900000000,30,059,Meagher County, MT,Nov-17,903,860,43,4.8
CN3005900000000,30,059,Meagher County, MT,Dec-17,899,855,44,4.9
CN3005900000000,30,059,Meagher County, MT,Jan-18,952,901,51,5.4
CN3005900000000,30,059,Meagher County, MT,Feb-18,943,896,47,5.0
CN3005900000000,30,059,Meagher County, MT,Mar-18,911,868,43,4.7
CN3005900000000,30,059,Meagher County, MT,Apr-18(p),882,846,36,4.1
CN3808100000000,38,081,Sargent County, ND,Mar-17,2306,2243,63,2.7
CN3808100000000,38,081,Sargent County, ND,Apr-17,2367,2316,51,2.2
CN3808100000000,38,081,Sargent County, ND,May-17,2420,2377,43,1.8
CN3808100000000,38,081,Sargent County, ND,Jun-17,2525,2468,57,2.3
CN3808100000000,38,081,Sargent County, ND,Jul-17,2492,2441,51,2.0
CN3808100000000,38,081,Sargent County, ND,Aug-17,2504,2451,53,2.1
CN3808100000000,38,081,Sargent County, ND,Sep-17,2490,2448,42,1.7
CN3808100000000,38,081,Sargent County, ND,Oct-17,2479,2445,34,1.4
CN3808100000000,38,081,Sargent County, ND,Nov-17,2377,2333,44,1.9
CN3808100000000,38,081,Sargent County, ND,Dec-17,2345,2302,43,1.8
CN3808100000000,38,081,Sargent County, ND,Jan-18,2365,2298,67,2.8
CN3808100000000,38,081,Sargent County, ND,Feb-18,2342,2279,63,2.7
CN3808100000000,38,081,Sargent County, ND,Mar-18,2367,2304,63,2.7
CN3808100000000,38,081,Sargent County, ND,Apr-18(p),2382,2328,54,2.3
CN2716300000000,27,163,Washington County, MN,Mar-17,140318,135576,4742,3.4
CN2716300000000,27,163,Washington County, MN,Apr-17,140581,136521,4060,2.9
CN2716300000000,27,163,Washington County, MN,May-17,141024,137036,3988,2.8
CN2716300000000,27,163,Washington County, MN,Jun-17,142129,137624,4505,3.2
CN2716300000000,27,163,Washington County, MN,Jul-17,143436,139172,4264,3.0
CN2716300000000,27,163,Washington County, MN,Aug-17,143047,138687,4360,3.0
CN2716300000000,27,163,Washington County, MN,Sep-17,142595,138804,3791,2.7
CN2716300000000,27,163,Washington County, MN,Oct-17,141218,138089,3129,2.2
CN2716300000000,27,163,Washington County, MN,Nov-17,141298,137944,3354,2.4
CN2716300000000,27,163,Washington County, MN,Dec-17,140643,136798,3845,2.7
CN2716300000000,27,163,Washington County, MN,Jan-18,142283,137683,4600,3.2
CN2716300000000,27,163,Washington County, MN,Feb-18,143223,138677,4546,3.2
CN2716300000000,27,163,Washington County, MN,Mar-18,142960,138587,4373,3.1
CN2716300000000,27,163,Washington County, MN,Apr-18(p),142965,139281,3684,2.6
CN0808100000000,08,081,Moffat County, CO,Mar-17,7260,6973,287,4.0
CN0808100000000,08,081,Moffat County, CO,Apr-17,7336,7093,243,3.3
CN0808100000000,08,081,Moffat County, CO,May-17,7272,7063,209,2.9
CN0808100000000,08,081,Moffat County, CO,Jun-17,7455,7231,224,3.0
CN0808100000000,08,081,Moffat County, CO,Jul-17,7457,7235,222,3.0
CN0808100000000,08,081,Moffat County, CO,Aug-17,7388,7183,205,2.8
CN0808100000000,08,081,Moffat County, CO,Sep-17,7367,7177,190,2.6
CN0808100000000,08,081,Moffat County, CO,Oct-17,7490,7285,205,2.7
CN0808100000000,08,081,Moffat County, CO,Nov-17,7430,7213,217,2.9
CN0808100000000,08,081,Moffat County, CO,Dec-17,7476,7210,266,3.6
CN0808100000000,08,081,Moffat County, CO,Jan-18,7459,7137,322,4.3
CN0808100000000,08,081,Moffat County, CO,Feb-18,7501,7165,336,4.5
CN0808100000000,08,081,Moffat County, CO,Mar-18,7469,7180,289,3.9
CN0808100000000,08,081,Moffat County, CO,Apr-18(p),7549,7302,247,3.3
CN0512100000000,05,121,Randolph County, AR,Mar-17,6921,6644,277,4.0
CN0512100000000,05,121,Randolph County, AR,Apr-17,6885,6642,243,3.5
CN0512100000000,05,121,Randolph County, AR,May-17,6962,6692,270,3.9
CN0512100000000,05,121,Randolph County, AR,Jun-17,7040,6741,299,4.2
CN0512100000000,05,121,Randolph County, AR,Jul-17,6924,6614,310,4.5
CN0512100000000,05,121,Randolph County, AR,Aug-17,6961,6666,295,4.2
CN0512100000000,05,121,Randolph County, AR,Sep-17,7014,6745,269,3.8
CN0512100000000,05,121,Randolph County, AR,Oct-17,6945,6692,253,3.6
CN0512100000000,05,121,Randolph County, AR,Nov-17,6927,6661,266,3.8
CN0512100000000,05,121,Randolph County, AR,Dec-17,6878,6591,287,4.2
CN0512100000000,05,121,Randolph County, AR,Jan-18,6777,6393,384,5.7
CN0512100000000,05,121,Randolph County, AR,Feb-18,6890,6547,343,5.0
CN0512100000000,05,121,Randolph County, AR,Mar-18,6898,6607,291,4.2
CN0512100000000,05,121,Randolph County, AR,Apr-18(p),6838,6600,238,3.5
CN1208900000000,12,089,Nassau County, FL,Mar-17,38569,37077,1492,3.9
CN1208900000000,12,089,Nassau County, FL,Apr-17,38703,37280,1423,3.7
CN1208900000000,12,089,Nassau County, FL,May-17,39047,37587,1460,3.7
CN1208900000000,12,089,Nassau County, FL,Jun-17,39315,37740,1575,4.0
CN1208900000000,12,089,Nassau County, FL,Jul-17,39585,38018,1567,4.0
CN1208900000000,12,089,Nassau County, FL,Aug-17,39375,37823,1552,3.9
CN1208900000000,12,089,Nassau County, FL,Sep-17,39938,38544,1394,3.5
CN1208900000000,12,089,Nassau County, FL,Oct-17,39481,38141,1340,3.4
CN1208900000000,12,089,Nassau County, FL,Nov-17,39362,38005,1357,3.4
CN1208900000000,12,089,Nassau County, FL,Dec-17,39205,37931,1274,3.2
CN1208900000000,12,089,Nassau County, FL,Jan-18,39172,37694,1478,3.8
CN1208900000000,12,089,Nassau County, FL,Feb-18,39456,38126,1330,3.4
CN1208900000000,12,089,Nassau County, FL,Mar-18,39556,38255,1301,3.3
CN1208900000000,12,089,Nassau County, FL,Apr-18(p),39367,38190,1177,3.0
CN4000100000000,40,001,Adair County, OK,Mar-17,8097,7674,423,5.2
CN4000100000000,40,001,Adair County, OK,Apr-17,8046,7670,376,4.7
CN4000100000000,40,001,Adair County, OK,May-17,8030,7616,414,5.2
CN4000100000000,40,001,Adair County, OK,Jun-17,8394,7934,460,5.5
CN4000100000000,40,001,Adair County, OK,Jul-17,8110,7682,428,5.3
CN4000100000000,40,001,Adair County, OK,Aug-17,8473,8050,423,5.0
CN4000100000000,40,001,Adair County, OK,Sep-17,8433,8025,408,4.8
CN4000100000000,40,001,Adair County, OK,Oct-17,8534,8141,393,4.6
CN4000100000000,40,001,Adair County, OK,Nov-17,8547,8172,375,4.4
CN4000100000000,40,001,Adair County, OK,Dec-17,8317,7952,365,4.4
CN4000100000000,40,001,Adair County, OK,Jan-18,8220,7818,402,4.9
CN4000100000000,40,001,Adair County, OK,Feb-18,8262,7882,380,4.6
CN4000100000000,40,001,Adair County, OK,Mar-18,8226,7858,368,4.5
CN4000100000000,40,001,Adair County, OK,Apr-18(p),8159,7789,370,4.5
CN2205700000000,22,057,Lafourche Parish, LA,Mar-17,41689,39301,2388,5.7
CN2205700000000,22,057,Lafourche Parish, LA,Apr-17,41635,39420,2215,5.3
CN2205700000000,22,057,Lafourche Parish, LA,May-17,41752,39577,2175,5.2
CN2205700000000,22,057,Lafourche Parish, LA,Jun-17,42334,39895,2439,5.8
CN2205700000000,22,057,Lafourche Parish, LA,Jul-17,42543,40206,2337,5.5
CN2205700000000,22,057,Lafourche Parish, LA,Aug-17,41990,39676,2314,5.5
CN2205700000000,22,057,Lafourche Parish, LA,Sep-17,41917,39854,2063,4.9
CN2205700000000,22,057,Lafourche Parish, LA,Oct-17,41776,40013,1763,4.2
CN2205700000000,22,057,Lafourche Parish, LA,Nov-17,41732,39978,1754,4.2
CN2205700000000,22,057,Lafourche Parish, LA,Dec-17,41430,39772,1658,4.0
CN2205700000000,22,057,Lafourche Parish, LA,Jan-18,41611,39738,1873,4.5
CN2205700000000,22,057,Lafourche Parish, LA,Feb-18,42048,40380,1668,4.0
CN2205700000000,22,057,Lafourche Parish, LA,Mar-18,42069,40244,1825,4.3
CN2205700000000,22,057,Lafourche Parish, LA,Apr-18(p),42022,40203,1819,4.3
CN3300500000000,33,005,Cheshire County, NH,Mar-17,40764,39533,1231,3.0
CN3300500000000,33,005,Cheshire County, NH,Apr-17,40634,39626,1008,2.5
CN3300500000000,33,005,Cheshire County, NH,May-17,40360,39363,997,2.5
CN3300500000000,33,005,Cheshire County, NH,Jun-17,40296,39240,1056,2.6
CN3300500000000,33,005,Cheshire County, NH,Jul-17,40524,39468,1056,2.6
CN3300500000000,33,005,Cheshire County, NH,Aug-17,40555,39530,1025,2.5
CN3300500000000,33,005,Cheshire County, NH,Sep-17,40086,39125,961,2.4
CN3300500000000,33,005,Cheshire County, NH,Oct-17,40266,39413,853,2.1
CN3300500000000,33,005,Cheshire County, NH,Nov-17,40323,39404,919,2.3
CN3300500000000,33,005,Cheshire County, NH,Dec-17,40227,39364,863,2.1
CN3300500000000,33,005,Cheshire County, NH,Jan-18,40103,38915,1188,3.0
CN3300500000000,33,005,Cheshire County, NH,Feb-18,40515,39338,1177,2.9
CN3300500000000,33,005,Cheshire County, NH,Mar-18,40893,39704,1189,2.9
CN3300500000000,33,005,Cheshire County, NH,Apr-18(p),40809,39731,1078,2.6
CN2014500000000,20,145,Pawnee County, KS,Mar-17,2985,2878,107,3.6
CN2014500000000,20,145,Pawnee County, KS,Apr-17,2969,2864,105,3.5
CN2014500000000,20,145,Pawnee County, KS,May-17,2976,2868,108,3.6
CN2014500000000,20,145,Pawnee County, KS,Jun-17,3102,2995,107,3.4
CN2014500000000,20,145,Pawnee County, KS,Jul-17,3183,3062,121,3.8
CN2014500000000,20,145,Pawnee County, KS,Aug-17,3054,2947,107,3.5
CN2014500000000,20,145,Pawnee County, KS,Sep-17,3050,2962,88,2.9
CN2014500000000,20,145,Pawnee County, KS,Oct-17,3102,3014,88,2.8
CN2014500000000,20,145,Pawnee County, KS,Nov-17,3015,2929,86,2.9
CN2014500000000,20,145,Pawnee County, KS,Dec-17,2998,2919,79,2.6
CN2014500000000,20,145,Pawnee County, KS,Jan-18,2946,2864,82,2.8
CN2014500000000,20,145,Pawnee County, KS,Feb-18,2941,2847,94,3.2
CN2014500000000,20,145,Pawnee County, KS,Mar-18,2928,2838,90,3.1
CN2014500000000,20,145,Pawnee County, KS,Apr-18(p),2757,2664,93,3.4
CN7211900000000,72,119,Rio Grande Municipio, PR,Mar-17,17229,15572,1657,9.6
CN7211900000000,72,119,Rio Grande Municipio, PR,Apr-17,17149,15406,1743,10.2
CN7211900000000,72,119,Rio Grande Municipio, PR,May-17,16870,15335,1535,9.1
CN7211900000000,72,119,Rio Grande Municipio, PR,Jun-17,16565,15246,1319,8.0
CN7211900000000,72,119,Rio Grande Municipio, PR,Jul-17,16645,15185,1460,8.8
CN7211900000000,72,119,Rio Grande Municipio, PR,Aug-17,16680,14981,1699,10.2
CN7211900000000,72,119,Rio Grande Municipio, PR,Sep-17(y),16830,15145,1685,10.0
CN7211900000000,72,119,Rio Grande Municipio, PR,Oct-17,16326,14557,1769,10.8
CN7211900000000,72,119,Rio Grande Municipio, PR,Nov-17,17085,15377,1708,10.0
CN7211900000000,72,119,Rio Grande Municipio, PR,Dec-17,17164,15485,1679,9.8
CN7211900000000,72,119,Rio Grande Municipio, PR,Jan-18,17022,15194,1828,10.7
CN7211900000000,72,119,Rio Grande Municipio, PR,Feb-18,17024,15253,1771,10.4
CN7211900000000,72,119,Rio Grande Municipio, PR,Mar-18,17000,15279,1721,10.1
CN7211900000000,72,119,Rio Grande Municipio, PR,Apr-18(p),16983,15360,1623,9.6
CN3501500000000,35,015,Eddy County, NM,Mar-17,28526,26916,1610,5.6
CN3501500000000,35,015,Eddy County, NM,Apr-17,28593,27088,1505,5.3
CN3501500000000,35,015,Eddy County, NM,May-17,28436,26941,1495,5.3
CN3501500000000,35,015,Eddy County, NM,Jun-17,28789,27102,1687,5.9
CN3501500000000,35,015,Eddy County, NM,Jul-17,28972,27271,1701,5.9
CN3501500000000,35,015,Eddy County, NM,Aug-17,28782,27259,1523,5.3
CN3501500000000,35,015,Eddy County, NM,Sep-17,29169,27738,1431,4.9
CN3501500000000,35,015,Eddy County, NM,Oct-17,29271,27926,1345,4.6
CN3501500000000,35,015,Eddy County, NM,Nov-17,29495,28218,1277,4.3
CN3501500000000,35,015,Eddy County, NM,Dec-17,29578,28399,1179,4.0
CN3501500000000,35,015,Eddy County, NM,Jan-18,29991,28797,1194,4.0
CN3501500000000,35,015,Eddy County, NM,Feb-18,30170,29053,1117,3.7
CN3501500000000,35,015,Eddy County, NM,Mar-18,29981,28943,1038,3.5
CN3501500000000,35,015,Eddy County, NM,Apr-18(p),29788,28885,903,3.0
CN2910500000000,29,105,Laclede County, MO,Mar-17,16267,15504,763,4.7
CN2910500000000,29,105,Laclede County, MO,Apr-17,16288,15649,639,3.9
CN2910500000000,29,105,Laclede County, MO,May-17,16264,15589,675,4.2
CN2910500000000,29,105,Laclede County, MO,Jun-17,16361,15677,684,4.2
CN2910500000000,29,105,Laclede County, MO,Jul-17,15878,15166,712,4.5
CN2910500000000,29,105,Laclede County, MO,Aug-17,16110,15083,1027,6.4
CN2910500000000,29,105,Laclede County, MO,Sep-17,16593,15562,1031,6.2
CN2910500000000,29,105,Laclede County, MO,Oct-17,15882,15405,477,3.0
CN2910500000000,29,105,Laclede County, MO,Nov-17,16096,15268,828,5.1
CN2910500000000,29,105,Laclede County, MO,Dec-17,15895,15150,745,4.7
CN2910500000000,29,105,Laclede County, MO,Jan-18,15951,15204,747,4.7
CN2910500000000,29,105,Laclede County, MO,Feb-18,16367,15624,743,4.5
CN2910500000000,29,105,Laclede County, MO,Mar-18,16391,15713,678,4.1
CN2910500000000,29,105,Laclede County, MO,Apr-18(p),16461,15854,607,3.7
CN1815700000000,18,157,Tippecanoe County, IN,Mar-17,95056,91881,3175,3.3
CN1815700000000,18,157,Tippecanoe County, IN,Apr-17,93966,91566,2400,2.6
CN1815700000000,18,157,Tippecanoe County, IN,May-17,91035,88321,2714,3.0
CN1815700000000,18,157,Tippecanoe County, IN,Jun-17,91514,88371,3143,3.4
CN1815700000000,18,157,Tippecanoe County, IN,Jul-17,92634,89392,3242,3.5
CN1815700000000,18,157,Tippecanoe County, IN,Aug-17,95842,92246,3596,3.8
CN1815700000000,18,157,Tippecanoe County, IN,Sep-17,95717,92939,2778,2.9
CN1815700000000,18,157,Tippecanoe County, IN,Oct-17,95895,93229,2666,2.8
CN1815700000000,18,157,Tippecanoe County, IN,Nov-17,95845,92926,2919,3.0
CN1815700000000,18,157,Tippecanoe County, IN,Dec-17,93034,90486,2548,2.7
CN1815700000000,18,157,Tippecanoe County, IN,Jan-18,93902,90934,2968,3.2
CN1815700000000,18,157,Tippecanoe County, IN,Feb-18,96646,93405,3241,3.4
CN1815700000000,18,157,Tippecanoe County, IN,Mar-18,96464,93600,2864,3.0
CN1815700000000,18,157,Tippecanoe County, IN,Apr-18(p),97619,95001,2618,2.7
CN5109500000000,51,095,James City County, VA,Mar-17,35314,34023,1291,3.7
CN5109500000000,51,095,James City County, VA,Apr-17,35381,34251,1130,3.2
CN5109500000000,51,095,James City County, VA,May-17,35482,34243,1239,3.5
CN5109500000000,51,095,James City County, VA,Jun-17,35851,34533,1318,3.7
CN5109500000000,51,095,James City County, VA,Jul-17,36082,34754,1328,3.7
CN5109500000000,51,095,James City County, VA,Aug-17,35712,34377,1335,3.7
CN5109500000000,51,095,James City County, VA,Sep-17,35531,34295,1236,3.5
CN5109500000000,51,095,James City County, VA,Oct-17,35184,34016,1168,3.3
CN5109500000000,51,095,James City County, VA,Nov-17,35020,33844,1176,3.4
CN5109500000000,51,095,James City County, VA,Dec-17,34826,33705,1121,3.2
CN5109500000000,51,095,James City County, VA,Jan-18,34821,33506,1315,3.8
CN5109500000000,51,095,James City County, VA,Feb-18,35283,34074,1209,3.4
CN5109500000000,51,095,James City County, VA,Mar-18,35508,34340,1168,3.3
CN5109500000000,51,095,James City County, VA,Apr-18(p),35514,34540,974,2.7
CN3908700000000,39,087,Lawrence County, OH,Mar-17,24798,23318,1480,6.0
CN3908700000000,39,087,Lawrence County, OH,Apr-17,24582,23241,1341,5.5
CN3908700000000,39,087,Lawrence County, OH,May-17,24675,23354,1321,5.4
CN3908700000000,39,087,Lawrence County, OH,Jun-17,24858,23303,1555,6.3
CN3908700000000,39,087,Lawrence County, OH,Jul-17,24813,23269,1544,6.2
CN3908700000000,39,087,Lawrence County, OH,Aug-17,24824,23286,1538,6.2
CN3908700000000,39,087,Lawrence County, OH,Sep-17,24818,23494,1324,5.3
CN3908700000000,39,087,Lawrence County, OH,Oct-17,24798,23542,1256,5.1
CN3908700000000,39,087,Lawrence County, OH,Nov-17,24734,23499,1235,5.0
CN3908700000000,39,087,Lawrence County, OH,Dec-17,24689,23384,1305,5.3
CN3908700000000,39,087,Lawrence County, OH,Jan-18,24113,22657,1456,6.0
CN3908700000000,39,087,Lawrence County, OH,Feb-18,24411,23030,1381,5.7
CN3908700000000,39,087,Lawrence County, OH,Mar-18,24568,23279,1289,5.2
CN3908700000000,39,087,Lawrence County, OH,Apr-18(p),24445,23245,1200,4.9
CN4815700000000,48,157,Fort Bend County, TX,Mar-17,369540,351321,18219,4.9
CN4815700000000,48,157,Fort Bend County, TX,Apr-17,369767,352805,16962,4.6
CN4815700000000,48,157,Fort Bend County, TX,May-17,368707,352075,16632,4.5
CN4815700000000,48,157,Fort Bend County, TX,Jun-17,369862,352098,17764,4.8
CN4815700000000,48,157,Fort Bend County, TX,Jul-17,371258,353666,17592,4.7
CN4815700000000,48,157,Fort Bend County, TX,Aug-17,369242,351562,17680,4.8
CN4815700000000,48,157,Fort Bend County, TX,Sep-17,371012,354538,16474,4.4
CN4815700000000,48,157,Fort Bend County, TX,Oct-17,368888,353930,14958,4.1
CN4815700000000,48,157,Fort Bend County, TX,Nov-17,371410,356206,15204,4.1
CN4815700000000,48,157,Fort Bend County, TX,Dec-17,371452,356749,14703,4.0
CN4815700000000,48,157,Fort Bend County, TX,Jan-18,371875,355525,16350,4.4
CN4815700000000,48,157,Fort Bend County, TX,Feb-18,377090,360681,16409,4.4
CN4815700000000,48,157,Fort Bend County, TX,Mar-18,377133,361056,16077,4.3
CN4815700000000,48,157,Fort Bend County, TX,Apr-18(p),378656,363802,14854,3.9
CN2203100000000,22,031,De Soto Parish, LA,Mar-17,10722,10031,691,6.4
CN2203100000000,22,031,De Soto Parish, LA,Apr-17,10668,10023,645,6.0
CN2203100000000,22,031,De Soto Parish, LA,May-17,10639,9976,663,6.2
CN2203100000000,22,031,De Soto Parish, LA,Jun-17,10846,10110,736,6.8
CN2203100000000,22,031,De Soto Parish, LA,Jul-17,10865,10171,694,6.4
CN2203100000000,22,031,De Soto Parish, LA,Aug-17,10753,10055,698,6.5
CN2203100000000,22,031,De Soto Parish, LA,Sep-17,10734,10104,630,5.9
CN2203100000000,22,031,De Soto Parish, LA,Oct-17,10657,10092,565,5.3
CN2203100000000,22,031,De Soto Parish, LA,Nov-17,10620,10089,531,5.0
CN2203100000000,22,031,De Soto Parish, LA,Dec-17,10592,10077,515,4.9
CN2203100000000,22,031,De Soto Parish, LA,Jan-18,10647,10095,552,5.2
CN2203100000000,22,031,De Soto Parish, LA,Feb-18,10775,10257,518,4.8
CN2203100000000,22,031,De Soto Parish, LA,Mar-18,10760,10218,542,5.0
CN2203100000000,22,031,De Soto Parish, LA,Apr-18(p),10720,10189,531,5.0
CN0803900000000,08,039,Elbert County, CO,Mar-17,13993,13647,346,2.5
CN0803900000000,08,039,Elbert County, CO,Apr-17,14147,13830,317,2.2
CN0803900000000,08,039,Elbert County, CO,May-17,14243,13932,311,2.2
CN0803900000000,08,039,Elbert County, CO,Jun-17,14387,14037,350,2.4
CN0803900000000,08,039,Elbert County, CO,Jul-17,14496,14164,332,2.3
CN0803900000000,08,039,Elbert County, CO,Aug-17,14454,14117,337,2.3
CN0803900000000,08,039,Elbert County, CO,Sep-17,14495,14158,337,2.3
CN0803900000000,08,039,Elbert County, CO,Oct-17,14655,14295,360,2.5
CN0803900000000,08,039,Elbert County, CO,Nov-17,14601,14221,380,2.6
CN0803900000000,08,039,Elbert County, CO,Dec-17,14576,14186,390,2.7
CN0803900000000,08,039,Elbert County, CO,Jan-18,14484,14057,427,2.9
CN0803900000000,08,039,Elbert County, CO,Feb-18,14524,14084,440,3.0
CN0803900000000,08,039,Elbert County, CO,Mar-18,14543,14159,384,2.6
CN0803900000000,08,039,Elbert County, CO,Apr-18(p),14643,14310,333,2.3
CN4836100000000,48,361,Orange County, TX,Mar-17,37544,35038,2506,6.7
CN4836100000000,48,361,Orange County, TX,Apr-17,37401,35009,2392,6.4
CN4836100000000,48,361,Orange County, TX,May-17,37155,34821,2334,6.3
CN4836100000000,48,361,Orange County, TX,Jun-17,37247,34779,2468,6.6
CN4836100000000,48,361,Orange County, TX,Jul-17,37059,34618,2441,6.6
CN4836100000000,48,361,Orange County, TX,Aug-17,36609,34170,2439,6.7
CN4836100000000,48,361,Orange County, TX,Sep-17,37476,34330,3146,8.4
CN4836100000000,48,361,Orange County, TX,Oct-17,37092,34648,2444,6.6
CN4836100000000,48,361,Orange County, TX,Nov-17,37080,34715,2365,6.4
CN4836100000000,48,361,Orange County, TX,Dec-17,37050,34646,2404,6.5
CN4836100000000,48,361,Orange County, TX,Jan-18,37286,34654,2632,7.1
CN4836100000000,48,361,Orange County, TX,Feb-18,37565,35098,2467,6.6
CN4836100000000,48,361,Orange County, TX,Mar-18,37504,35108,2396,6.4
CN4836100000000,48,361,Orange County, TX,Apr-18(p),37232,35023,2209,5.9
CN2404100000000,24,041,Talbot County, MD,Mar-17,19744,18918,826,4.2
CN2404100000000,24,041,Talbot County, MD,Apr-17,19927,19266,661,3.3
CN2404100000000,24,041,Talbot County, MD,May-17,19558,18838,720,3.7
CN2404100000000,24,041,Talbot County, MD,Jun-17,20242,19418,824,4.1
CN2404100000000,24,041,Talbot County, MD,Jul-17,20381,19606,775,3.8
CN2404100000000,24,041,Talbot County, MD,Aug-17,19903,19142,761,3.8
CN2404100000000,24,041,Talbot County, MD,Sep-17,19696,19006,690,3.5
CN2404100000000,24,041,Talbot County, MD,Oct-17,19792,19069,723,3.7
CN2404100000000,24,041,Talbot County, MD,Nov-17,19427,18647,780,4.0
CN2404100000000,24,041,Talbot County, MD,Dec-17,19222,18478,744,3.9
CN2404100000000,24,041,Talbot County, MD,Jan-18,19425,18463,962,5.0
CN2404100000000,24,041,Talbot County, MD,Feb-18,19670,18692,978,5.0
CN2404100000000,24,041,Talbot County, MD,Mar-18,19725,18788,937,4.8
CN2404100000000,24,041,Talbot County, MD,Apr-18(p),19679,18964,715,3.6
CN2605100000000,26,051,Gladwin County, MI,Mar-17,9905,9175,730,7.4
CN2605100000000,26,051,Gladwin County, MI,Apr-17,9856,9262,594,6.0
CN2605100000000,26,051,Gladwin County, MI,May-17,10008,9420,588,5.9
CN2605100000000,26,051,Gladwin County, MI,Jun-17,10106,9480,626,6.2
CN2605100000000,26,051,Gladwin County, MI,Jul-17,10137,9399,738,7.3
CN2605100000000,26,051,Gladwin County, MI,Aug-17,9967,9295,672,6.7
CN2605100000000,26,051,Gladwin County, MI,Sep-17,9895,9308,587,5.9
CN2605100000000,26,051,Gladwin County, MI,Oct-17,9790,9236,554,5.7
CN2605100000000,26,051,Gladwin County, MI,Nov-17,9759,9204,555,5.7
CN2605100000000,26,051,Gladwin County, MI,Dec-17,9749,9100,649,6.7
CN2605100000000,26,051,Gladwin County, MI,Jan-18,9888,9069,819,8.3
CN2605100000000,26,051,Gladwin County, MI,Feb-18,9993,9153,840,8.4
CN2605100000000,26,051,Gladwin County, MI,Mar-18,9997,9261,736,7.4
CN2605100000000,26,051,Gladwin County, MI,Apr-18(p),9951,9333,618,6.2
CN3111900000000,31,119,Madison County, NE,Mar-17,19038,18516,522,2.7
CN3111900000000,31,119,Madison County, NE,Apr-17,19087,18616,471,2.5
CN3111900000000,31,119,Madison County, NE,May-17,19076,18610,466,2.4
CN3111900000000,31,119,Madison County, NE,Jun-17,19320,18767,553,2.9
CN3111900000000,31,119,Madison County, NE,Jul-17,19493,18934,559,2.9
CN3111900000000,31,119,Madison County, NE,Aug-17,19119,18605,514,2.7
CN3111900000000,31,119,Madison County, NE,Sep-17,19044,18613,431,2.3
CN3111900000000,31,119,Madison County, NE,Oct-17,19159,18730,429,2.2
CN3111900000000,31,119,Madison County, NE,Nov-17,19137,18718,419,2.2
CN3111900000000,31,119,Madison County, NE,Dec-17,18999,18519,480,2.5
CN3111900000000,31,119,Madison County, NE,Jan-18,19148,18615,533,2.8
CN3111900000000,31,119,Madison County, NE,Feb-18,19396,18877,519,2.7
CN3111900000000,31,119,Madison County, NE,Mar-18,19336,18806,530,2.7
CN3111900000000,31,119,Madison County, NE,Apr-18(p),19330,18842,488,2.5
CN1715100000000,17,151,Pope County, IL,Mar-17,1779,1669,110,6.2
CN1715100000000,17,151,Pope County, IL,Apr-17,1796,1699,97,5.4
CN1715100000000,17,151,Pope County, IL,May-17,1790,1680,110,6.1
CN1715100000000,17,151,Pope County, IL,Jun-17,1781,1665,116,6.5
CN1715100000000,17,151,Pope County, IL,Jul-17,1747,1636,111,6.4
CN1715100000000,17,151,Pope County, IL,Aug-17,1731,1618,113,6.5
CN1715100000000,17,151,Pope County, IL,Sep-17,1728,1634,94,5.4
CN1715100000000,17,151,Pope County, IL,Oct-17,1721,1635,86,5.0
CN1715100000000,17,151,Pope County, IL,Nov-17,1717,1631,86,5.0
CN1715100000000,17,151,Pope County, IL,Dec-17,1711,1616,95,5.6
CN1715100000000,17,151,Pope County, IL,Jan-18,1736,1632,104,6.0
CN1715100000000,17,151,Pope County, IL,Feb-18,1736,1642,94,5.4
CN1715100000000,17,151,Pope County, IL,Mar-18,1768,1675,93,5.3
CN1715100000000,17,151,Pope County, IL,Apr-18(p),1771,1696,75,4.2
CN7206300000000,72,063,Gurabo Municipio, PR,Mar-17,17592,16319,1273,7.2
CN7206300000000,72,063,Gurabo Municipio, PR,Apr-17,17495,16174,1321,7.6
CN7206300000000,72,063,Gurabo Municipio, PR,May-17,17236,16089,1147,6.7
CN7206300000000,72,063,Gurabo Municipio, PR,Jun-17,17091,15992,1099,6.4
CN7206300000000,72,063,Gurabo Municipio, PR,Jul-17,17142,15927,1215,7.1
CN7206300000000,72,063,Gurabo Municipio, PR,Aug-17,17105,15713,1392,8.1
CN7206300000000,72,063,Gurabo Municipio, PR,Sep-17(y),17210,15891,1319,7.7
CN7206300000000,72,063,Gurabo Municipio, PR,Oct-17,16641,15243,1398,8.4
CN7206300000000,72,063,Gurabo Municipio, PR,Nov-17,17454,16113,1341,7.7
CN7206300000000,72,063,Gurabo Municipio, PR,Dec-17,17486,16232,1254,7.2
CN7206300000000,72,063,Gurabo Municipio, PR,Jan-18,17237,15923,1314,7.6
CN7206300000000,72,063,Gurabo Municipio, PR,Feb-18,17212,15988,1224,7.1
CN7206300000000,72,063,Gurabo Municipio, PR,Mar-18,17189,16010,1179,6.9
CN7206300000000,72,063,Gurabo Municipio, PR,Apr-18(p),17307,16115,1192,6.9
CN0111900000000,01,119,Sumter County, AL,Mar-17,5116,4762,354,6.9
CN0111900000000,01,119,Sumter County, AL,Apr-17,5046,4744,302,6.0
CN0111900000000,01,119,Sumter County, AL,May-17,5011,4702,309,6.2
CN0111900000000,01,119,Sumter County, AL,Jun-17,5093,4655,438,8.6
CN0111900000000,01,119,Sumter County, AL,Jul-17,5081,4669,412,8.1
CN0111900000000,01,119,Sumter County, AL,Aug-17,4903,4589,314,6.4
CN0111900000000,01,119,Sumter County, AL,Sep-17,4980,4725,255,5.1
CN0111900000000,01,119,Sumter County, AL,Oct-17,4956,4695,261,5.3
CN0111900000000,01,119,Sumter County, AL,Nov-17,4973,4719,254,5.1
CN0111900000000,01,119,Sumter County, AL,Dec-17,4913,4669,244,5.0
CN0111900000000,01,119,Sumter County, AL,Jan-18,4713,4430,283,6.0
CN0111900000000,01,119,Sumter County, AL,Feb-18,4748,4462,286,6.0
CN0111900000000,01,119,Sumter County, AL,Mar-18,4754,4475,279,5.9
CN0111900000000,01,119,Sumter County, AL,Apr-18(p),4766,4512,254,5.3
CN2004700000000,20,047,Edwards County, KS,Mar-17,1494,1445,49,3.3
CN2004700000000,20,047,Edwards County, KS,Apr-17,1486,1440,46,3.1
CN2004700000000,20,047,Edwards County, KS,May-17,1494,1447,47,3.1
CN2004700000000,20,047,Edwards County, KS,Jun-17,1555,1506,49,3.2
CN2004700000000,20,047,Edwards County, KS,Jul-17,1543,1491,52,3.4
CN2004700000000,20,047,Edwards County, KS,Aug-17,1535,1485,50,3.3
CN2004700000000,20,047,Edwards County, KS,Sep-17,1546,1507,39,2.5
CN2004700000000,20,047,Edwards County, KS,Oct-17,1602,1571,31,1.9
CN2004700000000,20,047,Edwards County, KS,Nov-17,1662,1626,36,2.2
CN2004700000000,20,047,Edwards County, KS,Dec-17,1681,1646,35,2.1
CN2004700000000,20,047,Edwards County, KS,Jan-18,1638,1602,36,2.2
CN2004700000000,20,047,Edwards County, KS,Feb-18,1556,1521,35,2.2
CN2004700000000,20,047,Edwards County, KS,Mar-18,1376,1339,37,2.7
CN2004700000000,20,047,Edwards County, KS,Apr-18(p),1294,1260,34,2.6
CN4825500000000,48,255,Karnes County, TX,Mar-17,6479,6235,244,3.8
CN4825500000000,48,255,Karnes County, TX,Apr-17,6484,6260,224,3.5
CN4825500000000,48,255,Karnes County, TX,May-17,6452,6229,223,3.5
CN4825500000000,48,255,Karnes County, TX,Jun-17,6443,6210,233,3.6
CN4825500000000,48,255,Karnes County, TX,Jul-17,6486,6256,230,3.5
CN4825500000000,48,255,Karnes County, TX,Aug-17,6394,6167,227,3.6
CN4825500000000,48,255,Karnes County, TX,Sep-17,6416,6215,201,3.1
CN4825500000000,48,255,Karnes County, TX,Oct-17,6394,6219,175,2.7
CN4825500000000,48,255,Karnes County, TX,Nov-17,6416,6228,188,2.9
CN4825500000000,48,255,Karnes County, TX,Dec-17,6349,6178,171,2.7
CN4825500000000,48,255,Karnes County, TX,Jan-18,6534,6345,189,2.9
CN4825500000000,48,255,Karnes County, TX,Feb-18,6585,6381,204,3.1
CN4825500000000,48,255,Karnes County, TX,Mar-18,6622,6407,215,3.2
CN4825500000000,48,255,Karnes County, TX,Apr-18(p),6691,6505,186,2.8
CN1203700000000,12,037,Franklin County, FL,Mar-17,4772,4594,178,3.7
CN1203700000000,12,037,Franklin County, FL,Apr-17,4823,4659,164,3.4
CN1203700000000,12,037,Franklin County, FL,May-17,4908,4738,170,3.5
CN1203700000000,12,037,Franklin County, FL,Jun-17,4888,4720,168,3.4
CN1203700000000,12,037,Franklin County, FL,Jul-17,4897,4730,167,3.4
CN1203700000000,12,037,Franklin County, FL,Aug-17,4862,4692,170,3.5
CN1203700000000,12,037,Franklin County, FL,Sep-17,4864,4707,157,3.2
CN1203700000000,12,037,Franklin County, FL,Oct-17,4702,4557,145,3.1
CN1203700000000,12,037,Franklin County, FL,Nov-17,4653,4497,156,3.4
CN1203700000000,12,037,Franklin County, FL,Dec-17,4581,4426,155,3.4
CN1203700000000,12,037,Franklin County, FL,Jan-18,4620,4443,177,3.8
CN1203700000000,12,037,Franklin County, FL,Feb-18,4689,4525,164,3.5
CN1203700000000,12,037,Franklin County, FL,Mar-18,4751,4602,149,3.1
CN1203700000000,12,037,Franklin County, FL,Apr-18(p),4794,4660,134,2.8
CN4007900000000,40,079,Le Flore County, OK,Mar-17,19455,18313,1142,5.9
CN4007900000000,40,079,Le Flore County, OK,Apr-17,19296,18270,1026,5.3
CN4007900000000,40,079,Le Flore County, OK,May-17,19304,18211,1093,5.7
CN4007900000000,40,079,Le Flore County, OK,Jun-17,19445,18260,1185,6.1
CN4007900000000,40,079,Le Flore County, OK,Jul-17,19268,18179,1089,5.7
CN4007900000000,40,079,Le Flore County, OK,Aug-17,19362,18237,1125,5.8
CN4007900000000,40,079,Le Flore County, OK,Sep-17,19392,18328,1064,5.5
CN4007900000000,40,079,Le Flore County, OK,Oct-17,19356,18270,1086,5.6
CN4007900000000,40,079,Le Flore County, OK,Nov-17,19443,18376,1067,5.5
CN4007900000000,40,079,Le Flore County, OK,Dec-17,19221,18138,1083,5.6
CN4007900000000,40,079,Le Flore County, OK,Jan-18,19136,17974,1162,6.1
CN4007900000000,40,079,Le Flore County, OK,Feb-18,19251,18190,1061,5.5
CN4007900000000,40,079,Le Flore County, OK,Mar-18,19251,18276,975,5.1
CN4007900000000,40,079,Le Flore County, OK,Apr-18(p),19018,18082,936,4.9
CN4831900000000,48,319,Mason County, TX,Mar-17,1883,1817,66,3.5
CN4831900000000,48,319,Mason County, TX,Apr-17,1871,1816,55,2.9
CN4831900000000,48,319,Mason County, TX,May-17,1872,1810,62,3.3
CN4831900000000,48,319,Mason County, TX,Jun-17,1871,1807,64,3.4
CN4831900000000,48,319,Mason County, TX,Jul-17,1779,1713,66,3.7
CN4831900000000,48,319,Mason County, TX,Aug-17,1779,1718,61,3.4
CN4831900000000,48,319,Mason County, TX,Sep-17,1721,1669,52,3.0
CN4831900000000,48,319,Mason County, TX,Oct-17,1746,1699,47,2.7
CN4831900000000,48,319,Mason County, TX,Nov-17,1743,1688,55,3.2
CN4831900000000,48,319,Mason County, TX,Dec-17,1760,1710,50,2.8
CN4831900000000,48,319,Mason County, TX,Jan-18,1740,1682,58,3.3
CN4831900000000,48,319,Mason County, TX,Feb-18,1789,1731,58,3.2
CN4831900000000,48,319,Mason County, TX,Mar-18,1850,1795,55,3.0
CN4831900000000,48,319,Mason County, TX,Apr-18(p),1837,1786,51,2.8
CN0106300000000,01,063,Greene County, AL,Mar-17,2871,2619,252,8.8
CN0106300000000,01,063,Greene County, AL,Apr-17,2838,2639,199,7.0
CN0106300000000,01,063,Greene County, AL,May-17,2864,2670,194,6.8
CN0106300000000,01,063,Greene County, AL,Jun-17,2842,2611,231,8.1
CN0106300000000,01,063,Greene County, AL,Jul-17,2822,2585,237,8.4
CN0106300000000,01,063,Greene County, AL,Aug-17,2835,2612,223,7.9
CN0106300000000,01,063,Greene County, AL,Sep-17,2848,2668,180,6.3
CN0106300000000,01,063,Greene County, AL,Oct-17,2814,2648,166,5.9
CN0106300000000,01,063,Greene County, AL,Nov-17,2789,2627,162,5.8
CN0106300000000,01,063,Greene County, AL,Dec-17,2770,2609,161,5.8
CN0106300000000,01,063,Greene County, AL,Jan-18,2750,2561,189,6.9
CN0106300000000,01,063,Greene County, AL,Feb-18,2790,2596,194,7.0
CN0106300000000,01,063,Greene County, AL,Mar-18,2805,2624,181,6.5
CN0106300000000,01,063,Greene County, AL,Apr-18(p),2822,2653,169,6.0
CN2921100000000,29,211,Sullivan County, MO,Mar-17,2746,2615,131,4.8
CN2921100000000,29,211,Sullivan County, MO,Apr-17,2833,2719,114,4.0
CN2921100000000,29,211,Sullivan County, MO,May-17,2773,2660,113,4.1
CN2921100000000,29,211,Sullivan County, MO,Jun-17,2800,2689,111,4.0
CN2921100000000,29,211,Sullivan County, MO,Jul-17,2657,2548,109,4.1
CN2921100000000,29,211,Sullivan County, MO,Aug-17,2547,2436,111,4.4
CN2921100000000,29,211,Sullivan County, MO,Sep-17,2615,2518,97,3.7
CN2921100000000,29,211,Sullivan County, MO,Oct-17,2701,2629,72,2.7
CN2921100000000,29,211,Sullivan County, MO,Nov-17,2691,2604,87,3.2
CN2921100000000,29,211,Sullivan County, MO,Dec-17,2667,2571,96,3.6
CN2921100000000,29,211,Sullivan County, MO,Jan-18,2730,2607,123,4.5
CN2921100000000,29,211,Sullivan County, MO,Feb-18,2720,2605,115,4.2
CN2921100000000,29,211,Sullivan County, MO,Mar-18,2696,2582,114,4.2
CN2921100000000,29,211,Sullivan County, MO,Apr-18(p),2734,2638,96,3.5
CN3607100000000,36,071,Orange County, NY,Mar-17,180648,172663,7985,4.4
CN3607100000000,36,071,Orange County, NY,Apr-17,180970,173162,7808,4.3
CN3607100000000,36,071,Orange County, NY,May-17,181612,173611,8001,4.4
CN3607100000000,36,071,Orange County, NY,Jun-17,185148,176481,8667,4.7
CN3607100000000,36,071,Orange County, NY,Jul-17,186906,178026,8880,4.8
CN3607100000000,36,071,Orange County, NY,Aug-17,184105,175348,8757,4.8
CN3607100000000,36,071,Orange County, NY,Sep-17,182089,173580,8509,4.7
CN3607100000000,36,071,Orange County, NY,Oct-17,180395,172322,8073,4.5
CN3607100000000,36,071,Orange County, NY,Nov-17,179847,171720,8127,4.5
CN3607100000000,36,071,Orange County, NY,Dec-17,178817,170911,7906,4.4
CN3607100000000,36,071,Orange County, NY,Jan-18,179521,170465,9056,5.0
CN3607100000000,36,071,Orange County, NY,Feb-18,177766,168362,9404,5.3
CN3607100000000,36,071,Orange County, NY,Mar-18,177469,168994,8475,4.8
CN3607100000000,36,071,Orange County, NY,Apr-18(p),178674,170799,7875,4.4
CN0112700000000,01,127,Walker County, AL,Mar-17,25296,23857,1439,5.7
CN0112700000000,01,127,Walker County, AL,Apr-17,25162,23958,1204,4.8
CN0112700000000,01,127,Walker County, AL,May-17,25069,23939,1130,4.5
CN0112700000000,01,127,Walker County, AL,Jun-17,25328,23963,1365,5.4
CN0112700000000,01,127,Walker County, AL,Jul-17,25275,24002,1273,5.0
CN0112700000000,01,127,Walker County, AL,Aug-17,25079,23860,1219,4.9
CN0112700000000,01,127,Walker County, AL,Sep-17,25085,24060,1025,4.1
CN0112700000000,01,127,Walker County, AL,Oct-17,25070,24043,1027,4.1
CN0112700000000,01,127,Walker County, AL,Nov-17,24913,23969,944,3.8
CN0112700000000,01,127,Walker County, AL,Dec-17,24802,23881,921,3.7
CN0112700000000,01,127,Walker County, AL,Jan-18,24830,23682,1148,4.6
CN0112700000000,01,127,Walker County, AL,Feb-18,25200,24029,1171,4.6
CN0112700000000,01,127,Walker County, AL,Mar-18,25234,24184,1050,4.2
CN0112700000000,01,127,Walker County, AL,Apr-18(p),25451,24501,950,3.7
CN1302500000000,13,025,Brantley County, GA,Mar-17,7200,6790,410,5.7
CN1302500000000,13,025,Brantley County, GA,Apr-17,7230,6865,365,5.0
CN1302500000000,13,025,Brantley County, GA,May-17,7286,6896,390,5.4
CN1302500000000,13,025,Brantley County, GA,Jun-17,7401,6962,439,5.9
CN1302500000000,13,025,Brantley County, GA,Jul-17,7407,6971,436,5.9
CN1302500000000,13,025,Brantley County, GA,Aug-17,7298,6851,447,6.1
CN1302500000000,13,025,Brantley County, GA,Sep-17,7168,6695,473,6.6
CN1302500000000,13,025,Brantley County, GA,Oct-17,7185,6790,395,5.5
CN1302500000000,13,025,Brantley County, GA,Nov-17,7139,6770,369,5.2
CN1302500000000,13,025,Brantley County, GA,Dec-17,7186,6803,383,5.3
CN1302500000000,13,025,Brantley County, GA,Jan-18,7244,6857,387,5.3
CN1302500000000,13,025,Brantley County, GA,Feb-18,7199,6820,379,5.3
CN1302500000000,13,025,Brantley County, GA,Mar-18,7222,6868,354,4.9
CN1302500000000,13,025,Brantley County, GA,Apr-18(p),7265,6965,300,4.1
CN5155000000000,51,550,Chesapeake city, VA,Mar-17,119388,114706,4682,3.9
CN5155000000000,51,550,Chesapeake city, VA,Apr-17,119913,115621,4292,3.6
CN5155000000000,51,550,Chesapeake city, VA,May-17,120096,115549,4547,3.8
CN5155000000000,51,550,Chesapeake city, VA,Jun-17,121243,116311,4932,4.1
CN5155000000000,51,550,Chesapeake city, VA,Jul-17,122333,117311,5022,4.1
CN5155000000000,51,550,Chesapeake city, VA,Aug-17,121101,116115,4986,4.1
CN5155000000000,51,550,Chesapeake city, VA,Sep-17,120346,115842,4504,3.7
CN5155000000000,51,550,Chesapeake city, VA,Oct-17,119191,114991,4200,3.5
CN5155000000000,51,550,Chesapeake city, VA,Nov-17,118292,114112,4180,3.5
CN5155000000000,51,550,Chesapeake city, VA,Dec-17,117461,113441,4020,3.4
CN5155000000000,51,550,Chesapeake city, VA,Jan-18,117215,112959,4256,3.6
CN5155000000000,51,550,Chesapeake city, VA,Feb-18,118665,114761,3904,3.3
CN5155000000000,51,550,Chesapeake city, VA,Mar-18,119602,115592,4010,3.4
CN5155000000000,51,550,Chesapeake city, VA,Apr-18(p),119725,116269,3456,2.9
CN1714300000000,17,143,Peoria County, IL,Mar-17,85373,79911,5462,6.4
CN1714300000000,17,143,Peoria County, IL,Apr-17,86254,81674,4580,5.3
CN1714300000000,17,143,Peoria County, IL,May-17,85797,81262,4535,5.3
CN1714300000000,17,143,Peoria County, IL,Jun-17,86553,81709,4844,5.6
CN1714300000000,17,143,Peoria County, IL,Jul-17,86448,81404,5044,5.8
CN1714300000000,17,143,Peoria County, IL,Aug-17,86086,81117,4969,5.8
CN1714300000000,17,143,Peoria County, IL,Sep-17,85369,81006,4363,5.1
CN1714300000000,17,143,Peoria County, IL,Oct-17,85244,81092,4152,4.9
CN1714300000000,17,143,Peoria County, IL,Nov-17,85163,80953,4210,4.9
CN1714300000000,17,143,Peoria County, IL,Dec-17,84968,80642,4326,5.1
CN1714300000000,17,143,Peoria County, IL,Jan-18,84013,79310,4703,5.6
CN1714300000000,17,143,Peoria County, IL,Feb-18,84807,80420,4387,5.2
CN1714300000000,17,143,Peoria County, IL,Mar-18,86709,82078,4631,5.3
CN1714300000000,17,143,Peoria County, IL,Apr-18(p),86657,82783,3874,4.5
CN3106300000000,31,063,Frontier County, NE,Mar-17,1552,1515,37,2.4
CN3106300000000,31,063,Frontier County, NE,Apr-17,1618,1579,39,2.4
CN3106300000000,31,063,Frontier County, NE,May-17,1598,1557,41,2.6
CN3106300000000,31,063,Frontier County, NE,Jun-17,1642,1596,46,2.8
CN3106300000000,31,063,Frontier County, NE,Jul-17,1554,1512,42,2.7
CN3106300000000,31,063,Frontier County, NE,Aug-17,1507,1468,39,2.6
CN3106300000000,31,063,Frontier County, NE,Sep-17,1527,1488,39,2.6
CN3106300000000,31,063,Frontier County, NE,Oct-17,1554,1519,35,2.3
CN3106300000000,31,063,Frontier County, NE,Nov-17,1556,1521,35,2.2
CN3106300000000,31,063,Frontier County, NE,Dec-17,1552,1513,39,2.5
CN3106300000000,31,063,Frontier County, NE,Jan-18,1553,1518,35,2.3
CN3106300000000,31,063,Frontier County, NE,Feb-18,1537,1503,34,2.2
CN3106300000000,31,063,Frontier County, NE,Mar-18,1579,1541,38,2.4
CN3106300000000,31,063,Frontier County, NE,Apr-18(p),1565,1529,36,2.3
CN5303700000000,53,037,Kittitas County, WA,Mar-17,22392,21073,1319,5.9
CN5303700000000,53,037,Kittitas County, WA,Apr-17,22740,21622,1118,4.9
CN5303700000000,53,037,Kittitas County, WA,May-17,23208,22134,1074,4.6
CN5303700000000,53,037,Kittitas County, WA,Jun-17,22673,21610,1063,4.7
CN5303700000000,53,037,Kittitas County, WA,Jul-17,21151,20056,1095,5.2
CN5303700000000,53,037,Kittitas County, WA,Aug-17,20864,19809,1055,5.1
CN5303700000000,53,037,Kittitas County, WA,Sep-17,22275,21256,1019,4.6
CN5303700000000,53,037,Kittitas County, WA,Oct-17,22920,21893,1027,4.5
CN5303700000000,53,037,Kittitas County, WA,Nov-17,22511,21416,1095,4.9
CN5303700000000,53,037,Kittitas County, WA,Dec-17,21733,20470,1263,5.8
CN5303700000000,53,037,Kittitas County, WA,Jan-18,21840,20396,1444,6.6
CN5303700000000,53,037,Kittitas County, WA,Feb-18,21686,20203,1483,6.8
CN5303700000000,53,037,Kittitas County, WA,Mar-18,22820,21466,1354,5.9
CN5303700000000,53,037,Kittitas County, WA,Apr-18(p),22666,21493,1173,5.2
CN0607100000000,06,071,San Bernardino County, CA,Mar-17,950235,900663,49572,5.2
CN0607100000000,06,071,San Bernardino County, CA,Apr-17,943686,898871,44815,4.7
CN0607100000000,06,071,San Bernardino County, CA,May-17,941226,898693,42533,4.5
CN0607100000000,06,071,San Bernardino County, CA,Jun-17,945172,895914,49258,5.2
CN0607100000000,06,071,San Bernardino County, CA,Jul-17,949499,897022,52477,5.5
CN0607100000000,06,071,San Bernardino County, CA,Aug-17,948932,898721,50211,5.3
CN0607100000000,06,071,San Bernardino County, CA,Sep-17,954977,911311,43666,4.6
CN0607100000000,06,071,San Bernardino County, CA,Oct-17,955330,913188,42142,4.4
CN0607100000000,06,071,San Bernardino County, CA,Nov-17,964054,923245,40809,4.2
CN0607100000000,06,071,San Bernardino County, CA,Dec-17,963058,924341,38717,4.0
CN0607100000000,06,071,San Bernardino County, CA,Jan-18,961917,919636,42281,4.4
CN0607100000000,06,071,San Bernardino County, CA,Feb-18,964641,923491,41150,4.3
CN0607100000000,06,071,San Bernardino County, CA,Mar-18,959717,921812,37905,3.9
CN0607100000000,06,071,San Bernardino County, CA,Apr-18(p),948560,914220,34340,3.6
CN4608300000000,46,083,Lincoln County, SD,Mar-17,31830,30976,854,2.7
CN4608300000000,46,083,Lincoln County, SD,Apr-17,31743,30976,767,2.4
CN4608300000000,46,083,Lincoln County, SD,May-17,31748,30965,783,2.5
CN4608300000000,46,083,Lincoln County, SD,Jun-17,31935,31162,773,2.4
CN4608300000000,46,083,Lincoln County, SD,Jul-17,32321,31571,750,2.3
CN4608300000000,46,083,Lincoln County, SD,Aug-17,32151,31341,810,2.5
CN4608300000000,46,083,Lincoln County, SD,Sep-17,31849,31093,756,2.4
CN4608300000000,46,083,Lincoln County, SD,Oct-17,32359,31606,753,2.3
CN4608300000000,46,083,Lincoln County, SD,Nov-17,32358,31551,807,2.5
CN4608300000000,46,083,Lincoln County, SD,Dec-17,32013,31199,814,2.5
CN4608300000000,46,083,Lincoln County, SD,Jan-18,31988,31069,919,2.9
CN4608300000000,46,083,Lincoln County, SD,Feb-18,32212,31275,937,2.9
CN4608300000000,46,083,Lincoln County, SD,Mar-18,32260,31389,871,2.7
CN4608300000000,46,083,Lincoln County, SD,Apr-18(p),32387,31537,850,2.6
CN2705700000000,27,057,Hubbard County, MN,Mar-17,9537,8805,732,7.7
CN2705700000000,27,057,Hubbard County, MN,Apr-17,9561,9024,537,5.6
CN2705700000000,27,057,Hubbard County, MN,May-17,9884,9471,413,4.2
CN2705700000000,27,057,Hubbard County, MN,Jun-17,10231,9787,444,4.3
CN2705700000000,27,057,Hubbard County, MN,Jul-17,10259,9829,430,4.2
CN2705700000000,27,057,Hubbard County, MN,Aug-17,10080,9649,431,4.3
CN2705700000000,27,057,Hubbard County, MN,Sep-17,9937,9586,351,3.5
CN2705700000000,27,057,Hubbard County, MN,Oct-17,9929,9612,317,3.2
CN2705700000000,27,057,Hubbard County, MN,Nov-17,10167,9589,578,5.7
CN2705700000000,27,057,Hubbard County, MN,Dec-17,10249,9573,676,6.6
CN2705700000000,27,057,Hubbard County, MN,Jan-18,10266,9468,798,7.8
CN2705700000000,27,057,Hubbard County, MN,Feb-18,10243,9504,739,7.2
CN2705700000000,27,057,Hubbard County, MN,Mar-18,10175,9492,683,6.7
CN2705700000000,27,057,Hubbard County, MN,Apr-18(p),10378,9837,541,5.2
CN5172000000000,51,720,Norton city, VA,Mar-17,1661,1564,97,5.8
CN5172000000000,51,720,Norton city, VA,Apr-17,1648,1564,84,5.1
CN5172000000000,51,720,Norton city, VA,May-17,1642,1551,91,5.5
CN5172000000000,51,720,Norton city, VA,Jun-17,1651,1557,94,5.7
CN5172000000000,51,720,Norton city, VA,Jul-17,1626,1530,96,5.9
CN5172000000000,51,720,Norton city, VA,Aug-17,1615,1524,91,5.6
CN5172000000000,51,720,Norton city, VA,Sep-17,1596,1518,78,4.9
CN5172000000000,51,720,Norton city, VA,Oct-17,1610,1532,78,4.8
CN5172000000000,51,720,Norton city, VA,Nov-17,1606,1530,76,4.7
CN5172000000000,51,720,Norton city, VA,Dec-17,1599,1525,74,4.6
CN5172000000000,51,720,Norton city, VA,Jan-18,1584,1509,75,4.7
CN5172000000000,51,720,Norton city, VA,Feb-18,1577,1509,68,4.3
CN5172000000000,51,720,Norton city, VA,Mar-18,1596,1521,75,4.7
CN5172000000000,51,720,Norton city, VA,Apr-18(p),1593,1530,63,4.0
CN3901900000000,39,019,Carroll County, OH,Mar-17,13503,12619,884,6.5
CN3901900000000,39,019,Carroll County, OH,Apr-17,13443,12688,755,5.6
CN3901900000000,39,019,Carroll County, OH,May-17,13393,12696,697,5.2
CN3901900000000,39,019,Carroll County, OH,Jun-17,13433,12695,738,5.5
CN3901900000000,39,019,Carroll County, OH,Jul-17,13338,12598,740,5.5
CN3901900000000,39,019,Carroll County, OH,Aug-17,13385,12668,717,5.4
CN3901900000000,39,019,Carroll County, OH,Sep-17,13286,12622,664,5.0
CN3901900000000,39,019,Carroll County, OH,Oct-17,13344,12678,666,5.0
CN3901900000000,39,019,Carroll County, OH,Nov-17,13360,12667,693,5.2
CN3901900000000,39,019,Carroll County, OH,Dec-17,13251,12502,749,5.7
CN3901900000000,39,019,Carroll County, OH,Jan-18,13165,12286,879,6.7
CN3901900000000,39,019,Carroll County, OH,Feb-18,13324,12524,800,6.0
CN3901900000000,39,019,Carroll County, OH,Mar-18,13432,12691,741,5.5
CN3901900000000,39,019,Carroll County, OH,Apr-18(p),13314,12647,667,5.0
CN3912500000000,39,125,Paulding County, OH,Mar-17,8993,8593,400,4.4
CN3912500000000,39,125,Paulding County, OH,Apr-17,8932,8586,346,3.9
CN3912500000000,39,125,Paulding County, OH,May-17,8955,8602,353,3.9
CN3912500000000,39,125,Paulding County, OH,Jun-17,8972,8559,413,4.6
CN3912500000000,39,125,Paulding County, OH,Jul-17,8857,8433,424,4.8
CN3912500000000,39,125,Paulding County, OH,Aug-17,9042,8619,423,4.7
CN3912500000000,39,125,Paulding County, OH,Sep-17,8955,8571,384,4.3
CN3912500000000,39,125,Paulding County, OH,Oct-17,8852,8506,346,3.9
CN3912500000000,39,125,Paulding County, OH,Nov-17,8802,8458,344,3.9
CN3912500000000,39,125,Paulding County, OH,Dec-17,8631,8291,340,3.9
CN3912500000000,39,125,Paulding County, OH,Jan-18,8453,8062,391,4.6
CN3912500000000,39,125,Paulding County, OH,Feb-18,8698,8345,353,4.1
CN3912500000000,39,125,Paulding County, OH,Mar-18,8899,8578,321,3.6
CN3912500000000,39,125,Paulding County, OH,Apr-18(p),8827,8517,310,3.5
CN4841700000000,48,417,Shackelford County, TX,Mar-17,1923,1862,61,3.2
CN4841700000000,48,417,Shackelford County, TX,Apr-17,1894,1843,51,2.7
CN4841700000000,48,417,Shackelford County, TX,May-17,1923,1870,53,2.8
CN4841700000000,48,417,Shackelford County, TX,Jun-17,1960,1901,59,3.0
CN4841700000000,48,417,Shackelford County, TX,Jul-17,1865,1801,64,3.4
CN4841700000000,48,417,Shackelford County, TX,Aug-17,1902,1846,56,2.9
CN4841700000000,48,417,Shackelford County, TX,Sep-17,1845,1794,51,2.8
CN4841700000000,48,417,Shackelford County, TX,Oct-17,1828,1782,46,2.5
CN4841700000000,48,417,Shackelford County, TX,Nov-17,1806,1760,46,2.5
CN4841700000000,48,417,Shackelford County, TX,Dec-17,1846,1799,47,2.5
CN4841700000000,48,417,Shackelford County, TX,Jan-18,1815,1766,49,2.7
CN4841700000000,48,417,Shackelford County, TX,Feb-18,1835,1783,52,2.8
CN4841700000000,48,417,Shackelford County, TX,Mar-18,1879,1831,48,2.6
CN4841700000000,48,417,Shackelford County, TX,Apr-18(p),1913,1871,42,2.2
CN1704500000000,17,045,Edgar County, IL,Mar-17,9474,8977,497,5.2
CN1704500000000,17,045,Edgar County, IL,Apr-17,9647,9248,399,4.1
CN1704500000000,17,045,Edgar County, IL,May-17,9554,9165,389,4.1
CN1704500000000,17,045,Edgar County, IL,Jun-17,9516,9078,438,4.6
CN1704500000000,17,045,Edgar County, IL,Jul-17,9501,9023,478,5.0
CN1704500000000,17,045,Edgar County, IL,Aug-17,9406,8916,490,5.2
CN1704500000000,17,045,Edgar County, IL,Sep-17,9237,8844,393,4.3
CN1704500000000,17,045,Edgar County, IL,Oct-17,9306,8941,365,3.9
CN1704500000000,17,045,Edgar County, IL,Nov-17,9310,8941,369,4.0
CN1704500000000,17,045,Edgar County, IL,Dec-17,9197,8822,375,4.1
CN1704500000000,17,045,Edgar County, IL,Jan-18,9203,8778,425,4.6
CN1704500000000,17,045,Edgar County, IL,Feb-18,9217,8838,379,4.1
CN1704500000000,17,045,Edgar County, IL,Mar-18,9368,8991,377,4.0
CN1704500000000,17,045,Edgar County, IL,Apr-18(p),9592,9274,318,3.3
CN2906700000000,29,067,Douglas County, MO,Mar-17,5033,4795,238,4.7
CN2906700000000,29,067,Douglas County, MO,Apr-17,5095,4872,223,4.4
CN2906700000000,29,067,Douglas County, MO,May-17,5026,4803,223,4.4
CN2906700000000,29,067,Douglas County, MO,Jun-17,5039,4811,228,4.5
CN2906700000000,29,067,Douglas County, MO,Jul-17,4907,4656,251,5.1
CN2906700000000,29,067,Douglas County, MO,Aug-17,4851,4569,282,5.8
CN2906700000000,29,067,Douglas County, MO,Sep-17,4923,4637,286,5.8
CN2906700000000,29,067,Douglas County, MO,Oct-17,4900,4750,150,3.1
CN2906700000000,29,067,Douglas County, MO,Nov-17,4922,4733,189,3.8
CN2906700000000,29,067,Douglas County, MO,Dec-17,4907,4721,186,3.8
CN2906700000000,29,067,Douglas County, MO,Jan-18,4928,4700,228,4.6
CN2906700000000,29,067,Douglas County, MO,Feb-18,4961,4745,216,4.4
CN2906700000000,29,067,Douglas County, MO,Mar-18,4961,4755,206,4.2
CN2906700000000,29,067,Douglas County, MO,Apr-18(p),5002,4812,190,3.8
CN2900700000000,29,007,Audrain County, MO,Mar-17,11070,10692,378,3.4
CN2900700000000,29,007,Audrain County, MO,Apr-17,11203,10848,355,3.2
CN2900700000000,29,007,Audrain County, MO,May-17,11000,10636,364,3.3
CN2900700000000,29,007,Audrain County, MO,Jun-17,11012,10628,384,3.5
CN2900700000000,29,007,Audrain County, MO,Jul-17,10758,10341,417,3.9
CN2900700000000,29,007,Audrain County, MO,Aug-17,10698,10207,491,4.6
CN2900700000000,29,007,Audrain County, MO,Sep-17,10777,10413,364,3.4
CN2900700000000,29,007,Audrain County, MO,Oct-17,10872,10603,269,2.5
CN2900700000000,29,007,Audrain County, MO,Nov-17,10985,10640,345,3.1
CN2900700000000,29,007,Audrain County, MO,Dec-17,10933,10562,371,3.4
CN2900700000000,29,007,Audrain County, MO,Jan-18,10814,10384,430,4.0
CN2900700000000,29,007,Audrain County, MO,Feb-18,10885,10449,436,4.0
CN2900700000000,29,007,Audrain County, MO,Mar-18,10836,10453,383,3.5
CN2900700000000,29,007,Audrain County, MO,Apr-18(p),10936,10576,360,3.3
CN2811700000000,28,117,Prentiss County, MS,Mar-17,11106,10584,522,4.7
CN2811700000000,28,117,Prentiss County, MS,Apr-17,11198,10735,463,4.1
CN2811700000000,28,117,Prentiss County, MS,May-17,11230,10679,551,4.9
CN2811700000000,28,117,Prentiss County, MS,Jun-17,11261,10643,618,5.5
CN2811700000000,28,117,Prentiss County, MS,Jul-17,11202,10623,579,5.2
CN2811700000000,28,117,Prentiss County, MS,Aug-17,11066,10552,514,4.6
CN2811700000000,28,117,Prentiss County, MS,Sep-17,11185,10711,474,4.2
CN2811700000000,28,117,Prentiss County, MS,Oct-17,11062,10617,445,4.0
CN2811700000000,28,117,Prentiss County, MS,Nov-17,11045,10614,431,3.9
CN2811700000000,28,117,Prentiss County, MS,Dec-17,11020,10592,428,3.9
CN2811700000000,28,117,Prentiss County, MS,Jan-18,10841,10419,422,3.9
CN2811700000000,28,117,Prentiss County, MS,Feb-18,10924,10493,431,3.9
CN2811700000000,28,117,Prentiss County, MS,Mar-18,11000,10564,436,4.0
CN2811700000000,28,117,Prentiss County, MS,Apr-18(p),11099,10669,430,3.9
CN3600300000000,36,003,Allegany County, NY,Mar-17,20315,18863,1452,7.1
CN3600300000000,36,003,Allegany County, NY,Apr-17,20056,18707,1349,6.7
CN3600300000000,36,003,Allegany County, NY,May-17,19690,18449,1241,6.3
CN3600300000000,36,003,Allegany County, NY,Jun-17,19549,18218,1331,6.8
CN3600300000000,36,003,Allegany County, NY,Jul-17,19734,18445,1289,6.5
CN3600300000000,36,003,Allegany County, NY,Aug-17,19608,18384,1224,6.2
CN3600300000000,36,003,Allegany County, NY,Sep-17,19828,18700,1128,5.7
CN3600300000000,36,003,Allegany County, NY,Oct-17,19763,18646,1117,5.7
CN3600300000000,36,003,Allegany County, NY,Nov-17,19826,18560,1266,6.4
CN3600300000000,36,003,Allegany County, NY,Dec-17,19647,18356,1291,6.6
CN3600300000000,36,003,Allegany County, NY,Jan-18,19614,17924,1690,8.6
CN3600300000000,36,003,Allegany County, NY,Feb-18,19941,18276,1665,8.3
CN3600300000000,36,003,Allegany County, NY,Mar-18,19462,17970,1492,7.7
CN3600300000000,36,003,Allegany County, NY,Apr-18(p),19096,17821,1275,6.7
CN2104300000000,21,043,Carter County, KY,Mar-17,10459,9348,1111,10.6
CN2104300000000,21,043,Carter County, KY,Apr-17,10239,9279,960,9.4
CN2104300000000,21,043,Carter County, KY,May-17,10191,9249,942,9.2
CN2104300000000,21,043,Carter County, KY,Jun-17,10424,9331,1093,10.5
CN2104300000000,21,043,Carter County, KY,Jul-17,10337,9301,1036,10.0
CN2104300000000,21,043,Carter County, KY,Aug-17,10207,9236,971,9.5
CN2104300000000,21,043,Carter County, KY,Sep-17,10108,9350,758,7.5
CN2104300000000,21,043,Carter County, KY,Oct-17,9919,9262,657,6.6
CN2104300000000,21,043,Carter County, KY,Nov-17,10008,9289,719,7.2
CN2104300000000,21,043,Carter County, KY,Dec-17,10125,9247,878,8.7
CN2104300000000,21,043,Carter County, KY,Jan-18,10446,9096,1350,12.9
CN2104300000000,21,043,Carter County, KY,Feb-18,10353,9306,1047,10.1
CN2104300000000,21,043,Carter County, KY,Mar-18,10328,9439,889,8.6
CN2104300000000,21,043,Carter County, KY,Apr-18(p),10221,9446,775,7.6
CN4814900000000,48,149,Fayette County, TX,Mar-17,12681,12257,424,3.3
CN4814900000000,48,149,Fayette County, TX,Apr-17,12701,12335,366,2.9
CN4814900000000,48,149,Fayette County, TX,May-17,12735,12364,371,2.9
CN4814900000000,48,149,Fayette County, TX,Jun-17,12816,12425,391,3.1
CN4814900000000,48,149,Fayette County, TX,Jul-17,12764,12355,409,3.2
CN4814900000000,48,149,Fayette County, TX,Aug-17,12627,12223,404,3.2
CN4814900000000,48,149,Fayette County, TX,Sep-17,12584,12211,373,3.0
CN4814900000000,48,149,Fayette County, TX,Oct-17,12543,12190,353,2.8
CN4814900000000,48,149,Fayette County, TX,Nov-17,12509,12134,375,3.0
CN4814900000000,48,149,Fayette County, TX,Dec-17,12529,12166,363,2.9
CN4814900000000,48,149,Fayette County, TX,Jan-18,12660,12265,395,3.1
CN4814900000000,48,149,Fayette County, TX,Feb-18,12765,12371,394,3.1
CN4814900000000,48,149,Fayette County, TX,Mar-18,12868,12474,394,3.1
CN4814900000000,48,149,Fayette County, TX,Apr-18(p),12714,12366,348,2.7
CN2015300000000,20,153,Rawlins County, KS,Mar-17,1460,1431,29,2.0
CN2015300000000,20,153,Rawlins County, KS,Apr-17,1410,1380,30,2.1
CN2015300000000,20,153,Rawlins County, KS,May-17,1417,1384,33,2.3
CN2015300000000,20,153,Rawlins County, KS,Jun-17,1491,1456,35,2.3
CN2015300000000,20,153,Rawlins County, KS,Jul-17,1480,1435,45,3.0
CN2015300000000,20,153,Rawlins County, KS,Aug-17,1494,1450,44,2.9
CN2015300000000,20,153,Rawlins County, KS,Sep-17,1499,1468,31,2.1
CN2015300000000,20,153,Rawlins County, KS,Oct-17,1496,1468,28,1.9
CN2015300000000,20,153,Rawlins County, KS,Nov-17,1483,1454,29,2.0
CN2015300000000,20,153,Rawlins County, KS,Dec-17,1473,1442,31,2.1
CN2015300000000,20,153,Rawlins County, KS,Jan-18,1429,1399,30,2.1
CN2015300000000,20,153,Rawlins County, KS,Feb-18,1412,1382,30,2.1
CN2015300000000,20,153,Rawlins County, KS,Mar-18,1428,1394,34,2.4
CN2015300000000,20,153,Rawlins County, KS,Apr-18(p),1334,1304,30,2.2
CN1603100000000,16,031,Cassia County, ID,Mar-17,11290,10970,320,2.8
CN1603100000000,16,031,Cassia County, ID,Apr-17,11513,11244,269,2.3
CN1603100000000,16,031,Cassia County, ID,May-17,11691,11413,278,2.4
CN1603100000000,16,031,Cassia County, ID,Jun-17,11888,11594,294,2.5
CN1603100000000,16,031,Cassia County, ID,Jul-17,11930,11643,287,2.4
CN1603100000000,16,031,Cassia County, ID,Aug-17,11958,11671,287,2.4
CN1603100000000,16,031,Cassia County, ID,Sep-17,11989,11741,248,2.1
CN1603100000000,16,031,Cassia County, ID,Oct-17,12450,12224,226,1.8
CN1603100000000,16,031,Cassia County, ID,Nov-17,11783,11518,265,2.2
CN1603100000000,16,031,Cassia County, ID,Dec-17,11563,11305,258,2.2
CN1603100000000,16,031,Cassia County, ID,Jan-18,11353,11011,342,3.0
CN1603100000000,16,031,Cassia County, ID,Feb-18,11577,11287,290,2.5
CN1603100000000,16,031,Cassia County, ID,Mar-18,11645,11360,285,2.4
CN1603100000000,16,031,Cassia County, ID,Apr-18(p),11838,11581,257,2.2
CN3110100000000,31,101,Keith County, NE,Mar-17,4526,4375,151,3.3
CN3110100000000,31,101,Keith County, NE,Apr-17,4577,4433,144,3.1
CN3110100000000,31,101,Keith County, NE,May-17,4681,4550,131,2.8
CN3110100000000,31,101,Keith County, NE,Jun-17,4873,4735,138,2.8
CN3110100000000,31,101,Keith County, NE,Jul-17,4730,4587,143,3.0
CN3110100000000,31,101,Keith County, NE,Aug-17,4660,4534,126,2.7
CN3110100000000,31,101,Keith County, NE,Sep-17,4476,4370,106,2.4
CN3110100000000,31,101,Keith County, NE,Oct-17,4416,4311,105,2.4
CN3110100000000,31,101,Keith County, NE,Nov-17,4427,4302,125,2.8
CN3110100000000,31,101,Keith County, NE,Dec-17,4396,4260,136,3.1
CN3110100000000,31,101,Keith County, NE,Jan-18,4471,4313,158,3.5
CN3110100000000,31,101,Keith County, NE,Feb-18,4441,4282,159,3.6
CN3110100000000,31,101,Keith County, NE,Mar-18,4497,4352,145,3.2
CN3110100000000,31,101,Keith County, NE,Apr-18(p),4463,4319,144,3.2
CN4502700000000,45,027,Clarendon County, SC,Mar-17,12247,11567,680,5.6
CN4502700000000,45,027,Clarendon County, SC,Apr-17,12259,11593,666,5.4
CN4502700000000,45,027,Clarendon County, SC,May-17,12326,11665,661,5.4
CN4502700000000,45,027,Clarendon County, SC,Jun-17,12568,11805,763,6.1
CN4502700000000,45,027,Clarendon County, SC,Jul-17,12566,11815,751,6.0
CN4502700000000,45,027,Clarendon County, SC,Aug-17,12543,11698,845,6.7
CN4502700000000,45,027,Clarendon County, SC,Sep-17,12431,11700,731,5.9
CN4502700000000,45,027,Clarendon County, SC,Oct-17,12438,11710,728,5.9
CN4502700000000,45,027,Clarendon County, SC,Nov-17,12426,11735,691,5.6
CN4502700000000,45,027,Clarendon County, SC,Dec-17,12618,11882,736,5.8
CN4502700000000,45,027,Clarendon County, SC,Jan-18,12706,11824,882,6.9
CN4502700000000,45,027,Clarendon County, SC,Feb-18,12697,11904,793,6.2
CN4502700000000,45,027,Clarendon County, SC,Mar-18,12471,11774,697,5.6
CN4502700000000,45,027,Clarendon County, SC,Apr-18(p),12299,11810,489,4.0
CN4012500000000,40,125,Pottawatomie County, OK,Mar-17,33042,31662,1380,4.2
CN4012500000000,40,125,Pottawatomie County, OK,Apr-17,33120,31876,1244,3.8
CN4012500000000,40,125,Pottawatomie County, OK,May-17,33190,31781,1409,4.2
CN4012500000000,40,125,Pottawatomie County, OK,Jun-17,33179,31665,1514,4.6
CN4012500000000,40,125,Pottawatomie County, OK,Jul-17,32542,31116,1426,4.4
CN4012500000000,40,125,Pottawatomie County, OK,Aug-17,32788,31369,1419,4.3
CN4012500000000,40,125,Pottawatomie County, OK,Sep-17,33206,31881,1325,4.0
CN4012500000000,40,125,Pottawatomie County, OK,Oct-17,33285,32010,1275,3.8
CN4012500000000,40,125,Pottawatomie County, OK,Nov-17,33371,32122,1249,3.7
CN4012500000000,40,125,Pottawatomie County, OK,Dec-17,33144,31870,1274,3.8
CN4012500000000,40,125,Pottawatomie County, OK,Jan-18,33012,31589,1423,4.3
CN4012500000000,40,125,Pottawatomie County, OK,Feb-18,33203,31854,1349,4.1
CN4012500000000,40,125,Pottawatomie County, OK,Mar-18,33475,32147,1328,4.0
CN4012500000000,40,125,Pottawatomie County, OK,Apr-18(p),33342,32037,1305,3.9
CN0401900000000,04,019,Pima County, AZ,Mar-17,477443,455490,21953,4.6
CN0401900000000,04,019,Pima County, AZ,Apr-17,474254,453783,20471,4.3
CN0401900000000,04,019,Pima County, AZ,May-17,474428,454039,20389,4.3
CN0401900000000,04,019,Pima County, AZ,Jun-17,471724,449673,22051,4.7
CN0401900000000,04,019,Pima County, AZ,Jul-17,472599,450803,21796,4.6
CN0401900000000,04,019,Pima County, AZ,Aug-17,470143,448269,21874,4.7
CN0401900000000,04,019,Pima County, AZ,Sep-17,480619,459502,21117,4.4
CN0401900000000,04,019,Pima County, AZ,Oct-17,476677,456410,20267,4.3
CN0401900000000,04,019,Pima County, AZ,Nov-17,477348,457107,20241,4.2
CN0401900000000,04,019,Pima County, AZ,Dec-17,478935,458610,20325,4.2
CN0401900000000,04,019,Pima County, AZ,Jan-18,481377,458578,22799,4.7
CN0401900000000,04,019,Pima County, AZ,Feb-18,486194,463406,22788,4.7
CN0401900000000,04,019,Pima County, AZ,Mar-18,484557,463798,20759,4.3
CN0401900000000,04,019,Pima County, AZ,Apr-18(p),482822,463230,19592,4.1
CN4848500000000,48,485,Wichita County, TX,Mar-17,56174,53906,2268,4.0
CN4848500000000,48,485,Wichita County, TX,Apr-17,56178,54218,1960,3.5
CN4848500000000,48,485,Wichita County, TX,May-17,55970,53978,1992,3.6
CN4848500000000,48,485,Wichita County, TX,Jun-17,56131,53948,2183,3.9
CN4848500000000,48,485,Wichita County, TX,Jul-17,56227,54032,2195,3.9
CN4848500000000,48,485,Wichita County, TX,Aug-17,55670,53558,2112,3.8
CN4848500000000,48,485,Wichita County, TX,Sep-17,55911,54030,1881,3.4
CN4848500000000,48,485,Wichita County, TX,Oct-17,55665,53936,1729,3.1
CN4848500000000,48,485,Wichita County, TX,Nov-17,55902,54059,1843,3.3
CN4848500000000,48,485,Wichita County, TX,Dec-17,55835,54092,1743,3.1
CN4848500000000,48,485,Wichita County, TX,Jan-18,56061,54052,2009,3.6
CN4848500000000,48,485,Wichita County, TX,Feb-18,56699,54677,2022,3.6
CN4848500000000,48,485,Wichita County, TX,Mar-18,56669,54540,2129,3.8
CN4848500000000,48,485,Wichita County, TX,Apr-18(p),56617,54792,1825,3.2
CN4903900000000,49,039,Sanpete County, UT,Mar-17,12300,11787,513,4.2
CN4903900000000,49,039,Sanpete County, UT,Apr-17,12274,11838,436,3.6
CN4903900000000,49,039,Sanpete County, UT,May-17,12022,11577,445,3.7
CN4903900000000,49,039,Sanpete County, UT,Jun-17,12261,11713,548,4.5
CN4903900000000,49,039,Sanpete County, UT,Jul-17,11643,11116,527,4.5
CN4903900000000,49,039,Sanpete County, UT,Aug-17,11677,11160,517,4.4
CN4903900000000,49,039,Sanpete County, UT,Sep-17,12393,11955,438,3.5
CN4903900000000,49,039,Sanpete County, UT,Oct-17,12261,11847,414,3.4
CN4903900000000,49,039,Sanpete County, UT,Nov-17,11936,11564,372,3.1
CN4903900000000,49,039,Sanpete County, UT,Dec-17,12037,11627,410,3.4
CN4903900000000,49,039,Sanpete County, UT,Jan-18,12027,11563,464,3.9
CN4903900000000,49,039,Sanpete County, UT,Feb-18,12346,11810,536,4.3
CN4903900000000,49,039,Sanpete County, UT,Mar-18,12622,12107,515,4.1
CN4903900000000,49,039,Sanpete County, UT,Apr-18(p),12471,12050,421,3.4
CN1915300000000,19,153,Polk County, IA,Mar-17,258743,249905,8838,3.4
CN1915300000000,19,153,Polk County, IA,Apr-17,258564,250725,7839,3.0
CN1915300000000,19,153,Polk County, IA,May-17,258397,250808,7589,2.9
CN1915300000000,19,153,Polk County, IA,Jun-17,262501,254133,8368,3.2
CN1915300000000,19,153,Polk County, IA,Jul-17,263718,255779,7939,3.0
CN1915300000000,19,153,Polk County, IA,Aug-17,260808,252910,7898,3.0
CN1915300000000,19,153,Polk County, IA,Sep-17,258239,251070,7169,2.8
CN1915300000000,19,153,Polk County, IA,Oct-17,258085,251960,6125,2.4
CN1915300000000,19,153,Polk County, IA,Nov-17,259052,252572,6480,2.5
CN1915300000000,19,153,Polk County, IA,Dec-17,257488,250402,7086,2.8
CN1915300000000,19,153,Polk County, IA,Jan-18,258492,249518,8974,3.5
CN1915300000000,19,153,Polk County, IA,Feb-18,258974,250168,8806,3.4
CN1915300000000,19,153,Polk County, IA,Mar-18,259546,251705,7841,3.0
CN1915300000000,19,153,Polk County, IA,Apr-18(p),261070,254665,6405,2.5
CN0608900000000,06,089,Shasta County, CA,Mar-17,74241,69102,5139,6.9
CN0608900000000,06,089,Shasta County, CA,Apr-17,74339,69753,4586,6.2
CN0608900000000,06,089,Shasta County, CA,May-17,74200,70255,3945,5.3
CN0608900000000,06,089,Shasta County, CA,Jun-17,75160,70996,4164,5.5
CN0608900000000,06,089,Shasta County, CA,Jul-17,74177,69844,4333,5.8
CN0608900000000,06,089,Shasta County, CA,Aug-17,74687,70538,4149,5.6
CN0608900000000,06,089,Shasta County, CA,Sep-17,74745,71108,3637,4.9
CN0608900000000,06,089,Shasta County, CA,Oct-17,75115,71534,3581,4.8
CN0608900000000,06,089,Shasta County, CA,Nov-17,74290,70661,3629,4.9
CN0608900000000,06,089,Shasta County, CA,Dec-17,73987,70215,3772,5.1
CN0608900000000,06,089,Shasta County, CA,Jan-18,74470,70243,4227,5.7
CN0608900000000,06,089,Shasta County, CA,Feb-18,74212,69828,4384,5.9
CN0608900000000,06,089,Shasta County, CA,Mar-18,74048,69823,4225,5.7
CN0608900000000,06,089,Shasta County, CA,Apr-18(p),73660,70050,3610,4.9
CN4703700000000,47,037,Davidson County, TN,Mar-17,384674,373077,11597,3.0
CN4703700000000,47,037,Davidson County, TN,Apr-17,385176,375481,9695,2.5
CN4703700000000,47,037,Davidson County, TN,May-17,386314,376998,9316,2.4
CN4703700000000,47,037,Davidson County, TN,Jun-17,392444,380607,11837,3.0
CN4703700000000,47,037,Davidson County, TN,Jul-17,394036,382649,11387,2.9
CN4703700000000,47,037,Davidson County, TN,Aug-17,388904,378064,10840,2.8
CN4703700000000,47,037,Davidson County, TN,Sep-17,392659,383004,9655,2.5
CN4703700000000,47,037,Davidson County, TN,Oct-17,392030,382866,9164,2.3
CN4703700000000,47,037,Davidson County, TN,Nov-17,390623,381298,9325,2.4
CN4703700000000,47,037,Davidson County, TN,Dec-17,389865,381000,8865,2.3
CN4703700000000,47,037,Davidson County, TN,Jan-18,388873,378530,10343,2.7
CN4703700000000,47,037,Davidson County, TN,Feb-18,393471,383291,10180,2.6
CN4703700000000,47,037,Davidson County, TN,Mar-18,395086,384904,10182,2.6
CN4703700000000,47,037,Davidson County, TN,Apr-18(p),397637,389112,8525,2.1
CN4714300000000,47,143,Rhea County, TN,Mar-17,13431,12453,978,7.3
CN4714300000000,47,143,Rhea County, TN,Apr-17,13376,12557,819,6.1
CN4714300000000,47,143,Rhea County, TN,May-17,13299,12554,745,5.6
CN4714300000000,47,143,Rhea County, TN,Jun-17,13359,12453,906,6.8
CN4714300000000,47,143,Rhea County, TN,Jul-17,13184,12335,849,6.4
CN4714300000000,47,143,Rhea County, TN,Aug-17,13231,12430,801,6.1
CN4714300000000,47,143,Rhea County, TN,Sep-17,13204,12491,713,5.4
CN4714300000000,47,143,Rhea County, TN,Oct-17,13214,12484,730,5.5
CN4714300000000,47,143,Rhea County, TN,Nov-17,13082,12418,664,5.1
CN4714300000000,47,143,Rhea County, TN,Dec-17,13074,12347,727,5.6
CN4714300000000,47,143,Rhea County, TN,Jan-18,13170,12280,890,6.8
CN4714300000000,47,143,Rhea County, TN,Feb-18,13354,12505,849,6.4
CN4714300000000,47,143,Rhea County, TN,Mar-18,13276,12524,752,5.7
CN4714300000000,47,143,Rhea County, TN,Apr-18(p),13289,12671,618,4.7
CN5002100000000,50,021,Rutland County, VT,Mar-17,30794,29597,1197,3.9
CN5002100000000,50,021,Rutland County, VT,Apr-17,30324,29183,1141,3.8
CN5002100000000,50,021,Rutland County, VT,May-17,30588,29476,1112,3.6
CN5002100000000,50,021,Rutland County, VT,Jun-17,31324,30121,1203,3.8
CN5002100000000,50,021,Rutland County, VT,Jul-17,31518,30360,1158,3.7
CN5002100000000,50,021,Rutland County, VT,Aug-17,31549,30475,1074,3.4
CN5002100000000,50,021,Rutland County, VT,Sep-17,30803,29713,1090,3.5
CN5002100000000,50,021,Rutland County, VT,Oct-17,30841,30011,830,2.7
CN5002100000000,50,021,Rutland County, VT,Nov-17,30877,29946,931,3.0
CN5002100000000,50,021,Rutland County, VT,Dec-17,30990,30136,854,2.8
CN5002100000000,50,021,Rutland County, VT,Jan-18,31056,29940,1116,3.6
CN5002100000000,50,021,Rutland County, VT,Feb-18,31206,30128,1078,3.5
CN5002100000000,50,021,Rutland County, VT,Mar-18,31309,30287,1022,3.3
CN5002100000000,50,021,Rutland County, VT,Apr-18(p),30794,29711,1083,3.5
CN0602900000000,06,029,Kern County, CA,Mar-17,381676,337932,43744,11.5
CN0602900000000,06,029,Kern County, CA,Apr-17,384517,346412,38105,9.9
CN0602900000000,06,029,Kern County, CA,May-17,385486,351511,33975,8.8
CN0602900000000,06,029,Kern County, CA,Jun-17,387561,351921,35640,9.2
CN0602900000000,06,029,Kern County, CA,Jul-17,384859,349150,35709,9.3
CN0602900000000,06,029,Kern County, CA,Aug-17,388255,354870,33385,8.6
CN0602900000000,06,029,Kern County, CA,Sep-17,389308,360252,29056,7.5
CN0602900000000,06,029,Kern County, CA,Oct-17,387218,359055,28163,7.3
CN0602900000000,06,029,Kern County, CA,Nov-17,382677,353866,28811,7.5
CN0602900000000,06,029,Kern County, CA,Dec-17,378909,347045,31864,8.4
CN0602900000000,06,029,Kern County, CA,Jan-18,382946,347473,35473,9.3
CN0602900000000,06,029,Kern County, CA,Feb-18,384261,347145,37116,9.7
CN0602900000000,06,029,Kern County, CA,Mar-18,376484,340224,36260,9.6
CN0602900000000,06,029,Kern County, CA,Apr-18(p),377016,345682,31334,8.3
CN0513900000000,05,139,Union County, AR,Mar-17,16128,15269,859,5.3
CN0513900000000,05,139,Union County, AR,Apr-17,16064,15279,785,4.9
CN0513900000000,05,139,Union County, AR,May-17,16205,15381,824,5.1
CN0513900000000,05,139,Union County, AR,Jun-17,16547,15569,978,5.9
CN0513900000000,05,139,Union County, AR,Jul-17,16051,15056,995,6.2
CN0513900000000,05,139,Union County, AR,Aug-17,16196,15327,869,5.4
CN0513900000000,05,139,Union County, AR,Sep-17,16186,15383,803,5.0
CN0513900000000,05,139,Union County, AR,Oct-17,16141,15418,723,4.5
CN0513900000000,05,139,Union County, AR,Nov-17,16066,15330,736,4.6
CN0513900000000,05,139,Union County, AR,Dec-17,16050,15223,827,5.2
CN0513900000000,05,139,Union County, AR,Jan-18,15969,14972,997,6.2
CN0513900000000,05,139,Union County, AR,Feb-18,16107,15035,1072,6.7
CN0513900000000,05,139,Union County, AR,Mar-18,16138,15129,1009,6.3
CN0513900000000,05,139,Union County, AR,Apr-18(p),15989,15100,889,5.6
CN4803300000000,48,033,Borden County, TX,Mar-17,338,328,10,3.0
CN4803300000000,48,033,Borden County, TX,Apr-17,337,328,9,2.7
CN4803300000000,48,033,Borden County, TX,May-17,332,323,9,2.7
CN4803300000000,48,033,Borden County, TX,Jun-17,328,316,12,3.7
CN4803300000000,48,033,Borden County, TX,Jul-17,312,299,13,4.2
CN4803300000000,48,033,Borden County, TX,Aug-17,312,301,11,3.5
CN4803300000000,48,033,Borden County, TX,Sep-17,300,289,11,3.7
CN4803300000000,48,033,Borden County, TX,Oct-17,302,292,10,3.3
CN4803300000000,48,033,Borden County, TX,Nov-17,304,294,10,3.3
CN4803300000000,48,033,Borden County, TX,Dec-17,305,293,12,3.9
CN4803300000000,48,033,Borden County, TX,Jan-18,301,288,13,4.3
CN4803300000000,48,033,Borden County, TX,Feb-18,308,294,14,4.5
CN4803300000000,48,033,Borden County, TX,Mar-18,317,304,13,4.1
CN4803300000000,48,033,Borden County, TX,Apr-18(p),305,292,13,4.3
CN2020900000000,20,209,Wyandotte County, KS,Mar-17,76533,72130,4403,5.8
CN2020900000000,20,209,Wyandotte County, KS,Apr-17,76189,72739,3450,4.5
CN2020900000000,20,209,Wyandotte County, KS,May-17,76249,72733,3516,4.6
CN2020900000000,20,209,Wyandotte County, KS,Jun-17,78012,74019,3993,5.1
CN2020900000000,20,209,Wyandotte County, KS,Jul-17,79606,75105,4501,5.7
CN2020900000000,20,209,Wyandotte County, KS,Aug-17,78416,73668,4748,6.1
CN2020900000000,20,209,Wyandotte County, KS,Sep-17,76696,73194,3502,4.6
CN2020900000000,20,209,Wyandotte County, KS,Oct-17,77073,73192,3881,5.0
CN2020900000000,20,209,Wyandotte County, KS,Nov-17,77169,73788,3381,4.4
CN2020900000000,20,209,Wyandotte County, KS,Dec-17,76873,73479,3394,4.4
CN2020900000000,20,209,Wyandotte County, KS,Jan-18,77634,73155,4479,5.8
CN2020900000000,20,209,Wyandotte County, KS,Feb-18,77269,73062,4207,5.4
CN2020900000000,20,209,Wyandotte County, KS,Mar-18,76536,72771,3765,4.9
CN2020900000000,20,209,Wyandotte County, KS,Apr-18(p),77092,73625,3467,4.5
CN2922900000000,29,229,Wright County, MO,Mar-17,7648,7288,360,4.7
CN2922900000000,29,229,Wright County, MO,Apr-17,7886,7580,306,3.9
CN2922900000000,29,229,Wright County, MO,May-17,7765,7425,340,4.4
CN2922900000000,29,229,Wright County, MO,Jun-17,7719,7386,333,4.3
CN2922900000000,29,229,Wright County, MO,Jul-17,7205,6734,471,6.5
CN2922900000000,29,229,Wright County, MO,Aug-17,7287,6810,477,6.5
CN2922900000000,29,229,Wright County, MO,Sep-17,7389,6979,410,5.5
CN2922900000000,29,229,Wright County, MO,Oct-17,7568,7270,298,3.9
CN2922900000000,29,229,Wright County, MO,Nov-17,7582,7232,350,4.6
CN2922900000000,29,229,Wright County, MO,Dec-17,7405,7074,331,4.5
CN2922900000000,29,229,Wright County, MO,Jan-18,7447,7088,359,4.8
CN2922900000000,29,229,Wright County, MO,Feb-18,7483,7115,368,4.9
CN2922900000000,29,229,Wright County, MO,Mar-18,7463,7126,337,4.5
CN2922900000000,29,229,Wright County, MO,Apr-18(p),7588,7290,298,3.9
CN2204900000000,22,049,Jackson Parish, LA,Mar-17,7099,6766,333,4.7
CN2204900000000,22,049,Jackson Parish, LA,Apr-17,7022,6713,309,4.4
CN2204900000000,22,049,Jackson Parish, LA,May-17,7097,6779,318,4.5
CN2204900000000,22,049,Jackson Parish, LA,Jun-17,7234,6869,365,5.0
CN2204900000000,22,049,Jackson Parish, LA,Jul-17,7056,6699,357,5.1
CN2204900000000,22,049,Jackson Parish, LA,Aug-17,6912,6564,348,5.0
CN2204900000000,22,049,Jackson Parish, LA,Sep-17,6946,6635,311,4.5
CN2204900000000,22,049,Jackson Parish, LA,Oct-17,6888,6624,264,3.8
CN2204900000000,22,049,Jackson Parish, LA,Nov-17,6911,6651,260,3.8
CN2204900000000,22,049,Jackson Parish, LA,Dec-17,6879,6636,243,3.5
CN2204900000000,22,049,Jackson Parish, LA,Jan-18,6923,6649,274,4.0
CN2204900000000,22,049,Jackson Parish, LA,Feb-18,6982,6723,259,3.7
CN2204900000000,22,049,Jackson Parish, LA,Mar-18,7045,6769,276,3.9
CN2204900000000,22,049,Jackson Parish, LA,Apr-18(p),7006,6741,265,3.8
CN3807300000000,38,073,Ransom County, ND,Mar-17,2807,2743,64,2.3
CN3807300000000,38,073,Ransom County, ND,Apr-17,2851,2801,50,1.8
CN3807300000000,38,073,Ransom County, ND,May-17,2887,2838,49,1.7
CN3807300000000,38,073,Ransom County, ND,Jun-17,2944,2887,57,1.9
CN3807300000000,38,073,Ransom County, ND,Jul-17,2934,2882,52,1.8
CN3807300000000,38,073,Ransom County, ND,Aug-17,2951,2901,50,1.7
CN3807300000000,38,073,Ransom County, ND,Sep-17,2879,2831,48,1.7
CN3807300000000,38,073,Ransom County, ND,Oct-17,2881,2840,41,1.4
CN3807300000000,38,073,Ransom County, ND,Nov-17,2777,2730,47,1.7
CN3807300000000,38,073,Ransom County, ND,Dec-17,2780,2721,59,2.1
CN3807300000000,38,073,Ransom County, ND,Jan-18,2788,2711,77,2.8
CN3807300000000,38,073,Ransom County, ND,Feb-18,2781,2705,76,2.7
CN3807300000000,38,073,Ransom County, ND,Mar-18,2796,2726,70,2.5
CN3807300000000,38,073,Ransom County, ND,Apr-18(p),2791,2732,59,2.1
CN2120500000000,21,205,Rowan County, KY,Mar-17,11149,10470,679,6.1
CN2120500000000,21,205,Rowan County, KY,Apr-17,11003,10425,578,5.3
CN2120500000000,21,205,Rowan County, KY,May-17,11020,10432,588,5.3
CN2120500000000,21,205,Rowan County, KY,Jun-17,10595,9856,739,7.0
CN2120500000000,21,205,Rowan County, KY,Jul-17,10358,9672,686,6.6
CN2120500000000,21,205,Rowan County, KY,Aug-17,10442,9831,611,5.9
CN2120500000000,21,205,Rowan County, KY,Sep-17,10605,10099,506,4.8
CN2120500000000,21,205,Rowan County, KY,Oct-17,10508,10013,495,4.7
CN2120500000000,21,205,Rowan County, KY,Nov-17,10582,10093,489,4.6
CN2120500000000,21,205,Rowan County, KY,Dec-17,10557,10047,510,4.8
CN2120500000000,21,205,Rowan County, KY,Jan-18,10494,9942,552,5.3
CN2120500000000,21,205,Rowan County, KY,Feb-18,11165,10494,671,6.0
CN2120500000000,21,205,Rowan County, KY,Mar-18,11235,10658,577,5.1
CN2120500000000,21,205,Rowan County, KY,Apr-18(p),11226,10710,516,4.6
CN3718300000000,37,183,Wake County, NC,Mar-17,568115,546008,22107,3.9
CN3718300000000,37,183,Wake County, NC,Apr-17,567183,547090,20093,3.5
CN3718300000000,37,183,Wake County, NC,May-17,570921,549730,21191,3.7
CN3718300000000,37,183,Wake County, NC,Jun-17,574079,551341,22738,4.0
CN3718300000000,37,183,Wake County, NC,Jul-17,582847,558744,24103,4.1
CN3718300000000,37,183,Wake County, NC,Aug-17,576555,552289,24266,4.2
CN3718300000000,37,183,Wake County, NC,Sep-17,579578,558170,21408,3.7
CN3718300000000,37,183,Wake County, NC,Oct-17,577827,556536,21291,3.7
CN3718300000000,37,183,Wake County, NC,Nov-17,578852,556495,22357,3.9
CN3718300000000,37,183,Wake County, NC,Dec-17,572348,551051,21297,3.7
CN3718300000000,37,183,Wake County, NC,Jan-18,575035,552460,22575,3.9
CN3718300000000,37,183,Wake County, NC,Feb-18,580198,557802,22396,3.9
CN3718300000000,37,183,Wake County, NC,Mar-18,582882,561240,21642,3.7
CN3718300000000,37,183,Wake County, NC,Apr-18(p),582190,563581,18609,3.2
CN2115900000000,21,159,Martin County, KY,Mar-17,3282,2988,294,9.0
CN2115900000000,21,159,Martin County, KY,Apr-17,3273,3021,252,7.7
CN2115900000000,21,159,Martin County, KY,May-17,3304,3050,254,7.7
CN2115900000000,21,159,Martin County, KY,Jun-17,3349,3086,263,7.9
CN2115900000000,21,159,Martin County, KY,Jul-17,3368,3129,239,7.1
CN2115900000000,21,159,Martin County, KY,Aug-17,3168,2946,222,7.0
CN2115900000000,21,159,Martin County, KY,Sep-17,3360,3166,194,5.8
CN2115900000000,21,159,Martin County, KY,Oct-17,3434,3236,198,5.8
CN2115900000000,21,159,Martin County, KY,Nov-17,3329,3139,190,5.7
CN2115900000000,21,159,Martin County, KY,Dec-17,3329,3144,185,5.6
CN2115900000000,21,159,Martin County, KY,Jan-18,3398,3206,192,5.7
CN2115900000000,21,159,Martin County, KY,Feb-18,3343,3123,220,6.6
CN2115900000000,21,159,Martin County, KY,Mar-18,3353,3138,215,6.4
CN2115900000000,21,159,Martin County, KY,Apr-18(p),3358,3180,178,5.3
CN1209700000000,12,097,Osceola County, FL,Mar-17,168682,161585,7097,4.2
CN1209700000000,12,097,Osceola County, FL,Apr-17,168355,161568,6787,4.0
CN1209700000000,12,097,Osceola County, FL,May-17,169499,162517,6982,4.1
CN1209700000000,12,097,Osceola County, FL,Jun-17,170826,163136,7690,4.5
CN1209700000000,12,097,Osceola County, FL,Jul-17,171563,163899,7664,4.5
CN1209700000000,12,097,Osceola County, FL,Aug-17,170685,163175,7510,4.4
CN1209700000000,12,097,Osceola County, FL,Sep-17,173362,166342,7020,4.0
CN1209700000000,12,097,Osceola County, FL,Oct-17,171144,164539,6605,3.9
CN1209700000000,12,097,Osceola County, FL,Nov-17,170769,164043,6726,3.9
CN1209700000000,12,097,Osceola County, FL,Dec-17,171165,164830,6335,3.7
CN1209700000000,12,097,Osceola County, FL,Jan-18,172083,164910,7173,4.2
CN1209700000000,12,097,Osceola County, FL,Feb-18,173861,167226,6635,3.8
CN1209700000000,12,097,Osceola County, FL,Mar-18,173615,167069,6546,3.8
CN1209700000000,12,097,Osceola County, FL,Apr-18(p),172244,166370,5874,3.4
CN7200300000000,72,003,Aguada Municipio, PR,Mar-17,12190,10614,1576,12.9
CN7200300000000,72,003,Aguada Municipio, PR,Apr-17,12092,10497,1595,13.2
CN7200300000000,72,003,Aguada Municipio, PR,May-17,11859,10468,1391,11.7
CN7200300000000,72,003,Aguada Municipio, PR,Jun-17,11684,10384,1300,11.1
CN7200300000000,72,003,Aguada Municipio, PR,Jul-17,11729,10332,1397,11.9
CN7200300000000,72,003,Aguada Municipio, PR,Aug-17,11831,10223,1608,13.6
CN7200300000000,72,003,Aguada Municipio, PR,Sep-17(y),11827,10302,1525,12.9
CN7200300000000,72,003,Aguada Municipio, PR,Oct-17,11705,10034,1671,14.3
CN7200300000000,72,003,Aguada Municipio, PR,Nov-17,12175,10599,1576,12.9
CN7200300000000,72,003,Aguada Municipio, PR,Dec-17,12190,10700,1490,12.2
CN7200300000000,72,003,Aguada Municipio, PR,Jan-18,12131,10542,1589,13.1
CN7200300000000,72,003,Aguada Municipio, PR,Feb-18,11988,10522,1466,12.2
CN7200300000000,72,003,Aguada Municipio, PR,Mar-18,11978,10574,1404,11.7
CN7200300000000,72,003,Aguada Municipio, PR,Apr-18(p),11988,10643,1345,11.2
CN3117900000000,31,179,Wayne County, NE,Mar-17,5701,5575,126,2.2
CN3117900000000,31,179,Wayne County, NE,Apr-17,5753,5626,127,2.2
CN3117900000000,31,179,Wayne County, NE,May-17,5735,5599,136,2.4
CN3117900000000,31,179,Wayne County, NE,Jun-17,5593,5407,186,3.3
CN3117900000000,31,179,Wayne County, NE,Jul-17,5479,5297,182,3.3
CN3117900000000,31,179,Wayne County, NE,Aug-17,5429,5268,161,3.0
CN3117900000000,31,179,Wayne County, NE,Sep-17,5582,5449,133,2.4
CN3117900000000,31,179,Wayne County, NE,Oct-17,5771,5655,116,2.0
CN3117900000000,31,179,Wayne County, NE,Nov-17,5707,5604,103,1.8
CN3117900000000,31,179,Wayne County, NE,Dec-17,5725,5601,124,2.2
CN3117900000000,31,179,Wayne County, NE,Jan-18,5669,5544,125,2.2
CN3117900000000,31,179,Wayne County, NE,Feb-18,5740,5618,122,2.1
CN3117900000000,31,179,Wayne County, NE,Mar-18,5781,5647,134,2.3
CN3117900000000,31,179,Wayne County, NE,Apr-18(p),5728,5591,137,2.4
CN2917300000000,29,173,Ralls County, MO,Mar-17,5532,5313,219,4.0
CN2917300000000,29,173,Ralls County, MO,Apr-17,5626,5456,170,3.0
CN2917300000000,29,173,Ralls County, MO,May-17,5560,5391,169,3.0
CN2917300000000,29,173,Ralls County, MO,Jun-17,5606,5437,169,3.0
CN2917300000000,29,173,Ralls County, MO,Jul-17,5505,5342,163,3.0
CN2917300000000,29,173,Ralls County, MO,Aug-17,5385,5205,180,3.3
CN2917300000000,29,173,Ralls County, MO,Sep-17,5412,5264,148,2.7
CN2917300000000,29,173,Ralls County, MO,Oct-17,5498,5387,111,2.0
CN2917300000000,29,173,Ralls County, MO,Nov-17,5578,5431,147,2.6
CN2917300000000,29,173,Ralls County, MO,Dec-17,5501,5339,162,2.9
CN2917300000000,29,173,Ralls County, MO,Jan-18,5409,5199,210,3.9
CN2917300000000,29,173,Ralls County, MO,Feb-18,5396,5171,225,4.2
CN2917300000000,29,173,Ralls County, MO,Mar-18,5380,5182,198,3.7
CN2917300000000,29,173,Ralls County, MO,Apr-18(p),5471,5308,163,3.0
CN3010500000000,30,105,Valley County, MT,Mar-17,4110,3931,179,4.4
CN3010500000000,30,105,Valley County, MT,Apr-17,4183,4040,143,3.4
CN3010500000000,30,105,Valley County, MT,May-17,4281,4162,119,2.8
CN3010500000000,30,105,Valley County, MT,Jun-17,4268,4137,131,3.1
CN3010500000000,30,105,Valley County, MT,Jul-17,4322,4197,125,2.9
CN3010500000000,30,105,Valley County, MT,Aug-17,4269,4151,118,2.8
CN3010500000000,30,105,Valley County, MT,Sep-17,4105,3995,110,2.7
CN3010500000000,30,105,Valley County, MT,Oct-17,4198,4084,114,2.7
CN3010500000000,30,105,Valley County, MT,Nov-17,4179,4060,119,2.8
CN3010500000000,30,105,Valley County, MT,Dec-17,4105,3980,125,3.0
CN3010500000000,30,105,Valley County, MT,Jan-18,4048,3873,175,4.3
CN3010500000000,30,105,Valley County, MT,Feb-18,4039,3863,176,4.4
CN3010500000000,30,105,Valley County, MT,Mar-18,3999,3820,179,4.5
CN3010500000000,30,105,Valley County, MT,Apr-18(p),4012,3883,129,3.2
CN3712300000000,37,123,Montgomery County, NC,Mar-17,11914,11367,547,4.6
CN3712300000000,37,123,Montgomery County, NC,Apr-17,11747,11257,490,4.2
CN3712300000000,37,123,Montgomery County, NC,May-17,11689,11171,518,4.4
CN3712300000000,37,123,Montgomery County, NC,Jun-17,11749,11201,548,4.7
CN3712300000000,37,123,Montgomery County, NC,Jul-17,11701,11108,593,5.1
CN3712300000000,37,123,Montgomery County, NC,Aug-17,11666,11090,576,4.9
CN3712300000000,37,123,Montgomery County, NC,Sep-17,11846,11331,515,4.3
CN3712300000000,37,123,Montgomery County, NC,Oct-17,11611,11099,512,4.4
CN3712300000000,37,123,Montgomery County, NC,Nov-17,11609,11074,535,4.6
CN3712300000000,37,123,Montgomery County, NC,Dec-17,11520,11026,494,4.3
CN3712300000000,37,123,Montgomery County, NC,Jan-18,11746,11220,526,4.5
CN3712300000000,37,123,Montgomery County, NC,Feb-18,11972,11438,534,4.5
CN3712300000000,37,123,Montgomery County, NC,Mar-18,11923,11410,513,4.3
CN3712300000000,37,123,Montgomery County, NC,Apr-18(p),11850,11408,442,3.7
CN3801300000000,38,013,Burke County, ND,Mar-17,1100,1057,43,3.9
CN3801300000000,38,013,Burke County, ND,Apr-17,1098,1056,42,3.8
CN3801300000000,38,013,Burke County, ND,May-17,1100,1072,28,2.5
CN3801300000000,38,013,Burke County, ND,Jun-17,1162,1128,34,2.9
CN3801300000000,38,013,Burke County, ND,Jul-17,1117,1090,27,2.4
CN3801300000000,38,013,Burke County, ND,Aug-17,1099,1069,30,2.7
CN3801300000000,38,013,Burke County, ND,Sep-17,1111,1083,28,2.5
CN3801300000000,38,013,Burke County, ND,Oct-17,1097,1074,23,2.1
CN3801300000000,38,013,Burke County, ND,Nov-17,1076,1049,27,2.5
CN3801300000000,38,013,Burke County, ND,Dec-17,1092,1062,30,2.7
CN3801300000000,38,013,Burke County, ND,Jan-18,1060,1026,34,3.2
CN3801300000000,38,013,Burke County, ND,Feb-18,1043,1010,33,3.2
CN3801300000000,38,013,Burke County, ND,Mar-18,1054,1020,34,3.2
CN3801300000000,38,013,Burke County, ND,Apr-18(p),1045,1015,30,2.9
CN4837900000000,48,379,Rains County, TX,Mar-17,5710,5501,209,3.7
CN4837900000000,48,379,Rains County, TX,Apr-17,5738,5559,179,3.1
CN4837900000000,48,379,Rains County, TX,May-17,5613,5427,186,3.3
CN4837900000000,48,379,Rains County, TX,Jun-17,5623,5419,204,3.6
CN4837900000000,48,379,Rains County, TX,Jul-17,5611,5398,213,3.8
CN4837900000000,48,379,Rains County, TX,Aug-17,5618,5397,221,3.9
CN4837900000000,48,379,Rains County, TX,Sep-17,5683,5491,192,3.4
CN4837900000000,48,379,Rains County, TX,Oct-17,5667,5485,182,3.2
CN4837900000000,48,379,Rains County, TX,Nov-17,5661,5475,186,3.3
CN4837900000000,48,379,Rains County, TX,Dec-17,5652,5473,179,3.2
CN4837900000000,48,379,Rains County, TX,Jan-18,5826,5614,212,3.6
CN4837900000000,48,379,Rains County, TX,Feb-18,5908,5698,210,3.6
CN4837900000000,48,379,Rains County, TX,Mar-18,5892,5682,210,3.6
CN4837900000000,48,379,Rains County, TX,Apr-18(p),5995,5804,191,3.2
CN4602300000000,46,023,Charles Mix County, SD,Mar-17,3825,3686,139,3.6
CN4602300000000,46,023,Charles Mix County, SD,Apr-17,3878,3738,140,3.6
CN4602300000000,46,023,Charles Mix County, SD,May-17,4007,3855,152,3.8
CN4602300000000,46,023,Charles Mix County, SD,Jun-17,4134,3975,159,3.8
CN4602300000000,46,023,Charles Mix County, SD,Jul-17,4049,3902,147,3.6
CN4602300000000,46,023,Charles Mix County, SD,Aug-17,3936,3789,147,3.7
CN4602300000000,46,023,Charles Mix County, SD,Sep-17,3814,3671,143,3.7
CN4602300000000,46,023,Charles Mix County, SD,Oct-17,3752,3616,136,3.6
CN4602300000000,46,023,Charles Mix County, SD,Nov-17,3725,3584,141,3.8
CN4602300000000,46,023,Charles Mix County, SD,Dec-17,3761,3620,141,3.7
CN4602300000000,46,023,Charles Mix County, SD,Jan-18,3761,3626,135,3.6
CN4602300000000,46,023,Charles Mix County, SD,Feb-18,3800,3656,144,3.8
CN4602300000000,46,023,Charles Mix County, SD,Mar-18,3837,3712,125,3.3
CN4602300000000,46,023,Charles Mix County, SD,Apr-18(p),3823,3680,143,3.7
CN0501500000000,05,015,Carroll County, AR,Mar-17,12791,12367,424,3.3
CN0501500000000,05,015,Carroll County, AR,Apr-17,12937,12558,379,2.9
CN0501500000000,05,015,Carroll County, AR,May-17,13257,12845,412,3.1
CN0501500000000,05,015,Carroll County, AR,Jun-17,13621,13213,408,3.0
CN0501500000000,05,015,Carroll County, AR,Jul-17,13396,12974,422,3.2
CN0501500000000,05,015,Carroll County, AR,Aug-17,13420,13047,373,2.8
CN0501500000000,05,015,Carroll County, AR,Sep-17,13317,12937,380,2.9
CN0501500000000,05,015,Carroll County, AR,Oct-17,13328,12988,340,2.6
CN0501500000000,05,015,Carroll County, AR,Nov-17,13077,12722,355,2.7
CN0501500000000,05,015,Carroll County, AR,Dec-17,12960,12510,450,3.5
CN0501500000000,05,015,Carroll County, AR,Jan-18,12613,11995,618,4.9
CN0501500000000,05,015,Carroll County, AR,Feb-18,12656,12107,549,4.3
CN0501500000000,05,015,Carroll County, AR,Mar-18,12833,12403,430,3.4
CN0501500000000,05,015,Carroll County, AR,Apr-18(p),12917,12563,354,2.7
CN4709700000000,47,097,Lauderdale County, TN,Mar-17,9496,8907,589,6.2
CN4709700000000,47,097,Lauderdale County, TN,Apr-17,9402,8882,520,5.5
CN4709700000000,47,097,Lauderdale County, TN,May-17,9314,8833,481,5.2
CN4709700000000,47,097,Lauderdale County, TN,Jun-17,9382,8785,597,6.4
CN4709700000000,47,097,Lauderdale County, TN,Jul-17,9433,8862,571,6.1
CN4709700000000,47,097,Lauderdale County, TN,Aug-17,9493,8937,556,5.9
CN4709700000000,47,097,Lauderdale County, TN,Sep-17,9480,8990,490,5.2
CN4709700000000,47,097,Lauderdale County, TN,Oct-17,9459,8941,518,5.5
CN4709700000000,47,097,Lauderdale County, TN,Nov-17,9447,8958,489,5.2
CN4709700000000,47,097,Lauderdale County, TN,Dec-17,9442,8963,479,5.1
CN4709700000000,47,097,Lauderdale County, TN,Jan-18,9481,8888,593,6.3
CN4709700000000,47,097,Lauderdale County, TN,Feb-18,9553,8986,567,5.9
CN4709700000000,47,097,Lauderdale County, TN,Mar-18,9498,8981,517,5.4
CN4709700000000,47,097,Lauderdale County, TN,Apr-18(p),9500,9033,467,4.9
CN1314900000000,13,149,Heard County, GA,Mar-17,5103,4853,250,4.9
CN1314900000000,13,149,Heard County, GA,Apr-17,5110,4866,244,4.8
CN1314900000000,13,149,Heard County, GA,May-17,5132,4879,253,4.9
CN1314900000000,13,149,Heard County, GA,Jun-17,5162,4882,280,5.4
CN1314900000000,13,149,Heard County, GA,Jul-17,5191,4903,288,5.5
CN1314900000000,13,149,Heard County, GA,Aug-17,5153,4880,273,5.3
CN1314900000000,13,149,Heard County, GA,Sep-17,5167,4939,228,4.4
CN1314900000000,13,149,Heard County, GA,Oct-17,5153,4929,224,4.3
CN1314900000000,13,149,Heard County, GA,Nov-17,5165,4946,219,4.2
CN1314900000000,13,149,Heard County, GA,Dec-17,5165,4947,218,4.2
CN1314900000000,13,149,Heard County, GA,Jan-18,5181,4946,235,4.5
CN1314900000000,13,149,Heard County, GA,Feb-18,5238,5000,238,4.5
CN1314900000000,13,149,Heard County, GA,Mar-18,5228,5016,212,4.1
CN1314900000000,13,149,Heard County, GA,Apr-18(p),5206,5007,199,3.8
CN0100300000000,01,003,Baldwin County, AL,Mar-17,91416,87297,4119,4.5
CN0100300000000,01,003,Baldwin County, AL,Apr-17,91865,88524,3341,3.6
CN0100300000000,01,003,Baldwin County, AL,May-17,92153,88937,3216,3.5
CN0100300000000,01,003,Baldwin County, AL,Jun-17,94176,90303,3873,4.1
CN0100300000000,01,003,Baldwin County, AL,Jul-17,94556,90971,3585,3.8
CN0100300000000,01,003,Baldwin County, AL,Aug-17,92994,89451,3543,3.8
CN0100300000000,01,003,Baldwin County, AL,Sep-17,91543,88476,3067,3.4
CN0100300000000,01,003,Baldwin County, AL,Oct-17,91035,87951,3084,3.4
CN0100300000000,01,003,Baldwin County, AL,Nov-17,90382,87439,2943,3.3
CN0100300000000,01,003,Baldwin County, AL,Dec-17,90001,87006,2995,3.3
CN0100300000000,01,003,Baldwin County, AL,Jan-18,88942,85381,3561,4.0
CN0100300000000,01,003,Baldwin County, AL,Feb-18,90682,87014,3668,4.0
CN0100300000000,01,003,Baldwin County, AL,Mar-18,93054,89763,3291,3.5
CN0100300000000,01,003,Baldwin County, AL,Apr-18(p),94513,91595,2918,3.1
CN0601100000000,06,011,Colusa County, CA,Mar-17,10846,8539,2307,21.3
CN0601100000000,06,011,Colusa County, CA,Apr-17,10564,8777,1787,16.9
CN0601100000000,06,011,Colusa County, CA,May-17,10730,9401,1329,12.4
CN0601100000000,06,011,Colusa County, CA,Jun-17,10683,9401,1282,12.0
CN0601100000000,06,011,Colusa County, CA,Jul-17,10916,9659,1257,11.5
CN0601100000000,06,011,Colusa County, CA,Aug-17,11188,10151,1037,9.3
CN0601100000000,06,011,Colusa County, CA,Sep-17,11153,10270,883,7.9
CN0601100000000,06,011,Colusa County, CA,Oct-17,10950,10042,908,8.3
CN0601100000000,06,011,Colusa County, CA,Nov-17,10461,9194,1267,12.1
CN0601100000000,06,011,Colusa County, CA,Dec-17,10339,8702,1637,15.8
CN0601100000000,06,011,Colusa County, CA,Jan-18,10435,8500,1935,18.5
CN0601100000000,06,011,Colusa County, CA,Feb-18,10794,8656,2138,19.8
CN0601100000000,06,011,Colusa County, CA,Mar-18,10806,8777,2029,18.8
CN0601100000000,06,011,Colusa County, CA,Apr-18(p),10545,8959,1586,15.0
CN4809300000000,48,093,Comanche County, TX,Mar-17,5423,5207,216,4.0
CN4809300000000,48,093,Comanche County, TX,Apr-17,5387,5210,177,3.3
CN4809300000000,48,093,Comanche County, TX,May-17,5387,5200,187,3.5
CN4809300000000,48,093,Comanche County, TX,Jun-17,5366,5169,197,3.7
CN4809300000000,48,093,Comanche County, TX,Jul-17,5232,5032,200,3.8
CN4809300000000,48,093,Comanche County, TX,Aug-17,5251,5050,201,3.8
CN4809300000000,48,093,Comanche County, TX,Sep-17,5236,5052,184,3.5
CN4809300000000,48,093,Comanche County, TX,Oct-17,5225,5062,163,3.1
CN4809300000000,48,093,Comanche County, TX,Nov-17,5168,4997,171,3.3
CN4809300000000,48,093,Comanche County, TX,Dec-17,5206,5042,164,3.2
CN4809300000000,48,093,Comanche County, TX,Jan-18,5194,4995,199,3.8
CN4809300000000,48,093,Comanche County, TX,Feb-18,5333,5115,218,4.1
CN4809300000000,48,093,Comanche County, TX,Mar-18,5431,5214,217,4.0
CN4809300000000,48,093,Comanche County, TX,Apr-18(p),5398,5212,186,3.4
CN4201100000000,42,011,Berks County, PA,Mar-17,212545,202263,10282,4.8
CN4201100000000,42,011,Berks County, PA,Apr-17,212578,203560,9018,4.2
CN4201100000000,42,011,Berks County, PA,May-17,212842,202959,9883,4.6
CN4201100000000,42,011,Berks County, PA,Jun-17,214061,204000,10061,4.7
CN4201100000000,42,011,Berks County, PA,Jul-17,214975,204420,10555,4.9
CN4201100000000,42,011,Berks County, PA,Aug-17,212771,202148,10623,5.0
CN4201100000000,42,011,Berks County, PA,Sep-17,211882,202938,8944,4.2
CN4201100000000,42,011,Berks County, PA,Oct-17,210186,201582,8604,4.1
CN4201100000000,42,011,Berks County, PA,Nov-17,210398,201613,8785,4.2
CN4201100000000,42,011,Berks County, PA,Dec-17,209796,201425,8371,4.0
CN4201100000000,42,011,Berks County, PA,Jan-18,210447,200157,10290,4.9
CN4201100000000,42,011,Berks County, PA,Feb-18,211282,200777,10505,5.0
CN4201100000000,42,011,Berks County, PA,Mar-18,208896,199808,9088,4.4
CN4201100000000,42,011,Berks County, PA,Apr-18(p),208953,200977,7976,3.8
CN5504700000000,55,047,Green Lake County, WI,Mar-17,9429,9004,425,4.5
CN5504700000000,55,047,Green Lake County, WI,Apr-17,9615,9284,331,3.4
CN5504700000000,55,047,Green Lake County, WI,May-17,9758,9430,328,3.4
CN5504700000000,55,047,Green Lake County, WI,Jun-17,10221,9807,414,4.1
CN5504700000000,55,047,Green Lake County, WI,Jul-17,10082,9746,336,3.3
CN5504700000000,55,047,Green Lake County, WI,Aug-17,10018,9663,355,3.5
CN5504700000000,55,047,Green Lake County, WI,Sep-17,9916,9623,293,3.0
CN5504700000000,55,047,Green Lake County, WI,Oct-17,9748,9450,298,3.1
CN5504700000000,55,047,Green Lake County, WI,Nov-17,9591,9290,301,3.1
CN5504700000000,55,047,Green Lake County, WI,Dec-17,9476,9178,298,3.1
CN5504700000000,55,047,Green Lake County, WI,Jan-18,9351,8999,352,3.8
CN5504700000000,55,047,Green Lake County, WI,Feb-18,9324,8913,411,4.4
CN5504700000000,55,047,Green Lake County, WI,Mar-18,9444,9051,393,4.2
CN5504700000000,55,047,Green Lake County, WI,Apr-18(p),9639,9363,276,2.9
CN1325500000000,13,255,Spalding County, GA,Mar-17,28413,26710,1703,6.0
CN1325500000000,13,255,Spalding County, GA,Apr-17,28364,26770,1594,5.6
CN1325500000000,13,255,Spalding County, GA,May-17,28432,26828,1604,5.6
CN1325500000000,13,255,Spalding County, GA,Jun-17,28513,26814,1699,6.0
CN1325500000000,13,255,Spalding County, GA,Jul-17,28696,26982,1714,6.0
CN1325500000000,13,255,Spalding County, GA,Aug-17,28564,26852,1712,6.0
CN1325500000000,13,255,Spalding County, GA,Sep-17,28893,27205,1688,5.8
CN1325500000000,13,255,Spalding County, GA,Oct-17,28619,27112,1507,5.3
CN1325500000000,13,255,Spalding County, GA,Nov-17,28651,27206,1445,5.0
CN1325500000000,13,255,Spalding County, GA,Dec-17,28654,27198,1456,5.1
CN1325500000000,13,255,Spalding County, GA,Jan-18,28778,27162,1616,5.6
CN1325500000000,13,255,Spalding County, GA,Feb-18,29055,27567,1488,5.1
CN1325500000000,13,255,Spalding County, GA,Mar-18,29025,27661,1364,4.7
CN1325500000000,13,255,Spalding County, GA,Apr-18(p),28806,27591,1215,4.2
CN4101500000000,41,015,Curry County, OR,Mar-17,8829,8229,600,6.8
CN4101500000000,41,015,Curry County, OR,Apr-17,8891,8355,536,6.0
CN4101500000000,41,015,Curry County, OR,May-17,9001,8505,496,5.5
CN4101500000000,41,015,Curry County, OR,Jun-17,9206,8673,533,5.8
CN4101500000000,41,015,Curry County, OR,Jul-17,9238,8702,536,5.8
CN4101500000000,41,015,Curry County, OR,Aug-17,9380,8845,535,5.7
CN4101500000000,41,015,Curry County, OR,Sep-17,9386,8885,501,5.3
CN4101500000000,41,015,Curry County, OR,Oct-17,9204,8673,531,5.8
CN4101500000000,41,015,Curry County, OR,Nov-17,8932,8368,564,6.3
CN4101500000000,41,015,Curry County, OR,Dec-17,8752,8191,561,6.4
CN4101500000000,41,015,Curry County, OR,Jan-18,8769,8143,626,7.1
CN4101500000000,41,015,Curry County, OR,Feb-18,8831,8228,603,6.8
CN4101500000000,41,015,Curry County, OR,Mar-18,9041,8441,600,6.6
CN4101500000000,41,015,Curry County, OR,Apr-18(p),9097,8575,522,5.7
CN5604300000000,56,043,Washakie County, WY,Mar-17,4061,3872,189,4.7
CN5604300000000,56,043,Washakie County, WY,Apr-17,4051,3867,184,4.5
CN5604300000000,56,043,Washakie County, WY,May-17,4078,3911,167,4.1
CN5604300000000,56,043,Washakie County, WY,Jun-17,4239,4064,175,4.1
CN5604300000000,56,043,Washakie County, WY,Jul-17,4138,3989,149,3.6
CN5604300000000,56,043,Washakie County, WY,Aug-17,4102,3963,139,3.4
CN5604300000000,56,043,Washakie County, WY,Sep-17,4080,3939,141,3.5
CN5604300000000,56,043,Washakie County, WY,Oct-17,4134,3995,139,3.4
CN5604300000000,56,043,Washakie County, WY,Nov-17,4159,4003,156,3.8
CN5604300000000,56,043,Washakie County, WY,Dec-17,4116,3958,158,3.8
CN5604300000000,56,043,Washakie County, WY,Jan-18,4052,3871,181,4.5
CN5604300000000,56,043,Washakie County, WY,Feb-18,4031,3827,204,5.1
CN5604300000000,56,043,Washakie County, WY,Mar-18,4039,3831,208,5.1
CN5604300000000,56,043,Washakie County, WY,Apr-18(p),3999,3827,172,4.3
CN4208900000000,42,089,Monroe County, PA,Mar-17,82332,77205,5127,6.2
CN4208900000000,42,089,Monroe County, PA,Apr-17,81419,76903,4516,5.5
CN4208900000000,42,089,Monroe County, PA,May-17,81834,76993,4841,5.9
CN4208900000000,42,089,Monroe County, PA,Jun-17,82724,77905,4819,5.8
CN4208900000000,42,089,Monroe County, PA,Jul-17,83756,78721,5035,6.0
CN4208900000000,42,089,Monroe County, PA,Aug-17,82876,77757,5119,6.2
CN4208900000000,42,089,Monroe County, PA,Sep-17,81615,77221,4394,5.4
CN4208900000000,42,089,Monroe County, PA,Oct-17,80667,76374,4293,5.3
CN4208900000000,42,089,Monroe County, PA,Nov-17,81010,76615,4395,5.4
CN4208900000000,42,089,Monroe County, PA,Dec-17,80712,76390,4322,5.4
CN4208900000000,42,089,Monroe County, PA,Jan-18,81687,76473,5214,6.4
CN4208900000000,42,089,Monroe County, PA,Feb-18,81576,76323,5253,6.4
CN4208900000000,42,089,Monroe County, PA,Mar-18,80658,75927,4731,5.9
CN4208900000000,42,089,Monroe County, PA,Apr-18(p),79973,75892,4081,5.1
CN4001900000000,40,019,Carter County, OK,Mar-17,22508,21443,1065,4.7
CN4001900000000,40,019,Carter County, OK,Apr-17,22478,21498,980,4.4
CN4001900000000,40,019,Carter County, OK,May-17,22570,21517,1053,4.7
CN4001900000000,40,019,Carter County, OK,Jun-17,22910,21805,1105,4.8
CN4001900000000,40,019,Carter County, OK,Jul-17,22306,21278,1028,4.6
CN4001900000000,40,019,Carter County, OK,Aug-17,21872,20861,1011,4.6
CN4001900000000,40,019,Carter County, OK,Sep-17,22456,21498,958,4.3
CN4001900000000,40,019,Carter County, OK,Oct-17,22659,21692,967,4.3
CN4001900000000,40,019,Carter County, OK,Nov-17,22740,21798,942,4.1
CN4001900000000,40,019,Carter County, OK,Dec-17,22549,21639,910,4.0
CN4001900000000,40,019,Carter County, OK,Jan-18,22548,21527,1021,4.5
CN4001900000000,40,019,Carter County, OK,Feb-18,22358,21413,945,4.2
CN4001900000000,40,019,Carter County, OK,Mar-18,22470,21552,918,4.1
CN4001900000000,40,019,Carter County, OK,Apr-18(p),22310,21420,890,4.0
CN2710300000000,27,103,Nicollet County, MN,Mar-17,20658,20043,615,3.0
CN2710300000000,27,103,Nicollet County, MN,Apr-17,20723,20238,485,2.3
CN2710300000000,27,103,Nicollet County, MN,May-17,20549,20062,487,2.4
CN2710300000000,27,103,Nicollet County, MN,Jun-17,20262,19708,554,2.7
CN2710300000000,27,103,Nicollet County, MN,Jul-17,20050,19515,535,2.7
CN2710300000000,27,103,Nicollet County, MN,Aug-17,20155,19649,506,2.5
CN2710300000000,27,103,Nicollet County, MN,Sep-17,20724,20272,452,2.2
CN2710300000000,27,103,Nicollet County, MN,Oct-17,21294,20927,367,1.7
CN2710300000000,27,103,Nicollet County, MN,Nov-17,21052,20675,377,1.8
CN2710300000000,27,103,Nicollet County, MN,Dec-17,20877,20380,497,2.4
CN2710300000000,27,103,Nicollet County, MN,Jan-18,21150,20528,622,2.9
CN2710300000000,27,103,Nicollet County, MN,Feb-18,21413,20791,622,2.9
CN2710300000000,27,103,Nicollet County, MN,Mar-18,21274,20693,581,2.7
CN2710300000000,27,103,Nicollet County, MN,Apr-18(p),21229,20749,480,2.3
CN0215800000000,02,158,Kusilvak Census Area, AK,Mar-17,2791,2212,579,20.7
CN0215800000000,02,158,Kusilvak Census Area, AK,Apr-17,2739,2171,568,20.7
CN0215800000000,02,158,Kusilvak Census Area, AK,May-17,2767,2192,575,20.8
CN0215800000000,02,158,Kusilvak Census Area, AK,Jun-17,2866,2227,639,22.3
CN0215800000000,02,158,Kusilvak Census Area, AK,Jul-17,2467,1877,590,23.9
CN0215800000000,02,158,Kusilvak Census Area, AK,Aug-17,2942,2377,565,19.2
CN0215800000000,02,158,Kusilvak Census Area, AK,Sep-17,3019,2531,488,16.2
CN0215800000000,02,158,Kusilvak Census Area, AK,Oct-17,2742,2227,515,18.8
CN0215800000000,02,158,Kusilvak Census Area, AK,Nov-17,2809,2285,524,18.7
CN0215800000000,02,158,Kusilvak Census Area, AK,Dec-17,2873,2330,543,18.9
CN0215800000000,02,158,Kusilvak Census Area, AK,Jan-18,2905,2296,609,21.0
CN0215800000000,02,158,Kusilvak Census Area, AK,Feb-18,2912,2263,649,22.3
CN0215800000000,02,158,Kusilvak Census Area, AK,Mar-18,2875,2224,651,22.6
CN0215800000000,02,158,Kusilvak Census Area, AK,Apr-18(p),2816,2231,585,20.8
CN2610700000000,26,107,Mecosta County, MI,Mar-17,18956,17815,1141,6.0
CN2610700000000,26,107,Mecosta County, MI,Apr-17,18924,18062,862,4.6
CN2610700000000,26,107,Mecosta County, MI,May-17,19101,18182,919,4.8
CN2610700000000,26,107,Mecosta County, MI,Jun-17,18432,17234,1198,6.5
CN2610700000000,26,107,Mecosta County, MI,Jul-17,18501,17143,1358,7.3
CN2610700000000,26,107,Mecosta County, MI,Aug-17,18278,17128,1150,6.3
CN2610700000000,26,107,Mecosta County, MI,Sep-17,19266,18263,1003,5.2
CN2610700000000,26,107,Mecosta County, MI,Oct-17,19238,18328,910,4.7
CN2610700000000,26,107,Mecosta County, MI,Nov-17,19340,18364,976,5.0
CN2610700000000,26,107,Mecosta County, MI,Dec-17,18969,17911,1058,5.6
CN2610700000000,26,107,Mecosta County, MI,Jan-18,18647,17377,1270,6.8
CN2610700000000,26,107,Mecosta County, MI,Feb-18,19170,17787,1383,7.2
CN2610700000000,26,107,Mecosta County, MI,Mar-18,18979,17821,1158,6.1
CN2610700000000,26,107,Mecosta County, MI,Apr-18(p),19050,18141,909,4.8
CN4716700000000,47,167,Tipton County, TN,Mar-17,27613,26312,1301,4.7
CN4716700000000,47,167,Tipton County, TN,Apr-17,27539,26421,1118,4.1
CN4716700000000,47,167,Tipton County, TN,May-17,27471,26408,1063,3.9
CN4716700000000,47,167,Tipton County, TN,Jun-17,27997,26669,1328,4.7
CN4716700000000,47,167,Tipton County, TN,Jul-17,28063,26797,1266,4.5
CN4716700000000,47,167,Tipton County, TN,Aug-17,27728,26529,1199,4.3
CN4716700000000,47,167,Tipton County, TN,Sep-17,27848,26754,1094,3.9
CN4716700000000,47,167,Tipton County, TN,Oct-17,27863,26754,1109,4.0
CN4716700000000,47,167,Tipton County, TN,Nov-17,28078,26978,1100,3.9
CN4716700000000,47,167,Tipton County, TN,Dec-17,28031,26940,1091,3.9
CN4716700000000,47,167,Tipton County, TN,Jan-18,27790,26519,1271,4.6
CN4716700000000,47,167,Tipton County, TN,Feb-18,28159,26925,1234,4.4
CN4716700000000,47,167,Tipton County, TN,Mar-18,28180,27004,1176,4.2
CN4716700000000,47,167,Tipton County, TN,Apr-18(p),28151,27132,1019,3.6
CN4508100000000,45,081,Saluda County, SC,Mar-17,8715,8387,328,3.8
CN4508100000000,45,081,Saluda County, SC,Apr-17,8798,8502,296,3.4
CN4508100000000,45,081,Saluda County, SC,May-17,8859,8551,308,3.5
CN4508100000000,45,081,Saluda County, SC,Jun-17,9088,8730,358,3.9
CN4508100000000,45,081,Saluda County, SC,Jul-17,9148,8787,361,3.9
CN4508100000000,45,081,Saluda County, SC,Aug-17,8945,8558,387,4.3
CN4508100000000,45,081,Saluda County, SC,Sep-17,8824,8474,350,4.0
CN4508100000000,45,081,Saluda County, SC,Oct-17,8733,8394,339,3.9
CN4508100000000,45,081,Saluda County, SC,Nov-17,8692,8355,337,3.9
CN4508100000000,45,081,Saluda County, SC,Dec-17,8833,8506,327,3.7
CN4508100000000,45,081,Saluda County, SC,Jan-18,8928,8522,406,4.5
CN4508100000000,45,081,Saluda County, SC,Feb-18,8878,8521,357,4.0
CN4508100000000,45,081,Saluda County, SC,Mar-18,8720,8395,325,3.7
CN4508100000000,45,081,Saluda County, SC,Apr-18(p),8681,8466,215,2.5
CN3805300000000,38,053,McKenzie County, ND,Mar-17,7917,7663,254,3.2
CN3805300000000,38,053,McKenzie County, ND,Apr-17,7995,7764,231,2.9
CN3805300000000,38,053,McKenzie County, ND,May-17,8022,7845,177,2.2
CN3805300000000,38,053,McKenzie County, ND,Jun-17,8312,8092,220,2.6
CN3805300000000,38,053,McKenzie County, ND,Jul-17,8480,8298,182,2.1
CN3805300000000,38,053,McKenzie County, ND,Aug-17,8569,8391,178,2.1
CN3805300000000,38,053,McKenzie County, ND,Sep-17,8481,8336,145,1.7
CN3805300000000,38,053,McKenzie County, ND,Oct-17,8434,8294,140,1.7
CN3805300000000,38,053,McKenzie County, ND,Nov-17,8262,8110,152,1.8
CN3805300000000,38,053,McKenzie County, ND,Dec-17,8196,8028,168,2.0
CN3805300000000,38,053,McKenzie County, ND,Jan-18,8240,8048,192,2.3
CN3805300000000,38,053,McKenzie County, ND,Feb-18,8229,8048,181,2.2
CN3805300000000,38,053,McKenzie County, ND,Mar-18,8201,8017,184,2.2
CN3805300000000,38,053,McKenzie County, ND,Apr-18(p),8314,8153,161,1.9
CN2609300000000,26,093,Livingston County, MI,Mar-17,100795,97301,3494,3.5
CN2609300000000,26,093,Livingston County, MI,Apr-17,99814,97389,2425,2.4
CN2609300000000,26,093,Livingston County, MI,May-17,100841,98352,2489,2.5
CN2609300000000,26,093,Livingston County, MI,Jun-17,101608,98544,3064,3.0
CN2609300000000,26,093,Livingston County, MI,Jul-17,102560,98964,3596,3.5
CN2609300000000,26,093,Livingston County, MI,Aug-17,102393,98677,3716,3.6
CN2609300000000,26,093,Livingston County, MI,Sep-17,102737,99225,3512,3.4
CN2609300000000,26,093,Livingston County, MI,Oct-17,101772,98654,3118,3.1
CN2609300000000,26,093,Livingston County, MI,Nov-17,101643,98682,2961,2.9
CN2609300000000,26,093,Livingston County, MI,Dec-17,101512,98394,3118,3.1
CN2609300000000,26,093,Livingston County, MI,Jan-18,100239,96213,4026,4.0
CN2609300000000,26,093,Livingston County, MI,Feb-18,100962,97053,3909,3.9
CN2609300000000,26,093,Livingston County, MI,Mar-18,101226,97686,3540,3.5
CN2609300000000,26,093,Livingston County, MI,Apr-18(p),100592,97723,2869,2.9
CN1906500000000,19,065,Fayette County, IA,Mar-17,10487,10018,469,4.5
CN1906500000000,19,065,Fayette County, IA,Apr-17,10513,10163,350,3.3
CN1906500000000,19,065,Fayette County, IA,May-17,10423,10092,331,3.2
CN1906500000000,19,065,Fayette County, IA,Jun-17,10272,9915,357,3.5
CN1906500000000,19,065,Fayette County, IA,Jul-17,10312,9964,348,3.4
CN1906500000000,19,065,Fayette County, IA,Aug-17,10189,9835,354,3.5
CN1906500000000,19,065,Fayette County, IA,Sep-17,10359,10055,304,2.9
CN1906500000000,19,065,Fayette County, IA,Oct-17,10559,10289,270,2.6
CN1906500000000,19,065,Fayette County, IA,Nov-17,10414,10125,289,2.8
CN1906500000000,19,065,Fayette County, IA,Dec-17,10408,10024,384,3.7
CN1906500000000,19,065,Fayette County, IA,Jan-18,10290,9788,502,4.9
CN1906500000000,19,065,Fayette County, IA,Feb-18,10450,9956,494,4.7
CN1906500000000,19,065,Fayette County, IA,Mar-18,10270,9883,387,3.8
CN1906500000000,19,065,Fayette County, IA,Apr-18(p),10257,9932,325,3.2
CN0508100000000,05,081,Little River County, AR,Mar-17,5578,5331,247,4.4
CN0508100000000,05,081,Little River County, AR,Apr-17,5573,5346,227,4.1
CN0508100000000,05,081,Little River County, AR,May-17,5582,5337,245,4.4
CN0508100000000,05,081,Little River County, AR,Jun-17,5695,5405,290,5.1
CN0508100000000,05,081,Little River County, AR,Jul-17,5676,5377,299,5.3
CN0508100000000,05,081,Little River County, AR,Aug-17,5589,5293,296,5.3
CN0508100000000,05,081,Little River County, AR,Sep-17,5596,5319,277,4.9
CN0508100000000,05,081,Little River County, AR,Oct-17,5573,5325,248,4.5
CN0508100000000,05,081,Little River County, AR,Nov-17,5591,5333,258,4.6
CN0508100000000,05,081,Little River County, AR,Dec-17,5555,5291,264,4.8
CN0508100000000,05,081,Little River County, AR,Jan-18,5486,5190,296,5.4
CN0508100000000,05,081,Little River County, AR,Feb-18,5532,5245,287,5.2
CN0508100000000,05,081,Little River County, AR,Mar-18,5571,5293,278,5.0
CN0508100000000,05,081,Little River County, AR,Apr-18(p),5553,5312,241,4.3
CN2000500000000,20,005,Atchison County, KS,Mar-17,7055,6687,368,5.2
CN2000500000000,20,005,Atchison County, KS,Apr-17,7076,6734,342,4.8
CN2000500000000,20,005,Atchison County, KS,May-17,7081,6742,339,4.8
CN2000500000000,20,005,Atchison County, KS,Jun-17,7220,6803,417,5.8
CN2000500000000,20,005,Atchison County, KS,Jul-17,7002,6562,440,6.3
CN2000500000000,20,005,Atchison County, KS,Aug-17,6971,6555,416,6.0
CN2000500000000,20,005,Atchison County, KS,Sep-17,7094,6743,351,4.9
CN2000500000000,20,005,Atchison County, KS,Oct-17,7029,6732,297,4.2
CN2000500000000,20,005,Atchison County, KS,Nov-17,7004,6708,296,4.2
CN2000500000000,20,005,Atchison County, KS,Dec-17,6970,6690,280,4.0
CN2000500000000,20,005,Atchison County, KS,Jan-18,6968,6613,355,5.1
CN2000500000000,20,005,Atchison County, KS,Feb-18,7007,6643,364,5.2
CN2000500000000,20,005,Atchison County, KS,Mar-18,6891,6584,307,4.5
CN2000500000000,20,005,Atchison County, KS,Apr-18(p),6838,6551,287,4.2
CN2900100000000,29,001,Adair County, MO,Mar-17,10255,9737,518,5.1
CN2900100000000,29,001,Adair County, MO,Apr-17,10433,10018,415,4.0
CN2900100000000,29,001,Adair County, MO,May-17,10268,9812,456,4.4
CN2900100000000,29,001,Adair County, MO,Jun-17,10244,9745,499,4.9
CN2900100000000,29,001,Adair County, MO,Jul-17,10169,9615,554,5.4
CN2900100000000,29,001,Adair County, MO,Aug-17,10118,9611,507,5.0
CN2900100000000,29,001,Adair County, MO,Sep-17,10464,10096,368,3.5
CN2900100000000,29,001,Adair County, MO,Oct-17,10072,9824,248,2.5
CN2900100000000,29,001,Adair County, MO,Nov-17,10181,9820,361,3.5
CN2900100000000,29,001,Adair County, MO,Dec-17,10033,9686,347,3.5
CN2900100000000,29,001,Adair County, MO,Jan-18,10069,9566,503,5.0
CN2900100000000,29,001,Adair County, MO,Feb-18,10472,10038,434,4.1
CN2900100000000,29,001,Adair County, MO,Mar-18,10488,10032,456,4.3
CN2900100000000,29,001,Adair County, MO,Apr-18(p),10629,10242,387,3.6
CN0101700000000,01,017,Chambers County, AL,Mar-17,15172,14475,697,4.6
CN0101700000000,01,017,Chambers County, AL,Apr-17,15142,14587,555,3.7
CN0101700000000,01,017,Chambers County, AL,May-17,15070,14536,534,3.5
CN0101700000000,01,017,Chambers County, AL,Jun-17,15116,14452,664,4.4
CN0101700000000,01,017,Chambers County, AL,Jul-17,15157,14518,639,4.2
CN0101700000000,01,017,Chambers County, AL,Aug-17,15090,14463,627,4.2
CN0101700000000,01,017,Chambers County, AL,Sep-17,15204,14655,549,3.6
CN0101700000000,01,017,Chambers County, AL,Oct-17,15234,14690,544,3.6
CN0101700000000,01,017,Chambers County, AL,Nov-17,15210,14701,509,3.3
CN0101700000000,01,017,Chambers County, AL,Dec-17,15187,14693,494,3.3
CN0101700000000,01,017,Chambers County, AL,Jan-18,15082,14489,593,3.9
CN0101700000000,01,017,Chambers County, AL,Feb-18,15090,14454,636,4.2
CN0101700000000,01,017,Chambers County, AL,Mar-18,15057,14489,568,3.8
CN0101700000000,01,017,Chambers County, AL,Apr-18(p),15196,14661,535,3.5
CN1704100000000,17,041,Douglas County, IL,Mar-17,10194,9770,424,4.2
CN1704100000000,17,041,Douglas County, IL,Apr-17,10215,9879,336,3.3
CN1704100000000,17,041,Douglas County, IL,May-17,10158,9810,348,3.4
CN1704100000000,17,041,Douglas County, IL,Jun-17,10165,9737,428,4.2
CN1704100000000,17,041,Douglas County, IL,Jul-17,10138,9694,444,4.4
CN1704100000000,17,041,Douglas County, IL,Aug-17,9936,9505,431,4.3
CN1704100000000,17,041,Douglas County, IL,Sep-17,10147,9776,371,3.7
CN1704100000000,17,041,Douglas County, IL,Oct-17,10143,9780,363,3.6
CN1704100000000,17,041,Douglas County, IL,Nov-17,10104,9732,372,3.7
CN1704100000000,17,041,Douglas County, IL,Dec-17,10004,9650,354,3.5
CN1704100000000,17,041,Douglas County, IL,Jan-18,9957,9558,399,4.0
CN1704100000000,17,041,Douglas County, IL,Feb-18,10037,9663,374,3.7
CN1704100000000,17,041,Douglas County, IL,Mar-18,10268,9866,402,3.9
CN1704100000000,17,041,Douglas County, IL,Apr-18(p),10335,10014,321,3.1
CN0218800000000,02,188,Northwest Arctic Borough, AK,Mar-17,2925,2427,498,17.0
CN0218800000000,02,188,Northwest Arctic Borough, AK,Apr-17,2974,2447,527,17.7
CN0218800000000,02,188,Northwest Arctic Borough, AK,May-17,2848,2312,536,18.8
CN0218800000000,02,188,Northwest Arctic Borough, AK,Jun-17,3088,2502,586,19.0
CN0218800000000,02,188,Northwest Arctic Borough, AK,Jul-17,3024,2481,543,18.0
CN0218800000000,02,188,Northwest Arctic Borough, AK,Aug-17,3022,2511,511,16.9
CN0218800000000,02,188,Northwest Arctic Borough, AK,Sep-17,3035,2574,461,15.2
CN0218800000000,02,188,Northwest Arctic Borough, AK,Oct-17,2889,2434,455,15.7
CN0218800000000,02,188,Northwest Arctic Borough, AK,Nov-17,2897,2453,444,15.3
CN0218800000000,02,188,Northwest Arctic Borough, AK,Dec-17,2938,2531,407,13.9
CN0218800000000,02,188,Northwest Arctic Borough, AK,Jan-18,2881,2409,472,16.4
CN0218800000000,02,188,Northwest Arctic Borough, AK,Feb-18,2926,2428,498,17.0
CN0218800000000,02,188,Northwest Arctic Borough, AK,Mar-18,2876,2411,465,16.2
CN0218800000000,02,188,Northwest Arctic Borough, AK,Apr-18(p),2879,2407,472,16.4
CN7212700000000,72,127,San Juan Municipio, PR,Mar-17,136221,126518,9703,7.1
CN7212700000000,72,127,San Juan Municipio, PR,Apr-17,135846,125912,9934,7.3
CN7212700000000,72,127,San Juan Municipio, PR,May-17,133224,124609,8615,6.5
CN7212700000000,72,127,San Juan Municipio, PR,Jun-17,131375,123851,7524,5.7
CN7212700000000,72,127,San Juan Municipio, PR,Jul-17,131497,123102,8395,6.4
CN7212700000000,72,127,San Juan Municipio, PR,Aug-17,131057,121574,9483,7.2
CN7212700000000,72,127,San Juan Municipio, PR,Sep-17(y),132938,123387,9551,7.2
CN7212700000000,72,127,San Juan Municipio, PR,Oct-17,127023,118054,8969,7.1
CN7212700000000,72,127,San Juan Municipio, PR,Nov-17,135065,125895,9170,6.8
CN7212700000000,72,127,San Juan Municipio, PR,Dec-17,135716,127236,8480,6.2
CN7212700000000,72,127,San Juan Municipio, PR,Jan-18,133949,124783,9166,6.8
CN7212700000000,72,127,San Juan Municipio, PR,Feb-18,133662,124849,8813,6.6
CN7212700000000,72,127,San Juan Municipio, PR,Mar-18,133384,124839,8545,6.4
CN7212700000000,72,127,San Juan Municipio, PR,Apr-18(p),134578,126322,8256,6.1
CN5111500000000,51,115,Mathews County, VA,Mar-17,4101,3928,173,4.2
CN5111500000000,51,115,Mathews County, VA,Apr-17,4111,3959,152,3.7
CN5111500000000,51,115,Mathews County, VA,May-17,4114,3958,156,3.8
CN5111500000000,51,115,Mathews County, VA,Jun-17,4155,3996,159,3.8
CN5111500000000,51,115,Mathews County, VA,Jul-17,4174,4020,154,3.7
CN5111500000000,51,115,Mathews County, VA,Aug-17,4126,3971,155,3.8
CN5111500000000,51,115,Mathews County, VA,Sep-17,4105,3965,140,3.4
CN5111500000000,51,115,Mathews County, VA,Oct-17,4064,3928,136,3.3
CN5111500000000,51,115,Mathews County, VA,Nov-17,4047,3910,137,3.4
CN5111500000000,51,115,Mathews County, VA,Dec-17,4026,3898,128,3.2
CN5111500000000,51,115,Mathews County, VA,Jan-18,4017,3868,149,3.7
CN5111500000000,51,115,Mathews County, VA,Feb-18,4070,3936,134,3.3
CN5111500000000,51,115,Mathews County, VA,Mar-18,4105,3963,142,3.5
CN5111500000000,51,115,Mathews County, VA,Apr-18(p),4109,3992,117,2.8
CN4828500000000,48,285,Lavaca County, TX,Mar-17,8739,8405,334,3.8
CN4828500000000,48,285,Lavaca County, TX,Apr-17,8764,8466,298,3.4
CN4828500000000,48,285,Lavaca County, TX,May-17,8802,8500,302,3.4
CN4828500000000,48,285,Lavaca County, TX,Jun-17,8910,8591,319,3.6
CN4828500000000,48,285,Lavaca County, TX,Jul-17,8864,8537,327,3.7
CN4828500000000,48,285,Lavaca County, TX,Aug-17,8814,8491,323,3.7
CN4828500000000,48,285,Lavaca County, TX,Sep-17,8586,8297,289,3.4
CN4828500000000,48,285,Lavaca County, TX,Oct-17,8601,8333,268,3.1
CN4828500000000,48,285,Lavaca County, TX,Nov-17,8577,8293,284,3.3
CN4828500000000,48,285,Lavaca County, TX,Dec-17,8576,8313,263,3.1
CN4828500000000,48,285,Lavaca County, TX,Jan-18,8586,8286,300,3.5
CN4828500000000,48,285,Lavaca County, TX,Feb-18,8646,8357,289,3.3
CN4828500000000,48,285,Lavaca County, TX,Mar-18,8735,8436,299,3.4
CN4828500000000,48,285,Lavaca County, TX,Apr-18(p),8741,8469,272,3.1
CN1313900000000,13,139,Hall County, GA,Mar-17,99389,95429,3960,4.0
CN1313900000000,13,139,Hall County, GA,Apr-17,99553,95830,3723,3.7
CN1313900000000,13,139,Hall County, GA,May-17,99911,96127,3784,3.8
CN1313900000000,13,139,Hall County, GA,Jun-17,100279,96091,4188,4.2
CN1313900000000,13,139,Hall County, GA,Jul-17,101252,97057,4195,4.1
CN1313900000000,13,139,Hall County, GA,Aug-17,100441,96320,4121,4.1
CN1313900000000,13,139,Hall County, GA,Sep-17,101344,97613,3731,3.7
CN1313900000000,13,139,Hall County, GA,Oct-17,101136,97513,3623,3.6
CN1313900000000,13,139,Hall County, GA,Nov-17,101478,97921,3557,3.5
CN1313900000000,13,139,Hall County, GA,Dec-17,101733,98206,3527,3.5
CN1313900000000,13,139,Hall County, GA,Jan-18,102064,98366,3698,3.6
CN1313900000000,13,139,Hall County, GA,Feb-18,103454,99730,3724,3.6
CN1313900000000,13,139,Hall County, GA,Mar-18,103723,100356,3367,3.2
CN1313900000000,13,139,Hall County, GA,Apr-18(p),103352,100399,2953,2.9
CN3917100000000,39,171,Williams County, OH,Mar-17,18984,18100,884,4.7
CN3917100000000,39,171,Williams County, OH,Apr-17,18876,18093,783,4.1
CN3917100000000,39,171,Williams County, OH,May-17,19029,18249,780,4.1
CN3917100000000,39,171,Williams County, OH,Jun-17,19340,18475,865,4.5
CN3917100000000,39,171,Williams County, OH,Jul-17,19278,18319,959,5.0
CN3917100000000,39,171,Williams County, OH,Aug-17,19383,18520,863,4.5
CN3917100000000,39,171,Williams County, OH,Sep-17,19167,18422,745,3.9
CN3917100000000,39,171,Williams County, OH,Oct-17,19133,18388,745,3.9
CN3917100000000,39,171,Williams County, OH,Nov-17,19024,18291,733,3.9
CN3917100000000,39,171,Williams County, OH,Dec-17,18980,18241,739,3.9
CN3917100000000,39,171,Williams County, OH,Jan-18,18654,17910,744,4.0
CN3917100000000,39,171,Williams County, OH,Feb-18,18786,18064,722,3.8
CN3917100000000,39,171,Williams County, OH,Mar-18,18988,18336,652,3.4
CN3917100000000,39,171,Williams County, OH,Apr-18(p),18897,18279,618,3.3
CN1329500000000,13,295,Walker County, GA,Mar-17,30576,29148,1428,4.7
CN1329500000000,13,295,Walker County, GA,Apr-17,30558,29227,1331,4.4
CN1329500000000,13,295,Walker County, GA,May-17,30530,29177,1353,4.4
CN1329500000000,13,295,Walker County, GA,Jun-17,30747,29256,1491,4.8
CN1329500000000,13,295,Walker County, GA,Jul-17,30785,29301,1484,4.8
CN1329500000000,13,295,Walker County, GA,Aug-17,30594,29144,1450,4.7
CN1329500000000,13,295,Walker County, GA,Sep-17,31076,29782,1294,4.2
CN1329500000000,13,295,Walker County, GA,Oct-17,31010,29700,1310,4.2
CN1329500000000,13,295,Walker County, GA,Nov-17,31126,29850,1276,4.1
CN1329500000000,13,295,Walker County, GA,Dec-17,31034,29764,1270,4.1
CN1329500000000,13,295,Walker County, GA,Jan-18,31134,29766,1368,4.4
CN1329500000000,13,295,Walker County, GA,Feb-18,31553,30171,1382,4.4
CN1329500000000,13,295,Walker County, GA,Mar-18,31572,30328,1244,3.9
CN1329500000000,13,295,Walker County, GA,Apr-18(p),31594,30486,1108,3.5
CN4604900000000,46,049,Faulk County, SD,Mar-17,1085,1047,38,3.5
CN4604900000000,46,049,Faulk County, SD,Apr-17,1150,1112,38,3.3
CN4604900000000,46,049,Faulk County, SD,May-17,1150,1117,33,2.9
CN4604900000000,46,049,Faulk County, SD,Jun-17,1203,1169,34,2.8
CN4604900000000,46,049,Faulk County, SD,Jul-17,1136,1104,32,2.8
CN4604900000000,46,049,Faulk County, SD,Aug-17,1090,1052,38,3.5
CN4604900000000,46,049,Faulk County, SD,Sep-17,1083,1049,34,3.1
CN4604900000000,46,049,Faulk County, SD,Oct-17,1070,1037,33,3.1
CN4604900000000,46,049,Faulk County, SD,Nov-17,1057,1021,36,3.4
CN4604900000000,46,049,Faulk County, SD,Dec-17,1106,1067,39,3.5
CN4604900000000,46,049,Faulk County, SD,Jan-18,1095,1055,40,3.7
CN4604900000000,46,049,Faulk County, SD,Feb-18,1088,1049,39,3.6
CN4604900000000,46,049,Faulk County, SD,Mar-18,1116,1080,36,3.2
CN4604900000000,46,049,Faulk County, SD,Apr-18(p),1078,1045,33,3.1
CN2112300000000,21,123,Larue County, KY,Mar-17,6029,5709,320,5.3
CN2112300000000,21,123,Larue County, KY,Apr-17,6069,5786,283,4.7
CN2112300000000,21,123,Larue County, KY,May-17,6043,5760,283,4.7
CN2112300000000,21,123,Larue County, KY,Jun-17,6106,5789,317,5.2
CN2112300000000,21,123,Larue County, KY,Jul-17,6053,5721,332,5.5
CN2112300000000,21,123,Larue County, KY,Aug-17,5911,5641,270,4.6
CN2112300000000,21,123,Larue County, KY,Sep-17,5885,5638,247,4.2
CN2112300000000,21,123,Larue County, KY,Oct-17,5875,5651,224,3.8
CN2112300000000,21,123,Larue County, KY,Nov-17,5876,5653,223,3.8
CN2112300000000,21,123,Larue County, KY,Dec-17,5873,5650,223,3.8
CN2112300000000,21,123,Larue County, KY,Jan-18,5912,5648,264,4.5
CN2112300000000,21,123,Larue County, KY,Feb-18,5985,5695,290,4.8
CN2112300000000,21,123,Larue County, KY,Mar-18,6072,5801,271,4.5
CN2112300000000,21,123,Larue County, KY,Apr-18(p),6060,5834,226,3.7
CN4840900000000,48,409,San Patricio County, TX,Mar-17,31219,28787,2432,7.8
CN4840900000000,48,409,San Patricio County, TX,Apr-17,31052,28731,2321,7.5
CN4840900000000,48,409,San Patricio County, TX,May-17,30827,28677,2150,7.0
CN4840900000000,48,409,San Patricio County, TX,Jun-17,30785,28539,2246,7.3
CN4840900000000,48,409,San Patricio County, TX,Jul-17,30483,28311,2172,7.1
CN4840900000000,48,409,San Patricio County, TX,Aug-17,30328,28103,2225,7.3
CN4840900000000,48,409,San Patricio County, TX,Sep-17,30676,28095,2581,8.4
CN4840900000000,48,409,San Patricio County, TX,Oct-17,30267,28013,2254,7.4
CN4840900000000,48,409,San Patricio County, TX,Nov-17,30371,28131,2240,7.4
CN4840900000000,48,409,San Patricio County, TX,Dec-17,30233,28079,2154,7.1
CN4840900000000,48,409,San Patricio County, TX,Jan-18,30213,27823,2390,7.9
CN4840900000000,48,409,San Patricio County, TX,Feb-18,30642,28382,2260,7.4
CN4840900000000,48,409,San Patricio County, TX,Mar-18,30720,28561,2159,7.0
CN4840900000000,48,409,San Patricio County, TX,Apr-18(p),30470,28482,1988,6.5
CN1307100000000,13,071,Colquitt County, GA,Mar-17,21944,20909,1035,4.7
CN1307100000000,13,071,Colquitt County, GA,Apr-17,21751,20801,950,4.4
CN1307100000000,13,071,Colquitt County, GA,May-17,22181,21214,967,4.4
CN1307100000000,13,071,Colquitt County, GA,Jun-17,22636,21582,1054,4.7
CN1307100000000,13,071,Colquitt County, GA,Jul-17,22215,21096,1119,5.0
CN1307100000000,13,071,Colquitt County, GA,Aug-17,22100,21074,1026,4.6
CN1307100000000,13,071,Colquitt County, GA,Sep-17,22123,21160,963,4.4
CN1307100000000,13,071,Colquitt County, GA,Oct-17,22565,21651,914,4.1
CN1307100000000,13,071,Colquitt County, GA,Nov-17,22393,21521,872,3.9
CN1307100000000,13,071,Colquitt County, GA,Dec-17,22416,21534,882,3.9
CN1307100000000,13,071,Colquitt County, GA,Jan-18,22948,21909,1039,4.5
CN1307100000000,13,071,Colquitt County, GA,Feb-18,21918,20967,951,4.3
CN1307100000000,13,071,Colquitt County, GA,Mar-18,21930,21060,870,4.0
CN1307100000000,13,071,Colquitt County, GA,Apr-18(p),21749,20998,751,3.5
CN1605700000000,16,057,Latah County, ID,Mar-17,20319,19622,697,3.4
CN1605700000000,16,057,Latah County, ID,Apr-17,20444,19838,606,3.0
CN1605700000000,16,057,Latah County, ID,May-17,20203,19705,498,2.5
CN1605700000000,16,057,Latah County, ID,Jun-17,19368,18824,544,2.8
CN1605700000000,16,057,Latah County, ID,Jul-17,19131,18614,517,2.7
CN1605700000000,16,057,Latah County, ID,Aug-17,19319,18829,490,2.5
CN1605700000000,16,057,Latah County, ID,Sep-17,20734,20282,452,2.2
CN1605700000000,16,057,Latah County, ID,Oct-17,20784,20361,423,2.0
CN1605700000000,16,057,Latah County, ID,Nov-17,20870,20397,473,2.3
CN1605700000000,16,057,Latah County, ID,Dec-17,20644,20226,418,2.0
CN1605700000000,16,057,Latah County, ID,Jan-18,19854,19247,607,3.1
CN1605700000000,16,057,Latah County, ID,Feb-18,20668,20116,552,2.7
CN1605700000000,16,057,Latah County, ID,Mar-18,20621,20056,565,2.7
CN1605700000000,16,057,Latah County, ID,Apr-18(p),20764,20209,555,2.7
CN1800300000000,18,003,Allen County, IN,Mar-17,179817,173471,6346,3.5
CN1800300000000,18,003,Allen County, IN,Apr-17,180472,175451,5021,2.8
CN1800300000000,18,003,Allen County, IN,May-17,181237,175820,5417,3.0
CN1800300000000,18,003,Allen County, IN,Jun-17,182985,177046,5939,3.2
CN1800300000000,18,003,Allen County, IN,Jul-17,182899,176768,6131,3.4
CN1800300000000,18,003,Allen County, IN,Aug-17,181043,174326,6717,3.7
CN1800300000000,18,003,Allen County, IN,Sep-17,181482,175730,5752,3.2
CN1800300000000,18,003,Allen County, IN,Oct-17,180392,175189,5203,2.9
CN1800300000000,18,003,Allen County, IN,Nov-17,179983,174672,5311,3.0
CN1800300000000,18,003,Allen County, IN,Dec-17,178657,173715,4942,2.8
CN1800300000000,18,003,Allen County, IN,Jan-18,178555,172733,5822,3.3
CN1800300000000,18,003,Allen County, IN,Feb-18,181956,175850,6106,3.4
CN1800300000000,18,003,Allen County, IN,Mar-18,182649,177249,5400,3.0
CN1800300000000,18,003,Allen County, IN,Apr-18(p),184173,179231,4942,2.7
CN0610500000000,06,105,Trinity County, CA,Mar-17,4773,4383,390,8.2
CN0610500000000,06,105,Trinity County, CA,Apr-17,4860,4532,328,6.7
CN0610500000000,06,105,Trinity County, CA,May-17,5054,4783,271,5.4
CN0610500000000,06,105,Trinity County, CA,Jun-17,5271,4988,283,5.4
CN0610500000000,06,105,Trinity County, CA,Jul-17,5220,4929,291,5.6
CN0610500000000,06,105,Trinity County, CA,Aug-17,5351,5080,271,5.1
CN0610500000000,06,105,Trinity County, CA,Sep-17,5131,4906,225,4.4
CN0610500000000,06,105,Trinity County, CA,Oct-17,4979,4754,225,4.5
CN0610500000000,06,105,Trinity County, CA,Nov-17,4858,4615,243,5.0
CN0610500000000,06,105,Trinity County, CA,Dec-17,4806,4526,280,5.8
CN0610500000000,06,105,Trinity County, CA,Jan-18,4788,4487,301,6.3
CN0610500000000,06,105,Trinity County, CA,Feb-18,4906,4548,358,7.3
CN0610500000000,06,105,Trinity County, CA,Mar-18,4891,4539,352,7.2
CN0610500000000,06,105,Trinity County, CA,Apr-18(p),4953,4664,289,5.8
CN3504500000000,35,045,San Juan County, NM,Mar-17,53151,48979,4172,7.8
CN3504500000000,35,045,San Juan County, NM,Apr-17,53719,49930,3789,7.1
CN3504500000000,35,045,San Juan County, NM,May-17,53205,49633,3572,6.7
CN3504500000000,35,045,San Juan County, NM,Jun-17,53475,49312,4163,7.8
CN3504500000000,35,045,San Juan County, NM,Jul-17,52684,48734,3950,7.5
CN3504500000000,35,045,San Juan County, NM,Aug-17,51682,47952,3730,7.2
CN3504500000000,35,045,San Juan County, NM,Sep-17,53192,49696,3496,6.6
CN3504500000000,35,045,San Juan County, NM,Oct-17,53413,50086,3327,6.2
CN3504500000000,35,045,San Juan County, NM,Nov-17,53627,50345,3282,6.1
CN3504500000000,35,045,San Juan County, NM,Dec-17,53564,50283,3281,6.1
CN3504500000000,35,045,San Juan County, NM,Jan-18,53404,49997,3407,6.4
CN3504500000000,35,045,San Juan County, NM,Feb-18,53442,50273,3169,5.9
CN3504500000000,35,045,San Juan County, NM,Mar-18,53251,50337,2914,5.5
CN3504500000000,35,045,San Juan County, NM,Apr-18(p),53053,50503,2550,4.8
CN5403300000000,54,033,Harrison County, WV,Mar-17,32202,30447,1755,5.4
CN5403300000000,54,033,Harrison County, WV,Apr-17,32663,31070,1593,4.9
CN5403300000000,54,033,Harrison County, WV,May-17,32594,31172,1422,4.4
CN5403300000000,54,033,Harrison County, WV,Jun-17,33464,31857,1607,4.8
CN5403300000000,54,033,Harrison County, WV,Jul-17,33370,31832,1538,4.6
CN5403300000000,54,033,Harrison County, WV,Aug-17,33095,31518,1577,4.8
CN5403300000000,54,033,Harrison County, WV,Sep-17,33312,31912,1400,4.2
CN5403300000000,54,033,Harrison County, WV,Oct-17,33171,31761,1410,4.3
CN5403300000000,54,033,Harrison County, WV,Nov-17,33054,31563,1491,4.5
CN5403300000000,54,033,Harrison County, WV,Dec-17,33025,31492,1533,4.6
CN5403300000000,54,033,Harrison County, WV,Jan-18,32889,31158,1731,5.3
CN5403300000000,54,033,Harrison County, WV,Feb-18,33019,31157,1862,5.6
CN5403300000000,54,033,Harrison County, WV,Mar-18,32776,31072,1704,5.2
CN5403300000000,54,033,Harrison County, WV,Apr-18(p),33109,31557,1552,4.7
CN4101700000000,41,017,Deschutes County, OR,Mar-17,91268,87150,4118,4.5
CN4101700000000,41,017,Deschutes County, OR,Apr-17,92319,88783,3536,3.8
CN4101700000000,41,017,Deschutes County, OR,May-17,92725,89361,3364,3.6
CN4101700000000,41,017,Deschutes County, OR,Jun-17,94269,90384,3885,4.1
CN4101700000000,41,017,Deschutes County, OR,Jul-17,95357,91375,3982,4.2
CN4101700000000,41,017,Deschutes County, OR,Aug-17,96343,92349,3994,4.1
CN4101700000000,41,017,Deschutes County, OR,Sep-17,95503,91840,3663,3.8
CN4101700000000,41,017,Deschutes County, OR,Oct-17,94665,90873,3792,4.0
CN4101700000000,41,017,Deschutes County, OR,Nov-17,94778,90872,3906,4.1
CN4101700000000,41,017,Deschutes County, OR,Dec-17,93692,89684,4008,4.3
CN4101700000000,41,017,Deschutes County, OR,Jan-18,94391,89881,4510,4.8
CN4101700000000,41,017,Deschutes County, OR,Feb-18,94874,90342,4532,4.8
CN4101700000000,41,017,Deschutes County, OR,Mar-18,94853,90502,4351,4.6
CN4101700000000,41,017,Deschutes County, OR,Apr-18(p),94099,90419,3680,3.9
CN2016100000000,20,161,Riley County, KS,Mar-17,35787,34746,1041,2.9
CN2016100000000,20,161,Riley County, KS,Apr-17,36155,35098,1057,2.9
CN2016100000000,20,161,Riley County, KS,May-17,35243,34173,1070,3.0
CN2016100000000,20,161,Riley County, KS,Jun-17,34360,33163,1197,3.5
CN2016100000000,20,161,Riley County, KS,Jul-17,33595,32321,1274,3.8
CN2016100000000,20,161,Riley County, KS,Aug-17,33013,31866,1147,3.5
CN2016100000000,20,161,Riley County, KS,Sep-17,35569,34616,953,2.7
CN2016100000000,20,161,Riley County, KS,Oct-17,35928,35091,837,2.3
CN2016100000000,20,161,Riley County, KS,Nov-17,35957,34995,962,2.7
CN2016100000000,20,161,Riley County, KS,Dec-17,35189,34337,852,2.4
CN2016100000000,20,161,Riley County, KS,Jan-18,32851,31934,917,2.8
CN2016100000000,20,161,Riley County, KS,Feb-18,35928,34914,1014,2.8
CN2016100000000,20,161,Riley County, KS,Mar-18,35705,34697,1008,2.8
CN2016100000000,20,161,Riley County, KS,Apr-18(p),36158,35173,985,2.7
CN3901500000000,39,015,Brown County, OH,Mar-17,19800,18603,1197,6.0
CN3901500000000,39,015,Brown County, OH,Apr-17,19689,18652,1037,5.3
CN3901500000000,39,015,Brown County, OH,May-17,19717,18709,1008,5.1
CN3901500000000,39,015,Brown County, OH,Jun-17,19906,18775,1131,5.7
CN3901500000000,39,015,Brown County, OH,Jul-17,19876,18733,1143,5.8
CN3901500000000,39,015,Brown County, OH,Aug-17,19966,18817,1149,5.8
CN3901500000000,39,015,Brown County, OH,Sep-17,19731,18722,1009,5.1
CN3901500000000,39,015,Brown County, OH,Oct-17,19683,18677,1006,5.1
CN3901500000000,39,015,Brown County, OH,Nov-17,19629,18635,994,5.1
CN3901500000000,39,015,Brown County, OH,Dec-17,19527,18464,1063,5.4
CN3901500000000,39,015,Brown County, OH,Jan-18,19414,18161,1253,6.5
CN3901500000000,39,015,Brown County, OH,Feb-18,19625,18477,1148,5.8
CN3901500000000,39,015,Brown County, OH,Mar-18,19822,18790,1032,5.2
CN3901500000000,39,015,Brown County, OH,Apr-18(p),19661,18722,939,4.8
CN4815100000000,48,151,Fisher County, TX,Mar-17,1742,1678,64,3.7
CN4815100000000,48,151,Fisher County, TX,Apr-17,1719,1659,60,3.5
CN4815100000000,48,151,Fisher County, TX,May-17,1742,1678,64,3.7
CN4815100000000,48,151,Fisher County, TX,Jun-17,1722,1660,62,3.6
CN4815100000000,48,151,Fisher County, TX,Jul-17,1732,1669,63,3.6
CN4815100000000,48,151,Fisher County, TX,Aug-17,1727,1667,60,3.5
CN4815100000000,48,151,Fisher County, TX,Sep-17,1706,1650,56,3.3
CN4815100000000,48,151,Fisher County, TX,Oct-17,1730,1679,51,2.9
CN4815100000000,48,151,Fisher County, TX,Nov-17,1713,1660,53,3.1
CN4815100000000,48,151,Fisher County, TX,Dec-17,1728,1679,49,2.8
CN4815100000000,48,151,Fisher County, TX,Jan-18,1709,1648,61,3.6
CN4815100000000,48,151,Fisher County, TX,Feb-18,1726,1665,61,3.5
CN4815100000000,48,151,Fisher County, TX,Mar-18,1767,1709,58,3.3
CN4815100000000,48,151,Fisher County, TX,Apr-18(p),1695,1644,51,3.0
CN2202900000000,22,029,Concordia Parish, LA,Mar-17,7198,6610,588,8.2
CN2202900000000,22,029,Concordia Parish, LA,Apr-17,7154,6596,558,7.8
CN2202900000000,22,029,Concordia Parish, LA,May-17,7287,6715,572,7.8
CN2202900000000,22,029,Concordia Parish, LA,Jun-17,7500,6816,684,9.1
CN2202900000000,22,029,Concordia Parish, LA,Jul-17,7284,6667,617,8.5
CN2202900000000,22,029,Concordia Parish, LA,Aug-17,7134,6537,597,8.4
CN2202900000000,22,029,Concordia Parish, LA,Sep-17,7040,6512,528,7.5
CN2202900000000,22,029,Concordia Parish, LA,Oct-17,7021,6550,471,6.7
CN2202900000000,22,029,Concordia Parish, LA,Nov-17,6985,6541,444,6.4
CN2202900000000,22,029,Concordia Parish, LA,Dec-17,6962,6511,451,6.5
CN2202900000000,22,029,Concordia Parish, LA,Jan-18,7008,6531,477,6.8
CN2202900000000,22,029,Concordia Parish, LA,Feb-18,6931,6505,426,6.1
CN2202900000000,22,029,Concordia Parish, LA,Mar-18,6981,6540,441,6.3
CN2202900000000,22,029,Concordia Parish, LA,Apr-18(p),6944,6511,433,6.2
CN4011100000000,40,111,Okmulgee County, OK,Mar-17,16055,15011,1044,6.5
CN4011100000000,40,111,Okmulgee County, OK,Apr-17,15962,15000,962,6.0
CN4011100000000,40,111,Okmulgee County, OK,May-17,15949,14963,986,6.2
CN4011100000000,40,111,Okmulgee County, OK,Jun-17,16192,15160,1032,6.4
CN4011100000000,40,111,Okmulgee County, OK,Jul-17,16218,15262,956,5.9
CN4011100000000,40,111,Okmulgee County, OK,Aug-17,16055,15089,966,6.0
CN4011100000000,40,111,Okmulgee County, OK,Sep-17,16140,15194,946,5.9
CN4011100000000,40,111,Okmulgee County, OK,Oct-17,16344,15346,998,6.1
CN4011100000000,40,111,Okmulgee County, OK,Nov-17,16462,15479,983,6.0
CN4011100000000,40,111,Okmulgee County, OK,Dec-17,16341,15364,977,6.0
CN4011100000000,40,111,Okmulgee County, OK,Jan-18,16228,15167,1061,6.5
CN4011100000000,40,111,Okmulgee County, OK,Feb-18,16208,15267,941,5.8
CN4011100000000,40,111,Okmulgee County, OK,Mar-18,16221,15341,880,5.4
CN4011100000000,40,111,Okmulgee County, OK,Apr-18(p),16234,15357,877,5.4
CN3706900000000,37,069,Franklin County, NC,Mar-17,29925,28550,1375,4.6
CN3706900000000,37,069,Franklin County, NC,Apr-17,29855,28585,1270,4.3
CN3706900000000,37,069,Franklin County, NC,May-17,30019,28685,1334,4.4
CN3706900000000,37,069,Franklin County, NC,Jun-17,30148,28728,1420,4.7
CN3706900000000,37,069,Franklin County, NC,Jul-17,30703,29184,1519,4.9
CN3706900000000,37,069,Franklin County, NC,Aug-17,30328,28803,1525,5.0
CN3706900000000,37,069,Franklin County, NC,Sep-17,30446,29105,1341,4.4
CN3706900000000,37,069,Franklin County, NC,Oct-17,30361,29037,1324,4.4
CN3706900000000,37,069,Franklin County, NC,Nov-17,30369,28989,1380,4.5
CN3706900000000,37,069,Franklin County, NC,Dec-17,30078,28738,1340,4.5
CN3706900000000,37,069,Franklin County, NC,Jan-18,30227,28805,1422,4.7
CN3706900000000,37,069,Franklin County, NC,Feb-18,30534,29125,1409,4.6
CN3706900000000,37,069,Franklin County, NC,Mar-18,30619,29278,1341,4.4
CN3706900000000,37,069,Franklin County, NC,Apr-18(p),30556,29406,1150,3.8
CN5307100000000,53,071,Walla Walla County, WA,Mar-17,28602,27070,1532,5.4
CN5307100000000,53,071,Walla Walla County, WA,Apr-17,28527,27243,1284,4.5
CN5307100000000,53,071,Walla Walla County, WA,May-17,28785,27491,1294,4.5
CN5307100000000,53,071,Walla Walla County, WA,Jun-17,29389,28058,1331,4.5
CN5307100000000,53,071,Walla Walla County, WA,Jul-17,29912,28556,1356,4.5
CN5307100000000,53,071,Walla Walla County, WA,Aug-17,29662,28336,1326,4.5
CN5307100000000,53,071,Walla Walla County, WA,Sep-17,29786,28517,1269,4.3
CN5307100000000,53,071,Walla Walla County, WA,Oct-17,31153,29868,1285,4.1
CN5307100000000,53,071,Walla Walla County, WA,Nov-17,30746,29398,1348,4.4
CN5307100000000,53,071,Walla Walla County, WA,Dec-17,29348,27779,1569,5.3
CN5307100000000,53,071,Walla Walla County, WA,Jan-18,28743,26987,1756,6.1
CN5307100000000,53,071,Walla Walla County, WA,Feb-18,29263,27541,1722,5.9
CN5307100000000,53,071,Walla Walla County, WA,Mar-18,29611,28054,1557,5.3
CN5307100000000,53,071,Walla Walla County, WA,Apr-18(p),29383,28002,1381,4.7
CN2916300000000,29,163,Pike County, MO,Mar-17,7879,7587,292,3.7
CN2916300000000,29,163,Pike County, MO,Apr-17,7965,7709,256,3.2
CN2916300000000,29,163,Pike County, MO,May-17,7944,7671,273,3.4
CN2916300000000,29,163,Pike County, MO,Jun-17,7989,7708,281,3.5
CN2916300000000,29,163,Pike County, MO,Jul-17,7726,7425,301,3.9
CN2916300000000,29,163,Pike County, MO,Aug-17,7632,7347,285,3.7
CN2916300000000,29,163,Pike County, MO,Sep-17,7690,7458,232,3.0
CN2916300000000,29,163,Pike County, MO,Oct-17,7809,7633,176,2.3
CN2916300000000,29,163,Pike County, MO,Nov-17,7838,7613,225,2.9
CN2916300000000,29,163,Pike County, MO,Dec-17,7810,7559,251,3.2
CN2916300000000,29,163,Pike County, MO,Jan-18,7649,7337,312,4.1
CN2916300000000,29,163,Pike County, MO,Feb-18,7699,7366,333,4.3
CN2916300000000,29,163,Pike County, MO,Mar-18,7678,7379,299,3.9
CN2916300000000,29,163,Pike County, MO,Apr-18(p),7797,7486,311,4.0
CN5166000000000,51,660,Harrisonburg city, VA,Mar-17,24794,23690,1104,4.5
CN5166000000000,51,660,Harrisonburg city, VA,Apr-17,24915,23936,979,3.9
CN5166000000000,51,660,Harrisonburg city, VA,May-17,24280,23190,1090,4.5
CN5166000000000,51,660,Harrisonburg city, VA,Jun-17,24272,22984,1288,5.3
CN5166000000000,51,660,Harrisonburg city, VA,Jul-17,24386,23156,1230,5.0
CN5166000000000,51,660,Harrisonburg city, VA,Aug-17,23932,22720,1212,5.1
CN5166000000000,51,660,Harrisonburg city, VA,Sep-17,24850,23769,1081,4.4
CN5166000000000,51,660,Harrisonburg city, VA,Oct-17,24760,23807,953,3.8
CN5166000000000,51,660,Harrisonburg city, VA,Nov-17,24731,23700,1031,4.2
CN5166000000000,51,660,Harrisonburg city, VA,Dec-17,24530,23656,874,3.6
CN5166000000000,51,660,Harrisonburg city, VA,Jan-18,24563,23571,992,4.0
CN5166000000000,51,660,Harrisonburg city, VA,Feb-18,24998,24063,935,3.7
CN5166000000000,51,660,Harrisonburg city, VA,Mar-18,24972,24042,930,3.7
CN5166000000000,51,660,Harrisonburg city, VA,Apr-18(p),25107,24328,779,3.1
CN2301300000000,23,013,Knox County, ME,Mar-17,20115,19289,826,4.1
CN2301300000000,23,013,Knox County, ME,Apr-17,20300,19600,700,3.4
CN2301300000000,23,013,Knox County, ME,May-17,20772,20149,623,3.0
CN2301300000000,23,013,Knox County, ME,Jun-17,21745,21118,627,2.9
CN2301300000000,23,013,Knox County, ME,Jul-17,22090,21491,599,2.7
CN2301300000000,23,013,Knox County, ME,Aug-17,22062,21542,520,2.4
CN2301300000000,23,013,Knox County, ME,Sep-17,20814,20288,526,2.5
CN2301300000000,23,013,Knox County, ME,Oct-17,20589,20062,527,2.6
CN2301300000000,23,013,Knox County, ME,Nov-17,20098,19502,596,3.0
CN2301300000000,23,013,Knox County, ME,Dec-17,20025,19500,525,2.6
CN2301300000000,23,013,Knox County, ME,Jan-18,19803,19116,687,3.5
CN2301300000000,23,013,Knox County, ME,Feb-18,20060,19326,734,3.7
CN2301300000000,23,013,Knox County, ME,Mar-18,20412,19721,691,3.4
CN2301300000000,23,013,Knox County, ME,Apr-18(p),20582,19948,634,3.1
CN3010300000000,30,103,Treasure County, MT,Mar-17,346,329,17,4.9
CN3010300000000,30,103,Treasure County, MT,Apr-17,363,348,15,4.1
CN3010300000000,30,103,Treasure County, MT,May-17,369,358,11,3.0
CN3010300000000,30,103,Treasure County, MT,Jun-17,346,333,13,3.8
CN3010300000000,30,103,Treasure County, MT,Jul-17,346,333,13,3.8
CN3010300000000,30,103,Treasure County, MT,Aug-17,347,331,16,4.6
CN3010300000000,30,103,Treasure County, MT,Sep-17,340,326,14,4.1
CN3010300000000,30,103,Treasure County, MT,Oct-17,340,330,10,2.9
CN3010300000000,30,103,Treasure County, MT,Nov-17,337,327,10,3.0
CN3010300000000,30,103,Treasure County, MT,Dec-17,328,316,12,3.7
CN3010300000000,30,103,Treasure County, MT,Jan-18,338,324,14,4.1
CN3010300000000,30,103,Treasure County, MT,Feb-18,341,326,15,4.4
CN3010300000000,30,103,Treasure County, MT,Mar-18,330,318,12,3.6
CN3010300000000,30,103,Treasure County, MT,Apr-18(p),335,324,11,3.3
CN4812900000000,48,129,Donley County, TX,Mar-17,1564,1505,59,3.8
CN4812900000000,48,129,Donley County, TX,Apr-17,1566,1512,54,3.4
CN4812900000000,48,129,Donley County, TX,May-17,1550,1497,53,3.4
CN4812900000000,48,129,Donley County, TX,Jun-17,1573,1507,66,4.2
CN4812900000000,48,129,Donley County, TX,Jul-17,1456,1393,63,4.3
CN4812900000000,48,129,Donley County, TX,Aug-17,1447,1390,57,3.9
CN4812900000000,48,129,Donley County, TX,Sep-17,1457,1410,47,3.2
CN4812900000000,48,129,Donley County, TX,Oct-17,1495,1452,43,2.9
CN4812900000000,48,129,Donley County, TX,Nov-17,1488,1437,51,3.4
CN4812900000000,48,129,Donley County, TX,Dec-17,1480,1431,49,3.3
CN4812900000000,48,129,Donley County, TX,Jan-18,1470,1421,49,3.3
CN4812900000000,48,129,Donley County, TX,Feb-18,1499,1448,51,3.4
CN4812900000000,48,129,Donley County, TX,Mar-18,1543,1492,51,3.3
CN4812900000000,48,129,Donley County, TX,Apr-18(p),1570,1522,48,3.1
CN0514300000000,05,143,Washington County, AR,Mar-17,121427,118557,2870,2.4
CN0514300000000,05,143,Washington County, AR,Apr-17,122023,119410,2613,2.1
CN0514300000000,05,143,Washington County, AR,May-17,122626,119559,3067,2.5
CN0514300000000,05,143,Washington County, AR,Jun-17,123278,119845,3433,2.8
CN0514300000000,05,143,Washington County, AR,Jul-17,124508,120843,3665,2.9
CN0514300000000,05,143,Washington County, AR,Aug-17,123036,119742,3294,2.7
CN0514300000000,05,143,Washington County, AR,Sep-17,123622,120552,3070,2.5
CN0514300000000,05,143,Washington County, AR,Oct-17,124049,121283,2766,2.2
CN0514300000000,05,143,Washington County, AR,Nov-17,123104,120277,2827,2.3
CN0514300000000,05,143,Washington County, AR,Dec-17,121244,118275,2969,2.4
CN0514300000000,05,143,Washington County, AR,Jan-18,119997,116590,3407,2.8
CN0514300000000,05,143,Washington County, AR,Feb-18,122454,118975,3479,2.8
CN0514300000000,05,143,Washington County, AR,Mar-18,123018,119833,3185,2.6
CN0514300000000,05,143,Washington County, AR,Apr-18(p),123755,120885,2870,2.3
CN5509500000000,55,095,Polk County, WI,Mar-17,25256,23963,1293,5.1
CN5509500000000,55,095,Polk County, WI,Apr-17,24789,23834,955,3.9
CN5509500000000,55,095,Polk County, WI,May-17,24825,24061,764,3.1
CN5509500000000,55,095,Polk County, WI,Jun-17,25557,24672,885,3.5
CN5509500000000,55,095,Polk County, WI,Jul-17,25176,24411,765,3.0
CN5509500000000,55,095,Polk County, WI,Aug-17,24805,24044,761,3.1
CN5509500000000,55,095,Polk County, WI,Sep-17,24917,24222,695,2.8
CN5509500000000,55,095,Polk County, WI,Oct-17,25058,24397,661,2.6
CN5509500000000,55,095,Polk County, WI,Nov-17,24967,24187,780,3.1
CN5509500000000,55,095,Polk County, WI,Dec-17,24996,24063,933,3.7
CN5509500000000,55,095,Polk County, WI,Jan-18,25083,23994,1089,4.3
CN5509500000000,55,095,Polk County, WI,Feb-18,25202,23946,1256,5.0
CN5509500000000,55,095,Polk County, WI,Mar-18,25316,24140,1176,4.6
CN5509500000000,55,095,Polk County, WI,Apr-18(p),25382,24353,1029,4.1
CN2106700000000,21,067,Fayette County, KY,Mar-17,173496,166538,6958,4.0
CN2106700000000,21,067,Fayette County, KY,Apr-17,174800,168523,6277,3.6
CN2106700000000,21,067,Fayette County, KY,May-17,174581,167952,6629,3.8
CN2106700000000,21,067,Fayette County, KY,Jun-17,176438,168857,7581,4.3
CN2106700000000,21,067,Fayette County, KY,Jul-17,175282,168058,7224,4.1
CN2106700000000,21,067,Fayette County, KY,Aug-17,173668,167232,6436,3.7
CN2106700000000,21,067,Fayette County, KY,Sep-17,174664,168995,5669,3.2
CN2106700000000,21,067,Fayette County, KY,Oct-17,174192,168943,5249,3.0
CN2106700000000,21,067,Fayette County, KY,Nov-17,175221,170072,5149,2.9
CN2106700000000,21,067,Fayette County, KY,Dec-17,174457,169534,4923,2.8
CN2106700000000,21,067,Fayette County, KY,Jan-18,172938,167685,5253,3.0
CN2106700000000,21,067,Fayette County, KY,Feb-18,173417,167255,6162,3.6
CN2106700000000,21,067,Fayette County, KY,Mar-18,174163,168276,5887,3.4
CN2106700000000,21,067,Fayette County, KY,Apr-18(p),175956,170740,5216,3.0
CN4207900000000,42,079,Luzerne County, PA,Mar-17,157980,147600,10380,6.6
CN4207900000000,42,079,Luzerne County, PA,Apr-17,157691,148858,8833,5.6
CN4207900000000,42,079,Luzerne County, PA,May-17,157913,148807,9106,5.8
CN4207900000000,42,079,Luzerne County, PA,Jun-17,158347,149075,9272,5.9
CN4207900000000,42,079,Luzerne County, PA,Jul-17,159078,149266,9812,6.2
CN4207900000000,42,079,Luzerne County, PA,Aug-17,157814,147973,9841,6.2
CN4207900000000,42,079,Luzerne County, PA,Sep-17,158545,150239,8306,5.2
CN4207900000000,42,079,Luzerne County, PA,Oct-17,158008,149932,8076,5.1
CN4207900000000,42,079,Luzerne County, PA,Nov-17,159214,150979,8235,5.2
CN4207900000000,42,079,Luzerne County, PA,Dec-17,158180,149692,8488,5.4
CN4207900000000,42,079,Luzerne County, PA,Jan-18,158194,147988,10206,6.5
CN4207900000000,42,079,Luzerne County, PA,Feb-18,157697,147581,10116,6.4
CN4207900000000,42,079,Luzerne County, PA,Mar-18,156328,147183,9145,5.8
CN4207900000000,42,079,Luzerne County, PA,Apr-18(p),156423,148658,7765,5.0
CN0402500000000,04,025,Yavapai County, AZ,Mar-17,100625,95880,4745,4.7
CN0402500000000,04,025,Yavapai County, AZ,Apr-17,101170,96718,4452,4.4
CN0402500000000,04,025,Yavapai County, AZ,May-17,101928,97547,4381,4.3
CN0402500000000,04,025,Yavapai County, AZ,Jun-17,103147,98525,4622,4.5
CN0402500000000,04,025,Yavapai County, AZ,Jul-17,102828,98301,4527,4.4
CN0402500000000,04,025,Yavapai County, AZ,Aug-17,102252,97588,4664,4.6
CN0402500000000,04,025,Yavapai County, AZ,Sep-17,103317,98803,4514,4.4
CN0402500000000,04,025,Yavapai County, AZ,Oct-17,102441,98165,4276,4.2
CN0402500000000,04,025,Yavapai County, AZ,Nov-17,102603,98251,4352,4.2
CN0402500000000,04,025,Yavapai County, AZ,Dec-17,101770,97414,4356,4.3
CN0402500000000,04,025,Yavapai County, AZ,Jan-18,101602,96629,4973,4.9
CN0402500000000,04,025,Yavapai County, AZ,Feb-18,103486,98570,4916,4.8
CN0402500000000,04,025,Yavapai County, AZ,Mar-18,103894,99424,4470,4.3
CN0402500000000,04,025,Yavapai County, AZ,Apr-18(p),103840,99635,4205,4.0
CN2711700000000,27,117,Pipestone County, MN,Mar-17,4829,4576,253,5.2
CN2711700000000,27,117,Pipestone County, MN,Apr-17,4905,4730,175,3.6
CN2711700000000,27,117,Pipestone County, MN,May-17,4907,4775,132,2.7
CN2711700000000,27,117,Pipestone County, MN,Jun-17,5023,4868,155,3.1
CN2711700000000,27,117,Pipestone County, MN,Jul-17,4985,4847,138,2.8
CN2711700000000,27,117,Pipestone County, MN,Aug-17,4849,4716,133,2.7
CN2711700000000,27,117,Pipestone County, MN,Sep-17,4817,4708,109,2.3
CN2711700000000,27,117,Pipestone County, MN,Oct-17,4974,4888,86,1.7
CN2711700000000,27,117,Pipestone County, MN,Nov-17,4942,4833,109,2.2
CN2711700000000,27,117,Pipestone County, MN,Dec-17,4963,4805,158,3.2
CN2711700000000,27,117,Pipestone County, MN,Jan-18,4982,4729,253,5.1
CN2711700000000,27,117,Pipestone County, MN,Feb-18,4955,4701,254,5.1
CN2711700000000,27,117,Pipestone County, MN,Mar-18,4989,4738,251,5.0
CN2711700000000,27,117,Pipestone County, MN,Apr-18(p),5098,4915,183,3.6
CN3709100000000,37,091,Hertford County, NC,Mar-17,9414,8863,551,5.9
CN3709100000000,37,091,Hertford County, NC,Apr-17,9309,8814,495,5.3
CN3709100000000,37,091,Hertford County, NC,May-17,9315,8790,525,5.6
CN3709100000000,37,091,Hertford County, NC,Jun-17,9280,8739,541,5.8
CN3709100000000,37,091,Hertford County, NC,Jul-17,9302,8732,570,6.1
CN3709100000000,37,091,Hertford County, NC,Aug-17,9105,8529,576,6.3
CN3709100000000,37,091,Hertford County, NC,Sep-17,9309,8801,508,5.5
CN3709100000000,37,091,Hertford County, NC,Oct-17,9276,8785,491,5.3
CN3709100000000,37,091,Hertford County, NC,Nov-17,9219,8705,514,5.6
CN3709100000000,37,091,Hertford County, NC,Dec-17,9214,8709,505,5.5
CN3709100000000,37,091,Hertford County, NC,Jan-18,9165,8613,552,6.0
CN3709100000000,37,091,Hertford County, NC,Feb-18,9190,8640,550,6.0
CN3709100000000,37,091,Hertford County, NC,Mar-18,9179,8664,515,5.6
CN3709100000000,37,091,Hertford County, NC,Apr-18(p),9105,8671,434,4.8
CN0508700000000,05,087,Madison County, AR,Mar-17,7420,7232,188,2.5
CN0508700000000,05,087,Madison County, AR,Apr-17,7485,7313,172,2.3
CN0508700000000,05,087,Madison County, AR,May-17,7538,7342,196,2.6
CN0508700000000,05,087,Madison County, AR,Jun-17,7588,7366,222,2.9
CN0508700000000,05,087,Madison County, AR,Jul-17,7596,7358,238,3.1
CN0508700000000,05,087,Madison County, AR,Aug-17,7436,7219,217,2.9
CN0508700000000,05,087,Madison County, AR,Sep-17,7442,7232,210,2.8
CN0508700000000,05,087,Madison County, AR,Oct-17,7543,7354,189,2.5
CN0508700000000,05,087,Madison County, AR,Nov-17,7470,7284,186,2.5
CN0508700000000,05,087,Madison County, AR,Dec-17,7378,7176,202,2.7
CN0508700000000,05,087,Madison County, AR,Jan-18,7256,6996,260,3.6
CN0508700000000,05,087,Madison County, AR,Feb-18,7379,7127,252,3.4
CN0508700000000,05,087,Madison County, AR,Mar-18,7395,7168,227,3.1
CN0508700000000,05,087,Madison County, AR,Apr-18(p),7447,7255,192,2.6
CN4610500000000,46,105,Perkins County, SD,Mar-17,1616,1567,49,3.0
CN4610500000000,46,105,Perkins County, SD,Apr-17,1636,1588,48,2.9
CN4610500000000,46,105,Perkins County, SD,May-17,1683,1636,47,2.8
CN4610500000000,46,105,Perkins County, SD,Jun-17,1727,1680,47,2.7
CN4610500000000,46,105,Perkins County, SD,Jul-17,1665,1622,43,2.6
CN4610500000000,46,105,Perkins County, SD,Aug-17,1621,1570,51,3.1
CN4610500000000,46,105,Perkins County, SD,Sep-17,1594,1549,45,2.8
CN4610500000000,46,105,Perkins County, SD,Oct-17,1566,1522,44,2.8
CN4610500000000,46,105,Perkins County, SD,Nov-17,1559,1510,49,3.1
CN4610500000000,46,105,Perkins County, SD,Dec-17,1612,1563,49,3.0
CN4610500000000,46,105,Perkins County, SD,Jan-18,1622,1565,57,3.5
CN4610500000000,46,105,Perkins County, SD,Feb-18,1601,1549,52,3.2
CN4610500000000,46,105,Perkins County, SD,Mar-18,1627,1581,46,2.8
CN4610500000000,46,105,Perkins County, SD,Apr-18(p),1582,1533,49,3.1
CN4005500000000,40,055,Greer County, OK,Mar-17,2060,1946,114,5.5
CN4005500000000,40,055,Greer County, OK,Apr-17,2064,1964,100,4.8
CN4005500000000,40,055,Greer County, OK,May-17,2046,1934,112,5.5
CN4005500000000,40,055,Greer County, OK,Jun-17,2035,1920,115,5.7
CN4005500000000,40,055,Greer County, OK,Jul-17,2037,1926,111,5.4
CN4005500000000,40,055,Greer County, OK,Aug-17,2095,1993,102,4.9
CN4005500000000,40,055,Greer County, OK,Sep-17,2061,1969,92,4.5
CN4005500000000,40,055,Greer County, OK,Oct-17,2113,2006,107,5.1
CN4005500000000,40,055,Greer County, OK,Nov-17,2139,2040,99,4.6
CN4005500000000,40,055,Greer County, OK,Dec-17,2076,1971,105,5.1
CN4005500000000,40,055,Greer County, OK,Jan-18,2024,1916,108,5.3
CN4005500000000,40,055,Greer County, OK,Feb-18,2044,1951,93,4.5
CN4005500000000,40,055,Greer County, OK,Mar-18,2010,1919,91,4.5
CN4005500000000,40,055,Greer County, OK,Apr-18(p),1962,1879,83,4.2
CN0604900000000,06,049,Modoc County, CA,Mar-17,3166,2820,346,10.9
CN0604900000000,06,049,Modoc County, CA,Apr-17,3201,2933,268,8.4
CN0604900000000,06,049,Modoc County, CA,May-17,3266,3042,224,6.9
CN0604900000000,06,049,Modoc County, CA,Jun-17,3348,3122,226,6.8
CN0604900000000,06,049,Modoc County, CA,Jul-17,3268,3042,226,6.9
CN0604900000000,06,049,Modoc County, CA,Aug-17,3298,3087,211,6.4
CN0604900000000,06,049,Modoc County, CA,Sep-17,3232,3051,181,5.6
CN0604900000000,06,049,Modoc County, CA,Oct-17,3286,3096,190,5.8
CN0604900000000,06,049,Modoc County, CA,Nov-17,3218,2985,233,7.2
CN0604900000000,06,049,Modoc County, CA,Dec-17,3151,2875,276,8.8
CN0604900000000,06,049,Modoc County, CA,Jan-18,3211,2882,329,10.2
CN0604900000000,06,049,Modoc County, CA,Feb-18,3200,2868,332,10.4
CN0604900000000,06,049,Modoc County, CA,Mar-18,3227,2919,308,9.5
CN0604900000000,06,049,Modoc County, CA,Apr-18(p),3276,3036,240,7.3
CN2810100000000,28,101,Newton County, MS,Mar-17,8837,8373,464,5.3
CN2810100000000,28,101,Newton County, MS,Apr-17,8532,8115,417,4.9
CN2810100000000,28,101,Newton County, MS,May-17,8575,8089,486,5.7
CN2810100000000,28,101,Newton County, MS,Jun-17,8595,8050,545,6.3
CN2810100000000,28,101,Newton County, MS,Jul-17,8616,8092,524,6.1
CN2810100000000,28,101,Newton County, MS,Aug-17,8269,7825,444,5.4
CN2810100000000,28,101,Newton County, MS,Sep-17,8294,7879,415,5.0
CN2810100000000,28,101,Newton County, MS,Oct-17,8249,7850,399,4.8
CN2810100000000,28,101,Newton County, MS,Nov-17,8226,7833,393,4.8
CN2810100000000,28,101,Newton County, MS,Dec-17,8312,7896,416,5.0
CN2810100000000,28,101,Newton County, MS,Jan-18,8230,7826,404,4.9
CN2810100000000,28,101,Newton County, MS,Feb-18,8284,7902,382,4.6
CN2810100000000,28,101,Newton County, MS,Mar-18,8286,7905,381,4.6
CN2810100000000,28,101,Newton County, MS,Apr-18(p),8287,7917,370,4.5
CN4200100000000,42,001,Adams County, PA,Mar-17,55244,53138,2106,3.8
CN4200100000000,42,001,Adams County, PA,Apr-17,55727,53912,1815,3.3
CN4200100000000,42,001,Adams County, PA,May-17,55991,53941,2050,3.7
CN4200100000000,42,001,Adams County, PA,Jun-17,55907,53725,2182,3.9
CN4200100000000,42,001,Adams County, PA,Jul-17,56396,54079,2317,4.1
CN4200100000000,42,001,Adams County, PA,Aug-17,55727,53453,2274,4.1
CN4200100000000,42,001,Adams County, PA,Sep-17,55542,53762,1780,3.2
CN4200100000000,42,001,Adams County, PA,Oct-17,55184,53502,1682,3.0
CN4200100000000,42,001,Adams County, PA,Nov-17,54846,53098,1748,3.2
CN4200100000000,42,001,Adams County, PA,Dec-17,54880,53114,1766,3.2
CN4200100000000,42,001,Adams County, PA,Jan-18,55283,53037,2246,4.1
CN4200100000000,42,001,Adams County, PA,Feb-18,55794,53572,2222,4.0
CN4200100000000,42,001,Adams County, PA,Mar-18,55059,53238,1821,3.3
CN4200100000000,42,001,Adams County, PA,Apr-18(p),54792,53218,1574,2.9
CN2615500000000,26,155,Shiawassee County, MI,Mar-17,33521,31658,1863,5.6
CN2615500000000,26,155,Shiawassee County, MI,Apr-17,33411,31870,1541,4.6
CN2615500000000,26,155,Shiawassee County, MI,May-17,33671,32161,1510,4.5
CN2615500000000,26,155,Shiawassee County, MI,Jun-17,33884,32113,1771,5.2
CN2615500000000,26,155,Shiawassee County, MI,Jul-17,33615,31487,2128,6.3
CN2615500000000,26,155,Shiawassee County, MI,Aug-17,33306,31480,1826,5.5
CN2615500000000,26,155,Shiawassee County, MI,Sep-17,33354,31762,1592,4.8
CN2615500000000,26,155,Shiawassee County, MI,Oct-17,33458,32012,1446,4.3
CN2615500000000,26,155,Shiawassee County, MI,Nov-17,33614,32150,1464,4.4
CN2615500000000,26,155,Shiawassee County, MI,Dec-17,33551,31857,1694,5.0
CN2615500000000,26,155,Shiawassee County, MI,Jan-18,33472,31237,2235,6.7
CN2615500000000,26,155,Shiawassee County, MI,Feb-18,33707,31663,2044,6.1
CN2615500000000,26,155,Shiawassee County, MI,Mar-18,33752,31965,1787,5.3
CN2615500000000,26,155,Shiawassee County, MI,Apr-18(p),33673,32174,1499,4.5
CN3401100000000,34,011,Cumberland County, NJ,Mar-17,66675,61930,4745,7.1
CN3401100000000,34,011,Cumberland County, NJ,Apr-17,65992,61828,4164,6.3
CN3401100000000,34,011,Cumberland County, NJ,May-17,66419,62308,4111,6.2
CN3401100000000,34,011,Cumberland County, NJ,Jun-17,66409,61964,4445,6.7
CN3401100000000,34,011,Cumberland County, NJ,Jul-17,64915,60071,4844,7.5
CN3401100000000,34,011,Cumberland County, NJ,Aug-17,65171,60309,4862,7.5
CN3401100000000,34,011,Cumberland County, NJ,Sep-17,66292,61878,4414,6.7
CN3401100000000,34,011,Cumberland County, NJ,Oct-17,66751,62530,4221,6.3
CN3401100000000,34,011,Cumberland County, NJ,Nov-17,67213,62796,4417,6.6
CN3401100000000,34,011,Cumberland County, NJ,Dec-17,67338,62695,4643,6.9
CN3401100000000,34,011,Cumberland County, NJ,Jan-18,67146,61712,5434,8.1
CN3401100000000,34,011,Cumberland County, NJ,Feb-18,67072,61580,5492,8.2
CN3401100000000,34,011,Cumberland County, NJ,Mar-18,66339,61216,5123,7.7
CN3401100000000,34,011,Cumberland County, NJ,Apr-18(p),65666,61329,4337,6.6
CN0101100000000,01,011,Bullock County, AL,Mar-17,4787,4534,253,5.3
CN0101100000000,01,011,Bullock County, AL,Apr-17,4664,4465,199,4.3
CN0101100000000,01,011,Bullock County, AL,May-17,4674,4487,187,4.0
CN0101100000000,01,011,Bullock County, AL,Jun-17,4777,4533,244,5.1
CN0101100000000,01,011,Bullock County, AL,Jul-17,4883,4630,253,5.2
CN0101100000000,01,011,Bullock County, AL,Aug-17,4903,4662,241,4.9
CN0101100000000,01,011,Bullock County, AL,Sep-17,5027,4814,213,4.2
CN0101100000000,01,011,Bullock County, AL,Oct-17,4961,4754,207,4.2
CN0101100000000,01,011,Bullock County, AL,Nov-17,4832,4636,196,4.1
CN0101100000000,01,011,Bullock County, AL,Dec-17,4689,4480,209,4.5
CN0101100000000,01,011,Bullock County, AL,Jan-18,4691,4446,245,5.2
CN0101100000000,01,011,Bullock County, AL,Feb-18,4712,4498,214,4.5
CN0101100000000,01,011,Bullock County, AL,Mar-18,4693,4495,198,4.2
CN0101100000000,01,011,Bullock County, AL,Apr-18(p),4699,4512,187,4.0
CN4101100000000,41,011,Coos County, OR,Mar-17,26403,24927,1476,5.6
CN4101100000000,41,011,Coos County, OR,Apr-17,26359,25000,1359,5.2
CN4101100000000,41,011,Coos County, OR,May-17,26477,25172,1305,4.9
CN4101100000000,41,011,Coos County, OR,Jun-17,26862,25355,1507,5.6
CN4101100000000,41,011,Coos County, OR,Jul-17,26840,25244,1596,5.9
CN4101100000000,41,011,Coos County, OR,Aug-17,26948,25330,1618,6.0
CN4101100000000,41,011,Coos County, OR,Sep-17,26988,25581,1407,5.2
CN4101100000000,41,011,Coos County, OR,Oct-17,26985,25548,1437,5.3
CN4101100000000,41,011,Coos County, OR,Nov-17,26899,25436,1463,5.4
CN4101100000000,41,011,Coos County, OR,Dec-17,26456,25041,1415,5.3
CN4101100000000,41,011,Coos County, OR,Jan-18,26355,24839,1516,5.8
CN4101100000000,41,011,Coos County, OR,Feb-18,26628,25105,1523,5.7
CN4101100000000,41,011,Coos County, OR,Mar-18,26722,25213,1509,5.6
CN4101100000000,41,011,Coos County, OR,Apr-18(p),26298,24941,1357,5.2
CN1710900000000,17,109,McDonough County, IL,Mar-17,13870,13169,701,5.1
CN1710900000000,17,109,McDonough County, IL,Apr-17,13835,13293,542,3.9
CN1710900000000,17,109,McDonough County, IL,May-17,13709,13153,556,4.1
CN1710900000000,17,109,McDonough County, IL,Jun-17,12480,11757,723,5.8
CN1710900000000,17,109,McDonough County, IL,Jul-17,12246,11479,767,6.3
CN1710900000000,17,109,McDonough County, IL,Aug-17,12628,11967,661,5.2
CN1710900000000,17,109,McDonough County, IL,Sep-17,13853,13295,558,4.0
CN1710900000000,17,109,McDonough County, IL,Oct-17,13975,13389,586,4.2
CN1710900000000,17,109,McDonough County, IL,Nov-17,14016,13422,594,4.2
CN1710900000000,17,109,McDonough County, IL,Dec-17,13591,13039,552,4.1
CN1710900000000,17,109,McDonough County, IL,Jan-18,13096,12467,629,4.8
CN1710900000000,17,109,McDonough County, IL,Feb-18,13504,12927,577,4.3
CN1710900000000,17,109,McDonough County, IL,Mar-18,13725,13117,608,4.4
CN1710900000000,17,109,McDonough County, IL,Apr-18(p),13807,13319,488,3.5
CN0514900000000,05,149,Yell County, AR,Mar-17,8670,8349,321,3.7
CN0514900000000,05,149,Yell County, AR,Apr-17,8730,8454,276,3.2
CN0514900000000,05,149,Yell County, AR,May-17,8809,8484,325,3.7
CN0514900000000,05,149,Yell County, AR,Jun-17,8862,8487,375,4.2
CN0514900000000,05,149,Yell County, AR,Jul-17,8547,8133,414,4.8
CN0514900000000,05,149,Yell County, AR,Aug-17,8444,8071,373,4.4
CN0514900000000,05,149,Yell County, AR,Sep-17,8557,8217,340,4.0
CN0514900000000,05,149,Yell County, AR,Oct-17,8792,8499,293,3.3
CN0514900000000,05,149,Yell County, AR,Nov-17,8727,8426,301,3.4
CN0514900000000,05,149,Yell County, AR,Dec-17,8658,8324,334,3.9
CN0514900000000,05,149,Yell County, AR,Jan-18,8452,8026,426,5.0
CN0514900000000,05,149,Yell County, AR,Feb-18,8428,8019,409,4.9
CN0514900000000,05,149,Yell County, AR,Mar-18,8469,8109,360,4.3
CN0514900000000,05,149,Yell County, AR,Apr-18(p),8497,8180,317,3.7
CN3603500000000,36,035,Fulton County, NY,Mar-17,23449,21993,1456,6.2
CN3603500000000,36,035,Fulton County, NY,Apr-17,23303,21996,1307,5.6
CN3603500000000,36,035,Fulton County, NY,May-17,23361,22102,1259,5.4
CN3603500000000,36,035,Fulton County, NY,Jun-17,23693,22406,1287,5.4
CN3603500000000,36,035,Fulton County, NY,Jul-17,23523,22247,1276,5.4
CN3603500000000,36,035,Fulton County, NY,Aug-17,23453,22171,1282,5.5
CN3603500000000,36,035,Fulton County, NY,Sep-17,23307,22030,1277,5.5
CN3603500000000,36,035,Fulton County, NY,Oct-17,23039,21816,1223,5.3
CN3603500000000,36,035,Fulton County, NY,Nov-17,22987,21643,1344,5.8
CN3603500000000,36,035,Fulton County, NY,Dec-17,22826,21435,1391,6.1
CN3603500000000,36,035,Fulton County, NY,Jan-18,23224,21512,1712,7.4
CN3603500000000,36,035,Fulton County, NY,Feb-18,23100,21342,1758,7.6
CN3603500000000,36,035,Fulton County, NY,Mar-18,22895,21324,1571,6.9
CN3603500000000,36,035,Fulton County, NY,Apr-18(p),22736,21427,1309,5.8
CN4508700000000,45,087,Union County, SC,Mar-17,11632,11079,553,4.8
CN4508700000000,45,087,Union County, SC,Apr-17,11618,11116,502,4.3
CN4508700000000,45,087,Union County, SC,May-17,11646,11119,527,4.5
CN4508700000000,45,087,Union County, SC,Jun-17,11812,11159,653,5.5
CN4508700000000,45,087,Union County, SC,Jul-17,11904,11110,794,6.7
CN4508700000000,45,087,Union County, SC,Aug-17,11859,11131,728,6.1
CN4508700000000,45,087,Union County, SC,Sep-17,11903,11260,643,5.4
CN4508700000000,45,087,Union County, SC,Oct-17,11836,11209,627,5.3
CN4508700000000,45,087,Union County, SC,Nov-17,11777,11192,585,5.0
CN4508700000000,45,087,Union County, SC,Dec-17,11800,11192,608,5.2
CN4508700000000,45,087,Union County, SC,Jan-18,11855,11115,740,6.2
CN4508700000000,45,087,Union County, SC,Feb-18,11936,11263,673,5.6
CN4508700000000,45,087,Union County, SC,Mar-18,11840,11257,583,4.9
CN4508700000000,45,087,Union County, SC,Apr-18(p),11705,11292,413,3.5
CN3107500000000,31,075,Grant County, NE,Mar-17,438,428,10,2.3
CN3107500000000,31,075,Grant County, NE,Apr-17,452,443,9,2.0
CN3107500000000,31,075,Grant County, NE,May-17,454,445,9,2.0
CN3107500000000,31,075,Grant County, NE,Jun-17,473,463,10,2.1
CN3107500000000,31,075,Grant County, NE,Jul-17,447,435,12,2.7
CN3107500000000,31,075,Grant County, NE,Aug-17,424,412,12,2.8
CN3107500000000,31,075,Grant County, NE,Sep-17,415,404,11,2.7
CN3107500000000,31,075,Grant County, NE,Oct-17,426,417,9,2.1
CN3107500000000,31,075,Grant County, NE,Nov-17,430,421,9,2.1
CN3107500000000,31,075,Grant County, NE,Dec-17,431,422,9,2.1
CN3107500000000,31,075,Grant County, NE,Jan-18,440,431,9,2.0
CN3107500000000,31,075,Grant County, NE,Feb-18,422,413,9,2.1
CN3107500000000,31,075,Grant County, NE,Mar-18,427,416,11,2.6
CN3107500000000,31,075,Grant County, NE,Apr-18(p),439,428,11,2.5
CN5177500000000,51,775,Salem city, VA,Mar-17,12996,12486,510,3.9
CN5177500000000,51,775,Salem city, VA,Apr-17,12934,12484,450,3.5
CN5177500000000,51,775,Salem city, VA,May-17,12967,12488,479,3.7
CN5177500000000,51,775,Salem city, VA,Jun-17,12915,12391,524,4.1
CN5177500000000,51,775,Salem city, VA,Jul-17,12993,12459,534,4.1
CN5177500000000,51,775,Salem city, VA,Aug-17,12917,12381,536,4.1
CN5177500000000,51,775,Salem city, VA,Sep-17,12964,12491,473,3.6
CN5177500000000,51,775,Salem city, VA,Oct-17,12887,12456,431,3.3
CN5177500000000,51,775,Salem city, VA,Nov-17,12822,12384,438,3.4
CN5177500000000,51,775,Salem city, VA,Dec-17,12719,12299,420,3.3
CN5177500000000,51,775,Salem city, VA,Jan-18,12782,12315,467,3.7
CN5177500000000,51,775,Salem city, VA,Feb-18,12894,12456,438,3.4
CN5177500000000,51,775,Salem city, VA,Mar-18,12990,12554,436,3.4
CN5177500000000,51,775,Salem city, VA,Apr-18(p),12973,12607,366,2.8
CN3805900000000,38,059,Morton County, ND,Mar-17,16871,16183,688,4.1
CN3805900000000,38,059,Morton County, ND,Apr-17,16906,16410,496,2.9
CN3805900000000,38,059,Morton County, ND,May-17,16903,16507,396,2.3
CN3805900000000,38,059,Morton County, ND,Jun-17,17187,16665,522,3.0
CN3805900000000,38,059,Morton County, ND,Jul-17,17190,16748,442,2.6
CN3805900000000,38,059,Morton County, ND,Aug-17,16981,16516,465,2.7
CN3805900000000,38,059,Morton County, ND,Sep-17,16520,16153,367,2.2
CN3805900000000,38,059,Morton County, ND,Oct-17,16561,16226,335,2.0
CN3805900000000,38,059,Morton County, ND,Nov-17,16472,16038,434,2.6
CN3805900000000,38,059,Morton County, ND,Dec-17,16513,15971,542,3.3
CN3805900000000,38,059,Morton County, ND,Jan-18,16678,15934,744,4.5
CN3805900000000,38,059,Morton County, ND,Feb-18,16799,16022,777,4.6
CN3805900000000,38,059,Morton County, ND,Mar-18,16739,16018,721,4.3
CN3805900000000,38,059,Morton County, ND,Apr-18(p),16642,16046,596,3.6
CN3100900000000,31,009,Blaine County, NE,Mar-17,256,244,12,4.7
CN3100900000000,31,009,Blaine County, NE,Apr-17,270,261,9,3.3
CN3100900000000,31,009,Blaine County, NE,May-17,278,267,11,4.0
CN3100900000000,31,009,Blaine County, NE,Jun-17,294,283,11,3.7
CN3100900000000,31,009,Blaine County, NE,Jul-17,284,272,12,4.2
CN3100900000000,31,009,Blaine County, NE,Aug-17,265,255,10,3.8
CN3100900000000,31,009,Blaine County, NE,Sep-17,247,236,11,4.5
CN3100900000000,31,009,Blaine County, NE,Oct-17,247,238,9,3.6
CN3100900000000,31,009,Blaine County, NE,Nov-17,256,243,13,5.1
CN3100900000000,31,009,Blaine County, NE,Dec-17,255,243,12,4.7
CN3100900000000,31,009,Blaine County, NE,Jan-18,260,248,12,4.6
CN3100900000000,31,009,Blaine County, NE,Feb-18,242,232,10,4.1
CN3100900000000,31,009,Blaine County, NE,Mar-18,263,250,13,4.9
CN3100900000000,31,009,Blaine County, NE,Apr-18(p),266,256,10,3.8
CN0505900000000,05,059,Hot Spring County, AR,Mar-17,14197,13722,475,3.3
CN0505900000000,05,059,Hot Spring County, AR,Apr-17,14248,13817,431,3.0
CN0505900000000,05,059,Hot Spring County, AR,May-17,14148,13646,502,3.5
CN0505900000000,05,059,Hot Spring County, AR,Jun-17,14491,13899,592,4.1
CN0505900000000,05,059,Hot Spring County, AR,Jul-17,14404,13779,625,4.3
CN0505900000000,05,059,Hot Spring County, AR,Aug-17,14110,13546,564,4.0
CN0505900000000,05,059,Hot Spring County, AR,Sep-17,14175,13640,535,3.8
CN0505900000000,05,059,Hot Spring County, AR,Oct-17,14217,13747,470,3.3
CN0505900000000,05,059,Hot Spring County, AR,Nov-17,14143,13680,463,3.3
CN0505900000000,05,059,Hot Spring County, AR,Dec-17,14088,13599,489,3.5
CN0505900000000,05,059,Hot Spring County, AR,Jan-18,14023,13426,597,4.3
CN0505900000000,05,059,Hot Spring County, AR,Feb-18,14028,13450,578,4.1
CN0505900000000,05,059,Hot Spring County, AR,Mar-18,14131,13603,528,3.7
CN0505900000000,05,059,Hot Spring County, AR,Apr-18(p),14160,13664,496,3.5
CN2711100000000,27,111,Otter Tail County, MN,Mar-17,31376,29614,1762,5.6
CN2711100000000,27,111,Otter Tail County, MN,Apr-17,31457,30209,1248,4.0
CN2711100000000,27,111,Otter Tail County, MN,May-17,31951,30977,974,3.0
CN2711100000000,27,111,Otter Tail County, MN,Jun-17,32711,31676,1035,3.2
CN2711100000000,27,111,Otter Tail County, MN,Jul-17,32481,31530,951,2.9
CN2711100000000,27,111,Otter Tail County, MN,Aug-17,31871,30921,950,3.0
CN2711100000000,27,111,Otter Tail County, MN,Sep-17,31258,30455,803,2.6
CN2711100000000,27,111,Otter Tail County, MN,Oct-17,31550,30858,692,2.2
CN2711100000000,27,111,Otter Tail County, MN,Nov-17,31830,30709,1121,3.5
CN2711100000000,27,111,Otter Tail County, MN,Dec-17,32153,30597,1556,4.8
CN2711100000000,27,111,Otter Tail County, MN,Jan-18,32067,30175,1892,5.9
CN2711100000000,27,111,Otter Tail County, MN,Feb-18,32065,30308,1757,5.5
CN2711100000000,27,111,Otter Tail County, MN,Mar-18,32217,30539,1678,5.2
CN2711100000000,27,111,Otter Tail County, MN,Apr-18(p),32529,31234,1295,4.0
CN4505900000000,45,059,Laurens County, SC,Mar-17,29992,28787,1205,4.0
CN4505900000000,45,059,Laurens County, SC,Apr-17,29985,28856,1129,3.8
CN4505900000000,45,059,Laurens County, SC,May-17,30088,28934,1154,3.8
CN4505900000000,45,059,Laurens County, SC,Jun-17,30365,29022,1343,4.4
CN4505900000000,45,059,Laurens County, SC,Jul-17,30513,28964,1549,5.1
CN4505900000000,45,059,Laurens County, SC,Aug-17,30310,28874,1436,4.7
CN4505900000000,45,059,Laurens County, SC,Sep-17,30350,29005,1345,4.4
CN4505900000000,45,059,Laurens County, SC,Oct-17,30376,29014,1362,4.5
CN4505900000000,45,059,Laurens County, SC,Nov-17,30160,28936,1224,4.1
CN4505900000000,45,059,Laurens County, SC,Dec-17,30242,28941,1301,4.3
CN4505900000000,45,059,Laurens County, SC,Jan-18,30431,28853,1578,5.2
CN4505900000000,45,059,Laurens County, SC,Feb-18,30481,29014,1467,4.8
CN4505900000000,45,059,Laurens County, SC,Mar-18,30474,29176,1298,4.3
CN4505900000000,45,059,Laurens County, SC,Apr-18(p),29990,29088,902,3.0
CN2922500000000,29,225,Webster County, MO,Mar-17,16781,16078,703,4.2
CN2922500000000,29,225,Webster County, MO,Apr-17,16965,16342,623,3.7
CN2922500000000,29,225,Webster County, MO,May-17,16822,16178,644,3.8
CN2922500000000,29,225,Webster County, MO,Jun-17,16899,16220,679,4.0
CN2922500000000,29,225,Webster County, MO,Jul-17,16956,16244,712,4.2
CN2922500000000,29,225,Webster County, MO,Aug-17,16653,15889,764,4.6
CN2922500000000,29,225,Webster County, MO,Sep-17,16765,16189,576,3.4
CN2922500000000,29,225,Webster County, MO,Oct-17,16611,16207,404,2.4
CN2922500000000,29,225,Webster County, MO,Nov-17,16690,16131,559,3.3
CN2922500000000,29,225,Webster County, MO,Dec-17,16639,16107,532,3.2
CN2922500000000,29,225,Webster County, MO,Jan-18,16600,15971,629,3.8
CN2922500000000,29,225,Webster County, MO,Feb-18,16792,16164,628,3.7
CN2922500000000,29,225,Webster County, MO,Mar-18,16736,16111,625,3.7
CN2922500000000,29,225,Webster County, MO,Apr-18(p),16818,16272,546,3.2
CN3600700000000,36,007,Broome County, NY,Mar-17,86679,81710,4969,5.7
CN3600700000000,36,007,Broome County, NY,Apr-17,86388,81753,4635,5.4
CN3600700000000,36,007,Broome County, NY,May-17,86801,82294,4507,5.2
CN3600700000000,36,007,Broome County, NY,Jun-17,87250,82335,4915,5.6
CN3600700000000,36,007,Broome County, NY,Jul-17,85845,81008,4837,5.6
CN3600700000000,36,007,Broome County, NY,Aug-17,85104,80533,4571,5.4
CN3600700000000,36,007,Broome County, NY,Sep-17,85915,81424,4491,5.2
CN3600700000000,36,007,Broome County, NY,Oct-17,85296,81022,4274,5.0
CN3600700000000,36,007,Broome County, NY,Nov-17,84789,80187,4602,5.4
CN3600700000000,36,007,Broome County, NY,Dec-17,84307,79565,4742,5.6
CN3600700000000,36,007,Broome County, NY,Jan-18,84846,79066,5780,6.8
CN3600700000000,36,007,Broome County, NY,Feb-18,84761,78866,5895,7.0
CN3600700000000,36,007,Broome County, NY,Mar-18,84465,79148,5317,6.3
CN3600700000000,36,007,Broome County, NY,Apr-18(p),84290,79637,4653,5.5
CN1912100000000,19,121,Madison County, IA,Mar-17,8288,7918,370,4.5
CN1912100000000,19,121,Madison County, IA,Apr-17,8280,7983,297,3.6
CN1912100000000,19,121,Madison County, IA,May-17,8287,8010,277,3.3
CN1912100000000,19,121,Madison County, IA,Jun-17,8421,8111,310,3.7
CN1912100000000,19,121,Madison County, IA,Jul-17,8485,8216,269,3.2
CN1912100000000,19,121,Madison County, IA,Aug-17,8382,8102,280,3.3
CN1912100000000,19,121,Madison County, IA,Sep-17,8236,8001,235,2.9
CN1912100000000,19,121,Madison County, IA,Oct-17,8245,8049,196,2.4
CN1912100000000,19,121,Madison County, IA,Nov-17,8245,8037,208,2.5
CN1912100000000,19,121,Madison County, IA,Dec-17,8210,7986,224,2.7
CN1912100000000,19,121,Madison County, IA,Jan-18,8294,7901,393,4.7
CN1912100000000,19,121,Madison County, IA,Feb-18,8359,7943,416,5.0
CN1912100000000,19,121,Madison County, IA,Mar-18,8284,7936,348,4.2
CN1912100000000,19,121,Madison County, IA,Apr-18(p),8268,8022,246,3.0
CN2913500000000,29,135,Moniteau County, MO,Mar-17,7472,7170,302,4.0
CN2913500000000,29,135,Moniteau County, MO,Apr-17,7593,7328,265,3.5
CN2913500000000,29,135,Moniteau County, MO,May-17,7487,7233,254,3.4
CN2913500000000,29,135,Moniteau County, MO,Jun-17,7420,7148,272,3.7
CN2913500000000,29,135,Moniteau County, MO,Jul-17,7430,7135,295,4.0
CN2913500000000,29,135,Moniteau County, MO,Aug-17,7292,6991,301,4.1
CN2913500000000,29,135,Moniteau County, MO,Sep-17,7204,6983,221,3.1
CN2913500000000,29,135,Moniteau County, MO,Oct-17,7246,7092,154,2.1
CN2913500000000,29,135,Moniteau County, MO,Nov-17,7271,7058,213,2.9
CN2913500000000,29,135,Moniteau County, MO,Dec-17,7149,6920,229,3.2
CN2913500000000,29,135,Moniteau County, MO,Jan-18,7205,6911,294,4.1
CN2913500000000,29,135,Moniteau County, MO,Feb-18,7300,7012,288,3.9
CN2913500000000,29,135,Moniteau County, MO,Mar-18,7301,7043,258,3.5
CN2913500000000,29,135,Moniteau County, MO,Apr-18(p),7383,7166,217,2.9
CN1717500000000,17,175,Stark County, IL,Mar-17,2676,2486,190,7.1
CN1717500000000,17,175,Stark County, IL,Apr-17,2739,2580,159,5.8
CN1717500000000,17,175,Stark County, IL,May-17,2738,2594,144,5.3
CN1717500000000,17,175,Stark County, IL,Jun-17,2771,2627,144,5.2
CN1717500000000,17,175,Stark County, IL,Jul-17,2720,2569,151,5.6
CN1717500000000,17,175,Stark County, IL,Aug-17,2705,2553,152,5.6
CN1717500000000,17,175,Stark County, IL,Sep-17,2654,2522,132,5.0
CN1717500000000,17,175,Stark County, IL,Oct-17,2636,2521,115,4.4
CN1717500000000,17,175,Stark County, IL,Nov-17,2628,2497,131,5.0
CN1717500000000,17,175,Stark County, IL,Dec-17,2598,2444,154,5.9
CN1717500000000,17,175,Stark County, IL,Jan-18,2605,2418,187,7.2
CN1717500000000,17,175,Stark County, IL,Feb-18,2627,2448,179,6.8
CN1717500000000,17,175,Stark County, IL,Mar-18,2709,2527,182,6.7
CN1717500000000,17,175,Stark County, IL,Apr-18(p),2712,2573,139,5.1
CN4806100000000,48,061,Cameron County, TX,Mar-17,167576,155593,11983,7.2
CN4806100000000,48,061,Cameron County, TX,Apr-17,167672,156245,11427,6.8
CN4806100000000,48,061,Cameron County, TX,May-17,166389,155466,10923,6.6
CN4806100000000,48,061,Cameron County, TX,Jun-17,168018,155471,12547,7.5
CN4806100000000,48,061,Cameron County, TX,Jul-17,167165,155072,12093,7.2
CN4806100000000,48,061,Cameron County, TX,Aug-17,166593,154536,12057,7.2
CN4806100000000,48,061,Cameron County, TX,Sep-17,165654,155090,10564,6.4
CN4806100000000,48,061,Cameron County, TX,Oct-17,163623,154213,9410,5.8
CN4806100000000,48,061,Cameron County, TX,Nov-17,164128,154402,9726,5.9
CN4806100000000,48,061,Cameron County, TX,Dec-17,164111,154368,9743,5.9
CN4806100000000,48,061,Cameron County, TX,Jan-18,165433,154144,11289,6.8
CN4806100000000,48,061,Cameron County, TX,Feb-18,166905,155783,11122,6.7
CN4806100000000,48,061,Cameron County, TX,Mar-18,168356,157395,10961,6.5
CN4806100000000,48,061,Cameron County, TX,Apr-18(p),168206,157744,10462,6.2
CN5168500000000,51,685,Manassas Park city, VA,Mar-17,8639,8333,306,3.5
CN5168500000000,51,685,Manassas Park city, VA,Apr-17,8617,8345,272,3.2
CN5168500000000,51,685,Manassas Park city, VA,May-17,8666,8380,286,3.3
CN5168500000000,51,685,Manassas Park city, VA,Jun-17,8723,8425,298,3.4
CN5168500000000,51,685,Manassas Park city, VA,Jul-17,8763,8463,300,3.4
CN5168500000000,51,685,Manassas Park city, VA,Aug-17,8636,8338,298,3.5
CN5168500000000,51,685,Manassas Park city, VA,Sep-17,8637,8366,271,3.1
CN5168500000000,51,685,Manassas Park city, VA,Oct-17,8612,8361,251,2.9
CN5168500000000,51,685,Manassas Park city, VA,Nov-17,8638,8382,256,3.0
CN5168500000000,51,685,Manassas Park city, VA,Dec-17,8633,8370,263,3.0
CN5168500000000,51,685,Manassas Park city, VA,Jan-18,8719,8410,309,3.5
CN5168500000000,51,685,Manassas Park city, VA,Feb-18,8785,8508,277,3.2
CN5168500000000,51,685,Manassas Park city, VA,Mar-18,8819,8542,277,3.1
CN5168500000000,51,685,Manassas Park city, VA,Apr-18(p),8773,8552,221,2.5
CN0806100000000,08,061,Kiowa County, CO,Mar-17,869,856,13,1.5
CN0806100000000,08,061,Kiowa County, CO,Apr-17,931,915,16,1.7
CN0806100000000,08,061,Kiowa County, CO,May-17,952,935,17,1.8
CN0806100000000,08,061,Kiowa County, CO,Jun-17,912,892,20,2.2
CN0806100000000,08,061,Kiowa County, CO,Jul-17,946,926,20,2.1
CN0806100000000,08,061,Kiowa County, CO,Aug-17,943,926,17,1.8
CN0806100000000,08,061,Kiowa County, CO,Sep-17,938,920,18,1.9
CN0806100000000,08,061,Kiowa County, CO,Oct-17,1023,1004,19,1.9
CN0806100000000,08,061,Kiowa County, CO,Nov-17,1007,989,18,1.8
CN0806100000000,08,061,Kiowa County, CO,Dec-17,1000,983,17,1.7
CN0806100000000,08,061,Kiowa County, CO,Jan-18,967,949,18,1.9
CN0806100000000,08,061,Kiowa County, CO,Feb-18,927,911,16,1.7
CN0806100000000,08,061,Kiowa County, CO,Mar-18,928,913,15,1.6
CN0806100000000,08,061,Kiowa County, CO,Apr-18(p),973,960,13,1.3
CN4837500000000,48,375,Potter County, TX,Mar-17,56116,54185,1931,3.4
CN4837500000000,48,375,Potter County, TX,Apr-17,56225,54553,1672,3.0
CN4837500000000,48,375,Potter County, TX,May-17,55946,54219,1727,3.1
CN4837500000000,48,375,Potter County, TX,Jun-17,55815,53874,1941,3.5
CN4837500000000,48,375,Potter County, TX,Jul-17,55655,53686,1969,3.5
CN4837500000000,48,375,Potter County, TX,Aug-17,55374,53504,1870,3.4
CN4837500000000,48,375,Potter County, TX,Sep-17,55886,54222,1664,3.0
CN4837500000000,48,375,Potter County, TX,Oct-17,55827,54289,1538,2.8
CN4837500000000,48,375,Potter County, TX,Nov-17,56212,54621,1591,2.8
CN4837500000000,48,375,Potter County, TX,Dec-17,56197,54694,1503,2.7
CN4837500000000,48,375,Potter County, TX,Jan-18,56075,54374,1701,3.0
CN4837500000000,48,375,Potter County, TX,Feb-18,56788,55053,1735,3.1
CN4837500000000,48,375,Potter County, TX,Mar-18,56946,55107,1839,3.2
CN4837500000000,48,375,Potter County, TX,Apr-18(p),57196,55643,1553,2.7
CN2301900000000,23,019,Penobscot County, ME,Mar-17,76980,73768,3212,4.2
CN2301900000000,23,019,Penobscot County, ME,Apr-17,77668,74609,3059,3.9
CN2301900000000,23,019,Penobscot County, ME,May-17,77082,73982,3100,4.0
CN2301900000000,23,019,Penobscot County, ME,Jun-17,77473,74440,3033,3.9
CN2301900000000,23,019,Penobscot County, ME,Jul-17,77457,74380,3077,4.0
CN2301900000000,23,019,Penobscot County, ME,Aug-17,76798,74240,2558,3.3
CN2301900000000,23,019,Penobscot County, ME,Sep-17,77300,74838,2462,3.2
CN2301900000000,23,019,Penobscot County, ME,Oct-17,77718,75243,2475,3.2
CN2301900000000,23,019,Penobscot County, ME,Nov-17,76839,74385,2454,3.2
CN2301900000000,23,019,Penobscot County, ME,Dec-17,76400,74198,2202,2.9
CN2301900000000,23,019,Penobscot County, ME,Jan-18,75336,72616,2720,3.6
CN2301900000000,23,019,Penobscot County, ME,Feb-18,76418,73683,2735,3.6
CN2301900000000,23,019,Penobscot County, ME,Mar-18,76451,73875,2576,3.4
CN2301900000000,23,019,Penobscot County, ME,Apr-18(p),77451,74820,2631,3.4
CN7206500000000,72,065,Hatillo Municipio, PR,Mar-17,13494,11309,2185,16.2
CN7206500000000,72,065,Hatillo Municipio, PR,Apr-17,13278,11146,2132,16.1
CN7206500000000,72,065,Hatillo Municipio, PR,May-17,13043,11295,1748,13.4
CN7206500000000,72,065,Hatillo Municipio, PR,Jun-17,12715,11293,1422,11.2
CN7206500000000,72,065,Hatillo Municipio, PR,Jul-17,12874,11419,1455,11.3
CN7206500000000,72,065,Hatillo Municipio, PR,Aug-17,12875,11308,1567,12.2
CN7206500000000,72,065,Hatillo Municipio, PR,Sep-17(y),12751,11252,1499,11.8
CN7206500000000,72,065,Hatillo Municipio, PR,Oct-17,12413,10796,1617,13.0
CN7206500000000,72,065,Hatillo Municipio, PR,Nov-17,13384,11470,1914,14.3
CN7206500000000,72,065,Hatillo Municipio, PR,Dec-17,13445,11508,1937,14.4
CN7206500000000,72,065,Hatillo Municipio, PR,Jan-18,13312,11224,2088,15.7
CN7206500000000,72,065,Hatillo Municipio, PR,Feb-18,13090,11126,1964,15.0
CN7206500000000,72,065,Hatillo Municipio, PR,Mar-18,13105,11170,1935,14.8
CN7206500000000,72,065,Hatillo Municipio, PR,Apr-18(p),13087,11307,1780,13.6
CN4834700000000,48,347,Nacogdoches County, TX,Mar-17,28748,27446,1302,4.5
CN4834700000000,48,347,Nacogdoches County, TX,Apr-17,28799,27635,1164,4.0
CN4834700000000,48,347,Nacogdoches County, TX,May-17,28812,27637,1175,4.1
CN4834700000000,48,347,Nacogdoches County, TX,Jun-17,28664,27312,1352,4.7
CN4834700000000,48,347,Nacogdoches County, TX,Jul-17,28372,27046,1326,4.7
CN4834700000000,48,347,Nacogdoches County, TX,Aug-17,28283,26969,1314,4.6
CN4834700000000,48,347,Nacogdoches County, TX,Sep-17,28525,27432,1093,3.8
CN4834700000000,48,347,Nacogdoches County, TX,Oct-17,28311,27313,998,3.5
CN4834700000000,48,347,Nacogdoches County, TX,Nov-17,28342,27300,1042,3.7
CN4834700000000,48,347,Nacogdoches County, TX,Dec-17,28391,27388,1003,3.5
CN4834700000000,48,347,Nacogdoches County, TX,Jan-18,28473,27295,1178,4.1
CN4834700000000,48,347,Nacogdoches County, TX,Feb-18,28738,27588,1150,4.0
CN4834700000000,48,347,Nacogdoches County, TX,Mar-18,28867,27687,1180,4.1
CN4834700000000,48,347,Nacogdoches County, TX,Apr-18(p),28708,27668,1040,3.6
CN3010900000000,30,109,Wibaux County, MT,Mar-17,471,455,16,3.4
CN3010900000000,30,109,Wibaux County, MT,Apr-17,502,486,16,3.2
CN3010900000000,30,109,Wibaux County, MT,May-17,527,511,16,3.0
CN3010900000000,30,109,Wibaux County, MT,Jun-17,512,492,20,3.9
CN3010900000000,30,109,Wibaux County, MT,Jul-17,524,505,19,3.6
CN3010900000000,30,109,Wibaux County, MT,Aug-17,498,481,17,3.4
CN3010900000000,30,109,Wibaux County, MT,Sep-17,482,466,16,3.3
CN3010900000000,30,109,Wibaux County, MT,Oct-17,486,468,18,3.7
CN3010900000000,30,109,Wibaux County, MT,Nov-17,472,456,16,3.4
CN3010900000000,30,109,Wibaux County, MT,Dec-17,465,450,15,3.2
CN3010900000000,30,109,Wibaux County, MT,Jan-18,455,438,17,3.7
CN3010900000000,30,109,Wibaux County, MT,Feb-18,452,435,17,3.8
CN3010900000000,30,109,Wibaux County, MT,Mar-18,445,427,18,4.0
CN3010900000000,30,109,Wibaux County, MT,Apr-18(p),457,440,17,3.7
CN0108900000000,01,089,Madison County, AL,Mar-17,175746,167927,7819,4.4
CN0108900000000,01,089,Madison County, AL,Apr-17,175537,169227,6310,3.6
CN0108900000000,01,089,Madison County, AL,May-17,174807,168641,6166,3.5
CN0108900000000,01,089,Madison County, AL,Jun-17,176216,168622,7594,4.3
CN0108900000000,01,089,Madison County, AL,Jul-17,174922,167924,6998,4.0
CN0108900000000,01,089,Madison County, AL,Aug-17,173969,167412,6557,3.8
CN0108900000000,01,089,Madison County, AL,Sep-17,174631,168969,5662,3.2
CN0108900000000,01,089,Madison County, AL,Oct-17,175239,169650,5589,3.2
CN0108900000000,01,089,Madison County, AL,Nov-17,176332,171036,5296,3.0
CN0108900000000,01,089,Madison County, AL,Dec-17,175240,170147,5093,2.9
CN0108900000000,01,089,Madison County, AL,Jan-18,174373,168142,6231,3.6
CN0108900000000,01,089,Madison County, AL,Feb-18,178059,171544,6515,3.7
CN0108900000000,01,089,Madison County, AL,Mar-18,178401,172419,5982,3.4
CN0108900000000,01,089,Madison County, AL,Apr-18(p),179926,174464,5462,3.0
CN3001900000000,30,019,Daniels County, MT,Mar-17,895,874,21,2.3
CN3001900000000,30,019,Daniels County, MT,Apr-17,922,906,16,1.7
CN3001900000000,30,019,Daniels County, MT,May-17,952,936,16,1.7
CN3001900000000,30,019,Daniels County, MT,Jun-17,914,895,19,2.1
CN3001900000000,30,019,Daniels County, MT,Jul-17,951,932,19,2.0
CN3001900000000,30,019,Daniels County, MT,Aug-17,917,895,22,2.4
CN3001900000000,30,019,Daniels County, MT,Sep-17,900,881,19,2.1
CN3001900000000,30,019,Daniels County, MT,Oct-17,906,887,19,2.1
CN3001900000000,30,019,Daniels County, MT,Nov-17,905,883,22,2.4
CN3001900000000,30,019,Daniels County, MT,Dec-17,895,868,27,3.0
CN3001900000000,30,019,Daniels County, MT,Jan-18,896,870,26,2.9
CN3001900000000,30,019,Daniels County, MT,Feb-18,885,862,23,2.6
CN3001900000000,30,019,Daniels County, MT,Mar-18,879,857,22,2.5
CN3001900000000,30,019,Daniels County, MT,Apr-18(p),886,870,16,1.8
CN0806700000000,08,067,La Plata County, CO,Mar-17,30606,29818,788,2.6
CN0806700000000,08,067,La Plata County, CO,Apr-17,31370,30659,711,2.3
CN0806700000000,08,067,La Plata County, CO,May-17,31548,30855,693,2.2
CN0806700000000,08,067,La Plata County, CO,Jun-17,32174,31383,791,2.5
CN0806700000000,08,067,La Plata County, CO,Jul-17,32403,31660,743,2.3
CN0806700000000,08,067,La Plata County, CO,Aug-17,32118,31370,748,2.3
CN0806700000000,08,067,La Plata County, CO,Sep-17,32019,31300,719,2.2
CN0806700000000,08,067,La Plata County, CO,Oct-17,32730,31988,742,2.3
CN0806700000000,08,067,La Plata County, CO,Nov-17,32382,31625,757,2.3
CN0806700000000,08,067,La Plata County, CO,Dec-17,31928,31133,795,2.5
CN0806700000000,08,067,La Plata County, CO,Jan-18,31317,30335,982,3.1
CN0806700000000,08,067,La Plata County, CO,Feb-18,31289,30229,1060,3.4
CN0806700000000,08,067,La Plata County, CO,Mar-18,31286,30381,905,2.9
CN0806700000000,08,067,La Plata County, CO,Apr-18(p),32039,31297,742,2.3
CN0604300000000,06,043,Mariposa County, CA,Mar-17,7165,6604,561,7.8
CN0604300000000,06,043,Mariposa County, CA,Apr-17,7525,7061,464,6.2
CN0604300000000,06,043,Mariposa County, CA,May-17,7778,7377,401,5.2
CN0604300000000,06,043,Mariposa County, CA,Jun-17,8230,7824,406,4.9
CN0604300000000,06,043,Mariposa County, CA,Jul-17,8383,7970,413,4.9
CN0604300000000,06,043,Mariposa County, CA,Aug-17,8360,7962,398,4.8
CN0604300000000,06,043,Mariposa County, CA,Sep-17,8186,7846,340,4.2
CN0604300000000,06,043,Mariposa County, CA,Oct-17,7649,7288,361,4.7
CN0604300000000,06,043,Mariposa County, CA,Nov-17,7218,6823,395,5.5
CN0604300000000,06,043,Mariposa County, CA,Dec-17,7152,6699,453,6.3
CN0604300000000,06,043,Mariposa County, CA,Jan-18,7011,6515,496,7.1
CN0604300000000,06,043,Mariposa County, CA,Feb-18,7074,6543,531,7.5
CN0604300000000,06,043,Mariposa County, CA,Mar-18,7057,6562,495,7.0
CN0604300000000,06,043,Mariposa County, CA,Apr-18(p),7281,6884,397,5.5
CN3904300000000,39,043,Erie County, OH,Mar-17,36625,33988,2637,7.2
CN3904300000000,39,043,Erie County, OH,Apr-17,36798,34578,2220,6.0
CN3904300000000,39,043,Erie County, OH,May-17,38218,36263,1955,5.1
CN3904300000000,39,043,Erie County, OH,Jun-17,40587,38421,2166,5.3
CN3904300000000,39,043,Erie County, OH,Jul-17,40789,38167,2622,6.4
CN3904300000000,39,043,Erie County, OH,Aug-17,40516,38299,2217,5.5
CN3904300000000,39,043,Erie County, OH,Sep-17,38743,36433,2310,6.0
CN3904300000000,39,043,Erie County, OH,Oct-17,37931,35754,2177,5.7
CN3904300000000,39,043,Erie County, OH,Nov-17,36514,34442,2072,5.7
CN3904300000000,39,043,Erie County, OH,Dec-17,36009,33771,2238,6.2
CN3904300000000,39,043,Erie County, OH,Jan-18,35391,32774,2617,7.4
CN3904300000000,39,043,Erie County, OH,Feb-18,36364,34074,2290,6.3
CN3904300000000,39,043,Erie County, OH,Mar-18,36814,34709,2105,5.7
CN3904300000000,39,043,Erie County, OH,Apr-18(p),37102,35179,1923,5.2
CN3100300000000,31,003,Antelope County, NE,Mar-17,3433,3327,106,3.1
CN3100300000000,31,003,Antelope County, NE,Apr-17,3573,3492,81,2.3
CN3100300000000,31,003,Antelope County, NE,May-17,3654,3578,76,2.1
CN3100300000000,31,003,Antelope County, NE,Jun-17,3849,3760,89,2.3
CN3100300000000,31,003,Antelope County, NE,Jul-17,3723,3634,89,2.4
CN3100300000000,31,003,Antelope County, NE,Aug-17,3600,3516,84,2.3
CN3100300000000,31,003,Antelope County, NE,Sep-17,3432,3359,73,2.1
CN3100300000000,31,003,Antelope County, NE,Oct-17,3461,3389,72,2.1
CN3100300000000,31,003,Antelope County, NE,Nov-17,3465,3390,75,2.2
CN3100300000000,31,003,Antelope County, NE,Dec-17,3441,3355,86,2.5
CN3100300000000,31,003,Antelope County, NE,Jan-18,3512,3417,95,2.7
CN3100300000000,31,003,Antelope County, NE,Feb-18,3405,3307,98,2.9
CN3100300000000,31,003,Antelope County, NE,Mar-18,3484,3385,99,2.8
CN3100300000000,31,003,Antelope County, NE,Apr-18(p),3514,3423,91,2.6
CN4207300000000,42,073,Lawrence County, PA,Mar-17,40865,37935,2930,7.2
CN4207300000000,42,073,Lawrence County, PA,Apr-17,40618,38358,2260,5.6
CN4207300000000,42,073,Lawrence County, PA,May-17,40686,38343,2343,5.8
CN4207300000000,42,073,Lawrence County, PA,Jun-17,40911,38542,2369,5.8
CN4207300000000,42,073,Lawrence County, PA,Jul-17,40909,38431,2478,6.1
CN4207300000000,42,073,Lawrence County, PA,Aug-17,40597,38176,2421,6.0
CN4207300000000,42,073,Lawrence County, PA,Sep-17,40438,38411,2027,5.0
CN4207300000000,42,073,Lawrence County, PA,Oct-17,40251,38267,1984,4.9
CN4207300000000,42,073,Lawrence County, PA,Nov-17,40244,38124,2120,5.3
CN4207300000000,42,073,Lawrence County, PA,Dec-17,40087,37761,2326,5.8
CN4207300000000,42,073,Lawrence County, PA,Jan-18,40258,37269,2989,7.4
CN4207300000000,42,073,Lawrence County, PA,Feb-18,40039,37160,2879,7.2
CN4207300000000,42,073,Lawrence County, PA,Mar-18,39590,37083,2507,6.3
CN4207300000000,42,073,Lawrence County, PA,Apr-18(p),39591,37567,2024,5.1
CN3709700000000,37,097,Iredell County, NC,Mar-17,86566,82931,3635,4.2
CN3709700000000,37,097,Iredell County, NC,Apr-17,86340,83068,3272,3.8
CN3709700000000,37,097,Iredell County, NC,May-17,86801,83346,3455,4.0
CN3709700000000,37,097,Iredell County, NC,Jun-17,87150,83472,3678,4.2
CN3709700000000,37,097,Iredell County, NC,Jul-17,87806,83908,3898,4.4
CN3709700000000,37,097,Iredell County, NC,Aug-17,87000,83090,3910,4.5
CN3709700000000,37,097,Iredell County, NC,Sep-17,88025,84514,3511,4.0
CN3709700000000,37,097,Iredell County, NC,Oct-17,88254,84732,3522,4.0
CN3709700000000,37,097,Iredell County, NC,Nov-17,88047,84347,3700,4.2
CN3709700000000,37,097,Iredell County, NC,Dec-17,87802,84226,3576,4.1
CN3709700000000,37,097,Iredell County, NC,Jan-18,87818,83974,3844,4.4
CN3709700000000,37,097,Iredell County, NC,Feb-18,88264,84558,3706,4.2
CN3709700000000,37,097,Iredell County, NC,Mar-18,88859,85364,3495,3.9
CN3709700000000,37,097,Iredell County, NC,Apr-18(p),88452,85462,2990,3.4
CN4700500000000,47,005,Benton County, TN,Mar-17,6820,6434,386,5.7
CN4700500000000,47,005,Benton County, TN,Apr-17,6782,6461,321,4.7
CN4700500000000,47,005,Benton County, TN,May-17,6787,6474,313,4.6
CN4700500000000,47,005,Benton County, TN,Jun-17,6732,6338,394,5.9
CN4700500000000,47,005,Benton County, TN,Jul-17,6720,6346,374,5.6
CN4700500000000,47,005,Benton County, TN,Aug-17,6804,6456,348,5.1
CN4700500000000,47,005,Benton County, TN,Sep-17,6791,6478,313,4.6
CN4700500000000,47,005,Benton County, TN,Oct-17,6792,6469,323,4.8
CN4700500000000,47,005,Benton County, TN,Nov-17,6727,6404,323,4.8
CN4700500000000,47,005,Benton County, TN,Dec-17,6753,6414,339,5.0
CN4700500000000,47,005,Benton County, TN,Jan-18,6878,6437,441,6.4
CN4700500000000,47,005,Benton County, TN,Feb-18,6846,6460,386,5.6
CN4700500000000,47,005,Benton County, TN,Mar-18,6851,6519,332,4.8
CN4700500000000,47,005,Benton County, TN,Apr-18(p),6868,6580,288,4.2
CN4011700000000,40,117,Pawnee County, OK,Mar-17,7402,6995,407,5.5
CN4011700000000,40,117,Pawnee County, OK,Apr-17,7347,6985,362,4.9
CN4011700000000,40,117,Pawnee County, OK,May-17,7350,6961,389,5.3
CN4011700000000,40,117,Pawnee County, OK,Jun-17,7477,7054,423,5.7
CN4011700000000,40,117,Pawnee County, OK,Jul-17,7499,7108,391,5.2
CN4011700000000,40,117,Pawnee County, OK,Aug-17,7429,7031,398,5.4
CN4011700000000,40,117,Pawnee County, OK,Sep-17,7460,7084,376,5.0
CN4011700000000,40,117,Pawnee County, OK,Oct-17,7540,7162,378,5.0
CN4011700000000,40,117,Pawnee County, OK,Nov-17,7617,7237,380,5.0
CN4011700000000,40,117,Pawnee County, OK,Dec-17,7553,7169,384,5.1
CN4011700000000,40,117,Pawnee County, OK,Jan-18,7513,7075,438,5.8
CN4011700000000,40,117,Pawnee County, OK,Feb-18,7493,7116,377,5.0
CN4011700000000,40,117,Pawnee County, OK,Mar-18,7512,7146,366,4.9
CN4011700000000,40,117,Pawnee County, OK,Apr-18(p),7492,7148,344,4.6
CN1313300000000,13,133,Greene County, GA,Mar-17,6763,6405,358,5.3
CN1313300000000,13,133,Greene County, GA,Apr-17,6810,6483,327,4.8
CN1313300000000,13,133,Greene County, GA,May-17,6864,6526,338,4.9
CN1313300000000,13,133,Greene County, GA,Jun-17,6893,6539,354,5.1
CN1313300000000,13,133,Greene County, GA,Jul-17,6923,6553,370,5.3
CN1313300000000,13,133,Greene County, GA,Aug-17,6870,6496,374,5.4
CN1313300000000,13,133,Greene County, GA,Sep-17,6896,6561,335,4.9
CN1313300000000,13,133,Greene County, GA,Oct-17,6823,6488,335,4.9
CN1313300000000,13,133,Greene County, GA,Nov-17,6769,6467,302,4.5
CN1313300000000,13,133,Greene County, GA,Dec-17,6765,6459,306,4.5
CN1313300000000,13,133,Greene County, GA,Jan-18,6826,6495,331,4.8
CN1313300000000,13,133,Greene County, GA,Feb-18,6845,6511,334,4.9
CN1313300000000,13,133,Greene County, GA,Mar-18,6860,6558,302,4.4
CN1313300000000,13,133,Greene County, GA,Apr-18(p),6866,6596,270,3.9
CN4604300000000,46,043,Douglas County, SD,Mar-17,1637,1586,51,3.1
CN4604300000000,46,043,Douglas County, SD,Apr-17,1632,1582,50,3.1
CN4604300000000,46,043,Douglas County, SD,May-17,1651,1605,46,2.8
CN4604300000000,46,043,Douglas County, SD,Jun-17,1716,1672,44,2.6
CN4604300000000,46,043,Douglas County, SD,Jul-17,1666,1623,43,2.6
CN4604300000000,46,043,Douglas County, SD,Aug-17,1614,1563,51,3.2
CN4604300000000,46,043,Douglas County, SD,Sep-17,1586,1541,45,2.8
CN4604300000000,46,043,Douglas County, SD,Oct-17,1563,1521,42,2.7
CN4604300000000,46,043,Douglas County, SD,Nov-17,1547,1509,38,2.5
CN4604300000000,46,043,Douglas County, SD,Dec-17,1599,1553,46,2.9
CN4604300000000,46,043,Douglas County, SD,Jan-18,1601,1544,57,3.6
CN4604300000000,46,043,Douglas County, SD,Feb-18,1575,1518,57,3.6
CN4604300000000,46,043,Douglas County, SD,Mar-18,1609,1556,53,3.3
CN4604300000000,46,043,Douglas County, SD,Apr-18(p),1569,1519,50,3.2
CN4902900000000,49,029,Morgan County, UT,Mar-17,5279,5108,171,3.2
CN4902900000000,49,029,Morgan County, UT,Apr-17,5299,5142,157,3.0
CN4902900000000,49,029,Morgan County, UT,May-17,5330,5184,146,2.7
CN4902900000000,49,029,Morgan County, UT,Jun-17,5373,5197,176,3.3
CN4902900000000,49,029,Morgan County, UT,Jul-17,5410,5249,161,3.0
CN4902900000000,49,029,Morgan County, UT,Aug-17,5387,5223,164,3.0
CN4902900000000,49,029,Morgan County, UT,Sep-17,5355,5221,134,2.5
CN4902900000000,49,029,Morgan County, UT,Oct-17,5376,5236,140,2.6
CN4902900000000,49,029,Morgan County, UT,Nov-17,5357,5229,128,2.4
CN4902900000000,49,029,Morgan County, UT,Dec-17,5341,5203,138,2.6
CN4902900000000,49,029,Morgan County, UT,Jan-18,5315,5168,147,2.8
CN4902900000000,49,029,Morgan County, UT,Feb-18,5364,5204,160,3.0
CN4902900000000,49,029,Morgan County, UT,Mar-18,5381,5217,164,3.0
CN4902900000000,49,029,Morgan County, UT,Apr-18(p),5368,5227,141,2.6
CN1710300000000,17,103,Lee County, IL,Mar-17,17542,16736,806,4.6
CN1710300000000,17,103,Lee County, IL,Apr-17,17879,17209,670,3.7
CN1710300000000,17,103,Lee County, IL,May-17,17710,16983,727,4.1
CN1710300000000,17,103,Lee County, IL,Jun-17,17762,17008,754,4.2
CN1710300000000,17,103,Lee County, IL,Jul-17,18000,17218,782,4.3
CN1710300000000,17,103,Lee County, IL,Aug-17,17678,16942,736,4.2
CN1710300000000,17,103,Lee County, IL,Sep-17,17790,17162,628,3.5
CN1710300000000,17,103,Lee County, IL,Oct-17,17893,17282,611,3.4
CN1710300000000,17,103,Lee County, IL,Nov-17,17868,17214,654,3.7
CN1710300000000,17,103,Lee County, IL,Dec-17,17838,17107,731,4.1
CN1710300000000,17,103,Lee County, IL,Jan-18,17685,16881,804,4.5
CN1710300000000,17,103,Lee County, IL,Feb-18,17640,16909,731,4.1
CN1710300000000,17,103,Lee County, IL,Mar-18,17874,17133,741,4.1
CN1710300000000,17,103,Lee County, IL,Apr-18(p),18123,17514,609,3.4
CN3004100000000,30,041,Hill County, MT,Mar-17,7813,7494,319,4.1
CN3004100000000,30,041,Hill County, MT,Apr-17,7719,7449,270,3.5
CN3004100000000,30,041,Hill County, MT,May-17,7696,7451,245,3.2
CN3004100000000,30,041,Hill County, MT,Jun-17,7782,7464,318,4.1
CN3004100000000,30,041,Hill County, MT,Jul-17,7839,7532,307,3.9
CN3004100000000,30,041,Hill County, MT,Aug-17,7826,7514,312,4.0
CN3004100000000,30,041,Hill County, MT,Sep-17,7914,7645,269,3.4
CN3004100000000,30,041,Hill County, MT,Oct-17,7947,7660,287,3.6
CN3004100000000,30,041,Hill County, MT,Nov-17,7982,7685,297,3.7
CN3004100000000,30,041,Hill County, MT,Dec-17,7915,7630,285,3.6
CN3004100000000,30,041,Hill County, MT,Jan-18,7880,7566,314,4.0
CN3004100000000,30,041,Hill County, MT,Feb-18,7886,7569,317,4.0
CN3004100000000,30,041,Hill County, MT,Mar-18,7872,7561,311,4.0
CN3004100000000,30,041,Hill County, MT,Apr-18(p),7867,7602,265,3.4
CN4806700000000,48,067,Cass County, TX,Mar-17,12498,11673,825,6.6
CN4806700000000,48,067,Cass County, TX,Apr-17,12395,11631,764,6.2
CN4806700000000,48,067,Cass County, TX,May-17,12245,11526,719,5.9
CN4806700000000,48,067,Cass County, TX,Jun-17,12271,11543,728,5.9
CN4806700000000,48,067,Cass County, TX,Jul-17,12045,11344,701,5.8
CN4806700000000,48,067,Cass County, TX,Aug-17,12050,11346,704,5.8
CN4806700000000,48,067,Cass County, TX,Sep-17,12079,11468,611,5.1
CN4806700000000,48,067,Cass County, TX,Oct-17,12039,11454,585,4.9
CN4806700000000,48,067,Cass County, TX,Nov-17,12020,11399,621,5.2
CN4806700000000,48,067,Cass County, TX,Dec-17,12081,11468,613,5.1
CN4806700000000,48,067,Cass County, TX,Jan-18,12140,11451,689,5.7
CN4806700000000,48,067,Cass County, TX,Feb-18,12248,11575,673,5.5
CN4806700000000,48,067,Cass County, TX,Mar-18,12465,11805,660,5.3
CN4806700000000,48,067,Cass County, TX,Apr-18(p),12291,11685,606,4.9
CN1816500000000,18,165,Vermillion County, IN,Mar-17,7168,6759,409,5.7
CN1816500000000,18,165,Vermillion County, IN,Apr-17,7175,6832,343,4.8
CN1816500000000,18,165,Vermillion County, IN,May-17,7256,6907,349,4.8
CN1816500000000,18,165,Vermillion County, IN,Jun-17,7179,6823,356,5.0
CN1816500000000,18,165,Vermillion County, IN,Jul-17,7137,6744,393,5.5
CN1816500000000,18,165,Vermillion County, IN,Aug-17,7069,6664,405,5.7
CN1816500000000,18,165,Vermillion County, IN,Sep-17,7111,6744,367,5.2
CN1816500000000,18,165,Vermillion County, IN,Oct-17,7071,6735,336,4.8
CN1816500000000,18,165,Vermillion County, IN,Nov-17,7074,6750,324,4.6
CN1816500000000,18,165,Vermillion County, IN,Dec-17,7075,6726,349,4.9
CN1816500000000,18,165,Vermillion County, IN,Jan-18,7010,6576,434,6.2
CN1816500000000,18,165,Vermillion County, IN,Feb-18,7167,6698,469,6.5
CN1816500000000,18,165,Vermillion County, IN,Mar-18,7206,6804,402,5.6
CN1816500000000,18,165,Vermillion County, IN,Apr-18(p),7164,6822,342,4.8
CN1912700000000,19,127,Marshall County, IA,Mar-17,18455,17333,1122,6.1
CN1912700000000,19,127,Marshall County, IA,Apr-17,18279,17424,855,4.7
CN1912700000000,19,127,Marshall County, IA,May-17,18211,17509,702,3.9
CN1912700000000,19,127,Marshall County, IA,Jun-17,18358,17612,746,4.1
CN1912700000000,19,127,Marshall County, IA,Jul-17,18435,17775,660,3.6
CN1912700000000,19,127,Marshall County, IA,Aug-17,18178,17515,663,3.6
CN1912700000000,19,127,Marshall County, IA,Sep-17,17948,17342,606,3.4
CN1912700000000,19,127,Marshall County, IA,Oct-17,17971,17451,520,2.9
CN1912700000000,19,127,Marshall County, IA,Nov-17,17911,17303,608,3.4
CN1912700000000,19,127,Marshall County, IA,Dec-17,18104,17095,1009,5.6
CN1912700000000,19,127,Marshall County, IA,Jan-18,18141,16896,1245,6.9
CN1912700000000,19,127,Marshall County, IA,Feb-18,18191,17035,1156,6.4
CN1912700000000,19,127,Marshall County, IA,Mar-18,18103,17098,1005,5.6
CN1912700000000,19,127,Marshall County, IA,Apr-18(p),17872,17117,755,4.2
CN5118700000000,51,187,Warren County, VA,Mar-17,19996,19214,782,3.9
CN5118700000000,51,187,Warren County, VA,Apr-17,19971,19289,682,3.4
CN5118700000000,51,187,Warren County, VA,May-17,20050,19349,701,3.5
CN5118700000000,51,187,Warren County, VA,Jun-17,20231,19487,744,3.7
CN5118700000000,51,187,Warren County, VA,Jul-17,20365,19572,793,3.9
CN5118700000000,51,187,Warren County, VA,Aug-17,20016,19252,764,3.8
CN5118700000000,51,187,Warren County, VA,Sep-17,20041,19332,709,3.5
CN5118700000000,51,187,Warren County, VA,Oct-17,19962,19300,662,3.3
CN5118700000000,51,187,Warren County, VA,Nov-17,20015,19337,678,3.4
CN5118700000000,51,187,Warren County, VA,Dec-17,19990,19341,649,3.2
CN5118700000000,51,187,Warren County, VA,Jan-18,20135,19376,759,3.8
CN5118700000000,51,187,Warren County, VA,Feb-18,20312,19618,694,3.4
CN5118700000000,51,187,Warren County, VA,Mar-18,20356,19666,690,3.4
CN5118700000000,51,187,Warren County, VA,Apr-18(p),20313,19735,578,2.8
CN0110100000000,01,101,Montgomery County, AL,Mar-17,106277,101219,5058,4.8
CN0110100000000,01,101,Montgomery County, AL,Apr-17,105885,101704,4181,3.9
CN0110100000000,01,101,Montgomery County, AL,May-17,105662,101601,4061,3.8
CN0110100000000,01,101,Montgomery County, AL,Jun-17,106336,101350,4986,4.7
CN0110100000000,01,101,Montgomery County, AL,Jul-17,105427,100385,5042,4.8
CN0110100000000,01,101,Montgomery County, AL,Aug-17,104521,100107,4414,4.2
CN0110100000000,01,101,Montgomery County, AL,Sep-17,104536,100675,3861,3.7
CN0110100000000,01,101,Montgomery County, AL,Oct-17,105241,101432,3809,3.6
CN0110100000000,01,101,Montgomery County, AL,Nov-17,105290,101685,3605,3.4
CN0110100000000,01,101,Montgomery County, AL,Dec-17,104973,101452,3521,3.4
CN0110100000000,01,101,Montgomery County, AL,Jan-18,104222,100033,4189,4.0
CN0110100000000,01,101,Montgomery County, AL,Feb-18,105306,100885,4421,4.2
CN0110100000000,01,101,Montgomery County, AL,Mar-18,105319,101229,4090,3.9
CN0110100000000,01,101,Montgomery County, AL,Apr-18(p),105620,101858,3762,3.6
CN4905100000000,49,051,Wasatch County, UT,Mar-17,14618,14119,499,3.4
CN4905100000000,49,051,Wasatch County, UT,Apr-17,14192,13738,454,3.2
CN4905100000000,49,051,Wasatch County, UT,May-17,14157,13624,533,3.8
CN4905100000000,49,051,Wasatch County, UT,Jun-17,14705,14161,544,3.7
CN4905100000000,49,051,Wasatch County, UT,Jul-17,14947,14459,488,3.3
CN4905100000000,49,051,Wasatch County, UT,Aug-17,14948,14460,488,3.3
CN4905100000000,49,051,Wasatch County, UT,Sep-17,14681,14257,424,2.9
CN4905100000000,49,051,Wasatch County, UT,Oct-17,14528,14082,446,3.1
CN4905100000000,49,051,Wasatch County, UT,Nov-17,14497,14078,419,2.9
CN4905100000000,49,051,Wasatch County, UT,Dec-17,14955,14558,397,2.7
CN4905100000000,49,051,Wasatch County, UT,Jan-18,15217,14787,430,2.8
CN4905100000000,49,051,Wasatch County, UT,Feb-18,15404,14924,480,3.1
CN4905100000000,49,051,Wasatch County, UT,Mar-18,15312,14829,483,3.2
CN4905100000000,49,051,Wasatch County, UT,Apr-18(p),14865,14381,484,3.3
CN1903700000000,19,037,Chickasaw County, IA,Mar-17,6255,5986,269,4.3
CN1903700000000,19,037,Chickasaw County, IA,Apr-17,6383,6160,223,3.5
CN1903700000000,19,037,Chickasaw County, IA,May-17,6438,6258,180,2.8
CN1903700000000,19,037,Chickasaw County, IA,Jun-17,6605,6422,183,2.8
CN1903700000000,19,037,Chickasaw County, IA,Jul-17,6512,6333,179,2.7
CN1903700000000,19,037,Chickasaw County, IA,Aug-17,6415,6233,182,2.8
CN1903700000000,19,037,Chickasaw County, IA,Sep-17,6397,6244,153,2.4
CN1903700000000,19,037,Chickasaw County, IA,Oct-17,6490,6364,126,1.9
CN1903700000000,19,037,Chickasaw County, IA,Nov-17,6411,6271,140,2.2
CN1903700000000,19,037,Chickasaw County, IA,Dec-17,6388,6186,202,3.2
CN1903700000000,19,037,Chickasaw County, IA,Jan-18,6322,6048,274,4.3
CN1903700000000,19,037,Chickasaw County, IA,Feb-18,6319,6057,262,4.1
CN1903700000000,19,037,Chickasaw County, IA,Mar-18,6276,6040,236,3.8
CN1903700000000,19,037,Chickasaw County, IA,Apr-18(p),6323,6121,202,3.2
CN2606500000000,26,065,Ingham County, MI,Mar-17,151094,145002,6092,4.0
CN2606500000000,26,065,Ingham County, MI,Apr-17,151255,146129,5126,3.4
CN2606500000000,26,065,Ingham County, MI,May-17,152171,146308,5863,3.9
CN2606500000000,26,065,Ingham County, MI,Jun-17,149692,141971,7721,5.2
CN2606500000000,26,065,Ingham County, MI,Jul-17,148610,139855,8755,5.9
CN2606500000000,26,065,Ingham County, MI,Aug-17,147669,140039,7630,5.2
CN2606500000000,26,065,Ingham County, MI,Sep-17,150753,144175,6578,4.4
CN2606500000000,26,065,Ingham County, MI,Oct-17,151068,145054,6014,4.0
CN2606500000000,26,065,Ingham County, MI,Nov-17,152447,146500,5947,3.9
CN2606500000000,26,065,Ingham County, MI,Dec-17,150551,144498,6053,4.0
CN2606500000000,26,065,Ingham County, MI,Jan-18,150723,143054,7669,5.1
CN2606500000000,26,065,Ingham County, MI,Feb-18,152971,145975,6996,4.6
CN2606500000000,26,065,Ingham County, MI,Mar-18,152508,146437,6071,4.0
CN2606500000000,26,065,Ingham County, MI,Apr-18(p),153177,147655,5522,3.6
CN1208100000000,12,081,Manatee County, FL,Mar-17,176500,169699,6801,3.9
CN1208100000000,12,081,Manatee County, FL,Apr-17,174684,168334,6350,3.6
CN1208100000000,12,081,Manatee County, FL,May-17,175115,168593,6522,3.7
CN1208100000000,12,081,Manatee County, FL,Jun-17,174190,167179,7011,4.0
CN1208100000000,12,081,Manatee County, FL,Jul-17,174431,167227,7204,4.1
CN1208100000000,12,081,Manatee County, FL,Aug-17,174104,166910,7194,4.1
CN1208100000000,12,081,Manatee County, FL,Sep-17,175345,168705,6640,3.8
CN1208100000000,12,081,Manatee County, FL,Oct-17,174783,168504,6279,3.6
CN1208100000000,12,081,Manatee County, FL,Nov-17,176373,170097,6276,3.6
CN1208100000000,12,081,Manatee County, FL,Dec-17,175810,169979,5831,3.3
CN1208100000000,12,081,Manatee County, FL,Jan-18,176461,169723,6738,3.8
CN1208100000000,12,081,Manatee County, FL,Feb-18,178519,172316,6203,3.5
CN1208100000000,12,081,Manatee County, FL,Mar-18,178760,172735,6025,3.4
CN1208100000000,12,081,Manatee County, FL,Apr-18(p),177568,172065,5503,3.1
CN4707700000000,47,077,Henderson County, TN,Mar-17,11923,11230,693,5.8
CN4707700000000,47,077,Henderson County, TN,Apr-17,11918,11367,551,4.6
CN4707700000000,47,077,Henderson County, TN,May-17,11922,11398,524,4.4
CN4707700000000,47,077,Henderson County, TN,Jun-17,12019,11395,624,5.2
CN4707700000000,47,077,Henderson County, TN,Jul-17,11997,11404,593,4.9
CN4707700000000,47,077,Henderson County, TN,Aug-17,11946,11377,569,4.8
CN4707700000000,47,077,Henderson County, TN,Sep-17,11885,11378,507,4.3
CN4707700000000,47,077,Henderson County, TN,Oct-17,11807,11298,509,4.3
CN4707700000000,47,077,Henderson County, TN,Nov-17,11770,11275,495,4.2
CN4707700000000,47,077,Henderson County, TN,Dec-17,11845,11327,518,4.4
CN4707700000000,47,077,Henderson County, TN,Jan-18,11915,11255,660,5.5
CN4707700000000,47,077,Henderson County, TN,Feb-18,12048,11386,662,5.5
CN4707700000000,47,077,Henderson County, TN,Mar-18,11991,11409,582,4.9
CN4707700000000,47,077,Henderson County, TN,Apr-18(p),12058,11587,471,3.9
CN2612700000000,26,127,Oceana County, MI,Mar-17,12098,10978,1120,9.3
CN2612700000000,26,127,Oceana County, MI,Apr-17,12141,11293,848,7.0
CN2612700000000,26,127,Oceana County, MI,May-17,12244,11496,748,6.1
CN2612700000000,26,127,Oceana County, MI,Jun-17,12874,12115,759,5.9
CN2612700000000,26,127,Oceana County, MI,Jul-17,13291,12413,878,6.6
CN2612700000000,26,127,Oceana County, MI,Aug-17,12906,12141,765,5.9
CN2612700000000,26,127,Oceana County, MI,Sep-17,12707,12048,659,5.2
CN2612700000000,26,127,Oceana County, MI,Oct-17,12350,11741,609,4.9
CN2612700000000,26,127,Oceana County, MI,Nov-17,12023,11297,726,6.0
CN2612700000000,26,127,Oceana County, MI,Dec-17,12101,11154,947,7.8
CN2612700000000,26,127,Oceana County, MI,Jan-18,12006,10857,1149,9.6
CN2612700000000,26,127,Oceana County, MI,Feb-18,12298,11027,1271,10.3
CN2612700000000,26,127,Oceana County, MI,Mar-18,12209,11110,1099,9.0
CN2612700000000,26,127,Oceana County, MI,Apr-18(p),12236,11381,855,7.0
CN4002700000000,40,027,Cleveland County, OK,Mar-17,139481,134498,4983,3.6
CN4002700000000,40,027,Cleveland County, OK,Apr-17,139301,134805,4496,3.2
CN4002700000000,40,027,Cleveland County, OK,May-17,139424,134310,5114,3.7
CN4002700000000,40,027,Cleveland County, OK,Jun-17,141480,135813,5667,4.0
CN4002700000000,40,027,Cleveland County, OK,Jul-17,141778,136597,5181,3.7
CN4002700000000,40,027,Cleveland County, OK,Aug-17,140152,135116,5036,3.6
CN4002700000000,40,027,Cleveland County, OK,Sep-17,141765,136924,4841,3.4
CN4002700000000,40,027,Cleveland County, OK,Oct-17,141305,136841,4464,3.2
CN4002700000000,40,027,Cleveland County, OK,Nov-17,141478,137031,4447,3.1
CN4002700000000,40,027,Cleveland County, OK,Dec-17,140799,136371,4428,3.1
CN4002700000000,40,027,Cleveland County, OK,Jan-18,139897,134979,4918,3.5
CN4002700000000,40,027,Cleveland County, OK,Feb-18,142225,137444,4781,3.4
CN4002700000000,40,027,Cleveland County, OK,Mar-18,143401,138714,4687,3.3
CN4002700000000,40,027,Cleveland County, OK,Apr-18(p),143218,138635,4583,3.2
CN1909300000000,19,093,Ida County, IA,Mar-17,3929,3805,124,3.2
CN1909300000000,19,093,Ida County, IA,Apr-17,4002,3919,83,2.1
CN1909300000000,19,093,Ida County, IA,May-17,4037,3958,79,2.0
CN1909300000000,19,093,Ida County, IA,Jun-17,4118,4023,95,2.3
CN1909300000000,19,093,Ida County, IA,Jul-17,4137,4045,92,2.2
CN1909300000000,19,093,Ida County, IA,Aug-17,4056,3961,95,2.3
CN1909300000000,19,093,Ida County, IA,Sep-17,4040,3957,83,2.1
CN1909300000000,19,093,Ida County, IA,Oct-17,4096,4026,70,1.7
CN1909300000000,19,093,Ida County, IA,Nov-17,4021,3949,72,1.8
CN1909300000000,19,093,Ida County, IA,Dec-17,4025,3944,81,2.0
CN1909300000000,19,093,Ida County, IA,Jan-18,3993,3863,130,3.3
CN1909300000000,19,093,Ida County, IA,Feb-18,4003,3867,136,3.4
CN1909300000000,19,093,Ida County, IA,Mar-18,4002,3885,117,2.9
CN1909300000000,19,093,Ida County, IA,Apr-18(p),4002,3911,91,2.3
CN1915500000000,19,155,Pottawattamie County, IA,Mar-17,48103,46652,1451,3.0
CN1915500000000,19,155,Pottawattamie County, IA,Apr-17,47879,46562,1317,2.8
CN1915500000000,19,155,Pottawattamie County, IA,May-17,47814,46582,1232,2.6
CN1915500000000,19,155,Pottawattamie County, IA,Jun-17,48391,46978,1413,2.9
CN1915500000000,19,155,Pottawattamie County, IA,Jul-17,48662,47333,1329,2.7
CN1915500000000,19,155,Pottawattamie County, IA,Aug-17,48160,46777,1383,2.9
CN1915500000000,19,155,Pottawattamie County, IA,Sep-17,47838,46634,1204,2.5
CN1915500000000,19,155,Pottawattamie County, IA,Oct-17,47823,46805,1018,2.1
CN1915500000000,19,155,Pottawattamie County, IA,Nov-17,47840,46802,1038,2.2
CN1915500000000,19,155,Pottawattamie County, IA,Dec-17,47731,46533,1198,2.5
CN1915500000000,19,155,Pottawattamie County, IA,Jan-18,47795,46253,1542,3.2
CN1915500000000,19,155,Pottawattamie County, IA,Feb-18,47927,46405,1522,3.2
CN1915500000000,19,155,Pottawattamie County, IA,Mar-18,48222,46907,1315,2.7
CN1915500000000,19,155,Pottawattamie County, IA,Apr-18(p),48268,47145,1123,2.3
CN5300500000000,53,005,Benton County, WA,Mar-17,95179,89504,5675,6.0
CN5300500000000,53,005,Benton County, WA,Apr-17,95815,90810,5005,5.2
CN5300500000000,53,005,Benton County, WA,May-17,96551,91653,4898,5.1
CN5300500000000,53,005,Benton County, WA,Jun-17,101791,96934,4857,4.8
CN5300500000000,53,005,Benton County, WA,Jul-17,100908,96075,4833,4.8
CN5300500000000,53,005,Benton County, WA,Aug-17,98234,93279,4955,5.0
CN5300500000000,53,005,Benton County, WA,Sep-17,98230,93620,4610,4.7
CN5300500000000,53,005,Benton County, WA,Oct-17,98509,93925,4584,4.7
CN5300500000000,53,005,Benton County, WA,Nov-17,97917,92934,4983,5.1
CN5300500000000,53,005,Benton County, WA,Dec-17,97520,91593,5927,6.1
CN5300500000000,53,005,Benton County, WA,Jan-18,96442,90051,6391,6.6
CN5300500000000,53,005,Benton County, WA,Feb-18,96143,89762,6381,6.6
CN5300500000000,53,005,Benton County, WA,Mar-18,97300,91494,5806,6.0
CN5300500000000,53,005,Benton County, WA,Apr-18(p),96746,91485,5261,5.4
CN2003300000000,20,033,Comanche County, KS,Mar-17,911,888,23,2.5
CN2003300000000,20,033,Comanche County, KS,Apr-17,918,894,24,2.6
CN2003300000000,20,033,Comanche County, KS,May-17,919,889,30,3.3
CN2003300000000,20,033,Comanche County, KS,Jun-17,951,920,31,3.3
CN2003300000000,20,033,Comanche County, KS,Jul-17,917,885,32,3.5
CN2003300000000,20,033,Comanche County, KS,Aug-17,923,889,34,3.7
CN2003300000000,20,033,Comanche County, KS,Sep-17,923,898,25,2.7
CN2003300000000,20,033,Comanche County, KS,Oct-17,937,915,22,2.3
CN2003300000000,20,033,Comanche County, KS,Nov-17,936,912,24,2.6
CN2003300000000,20,033,Comanche County, KS,Dec-17,930,906,24,2.6
CN2003300000000,20,033,Comanche County, KS,Jan-18,886,864,22,2.5
CN2003300000000,20,033,Comanche County, KS,Feb-18,880,860,20,2.3
CN2003300000000,20,033,Comanche County, KS,Mar-18,853,832,21,2.5
CN2003300000000,20,033,Comanche County, KS,Apr-18(p),837,815,22,2.6
CN1300500000000,13,005,Bacon County, GA,Mar-17,5091,4861,230,4.5
CN1300500000000,13,005,Bacon County, GA,Apr-17,5050,4845,205,4.1
CN1300500000000,13,005,Bacon County, GA,May-17,5100,4890,210,4.1
CN1300500000000,13,005,Bacon County, GA,Jun-17,5192,4938,254,4.9
CN1300500000000,13,005,Bacon County, GA,Jul-17,5062,4811,251,5.0
CN1300500000000,13,005,Bacon County, GA,Aug-17,5041,4801,240,4.8
CN1300500000000,13,005,Bacon County, GA,Sep-17,5055,4814,241,4.8
CN1300500000000,13,005,Bacon County, GA,Oct-17,5073,4861,212,4.2
CN1300500000000,13,005,Bacon County, GA,Nov-17,5065,4855,210,4.1
CN1300500000000,13,005,Bacon County, GA,Dec-17,5087,4873,214,4.2
CN1300500000000,13,005,Bacon County, GA,Jan-18,5195,4959,236,4.5
CN1300500000000,13,005,Bacon County, GA,Feb-18,5029,4803,226,4.5
CN1300500000000,13,005,Bacon County, GA,Mar-18,5018,4812,206,4.1
CN1300500000000,13,005,Bacon County, GA,Apr-18(p),5041,4867,174,3.5
CN4713900000000,47,139,Polk County, TN,Mar-17,7236,6872,364,5.0
CN4713900000000,47,139,Polk County, TN,Apr-17,7194,6891,303,4.2
CN4713900000000,47,139,Polk County, TN,May-17,7194,6903,291,4.0
CN4713900000000,47,139,Polk County, TN,Jun-17,7322,6951,371,5.1
CN4713900000000,47,139,Polk County, TN,Jul-17,7364,7011,353,4.8
CN4713900000000,47,139,Polk County, TN,Aug-17,7353,7025,328,4.5
CN4713900000000,47,139,Polk County, TN,Sep-17,7398,7112,286,3.9
CN4713900000000,47,139,Polk County, TN,Oct-17,7418,7129,289,3.9
CN4713900000000,47,139,Polk County, TN,Nov-17,7615,7327,288,3.8
CN4713900000000,47,139,Polk County, TN,Dec-17,7729,7427,302,3.9
CN4713900000000,47,139,Polk County, TN,Jan-18,7362,7007,355,4.8
CN4713900000000,47,139,Polk County, TN,Feb-18,7381,7044,337,4.6
CN4713900000000,47,139,Polk County, TN,Mar-18,7322,7015,307,4.2
CN4713900000000,47,139,Polk County, TN,Apr-18(p),7376,7125,251,3.4
CN3910500000000,39,105,Meigs County, OH,Mar-17,9067,8253,814,9.0
CN3910500000000,39,105,Meigs County, OH,Apr-17,8987,8328,659,7.3
CN3910500000000,39,105,Meigs County, OH,May-17,8751,8163,588,6.7
CN3910500000000,39,105,Meigs County, OH,Jun-17,8874,8170,704,7.9
CN3910500000000,39,105,Meigs County, OH,Jul-17,8822,8095,727,8.2
CN3910500000000,39,105,Meigs County, OH,Aug-17,8865,8127,738,8.3
CN3910500000000,39,105,Meigs County, OH,Sep-17,9101,8471,630,6.9
CN3910500000000,39,105,Meigs County, OH,Oct-17,9083,8475,608,6.7
CN3910500000000,39,105,Meigs County, OH,Nov-17,9035,8405,630,7.0
CN3910500000000,39,105,Meigs County, OH,Dec-17,8761,8028,733,8.4
CN3910500000000,39,105,Meigs County, OH,Jan-18,8949,8109,840,9.4
CN3910500000000,39,105,Meigs County, OH,Feb-18,9052,8250,802,8.9
CN3910500000000,39,105,Meigs County, OH,Mar-18,9159,8482,677,7.4
CN3910500000000,39,105,Meigs County, OH,Apr-18(p),9059,8464,595,6.6
CN1322300000000,13,223,Paulding County, GA,Mar-17,81833,78380,3453,4.2
CN1322300000000,13,223,Paulding County, GA,Apr-17,81777,78518,3259,4.0
CN1322300000000,13,223,Paulding County, GA,May-17,82005,78692,3313,4.0
CN1322300000000,13,223,Paulding County, GA,Jun-17,82303,78633,3670,4.5
CN1322300000000,13,223,Paulding County, GA,Jul-17,82814,79152,3662,4.4
CN1322300000000,13,223,Paulding County, GA,Aug-17,82364,78797,3567,4.3
CN1322300000000,13,223,Paulding County, GA,Sep-17,83078,79831,3247,3.9
CN1322300000000,13,223,Paulding County, GA,Oct-17,82711,79553,3158,3.8
CN1322300000000,13,223,Paulding County, GA,Nov-17,82939,79852,3087,3.7
CN1322300000000,13,223,Paulding County, GA,Dec-17,82886,79822,3064,3.7
CN1322300000000,13,223,Paulding County, GA,Jan-18,82876,79667,3209,3.9
CN1322300000000,13,223,Paulding County, GA,Feb-18,84226,80929,3297,3.9
CN1322300000000,13,223,Paulding County, GA,Mar-18,84259,81224,3035,3.6
CN1322300000000,13,223,Paulding County, GA,Apr-18(p),83675,80951,2724,3.3
CN2115700000000,21,157,Marshall County, KY,Mar-17,15789,14853,936,5.9
CN2115700000000,21,157,Marshall County, KY,Apr-17,15282,14418,864,5.7
CN2115700000000,21,157,Marshall County, KY,May-17,15244,14307,937,6.1
CN2115700000000,21,157,Marshall County, KY,Jun-17,15573,14601,972,6.2
CN2115700000000,21,157,Marshall County, KY,Jul-17,15134,14200,934,6.2
CN2115700000000,21,157,Marshall County, KY,Aug-17,15229,14366,863,5.7
CN2115700000000,21,157,Marshall County, KY,Sep-17,15221,14460,761,5.0
CN2115700000000,21,157,Marshall County, KY,Oct-17,14923,14209,714,4.8
CN2115700000000,21,157,Marshall County, KY,Nov-17,14891,14163,728,4.9
CN2115700000000,21,157,Marshall County, KY,Dec-17,14863,14072,791,5.3
CN2115700000000,21,157,Marshall County, KY,Jan-18,14793,13891,902,6.1
CN2115700000000,21,157,Marshall County, KY,Feb-18,14850,13887,963,6.5
CN2115700000000,21,157,Marshall County, KY,Mar-18,15290,14386,904,5.9
CN2115700000000,21,157,Marshall County, KY,Apr-18(p),15187,14439,748,4.9
CN4014500000000,40,145,Wagoner County, OK,Mar-17,36595,34959,1636,4.5
CN4014500000000,40,145,Wagoner County, OK,Apr-17,36408,34912,1496,4.1
CN4014500000000,40,145,Wagoner County, OK,May-17,36540,34878,1662,4.5
CN4014500000000,40,145,Wagoner County, OK,Jun-17,37171,35399,1772,4.8
CN4014500000000,40,145,Wagoner County, OK,Jul-17,37231,35576,1655,4.4
CN4014500000000,40,145,Wagoner County, OK,Aug-17,36700,35057,1643,4.5
CN4014500000000,40,145,Wagoner County, OK,Sep-17,36942,35374,1568,4.2
CN4014500000000,40,145,Wagoner County, OK,Oct-17,37172,35622,1550,4.2
CN4014500000000,40,145,Wagoner County, OK,Nov-17,37358,35879,1479,4.0
CN4014500000000,40,145,Wagoner County, OK,Dec-17,37184,35720,1464,3.9
CN4014500000000,40,145,Wagoner County, OK,Jan-18,36877,35326,1551,4.2
CN4014500000000,40,145,Wagoner County, OK,Feb-18,37002,35547,1455,3.9
CN4014500000000,40,145,Wagoner County, OK,Mar-18,37225,35803,1422,3.8
CN4014500000000,40,145,Wagoner County, OK,Apr-18(p),37283,35910,1373,3.7
CN2121900000000,21,219,Todd County, KY,Mar-17,5577,5313,264,4.7
CN2121900000000,21,219,Todd County, KY,Apr-17,5610,5390,220,3.9
CN2121900000000,21,219,Todd County, KY,May-17,5599,5372,227,4.1
CN2121900000000,21,219,Todd County, KY,Jun-17,5631,5371,260,4.6
CN2121900000000,21,219,Todd County, KY,Jul-17,5338,5087,251,4.7
CN2121900000000,21,219,Todd County, KY,Aug-17,5471,5254,217,4.0
CN2121900000000,21,219,Todd County, KY,Sep-17,5458,5269,189,3.5
CN2121900000000,21,219,Todd County, KY,Oct-17,5414,5239,175,3.2
CN2121900000000,21,219,Todd County, KY,Nov-17,5477,5289,188,3.4
CN2121900000000,21,219,Todd County, KY,Dec-17,5423,5246,177,3.3
CN2121900000000,21,219,Todd County, KY,Jan-18,5466,5249,217,4.0
CN2121900000000,21,219,Todd County, KY,Feb-18,5471,5231,240,4.4
CN2121900000000,21,219,Todd County, KY,Mar-18,5501,5276,225,4.1
CN2121900000000,21,219,Todd County, KY,Apr-18(p),5517,5324,193,3.5
CN4703900000000,47,039,Decatur County, TN,Mar-17,4677,4391,286,6.1
CN4703900000000,47,039,Decatur County, TN,Apr-17,4636,4412,224,4.8
CN4703900000000,47,039,Decatur County, TN,May-17,4633,4433,200,4.3
CN4703900000000,47,039,Decatur County, TN,Jun-17,4680,4441,239,5.1
CN4703900000000,47,039,Decatur County, TN,Jul-17,4710,4478,232,4.9
CN4703900000000,47,039,Decatur County, TN,Aug-17,4680,4457,223,4.8
CN4703900000000,47,039,Decatur County, TN,Sep-17,4665,4467,198,4.2
CN4703900000000,47,039,Decatur County, TN,Oct-17,4621,4419,202,4.4
CN4703900000000,47,039,Decatur County, TN,Nov-17,4584,4373,211,4.6
CN4703900000000,47,039,Decatur County, TN,Dec-17,4606,4392,214,4.6
CN4703900000000,47,039,Decatur County, TN,Jan-18,4656,4388,268,5.8
CN4703900000000,47,039,Decatur County, TN,Feb-18,4704,4420,284,6.0
CN4703900000000,47,039,Decatur County, TN,Mar-18,4685,4439,246,5.3
CN4703900000000,47,039,Decatur County, TN,Apr-18(p),4685,4500,185,3.9
CN2109500000000,21,095,Harlan County, KY,Mar-17,7189,6405,784,10.9
CN2109500000000,21,095,Harlan County, KY,Apr-17,7105,6437,668,9.4
CN2109500000000,21,095,Harlan County, KY,May-17,7097,6420,677,9.5
CN2109500000000,21,095,Harlan County, KY,Jun-17,7151,6418,733,10.3
CN2109500000000,21,095,Harlan County, KY,Jul-17,7218,6523,695,9.6
CN2109500000000,21,095,Harlan County, KY,Aug-17,6819,6194,625,9.2
CN2109500000000,21,095,Harlan County, KY,Sep-17,6846,6289,557,8.1
CN2109500000000,21,095,Harlan County, KY,Oct-17,6623,6121,502,7.6
CN2109500000000,21,095,Harlan County, KY,Nov-17,6583,6119,464,7.0
CN2109500000000,21,095,Harlan County, KY,Dec-17,6583,6142,441,6.7
CN2109500000000,21,095,Harlan County, KY,Jan-18,6659,6193,466,7.0
CN2109500000000,21,095,Harlan County, KY,Feb-18,6767,6251,516,7.6
CN2109500000000,21,095,Harlan County, KY,Mar-18,6841,6340,501,7.3
CN2109500000000,21,095,Harlan County, KY,Apr-18(p),6781,6328,453,6.7
CN2500300000000,25,003,Berkshire County, MA,Mar-17,64460,61048,3412,5.3
CN2500300000000,25,003,Berkshire County, MA,Apr-17,63638,60738,2900,4.6
CN2500300000000,25,003,Berkshire County, MA,May-17,64312,61513,2799,4.4
CN2500300000000,25,003,Berkshire County, MA,Jun-17,66783,63874,2909,4.4
CN2500300000000,25,003,Berkshire County, MA,Jul-17,68113,65349,2764,4.1
CN2500300000000,25,003,Berkshire County, MA,Aug-17,67422,64858,2564,3.8
CN2500300000000,25,003,Berkshire County, MA,Sep-17,64678,62188,2490,3.8
CN2500300000000,25,003,Berkshire County, MA,Oct-17,64193,62023,2170,3.4
CN2500300000000,25,003,Berkshire County, MA,Nov-17,64195,61964,2231,3.5
CN2500300000000,25,003,Berkshire County, MA,Dec-17,64579,62125,2454,3.8
CN2500300000000,25,003,Berkshire County, MA,Jan-18,64373,61070,3303,5.1
CN2500300000000,25,003,Berkshire County, MA,Feb-18,64485,61072,3413,5.3
CN2500300000000,25,003,Berkshire County, MA,Mar-18,64510,61215,3295,5.1
CN2500300000000,25,003,Berkshire County, MA,Apr-18(p),64375,61579,2796,4.3
CN4008300000000,40,083,Logan County, OK,Mar-17,21576,20763,813,3.8
CN4008300000000,40,083,Logan County, OK,Apr-17,21544,20821,723,3.4
CN4008300000000,40,083,Logan County, OK,May-17,21546,20706,840,3.9
CN4008300000000,40,083,Logan County, OK,Jun-17,21836,20899,937,4.3
CN4008300000000,40,083,Logan County, OK,Jul-17,21897,21066,831,3.8
CN4008300000000,40,083,Logan County, OK,Aug-17,21738,20916,822,3.8
CN4008300000000,40,083,Logan County, OK,Sep-17,21928,21143,785,3.6
CN4008300000000,40,083,Logan County, OK,Oct-17,21924,21212,712,3.2
CN4008300000000,40,083,Logan County, OK,Nov-17,22032,21292,740,3.4
CN4008300000000,40,083,Logan County, OK,Dec-17,21836,21107,729,3.3
CN4008300000000,40,083,Logan County, OK,Jan-18,21642,20842,800,3.7
CN4008300000000,40,083,Logan County, OK,Feb-18,21993,21219,774,3.5
CN4008300000000,40,083,Logan County, OK,Mar-18,22108,21353,755,3.4
CN4008300000000,40,083,Logan County, OK,Apr-18(p),22029,21292,737,3.3
CN0601500000000,06,015,Del Norte County, CA,Mar-17,9714,8995,719,7.4
CN0601500000000,06,015,Del Norte County, CA,Apr-17,9707,9053,654,6.7
CN0601500000000,06,015,Del Norte County, CA,May-17,9671,9089,582,6.0
CN0601500000000,06,015,Del Norte County, CA,Jun-17,9786,9173,613,6.3
CN0601500000000,06,015,Del Norte County, CA,Jul-17,9943,9312,631,6.3
CN0601500000000,06,015,Del Norte County, CA,Aug-17,9957,9335,622,6.2
CN0601500000000,06,015,Del Norte County, CA,Sep-17,9948,9418,530,5.3
CN0601500000000,06,015,Del Norte County, CA,Oct-17,9846,9308,538,5.5
CN0601500000000,06,015,Del Norte County, CA,Nov-17,9686,9125,561,5.8
CN0601500000000,06,015,Del Norte County, CA,Dec-17,9633,9051,582,6.0
CN0601500000000,06,015,Del Norte County, CA,Jan-18,9729,9080,649,6.7
CN0601500000000,06,015,Del Norte County, CA,Feb-18,9790,9176,614,6.3
CN0601500000000,06,015,Del Norte County, CA,Mar-18,9744,9179,565,5.8
CN0601500000000,06,015,Del Norte County, CA,Apr-18(p),9719,9219,500,5.1
CN2916900000000,29,169,Pulaski County, MO,Mar-17,14586,13927,659,4.5
CN2916900000000,29,169,Pulaski County, MO,Apr-17,14522,13906,616,4.2
CN2916900000000,29,169,Pulaski County, MO,May-17,14552,13907,645,4.4
CN2916900000000,29,169,Pulaski County, MO,Jun-17,14530,13891,639,4.4
CN2916900000000,29,169,Pulaski County, MO,Jul-17,13978,13310,668,4.8
CN2916900000000,29,169,Pulaski County, MO,Aug-17,14488,13743,745,5.1
CN2916900000000,29,169,Pulaski County, MO,Sep-17,14309,13684,625,4.4
CN2916900000000,29,169,Pulaski County, MO,Oct-17,14081,13650,431,3.1
CN2916900000000,29,169,Pulaski County, MO,Nov-17,14142,13594,548,3.9
CN2916900000000,29,169,Pulaski County, MO,Dec-17,14086,13523,563,4.0
CN2916900000000,29,169,Pulaski County, MO,Jan-18,13877,13227,650,4.7
CN2916900000000,29,169,Pulaski County, MO,Feb-18,14233,13620,613,4.3
CN2916900000000,29,169,Pulaski County, MO,Mar-18,14224,13617,607,4.3
CN2916900000000,29,169,Pulaski County, MO,Apr-18(p),14270,13723,547,3.8
CN1919300000000,19,193,Woodbury County, IA,Mar-17,54298,52376,1922,3.5
CN1919300000000,19,193,Woodbury County, IA,Apr-17,54115,52430,1685,3.1
CN1919300000000,19,193,Woodbury County, IA,May-17,54142,52552,1590,2.9
CN1919300000000,19,193,Woodbury County, IA,Jun-17,54891,53026,1865,3.4
CN1919300000000,19,193,Woodbury County, IA,Jul-17,54616,52889,1727,3.2
CN1919300000000,19,193,Woodbury County, IA,Aug-17,53995,52262,1733,3.2
CN1919300000000,19,193,Woodbury County, IA,Sep-17,54231,52757,1474,2.7
CN1919300000000,19,193,Woodbury County, IA,Oct-17,54017,52710,1307,2.4
CN1919300000000,19,193,Woodbury County, IA,Nov-17,53986,52586,1400,2.6
CN1919300000000,19,193,Woodbury County, IA,Dec-17,53769,52163,1606,3.0
CN1919300000000,19,193,Woodbury County, IA,Jan-18,53860,51908,1952,3.6
CN1919300000000,19,193,Woodbury County, IA,Feb-18,54106,52253,1853,3.4
CN1919300000000,19,193,Woodbury County, IA,Mar-18,54418,52770,1648,3.0
CN1919300000000,19,193,Woodbury County, IA,Apr-18(p),54187,52876,1311,2.4
CN2103900000000,21,039,Carlisle County, KY,Mar-17,2477,2278,199,8.0
CN2103900000000,21,039,Carlisle County, KY,Apr-17,2574,2404,170,6.6
CN2103900000000,21,039,Carlisle County, KY,May-17,2540,2370,170,6.7
CN2103900000000,21,039,Carlisle County, KY,Jun-17,2578,2397,181,7.0
CN2103900000000,21,039,Carlisle County, KY,Jul-17,2395,2227,168,7.0
CN2103900000000,21,039,Carlisle County, KY,Aug-17,2356,2191,165,7.0
CN2103900000000,21,039,Carlisle County, KY,Sep-17,2395,2249,146,6.1
CN2103900000000,21,039,Carlisle County, KY,Oct-17,2361,2237,124,5.3
CN2103900000000,21,039,Carlisle County, KY,Nov-17,2294,2168,126,5.5
CN2103900000000,21,039,Carlisle County, KY,Dec-17,2253,2131,122,5.4
CN2103900000000,21,039,Carlisle County, KY,Jan-18,2298,2163,135,5.9
CN2103900000000,21,039,Carlisle County, KY,Feb-18,2382,2240,142,6.0
CN2103900000000,21,039,Carlisle County, KY,Mar-18,2379,2250,129,5.4
CN2103900000000,21,039,Carlisle County, KY,Apr-18(p),2453,2332,121,4.9
CN3706300000000,37,063,Durham County, NC,Mar-17,164755,158164,6591,4.0
CN3706300000000,37,063,Durham County, NC,Apr-17,164750,158706,6044,3.7
CN3706300000000,37,063,Durham County, NC,May-17,165749,159409,6340,3.8
CN3706300000000,37,063,Durham County, NC,Jun-17,165867,159053,6814,4.1
CN3706300000000,37,063,Durham County, NC,Jul-17,167738,160481,7257,4.3
CN3706300000000,37,063,Durham County, NC,Aug-17,165639,158407,7232,4.4
CN3706300000000,37,063,Durham County, NC,Sep-17,167203,160720,6483,3.9
CN3706300000000,37,063,Durham County, NC,Oct-17,166551,160093,6458,3.9
CN3706300000000,37,063,Durham County, NC,Nov-17,166441,159728,6713,4.0
CN3706300000000,37,063,Durham County, NC,Dec-17,164441,158082,6359,3.9
CN3706300000000,37,063,Durham County, NC,Jan-18,164852,158120,6732,4.1
CN3706300000000,37,063,Durham County, NC,Feb-18,166695,160087,6608,4.0
CN3706300000000,37,063,Durham County, NC,Mar-18,167869,161466,6403,3.8
CN3706300000000,37,063,Durham County, NC,Apr-18(p),166916,161354,5562,3.3
CN3203100000000,32,031,Washoe County, NV,Mar-17,234909,224147,10762,4.6
CN3203100000000,32,031,Washoe County, NV,Apr-17,236433,226346,10087,4.3
CN3203100000000,32,031,Washoe County, NV,May-17,238496,228676,9820,4.1
CN3203100000000,32,031,Washoe County, NV,Jun-17,239311,229086,10225,4.3
CN3203100000000,32,031,Washoe County, NV,Jul-17,240618,230664,9954,4.1
CN3203100000000,32,031,Washoe County, NV,Aug-17,240865,231334,9531,4.0
CN3203100000000,32,031,Washoe County, NV,Sep-17,243137,233767,9370,3.9
CN3203100000000,32,031,Washoe County, NV,Oct-17,243215,234181,9034,3.7
CN3203100000000,32,031,Washoe County, NV,Nov-17,243030,234060,8970,3.7
CN3203100000000,32,031,Washoe County, NV,Dec-17,243306,234378,8928,3.7
CN3203100000000,32,031,Washoe County, NV,Jan-18,241066,230201,10865,4.5
CN3203100000000,32,031,Washoe County, NV,Feb-18,244416,234158,10258,4.2
CN3203100000000,32,031,Washoe County, NV,Mar-18,245414,235120,10294,4.2
CN3203100000000,32,031,Washoe County, NV,Apr-18(p),245667,236184,9483,3.9
CN7203100000000,72,031,Carolina Municipio, PR,Mar-17,62466,57789,4677,7.5
CN7203100000000,72,031,Carolina Municipio, PR,Apr-17,62362,57295,5067,8.1
CN7203100000000,72,031,Carolina Municipio, PR,May-17,61347,56884,4463,7.3
CN7203100000000,72,031,Carolina Municipio, PR,Jun-17,60579,56511,4068,6.7
CN7203100000000,72,031,Carolina Municipio, PR,Jul-17,60843,56244,4599,7.6
CN7203100000000,72,031,Carolina Municipio, PR,Aug-17,60419,55484,4935,8.2
CN7203100000000,72,031,Carolina Municipio, PR,Sep-17(y),61030,56203,4827,7.9
CN7203100000000,72,031,Carolina Municipio, PR,Oct-17,58643,53966,4677,8.0
CN7203100000000,72,031,Carolina Municipio, PR,Nov-17,61579,57109,4470,7.3
CN7203100000000,72,031,Carolina Municipio, PR,Dec-17,62034,57574,4460,7.2
CN7203100000000,72,031,Carolina Municipio, PR,Jan-18,61332,56509,4823,7.9
CN7203100000000,72,031,Carolina Municipio, PR,Feb-18,61232,56724,4508,7.4
CN7203100000000,72,031,Carolina Municipio, PR,Mar-18,61259,56784,4475,7.3
CN7203100000000,72,031,Carolina Municipio, PR,Apr-18(p),61429,57180,4249,6.9
CN2209500000000,22,095,St. John the Baptist Parish, LA,Mar-17,19895,18655,1240,6.2
CN2209500000000,22,095,St. John the Baptist Parish, LA,Apr-17,19966,18775,1191,6.0
CN2209500000000,22,095,St. John the Baptist Parish, LA,May-17,19920,18694,1226,6.2
CN2209500000000,22,095,St. John the Baptist Parish, LA,Jun-17,20097,18694,1403,7.0
CN2209500000000,22,095,St. John the Baptist Parish, LA,Jul-17,20080,18754,1326,6.6
CN2209500000000,22,095,St. John the Baptist Parish, LA,Aug-17,20016,18674,1342,6.7
CN2209500000000,22,095,St. John the Baptist Parish, LA,Sep-17,20055,18866,1189,5.9
CN2209500000000,22,095,St. John the Baptist Parish, LA,Oct-17,20029,18993,1036,5.2
CN2209500000000,22,095,St. John the Baptist Parish, LA,Nov-17,20020,19029,991,5.0
CN2209500000000,22,095,St. John the Baptist Parish, LA,Dec-17,19979,18980,999,5.0
CN2209500000000,22,095,St. John the Baptist Parish, LA,Jan-18,20024,18971,1053,5.3
CN2209500000000,22,095,St. John the Baptist Parish, LA,Feb-18,20143,19168,975,4.8
CN2209500000000,22,095,St. John the Baptist Parish, LA,Mar-18,20182,19163,1019,5.0
CN2209500000000,22,095,St. John the Baptist Parish, LA,Apr-18(p),20258,19250,1008,5.0
CN5406700000000,54,067,Nicholas County, WV,Mar-17,9252,8498,754,8.1
CN5406700000000,54,067,Nicholas County, WV,Apr-17,9319,8672,647,6.9
CN5406700000000,54,067,Nicholas County, WV,May-17,9352,8759,593,6.3
CN5406700000000,54,067,Nicholas County, WV,Jun-17,9606,8948,658,6.8
CN5406700000000,54,067,Nicholas County, WV,Jul-17,9422,8804,618,6.6
CN5406700000000,54,067,Nicholas County, WV,Aug-17,9457,8792,665,7.0
CN5406700000000,54,067,Nicholas County, WV,Sep-17,9329,8765,564,6.0
CN5406700000000,54,067,Nicholas County, WV,Oct-17,9333,8771,562,6.0
CN5406700000000,54,067,Nicholas County, WV,Nov-17,9254,8648,606,6.5
CN5406700000000,54,067,Nicholas County, WV,Dec-17,9184,8545,639,7.0
CN5406700000000,54,067,Nicholas County, WV,Jan-18,9285,8586,699,7.5
CN5406700000000,54,067,Nicholas County, WV,Feb-18,9293,8552,741,8.0
CN5406700000000,54,067,Nicholas County, WV,Mar-18,9241,8528,713,7.7
CN5406700000000,54,067,Nicholas County, WV,Apr-18(p),9287,8659,628,6.8
CN3600100000000,36,001,Albany County, NY,Mar-17,159690,153267,6423,4.0
CN3600100000000,36,001,Albany County, NY,Apr-17,160503,154267,6236,3.9
CN3600100000000,36,001,Albany County, NY,May-17,159949,153511,6438,4.0
CN3600100000000,36,001,Albany County, NY,Jun-17,162514,155305,7209,4.4
CN3600100000000,36,001,Albany County, NY,Jul-17,162287,154947,7340,4.5
CN3600100000000,36,001,Albany County, NY,Aug-17,160935,153797,7138,4.4
CN3600100000000,36,001,Albany County, NY,Sep-17,160800,153882,6918,4.3
CN3600100000000,36,001,Albany County, NY,Oct-17,159841,153299,6542,4.1
CN3600100000000,36,001,Albany County, NY,Nov-17,158706,152146,6560,4.1
CN3600100000000,36,001,Albany County, NY,Dec-17,157524,151160,6364,4.0
CN3600100000000,36,001,Albany County, NY,Jan-18,159166,151634,7532,4.7
CN3600100000000,36,001,Albany County, NY,Feb-18,157969,150342,7627,4.8
CN3600100000000,36,001,Albany County, NY,Mar-18,157945,150948,6997,4.4
CN3600100000000,36,001,Albany County, NY,Apr-18(p),158106,151726,6380,4.0
CN1310500000000,13,105,Elbert County, GA,Mar-17,7929,7511,418,5.3
CN1310500000000,13,105,Elbert County, GA,Apr-17,7907,7523,384,4.9
CN1310500000000,13,105,Elbert County, GA,May-17,7893,7516,377,4.8
CN1310500000000,13,105,Elbert County, GA,Jun-17,7865,7450,415,5.3
CN1310500000000,13,105,Elbert County, GA,Jul-17,7920,7403,517,6.5
CN1310500000000,13,105,Elbert County, GA,Aug-17,7802,7379,423,5.4
CN1310500000000,13,105,Elbert County, GA,Sep-17,7878,7484,394,5.0
CN1310500000000,13,105,Elbert County, GA,Oct-17,7811,7429,382,4.9
CN1310500000000,13,105,Elbert County, GA,Nov-17,7770,7404,366,4.7
CN1310500000000,13,105,Elbert County, GA,Dec-17,7735,7369,366,4.7
CN1310500000000,13,105,Elbert County, GA,Jan-18,8173,7462,711,8.7
CN1310500000000,13,105,Elbert County, GA,Feb-18,7976,7565,411,5.2
CN1310500000000,13,105,Elbert County, GA,Mar-18,7976,7595,381,4.8
CN1310500000000,13,105,Elbert County, GA,Apr-18(p),7931,7585,346,4.4
CN1605100000000,16,051,Jefferson County, ID,Mar-17,12676,12306,370,2.9
CN1605100000000,16,051,Jefferson County, ID,Apr-17,12896,12592,304,2.4
CN1605100000000,16,051,Jefferson County, ID,May-17,13137,12852,285,2.2
CN1605100000000,16,051,Jefferson County, ID,Jun-17,13301,12992,309,2.3
CN1605100000000,16,051,Jefferson County, ID,Jul-17,13279,12969,310,2.3
CN1605100000000,16,051,Jefferson County, ID,Aug-17,13211,12913,298,2.3
CN1605100000000,16,051,Jefferson County, ID,Sep-17,13060,12771,289,2.2
CN1605100000000,16,051,Jefferson County, ID,Oct-17,13409,13127,282,2.1
CN1605100000000,16,051,Jefferson County, ID,Nov-17,13184,12871,313,2.4
CN1605100000000,16,051,Jefferson County, ID,Dec-17,13131,12837,294,2.2
CN1605100000000,16,051,Jefferson County, ID,Jan-18,13127,12699,428,3.3
CN1605100000000,16,051,Jefferson County, ID,Feb-18,13155,12785,370,2.8
CN1605100000000,16,051,Jefferson County, ID,Mar-18,13155,12802,353,2.7
CN1605100000000,16,051,Jefferson County, ID,Apr-18(p),13206,12913,293,2.2
CN4601500000000,46,015,Brule County, SD,Mar-17,2398,2329,69,2.9
CN4601500000000,46,015,Brule County, SD,Apr-17,2463,2389,74,3.0
CN4601500000000,46,015,Brule County, SD,May-17,2532,2453,79,3.1
CN4601500000000,46,015,Brule County, SD,Jun-17,2602,2525,77,3.0
CN4601500000000,46,015,Brule County, SD,Jul-17,2535,2461,74,2.9
CN4601500000000,46,015,Brule County, SD,Aug-17,2479,2395,84,3.4
CN4601500000000,46,015,Brule County, SD,Sep-17,2433,2358,75,3.1
CN4601500000000,46,015,Brule County, SD,Oct-17,2443,2369,74,3.0
CN4601500000000,46,015,Brule County, SD,Nov-17,2428,2350,78,3.2
CN4601500000000,46,015,Brule County, SD,Dec-17,2436,2359,77,3.2
CN4601500000000,46,015,Brule County, SD,Jan-18,2404,2325,79,3.3
CN4601500000000,46,015,Brule County, SD,Feb-18,2415,2339,76,3.1
CN4601500000000,46,015,Brule County, SD,Mar-18,2456,2380,76,3.1
CN4601500000000,46,015,Brule County, SD,Apr-18(p),2456,2378,78,3.2
CN5102500000000,51,025,Brunswick County, VA,Mar-17,6063,5722,341,5.6
CN5102500000000,51,025,Brunswick County, VA,Apr-17,6048,5738,310,5.1
CN5102500000000,51,025,Brunswick County, VA,May-17,6052,5740,312,5.2
CN5102500000000,51,025,Brunswick County, VA,Jun-17,6125,5798,327,5.3
CN5102500000000,51,025,Brunswick County, VA,Jul-17,6018,5689,329,5.5
CN5102500000000,51,025,Brunswick County, VA,Aug-17,5958,5625,333,5.6
CN5102500000000,51,025,Brunswick County, VA,Sep-17,5982,5675,307,5.1
CN5102500000000,51,025,Brunswick County, VA,Oct-17,5913,5611,302,5.1
CN5102500000000,51,025,Brunswick County, VA,Nov-17,5912,5606,306,5.2
CN5102500000000,51,025,Brunswick County, VA,Dec-17,5932,5609,323,5.4
CN5102500000000,51,025,Brunswick County, VA,Jan-18,5873,5518,355,6.0
CN5102500000000,51,025,Brunswick County, VA,Feb-18,5934,5596,338,5.7
CN5102500000000,51,025,Brunswick County, VA,Mar-18,5970,5647,323,5.4
CN5102500000000,51,025,Brunswick County, VA,Apr-18(p),6001,5712,289,4.8
CN1813100000000,18,131,Pulaski County, IN,Mar-17,6230,5996,234,3.8
CN1813100000000,18,131,Pulaski County, IN,Apr-17,6310,6115,195,3.1
CN1813100000000,18,131,Pulaski County, IN,May-17,6652,6456,196,2.9
CN1813100000000,18,131,Pulaski County, IN,Jun-17,6691,6483,208,3.1
CN1813100000000,18,131,Pulaski County, IN,Jul-17,6463,6246,217,3.4
CN1813100000000,18,131,Pulaski County, IN,Aug-17,6473,6234,239,3.7
CN1813100000000,18,131,Pulaski County, IN,Sep-17,6287,6094,193,3.1
CN1813100000000,18,131,Pulaski County, IN,Oct-17,6285,6092,193,3.1
CN1813100000000,18,131,Pulaski County, IN,Nov-17,6354,6158,196,3.1
CN1813100000000,18,131,Pulaski County, IN,Dec-17,6244,6058,186,3.0
CN1813100000000,18,131,Pulaski County, IN,Jan-18,6087,5860,227,3.7
CN1813100000000,18,131,Pulaski County, IN,Feb-18,6187,5958,229,3.7
CN1813100000000,18,131,Pulaski County, IN,Mar-18,6270,6070,200,3.2
CN1813100000000,18,131,Pulaski County, IN,Apr-18(p),6299,6115,184,2.9
CN3718100000000,37,181,Vance County, NC,Mar-17,18181,17099,1082,6.0
CN3718100000000,37,181,Vance County, NC,Apr-17,18022,17021,1001,5.6
CN3718100000000,37,181,Vance County, NC,May-17,17988,16940,1048,5.8
CN3718100000000,37,181,Vance County, NC,Jun-17,17692,16599,1093,6.2
CN3718100000000,37,181,Vance County, NC,Jul-17,17740,16560,1180,6.7
CN3718100000000,37,181,Vance County, NC,Aug-17,17722,16519,1203,6.8
CN3718100000000,37,181,Vance County, NC,Sep-17,17926,16827,1099,6.1
CN3718100000000,37,181,Vance County, NC,Oct-17,17840,16759,1081,6.1
CN3718100000000,37,181,Vance County, NC,Nov-17,17826,16720,1106,6.2
CN3718100000000,37,181,Vance County, NC,Dec-17,17699,16613,1086,6.1
CN3718100000000,37,181,Vance County, NC,Jan-18,17862,16683,1179,6.6
CN3718100000000,37,181,Vance County, NC,Feb-18,17961,16706,1255,7.0
CN3718100000000,37,181,Vance County, NC,Mar-18,18020,16866,1154,6.4
CN3718100000000,37,181,Vance County, NC,Apr-18(p),17901,16901,1000,5.6
CN1813700000000,18,137,Ripley County, IN,Mar-17,14059,13532,527,3.7
CN1813700000000,18,137,Ripley County, IN,Apr-17,14047,13640,407,2.9
CN1813700000000,18,137,Ripley County, IN,May-17,14198,13754,444,3.1
CN1813700000000,18,137,Ripley County, IN,Jun-17,14184,13715,469,3.3
CN1813700000000,18,137,Ripley County, IN,Jul-17,14195,13715,480,3.4
CN1813700000000,18,137,Ripley County, IN,Aug-17,14226,13688,538,3.8
CN1813700000000,18,137,Ripley County, IN,Sep-17,14039,13586,453,3.2
CN1813700000000,18,137,Ripley County, IN,Oct-17,13850,13398,452,3.3
CN1813700000000,18,137,Ripley County, IN,Nov-17,13753,13296,457,3.3
CN1813700000000,18,137,Ripley County, IN,Dec-17,13759,13279,480,3.5
CN1813700000000,18,137,Ripley County, IN,Jan-18,13576,13021,555,4.1
CN1813700000000,18,137,Ripley County, IN,Feb-18,13790,13199,591,4.3
CN1813700000000,18,137,Ripley County, IN,Mar-18,13935,13440,495,3.6
CN1813700000000,18,137,Ripley County, IN,Apr-18(p),14028,13583,445,3.2
CN2121300000000,21,213,Simpson County, KY,Mar-17,8869,8413,456,5.1
CN2121300000000,21,213,Simpson County, KY,Apr-17,8849,8463,386,4.4
CN2121300000000,21,213,Simpson County, KY,May-17,8840,8445,395,4.5
CN2121300000000,21,213,Simpson County, KY,Jun-17,8880,8412,468,5.3
CN2121300000000,21,213,Simpson County, KY,Jul-17,8728,8294,434,5.0
CN2121300000000,21,213,Simpson County, KY,Aug-17,8602,8209,393,4.6
CN2121300000000,21,213,Simpson County, KY,Sep-17,8721,8369,352,4.0
CN2121300000000,21,213,Simpson County, KY,Oct-17,8641,8320,321,3.7
CN2121300000000,21,213,Simpson County, KY,Nov-17,8641,8296,345,4.0
CN2121300000000,21,213,Simpson County, KY,Dec-17,8616,8315,301,3.5
CN2121300000000,21,213,Simpson County, KY,Jan-18,8698,8378,320,3.7
CN2121300000000,21,213,Simpson County, KY,Feb-18,8787,8413,374,4.3
CN2121300000000,21,213,Simpson County, KY,Mar-18,8910,8558,352,4.0
CN2121300000000,21,213,Simpson County, KY,Apr-18(p),8916,8616,300,3.4
CN3712500000000,37,125,Moore County, NC,Mar-17,39961,38193,1768,4.4
CN3712500000000,37,125,Moore County, NC,Apr-17,39800,38231,1569,3.9
CN3712500000000,37,125,Moore County, NC,May-17,39940,38266,1674,4.2
CN3712500000000,37,125,Moore County, NC,Jun-17,40087,38300,1787,4.5
CN3712500000000,37,125,Moore County, NC,Jul-17,39851,37931,1920,4.8
CN3712500000000,37,125,Moore County, NC,Aug-17,39806,37881,1925,4.8
CN3712500000000,37,125,Moore County, NC,Sep-17,40502,38779,1723,4.3
CN3712500000000,37,125,Moore County, NC,Oct-17,40322,38619,1703,4.2
CN3712500000000,37,125,Moore County, NC,Nov-17,40294,38501,1793,4.4
CN3712500000000,37,125,Moore County, NC,Dec-17,39875,38123,1752,4.4
CN3712500000000,37,125,Moore County, NC,Jan-18,39685,37829,1856,4.7
CN3712500000000,37,125,Moore County, NC,Feb-18,40255,38456,1799,4.5
CN3712500000000,37,125,Moore County, NC,Mar-18,40535,38792,1743,4.3
CN3712500000000,37,125,Moore County, NC,Apr-18(p),40467,39007,1460,3.6
CN2804500000000,28,045,Hancock County, MS,Mar-17,18959,17915,1044,5.5
CN2804500000000,28,045,Hancock County, MS,Apr-17,18939,17980,959,5.1
CN2804500000000,28,045,Hancock County, MS,May-17,18928,17841,1087,5.7
CN2804500000000,28,045,Hancock County, MS,Jun-17,19194,18001,1193,6.2
CN2804500000000,28,045,Hancock County, MS,Jul-17,19253,18126,1127,5.9
CN2804500000000,28,045,Hancock County, MS,Aug-17,18797,17818,979,5.2
CN2804500000000,28,045,Hancock County, MS,Sep-17,18754,17809,945,5.0
CN2804500000000,28,045,Hancock County, MS,Oct-17,18828,17930,898,4.8
CN2804500000000,28,045,Hancock County, MS,Nov-17,18745,17890,855,4.6
CN2804500000000,28,045,Hancock County, MS,Dec-17,18779,17909,870,4.6
CN2804500000000,28,045,Hancock County, MS,Jan-18,18534,17662,872,4.7
CN2804500000000,28,045,Hancock County, MS,Feb-18,18645,17784,861,4.6
CN2804500000000,28,045,Hancock County, MS,Mar-18,18668,17869,799,4.3
CN2804500000000,28,045,Hancock County, MS,Apr-18(p),18856,18035,821,4.4
CN4703300000000,47,033,Crockett County, TN,Mar-17,7002,6655,347,5.0
CN4703300000000,47,033,Crockett County, TN,Apr-17,6863,6602,261,3.8
CN4703300000000,47,033,Crockett County, TN,May-17,6767,6525,242,3.6
CN4703300000000,47,033,Crockett County, TN,Jun-17,6911,6624,287,4.2
CN4703300000000,47,033,Crockett County, TN,Jul-17,7008,6737,271,3.9
CN4703300000000,47,033,Crockett County, TN,Aug-17,7034,6767,267,3.8
CN4703300000000,47,033,Crockett County, TN,Sep-17,7032,6784,248,3.5
CN4703300000000,47,033,Crockett County, TN,Oct-17,6950,6713,237,3.4
CN4703300000000,47,033,Crockett County, TN,Nov-17,6957,6709,248,3.6
CN4703300000000,47,033,Crockett County, TN,Dec-17,6967,6728,239,3.4
CN4703300000000,47,033,Crockett County, TN,Jan-18,6891,6582,309,4.5
CN4703300000000,47,033,Crockett County, TN,Feb-18,7036,6737,299,4.2
CN4703300000000,47,033,Crockett County, TN,Mar-18,6981,6695,286,4.1
CN4703300000000,47,033,Crockett County, TN,Apr-18(p),7031,6799,232,3.3
CN7203700000000,72,037,Ceiba Municipio, PR,Mar-17,3806,3355,451,11.8
CN7203700000000,72,037,Ceiba Municipio, PR,Apr-17,3817,3331,486,12.7
CN7203700000000,72,037,Ceiba Municipio, PR,May-17,3780,3302,478,12.6
CN7203700000000,72,037,Ceiba Municipio, PR,Jun-17,3727,3281,446,12.0
CN7203700000000,72,037,Ceiba Municipio, PR,Jul-17,3808,3266,542,14.2
CN7203700000000,72,037,Ceiba Municipio, PR,Aug-17,3818,3223,595,15.6
CN7203700000000,72,037,Ceiba Municipio, PR,Sep-17(y),3798,3267,531,14.0
CN7203700000000,72,037,Ceiba Municipio, PR,Oct-17,3715,3132,583,15.7
CN7203700000000,72,037,Ceiba Municipio, PR,Nov-17,3897,3326,571,14.7
CN7203700000000,72,037,Ceiba Municipio, PR,Dec-17,3905,3358,547,14.0
CN7203700000000,72,037,Ceiba Municipio, PR,Jan-18,3881,3292,589,15.2
CN7203700000000,72,037,Ceiba Municipio, PR,Feb-18,3865,3299,566,14.6
CN7203700000000,72,037,Ceiba Municipio, PR,Mar-18,3897,3299,598,15.3
CN7203700000000,72,037,Ceiba Municipio, PR,Apr-18(p),3883,3334,549,14.1
CN4809500000000,48,095,Concho County, TX,Mar-17,1379,1343,36,2.6
CN4809500000000,48,095,Concho County, TX,Apr-17,1360,1328,32,2.4
CN4809500000000,48,095,Concho County, TX,May-17,1331,1265,66,5.0
CN4809500000000,48,095,Concho County, TX,Jun-17,1199,1129,70,5.8
CN4809500000000,48,095,Concho County, TX,Jul-17,1100,1034,66,6.0
CN4809500000000,48,095,Concho County, TX,Aug-17,1147,1081,66,5.8
CN4809500000000,48,095,Concho County, TX,Sep-17,1086,1031,55,5.1
CN4809500000000,48,095,Concho County, TX,Oct-17,1149,1098,51,4.4
CN4809500000000,48,095,Concho County, TX,Nov-17,1093,1042,51,4.7
CN4809500000000,48,095,Concho County, TX,Dec-17,1108,1063,45,4.1
CN4809500000000,48,095,Concho County, TX,Jan-18,1074,1031,43,4.0
CN4809500000000,48,095,Concho County, TX,Feb-18,1117,1075,42,3.8
CN4809500000000,48,095,Concho County, TX,Mar-18,1214,1172,42,3.5
CN4809500000000,48,095,Concho County, TX,Apr-18(p),1147,1109,38,3.3
CN5118100000000,51,181,Surry County, VA,Mar-17,3639,3462,177,4.9
CN5118100000000,51,181,Surry County, VA,Apr-17,3683,3524,159,4.3
CN5118100000000,51,181,Surry County, VA,May-17,3926,3780,146,3.7
CN5118100000000,51,181,Surry County, VA,Jun-17,3714,3540,174,4.7
CN5118100000000,51,181,Surry County, VA,Jul-17,3724,3551,173,4.6
CN5118100000000,51,181,Surry County, VA,Aug-17,3684,3509,175,4.8
CN5118100000000,51,181,Surry County, VA,Sep-17,3715,3561,154,4.1
CN5118100000000,51,181,Surry County, VA,Oct-17,3775,3632,143,3.8
CN5118100000000,51,181,Surry County, VA,Nov-17,3789,3642,147,3.9
CN5118100000000,51,181,Surry County, VA,Dec-17,3646,3480,166,4.6
CN5118100000000,51,181,Surry County, VA,Jan-18,3578,3411,167,4.7
CN5118100000000,51,181,Surry County, VA,Feb-18,3614,3477,137,3.8
CN5118100000000,51,181,Surry County, VA,Mar-18,3630,3500,130,3.6
CN5118100000000,51,181,Surry County, VA,Apr-18(p),3730,3620,110,2.9
CN0809500000000,08,095,Phillips County, CO,Mar-17,2362,2317,45,1.9
CN0809500000000,08,095,Phillips County, CO,Apr-17,2561,2520,41,1.6
CN0809500000000,08,095,Phillips County, CO,May-17,2646,2607,39,1.5
CN0809500000000,08,095,Phillips County, CO,Jun-17,2643,2598,45,1.7
CN0809500000000,08,095,Phillips County, CO,Jul-17,2674,2637,37,1.4
CN0809500000000,08,095,Phillips County, CO,Aug-17,2622,2584,38,1.4
CN0809500000000,08,095,Phillips County, CO,Sep-17,2569,2532,37,1.4
CN0809500000000,08,095,Phillips County, CO,Oct-17,2814,2774,40,1.4
CN0809500000000,08,095,Phillips County, CO,Nov-17,2692,2654,38,1.4
CN0809500000000,08,095,Phillips County, CO,Dec-17,2663,2621,42,1.6
CN0809500000000,08,095,Phillips County, CO,Jan-18,2568,2522,46,1.8
CN0809500000000,08,095,Phillips County, CO,Feb-18,2414,2367,47,1.9
CN0809500000000,08,095,Phillips County, CO,Mar-18,2413,2367,46,1.9
CN0809500000000,08,095,Phillips County, CO,Apr-18(p),2574,2533,41,1.6
CN4847500000000,48,475,Ward County, TX,Mar-17,5580,5337,243,4.4
CN4847500000000,48,475,Ward County, TX,Apr-17,5557,5339,218,3.9
CN4847500000000,48,475,Ward County, TX,May-17,5606,5377,229,4.1
CN4847500000000,48,475,Ward County, TX,Jun-17,5570,5337,233,4.2
CN4847500000000,48,475,Ward County, TX,Jul-17,5507,5284,223,4.0
CN4847500000000,48,475,Ward County, TX,Aug-17,5564,5340,224,4.0
CN4847500000000,48,475,Ward County, TX,Sep-17,5625,5422,203,3.6
CN4847500000000,48,475,Ward County, TX,Oct-17,5515,5322,193,3.5
CN4847500000000,48,475,Ward County, TX,Nov-17,5556,5360,196,3.5
CN4847500000000,48,475,Ward County, TX,Dec-17,5519,5332,187,3.4
CN4847500000000,48,475,Ward County, TX,Jan-18,5505,5302,203,3.7
CN4847500000000,48,475,Ward County, TX,Feb-18,5637,5448,189,3.4
CN4847500000000,48,475,Ward County, TX,Mar-18,5631,5441,190,3.4
CN4847500000000,48,475,Ward County, TX,Apr-18(p),5658,5485,173,3.1
CN4834100000000,48,341,Moore County, TX,Mar-17,11260,10939,321,2.9
CN4834100000000,48,341,Moore County, TX,Apr-17,11254,10961,293,2.6
CN4834100000000,48,341,Moore County, TX,May-17,11230,10909,321,2.9
CN4834100000000,48,341,Moore County, TX,Jun-17,11067,10718,349,3.2
CN4834100000000,48,341,Moore County, TX,Jul-17,10994,10652,342,3.1
CN4834100000000,48,341,Moore County, TX,Aug-17,10886,10559,327,3.0
CN4834100000000,48,341,Moore County, TX,Sep-17,10903,10602,301,2.8
CN4834100000000,48,341,Moore County, TX,Oct-17,10810,10533,277,2.6
CN4834100000000,48,341,Moore County, TX,Nov-17,10721,10424,297,2.8
CN4834100000000,48,341,Moore County, TX,Dec-17,10760,10480,280,2.6
CN4834100000000,48,341,Moore County, TX,Jan-18,10651,10327,324,3.0
CN4834100000000,48,341,Moore County, TX,Feb-18,10784,10462,322,3.0
CN4834100000000,48,341,Moore County, TX,Mar-18,10938,10610,328,3.0
CN4834100000000,48,341,Moore County, TX,Apr-18(p),10954,10665,289,2.6
CN1704700000000,17,047,Edwards County, IL,Mar-17,2921,2773,148,5.1
CN1704700000000,17,047,Edwards County, IL,Apr-17,2931,2826,105,3.6
CN1704700000000,17,047,Edwards County, IL,May-17,2876,2767,109,3.8
CN1704700000000,17,047,Edwards County, IL,Jun-17,2877,2755,122,4.2
CN1704700000000,17,047,Edwards County, IL,Jul-17,2857,2730,127,4.4
CN1704700000000,17,047,Edwards County, IL,Aug-17,2785,2653,132,4.7
CN1704700000000,17,047,Edwards County, IL,Sep-17,2757,2647,110,4.0
CN1704700000000,17,047,Edwards County, IL,Oct-17,2768,2664,104,3.8
CN1704700000000,17,047,Edwards County, IL,Nov-17,2742,2622,120,4.4
CN1704700000000,17,047,Edwards County, IL,Dec-17,2739,2622,117,4.3
CN1704700000000,17,047,Edwards County, IL,Jan-18,2751,2625,126,4.6
CN1704700000000,17,047,Edwards County, IL,Feb-18,2756,2641,115,4.2
CN1704700000000,17,047,Edwards County, IL,Mar-18,2794,2679,115,4.1
CN1704700000000,17,047,Edwards County, IL,Apr-18(p),2855,2759,96,3.4
CN4008900000000,40,089,McCurtain County, OK,Mar-17,14781,13896,885,6.0
CN4008900000000,40,089,McCurtain County, OK,Apr-17,14786,13955,831,5.6
CN4008900000000,40,089,McCurtain County, OK,May-17,15020,14151,869,5.8
CN4008900000000,40,089,McCurtain County, OK,Jun-17,14703,13687,1016,6.9
CN4008900000000,40,089,McCurtain County, OK,Jul-17,14382,13431,951,6.6
CN4008900000000,40,089,McCurtain County, OK,Aug-17,14826,13847,979,6.6
CN4008900000000,40,089,McCurtain County, OK,Sep-17,14716,13899,817,5.6
CN4008900000000,40,089,McCurtain County, OK,Oct-17,14978,14131,847,5.7
CN4008900000000,40,089,McCurtain County, OK,Nov-17,15000,14152,848,5.7
CN4008900000000,40,089,McCurtain County, OK,Dec-17,14922,13933,989,6.6
CN4008900000000,40,089,McCurtain County, OK,Jan-18,15050,13960,1090,7.2
CN4008900000000,40,089,McCurtain County, OK,Feb-18,14964,14089,875,5.8
CN4008900000000,40,089,McCurtain County, OK,Mar-18,15019,14212,807,5.4
CN4008900000000,40,089,McCurtain County, OK,Apr-18(p),14846,14028,818,5.5
CN2202300000000,22,023,Cameron Parish, LA,Mar-17,3946,3800,146,3.7
CN2202300000000,22,023,Cameron Parish, LA,Apr-17,3977,3838,139,3.5
CN2202300000000,22,023,Cameron Parish, LA,May-17,3997,3863,134,3.4
CN2202300000000,22,023,Cameron Parish, LA,Jun-17,4106,3950,156,3.8
CN2202300000000,22,023,Cameron Parish, LA,Jul-17,4152,3994,158,3.8
CN2202300000000,22,023,Cameron Parish, LA,Aug-17,4119,3960,159,3.9
CN2202300000000,22,023,Cameron Parish, LA,Sep-17,4112,3961,151,3.7
CN2202300000000,22,023,Cameron Parish, LA,Oct-17,4116,3989,127,3.1
CN2202300000000,22,023,Cameron Parish, LA,Nov-17,4116,3991,125,3.0
CN2202300000000,22,023,Cameron Parish, LA,Dec-17,4059,3944,115,2.8
CN2202300000000,22,023,Cameron Parish, LA,Jan-18,4085,3962,123,3.0
CN2202300000000,22,023,Cameron Parish, LA,Feb-18,4165,4045,120,2.9
CN2202300000000,22,023,Cameron Parish, LA,Mar-18,4190,4062,128,3.1
CN2202300000000,22,023,Cameron Parish, LA,Apr-18(p),4189,4059,130,3.1
CN4707100000000,47,071,Hardin County, TN,Mar-17,10308,9765,543,5.3
CN4707100000000,47,071,Hardin County, TN,Apr-17,10365,9926,439,4.2
CN4707100000000,47,071,Hardin County, TN,May-17,10529,10097,432,4.1
CN4707100000000,47,071,Hardin County, TN,Jun-17,10526,9957,569,5.4
CN4707100000000,47,071,Hardin County, TN,Jul-17,10486,9957,529,5.0
CN4707100000000,47,071,Hardin County, TN,Aug-17,10546,10078,468,4.4
CN4707100000000,47,071,Hardin County, TN,Sep-17,10538,10114,424,4.0
CN4707100000000,47,071,Hardin County, TN,Oct-17,10450,10050,400,3.8
CN4707100000000,47,071,Hardin County, TN,Nov-17,10352,9933,419,4.0
CN4707100000000,47,071,Hardin County, TN,Dec-17,10380,9974,406,3.9
CN4707100000000,47,071,Hardin County, TN,Jan-18,10433,9929,504,4.8
CN4707100000000,47,071,Hardin County, TN,Feb-18,10473,10012,461,4.4
CN4707100000000,47,071,Hardin County, TN,Mar-18,10533,10086,447,4.2
CN4707100000000,47,071,Hardin County, TN,Apr-18(p),10609,10230,379,3.6
CN5511300000000,55,113,Sawyer County, WI,Mar-17,7632,7134,498,6.5
CN5511300000000,55,113,Sawyer County, WI,Apr-17,7750,7344,406,5.2
CN5511300000000,55,113,Sawyer County, WI,May-17,8046,7724,322,4.0
CN5511300000000,55,113,Sawyer County, WI,Jun-17,8555,8177,378,4.4
CN5511300000000,55,113,Sawyer County, WI,Jul-17,8622,8292,330,3.8
CN5511300000000,55,113,Sawyer County, WI,Aug-17,8506,8155,351,4.1
CN5511300000000,55,113,Sawyer County, WI,Sep-17,8182,7901,281,3.4
CN5511300000000,55,113,Sawyer County, WI,Oct-17,8149,7879,270,3.3
CN5511300000000,55,113,Sawyer County, WI,Nov-17,7922,7587,335,4.2
CN5511300000000,55,113,Sawyer County, WI,Dec-17,7859,7505,354,4.5
CN5511300000000,55,113,Sawyer County, WI,Jan-18,7686,7328,358,4.7
CN5511300000000,55,113,Sawyer County, WI,Feb-18,7717,7285,432,5.6
CN5511300000000,55,113,Sawyer County, WI,Mar-18,7737,7302,435,5.6
CN5511300000000,55,113,Sawyer County, WI,Apr-18(p),7844,7417,427,5.4
CN0802300000000,08,023,Costilla County, CO,Mar-17,1758,1689,69,3.9
CN0802300000000,08,023,Costilla County, CO,Apr-17,1804,1747,57,3.2
CN0802300000000,08,023,Costilla County, CO,May-17,1807,1754,53,2.9
CN0802300000000,08,023,Costilla County, CO,Jun-17,1847,1787,60,3.2
CN0802300000000,08,023,Costilla County, CO,Jul-17,1871,1804,67,3.6
CN0802300000000,08,023,Costilla County, CO,Aug-17,1864,1802,62,3.3
CN0802300000000,08,023,Costilla County, CO,Sep-17,1845,1787,58,3.1
CN0802300000000,08,023,Costilla County, CO,Oct-17,1931,1873,58,3.0
CN0802300000000,08,023,Costilla County, CO,Nov-17,1897,1826,71,3.7
CN0802300000000,08,023,Costilla County, CO,Dec-17,1880,1809,71,3.8
CN0802300000000,08,023,Costilla County, CO,Jan-18,1846,1766,80,4.3
CN0802300000000,08,023,Costilla County, CO,Feb-18,1835,1756,79,4.3
CN0802300000000,08,023,Costilla County, CO,Mar-18,1856,1790,66,3.6
CN0802300000000,08,023,Costilla County, CO,Apr-18(p),1908,1847,61,3.2
CN4824100000000,48,241,Jasper County, TX,Mar-17,13678,12631,1047,7.7
CN4824100000000,48,241,Jasper County, TX,Apr-17,13401,12443,958,7.1
CN4824100000000,48,241,Jasper County, TX,May-17,13429,12483,946,7.0
CN4824100000000,48,241,Jasper County, TX,Jun-17,13534,12521,1013,7.5
CN4824100000000,48,241,Jasper County, TX,Jul-17,13339,12318,1021,7.7
CN4824100000000,48,241,Jasper County, TX,Aug-17,13357,12333,1024,7.7
CN4824100000000,48,241,Jasper County, TX,Sep-17,13287,12354,933,7.0
CN4824100000000,48,241,Jasper County, TX,Oct-17,13101,12244,857,6.5
CN4824100000000,48,241,Jasper County, TX,Nov-17,13185,12283,902,6.8
CN4824100000000,48,241,Jasper County, TX,Dec-17,13192,12271,921,7.0
CN4824100000000,48,241,Jasper County, TX,Jan-18,13172,12160,1012,7.7
CN4824100000000,48,241,Jasper County, TX,Feb-18,13273,12324,949,7.1
CN4824100000000,48,241,Jasper County, TX,Mar-18,13422,12490,932,6.9
CN4824100000000,48,241,Jasper County, TX,Apr-18(p),13377,12509,868,6.5
CN1208700000000,12,087,Monroe County, FL,Mar-17,47739,46428,1311,2.7
CN1208700000000,12,087,Monroe County, FL,Apr-17,47690,46459,1231,2.6
CN1208700000000,12,087,Monroe County, FL,May-17,47515,46225,1290,2.7
CN1208700000000,12,087,Monroe County, FL,Jun-17,46914,45580,1334,2.8
CN1208700000000,12,087,Monroe County, FL,Jul-17,46740,45403,1337,2.9
CN1208700000000,12,087,Monroe County, FL,Aug-17,46653,45334,1319,2.8
CN1208700000000,12,087,Monroe County, FL,Sep-17,42221,39929,2292,5.4
CN1208700000000,12,087,Monroe County, FL,Oct-17,41459,39531,1928,4.7
CN1208700000000,12,087,Monroe County, FL,Nov-17,41337,39737,1600,3.9
CN1208700000000,12,087,Monroe County, FL,Dec-17,41254,39842,1412,3.4
CN1208700000000,12,087,Monroe County, FL,Jan-18,41866,40312,1554,3.7
CN1208700000000,12,087,Monroe County, FL,Feb-18,42229,40830,1399,3.3
CN1208700000000,12,087,Monroe County, FL,Mar-18,42538,41201,1337,3.1
CN1208700000000,12,087,Monroe County, FL,Apr-18(p),42443,41275,1168,2.8
CN4830300000000,48,303,Lubbock County, TX,Mar-17,155841,150313,5528,3.5
CN4830300000000,48,303,Lubbock County, TX,Apr-17,156153,151691,4462,2.9
CN4830300000000,48,303,Lubbock County, TX,May-17,155823,151178,4645,3.0
CN4830300000000,48,303,Lubbock County, TX,Jun-17,155407,149700,5707,3.7
CN4830300000000,48,303,Lubbock County, TX,Jul-17,156147,150462,5685,3.6
CN4830300000000,48,303,Lubbock County, TX,Aug-17,156128,150609,5519,3.5
CN4830300000000,48,303,Lubbock County, TX,Sep-17,156665,152154,4511,2.9
CN4830300000000,48,303,Lubbock County, TX,Oct-17,156130,151981,4149,2.7
CN4830300000000,48,303,Lubbock County, TX,Nov-17,156534,152215,4319,2.8
CN4830300000000,48,303,Lubbock County, TX,Dec-17,155696,151541,4155,2.7
CN4830300000000,48,303,Lubbock County, TX,Jan-18,155724,150958,4766,3.1
CN4830300000000,48,303,Lubbock County, TX,Feb-18,159014,154085,4929,3.1
CN4830300000000,48,303,Lubbock County, TX,Mar-18,159674,154124,5550,3.5
CN4830300000000,48,303,Lubbock County, TX,Apr-18(p),159217,154768,4449,2.8
CN3116500000000,31,165,Sioux County, NE,Mar-17,745,722,23,3.1
CN3116500000000,31,165,Sioux County, NE,Apr-17,776,754,22,2.8
CN3116500000000,31,165,Sioux County, NE,May-17,791,764,27,3.4
CN3116500000000,31,165,Sioux County, NE,Jun-17,836,812,24,2.9
CN3116500000000,31,165,Sioux County, NE,Jul-17,820,796,24,2.9
CN3116500000000,31,165,Sioux County, NE,Aug-17,778,756,22,2.8
CN3116500000000,31,165,Sioux County, NE,Sep-17,732,711,21,2.9
CN3116500000000,31,165,Sioux County, NE,Oct-17,739,719,20,2.7
CN3116500000000,31,165,Sioux County, NE,Nov-17,748,724,24,3.2
CN3116500000000,31,165,Sioux County, NE,Dec-17,740,717,23,3.1
CN3116500000000,31,165,Sioux County, NE,Jan-18,755,738,17,2.3
CN3116500000000,31,165,Sioux County, NE,Feb-18,729,708,21,2.9
CN3116500000000,31,165,Sioux County, NE,Mar-18,755,735,20,2.6
CN3116500000000,31,165,Sioux County, NE,Apr-18(p),766,745,21,2.7
CN2103300000000,21,033,Caldwell County, KY,Mar-17,5526,5192,334,6.0
CN2103300000000,21,033,Caldwell County, KY,Apr-17,5551,5276,275,5.0
CN2103300000000,21,033,Caldwell County, KY,May-17,5580,5273,307,5.5
CN2103300000000,21,033,Caldwell County, KY,Jun-17,5590,5241,349,6.2
CN2103300000000,21,033,Caldwell County, KY,Jul-17,5411,5108,303,5.6
CN2103300000000,21,033,Caldwell County, KY,Aug-17,5332,5077,255,4.8
CN2103300000000,21,033,Caldwell County, KY,Sep-17,5374,5135,239,4.4
CN2103300000000,21,033,Caldwell County, KY,Oct-17,5439,5213,226,4.2
CN2103300000000,21,033,Caldwell County, KY,Nov-17,5461,5250,211,3.9
CN2103300000000,21,033,Caldwell County, KY,Dec-17,5401,5196,205,3.8
CN2103300000000,21,033,Caldwell County, KY,Jan-18,5438,5189,249,4.6
CN2103300000000,21,033,Caldwell County, KY,Feb-18,5477,5185,292,5.3
CN2103300000000,21,033,Caldwell County, KY,Mar-18,5519,5252,267,4.8
CN2103300000000,21,033,Caldwell County, KY,Apr-18(p),5530,5292,238,4.3
CN3501700000000,35,017,Grant County, NM,Mar-17,12203,11452,751,6.2
CN3501700000000,35,017,Grant County, NM,Apr-17,12244,11535,709,5.8
CN3501700000000,35,017,Grant County, NM,May-17,12117,11422,695,5.7
CN3501700000000,35,017,Grant County, NM,Jun-17,12058,11244,814,6.8
CN3501700000000,35,017,Grant County, NM,Jul-17,12059,11247,812,6.7
CN3501700000000,35,017,Grant County, NM,Aug-17,11962,11211,751,6.3
CN3501700000000,35,017,Grant County, NM,Sep-17,11964,11241,723,6.0
CN3501700000000,35,017,Grant County, NM,Oct-17,12244,11519,725,5.9
CN3501700000000,35,017,Grant County, NM,Nov-17,12307,11598,709,5.8
CN3501700000000,35,017,Grant County, NM,Dec-17,12249,11567,682,5.6
CN3501700000000,35,017,Grant County, NM,Jan-18,12000,11297,703,5.9
CN3501700000000,35,017,Grant County, NM,Feb-18,12105,11440,665,5.5
CN3501700000000,35,017,Grant County, NM,Mar-18,12086,11468,618,5.1
CN3501700000000,35,017,Grant County, NM,Apr-18(p),12049,11537,512,4.2
CN1714700000000,17,147,Piatt County, IL,Mar-17,8591,8204,387,4.5
CN1714700000000,17,147,Piatt County, IL,Apr-17,8660,8369,291,3.4
CN1714700000000,17,147,Piatt County, IL,May-17,8516,8232,284,3.3
CN1714700000000,17,147,Piatt County, IL,Jun-17,8299,7978,321,3.9
CN1714700000000,17,147,Piatt County, IL,Jul-17,8316,7990,326,3.9
CN1714700000000,17,147,Piatt County, IL,Aug-17,8134,7795,339,4.2
CN1714700000000,17,147,Piatt County, IL,Sep-17,8561,8269,292,3.4
CN1714700000000,17,147,Piatt County, IL,Oct-17,8559,8269,290,3.4
CN1714700000000,17,147,Piatt County, IL,Nov-17,8497,8197,300,3.5
CN1714700000000,17,147,Piatt County, IL,Dec-17,8393,8084,309,3.7
CN1714700000000,17,147,Piatt County, IL,Jan-18,8337,7978,359,4.3
CN1714700000000,17,147,Piatt County, IL,Feb-18,8514,8178,336,3.9
CN1714700000000,17,147,Piatt County, IL,Mar-18,8721,8378,343,3.9
CN1714700000000,17,147,Piatt County, IL,Apr-18(p),8790,8499,291,3.3
CN3104700000000,31,047,Dawson County, NE,Mar-17,12775,12384,391,3.1
CN3104700000000,31,047,Dawson County, NE,Apr-17,12951,12596,355,2.7
CN3104700000000,31,047,Dawson County, NE,May-17,13038,12703,335,2.6
CN3104700000000,31,047,Dawson County, NE,Jun-17,13390,13016,374,2.8
CN3104700000000,31,047,Dawson County, NE,Jul-17,13177,12817,360,2.7
CN3104700000000,31,047,Dawson County, NE,Aug-17,12901,12564,337,2.6
CN3104700000000,31,047,Dawson County, NE,Sep-17,12573,12261,312,2.5
CN3104700000000,31,047,Dawson County, NE,Oct-17,12673,12354,319,2.5
CN3104700000000,31,047,Dawson County, NE,Nov-17,12673,12344,329,2.6
CN3104700000000,31,047,Dawson County, NE,Dec-17,12657,12302,355,2.8
CN3104700000000,31,047,Dawson County, NE,Jan-18,12847,12453,394,3.1
CN3104700000000,31,047,Dawson County, NE,Feb-18,12723,12324,399,3.1
CN3104700000000,31,047,Dawson County, NE,Mar-18,12840,12460,380,3.0
CN3104700000000,31,047,Dawson County, NE,Apr-18(p),12827,12458,369,2.9
CN0812300000000,08,123,Weld County, CO,Mar-17,153903,149778,4125,2.7
CN0812300000000,08,123,Weld County, CO,Apr-17,155640,151850,3790,2.4
CN0812300000000,08,123,Weld County, CO,May-17,156751,153042,3709,2.4
CN0812300000000,08,123,Weld County, CO,Jun-17,156503,152100,4403,2.8
CN0812300000000,08,123,Weld County, CO,Jul-17,156723,152555,4168,2.7
CN0812300000000,08,123,Weld County, CO,Aug-17,158212,154082,4130,2.6
CN0812300000000,08,123,Weld County, CO,Sep-17,160498,156519,3979,2.5
CN0812300000000,08,123,Weld County, CO,Oct-17,162068,157988,4080,2.5
CN0812300000000,08,123,Weld County, CO,Nov-17,161170,156986,4184,2.6
CN0812300000000,08,123,Weld County, CO,Dec-17,160310,156034,4276,2.7
CN0812300000000,08,123,Weld County, CO,Jan-18,159493,154520,4973,3.1
CN0812300000000,08,123,Weld County, CO,Feb-18,161730,156728,5002,3.1
CN0812300000000,08,123,Weld County, CO,Mar-18,161623,157258,4365,2.7
CN0812300000000,08,123,Weld County, CO,Apr-18(p),161754,157917,3837,2.4
CN2401900000000,24,019,Dorchester County, MD,Mar-17,15834,14834,1000,6.3
CN2401900000000,24,019,Dorchester County, MD,Apr-17,16070,15187,883,5.5
CN2401900000000,24,019,Dorchester County, MD,May-17,15798,14976,822,5.2
CN2401900000000,24,019,Dorchester County, MD,Jun-17,16238,15355,883,5.4
CN2401900000000,24,019,Dorchester County, MD,Jul-17,15972,15126,846,5.3
CN2401900000000,24,019,Dorchester County, MD,Aug-17,15357,14489,868,5.7
CN2401900000000,24,019,Dorchester County, MD,Sep-17,15441,14673,768,5.0
CN2401900000000,24,019,Dorchester County, MD,Oct-17,16055,15249,806,5.0
CN2401900000000,24,019,Dorchester County, MD,Nov-17,15648,14825,823,5.3
CN2401900000000,24,019,Dorchester County, MD,Dec-17,15353,14461,892,5.8
CN2401900000000,24,019,Dorchester County, MD,Jan-18,15458,14420,1038,6.7
CN2401900000000,24,019,Dorchester County, MD,Feb-18,15534,14491,1043,6.7
CN2401900000000,24,019,Dorchester County, MD,Mar-18,15508,14515,993,6.4
CN2401900000000,24,019,Dorchester County, MD,Apr-18(p),15581,14747,834,5.4
CN1803700000000,18,037,Dubois County, IN,Mar-17,23085,22465,620,2.7
CN1803700000000,18,037,Dubois County, IN,Apr-17,23057,22573,484,2.1
CN1803700000000,18,037,Dubois County, IN,May-17,23601,23056,545,2.3
CN1803700000000,18,037,Dubois County, IN,Jun-17,23975,23350,625,2.6
CN1803700000000,18,037,Dubois County, IN,Jul-17,23707,23062,645,2.7
CN1803700000000,18,037,Dubois County, IN,Aug-17,23369,22674,695,3.0
CN1803700000000,18,037,Dubois County, IN,Sep-17,22737,22188,549,2.4
CN1803700000000,18,037,Dubois County, IN,Oct-17,22974,22463,511,2.2
CN1803700000000,18,037,Dubois County, IN,Nov-17,23026,22494,532,2.3
CN1803700000000,18,037,Dubois County, IN,Dec-17,22952,22462,490,2.1
CN1803700000000,18,037,Dubois County, IN,Jan-18,22889,22299,590,2.6
CN1803700000000,18,037,Dubois County, IN,Feb-18,22843,22238,605,2.6
CN1803700000000,18,037,Dubois County, IN,Mar-18,23091,22564,527,2.3
CN1803700000000,18,037,Dubois County, IN,Apr-18(p),23158,22689,469,2.0
CN5108100000000,51,081,Greensville County, VA,Mar-17,4267,4070,197,4.6
CN5108100000000,51,081,Greensville County, VA,Apr-17,4317,4142,175,4.1
CN5108100000000,51,081,Greensville County, VA,May-17,4307,4127,180,4.2
CN5108100000000,51,081,Greensville County, VA,Jun-17,4327,4141,186,4.3
CN5108100000000,51,081,Greensville County, VA,Jul-17,4315,4115,200,4.6
CN5108100000000,51,081,Greensville County, VA,Aug-17,4271,4062,209,4.9
CN5108100000000,51,081,Greensville County, VA,Sep-17,4243,4049,194,4.6
CN5108100000000,51,081,Greensville County, VA,Oct-17,4287,4103,184,4.3
CN5108100000000,51,081,Greensville County, VA,Nov-17,4268,4084,184,4.3
CN5108100000000,51,081,Greensville County, VA,Dec-17,4295,4094,201,4.7
CN5108100000000,51,081,Greensville County, VA,Jan-18,4299,4095,204,4.7
CN5108100000000,51,081,Greensville County, VA,Feb-18,4231,4045,186,4.4
CN5108100000000,51,081,Greensville County, VA,Mar-18,4249,4077,172,4.0
CN5108100000000,51,081,Greensville County, VA,Apr-18(p),4260,4106,154,3.6
CN4819500000000,48,195,Hansford County, TX,Mar-17,2909,2829,80,2.8
CN4819500000000,48,195,Hansford County, TX,Apr-17,2901,2834,67,2.3
CN4819500000000,48,195,Hansford County, TX,May-17,2929,2857,72,2.5
CN4819500000000,48,195,Hansford County, TX,Jun-17,2917,2843,74,2.5
CN4819500000000,48,195,Hansford County, TX,Jul-17,2864,2789,75,2.6
CN4819500000000,48,195,Hansford County, TX,Aug-17,2880,2809,71,2.5
CN4819500000000,48,195,Hansford County, TX,Sep-17,2830,2770,60,2.1
CN4819500000000,48,195,Hansford County, TX,Oct-17,2849,2793,56,2.0
CN4819500000000,48,195,Hansford County, TX,Nov-17,2780,2717,63,2.3
CN4819500000000,48,195,Hansford County, TX,Dec-17,2800,2736,64,2.3
CN4819500000000,48,195,Hansford County, TX,Jan-18,2763,2687,76,2.8
CN4819500000000,48,195,Hansford County, TX,Feb-18,2820,2748,72,2.6
CN4819500000000,48,195,Hansford County, TX,Mar-18,2893,2821,72,2.5
CN4819500000000,48,195,Hansford County, TX,Apr-18(p),2876,2809,67,2.3
CN5114300000000,51,143,Pittsylvania County, VA,Mar-17,29705,28357,1348,4.5
CN5114300000000,51,143,Pittsylvania County, VA,Apr-17,29665,28416,1249,4.2
CN5114300000000,51,143,Pittsylvania County, VA,May-17,29638,28326,1312,4.4
CN5114300000000,51,143,Pittsylvania County, VA,Jun-17,29785,28376,1409,4.7
CN5114300000000,51,143,Pittsylvania County, VA,Jul-17,29454,28033,1421,4.8
CN5114300000000,51,143,Pittsylvania County, VA,Aug-17,29316,27929,1387,4.7
CN5114300000000,51,143,Pittsylvania County, VA,Sep-17,29532,28237,1295,4.4
CN5114300000000,51,143,Pittsylvania County, VA,Oct-17,29499,28292,1207,4.1
CN5114300000000,51,143,Pittsylvania County, VA,Nov-17,29507,28312,1195,4.0
CN5114300000000,51,143,Pittsylvania County, VA,Dec-17,29515,28332,1183,4.0
CN5114300000000,51,143,Pittsylvania County, VA,Jan-18,29207,27877,1330,4.6
CN5114300000000,51,143,Pittsylvania County, VA,Feb-18,29152,27935,1217,4.2
CN5114300000000,51,143,Pittsylvania County, VA,Mar-18,29446,28166,1280,4.3
CN5114300000000,51,143,Pittsylvania County, VA,Apr-18(p),29543,28355,1188,4.0
CN4210700000000,42,107,Schuylkill County, PA,Mar-17,66678,62367,4311,6.5
CN4210700000000,42,107,Schuylkill County, PA,Apr-17,66582,63003,3579,5.4
CN4210700000000,42,107,Schuylkill County, PA,May-17,66535,62773,3762,5.7
CN4210700000000,42,107,Schuylkill County, PA,Jun-17,67486,63508,3978,5.9
CN4210700000000,42,107,Schuylkill County, PA,Jul-17,67257,63100,4157,6.2
CN4210700000000,42,107,Schuylkill County, PA,Aug-17,66621,62516,4105,6.2
CN4210700000000,42,107,Schuylkill County, PA,Sep-17,65744,62319,3425,5.2
CN4210700000000,42,107,Schuylkill County, PA,Oct-17,64976,61655,3321,5.1
CN4210700000000,42,107,Schuylkill County, PA,Nov-17,64895,61457,3438,5.3
CN4210700000000,42,107,Schuylkill County, PA,Dec-17,65068,61557,3511,5.4
CN4210700000000,42,107,Schuylkill County, PA,Jan-18,65529,61280,4249,6.5
CN4210700000000,42,107,Schuylkill County, PA,Feb-18,65142,60999,4143,6.4
CN4210700000000,42,107,Schuylkill County, PA,Mar-18,64502,60862,3640,5.6
CN4210700000000,42,107,Schuylkill County, PA,Apr-18(p),64414,61259,3155,4.9
CN4713300000000,47,133,Overton County, TN,Mar-17,9612,9169,443,4.6
CN4713300000000,47,133,Overton County, TN,Apr-17,9552,9209,343,3.6
CN4713300000000,47,133,Overton County, TN,May-17,9499,9163,336,3.5
CN4713300000000,47,133,Overton County, TN,Jun-17,9503,9080,423,4.5
CN4713300000000,47,133,Overton County, TN,Jul-17,9451,9042,409,4.3
CN4713300000000,47,133,Overton County, TN,Aug-17,9605,9244,361,3.8
CN4713300000000,47,133,Overton County, TN,Sep-17,9722,9391,331,3.4
CN4713300000000,47,133,Overton County, TN,Oct-17,9681,9335,346,3.6
CN4713300000000,47,133,Overton County, TN,Nov-17,9668,9342,326,3.4
CN4713300000000,47,133,Overton County, TN,Dec-17,9639,9333,306,3.2
CN4713300000000,47,133,Overton County, TN,Jan-18,9639,9209,430,4.5
CN4713300000000,47,133,Overton County, TN,Feb-18,9782,9344,438,4.5
CN4713300000000,47,133,Overton County, TN,Mar-18,9721,9346,375,3.9
CN4713300000000,47,133,Overton County, TN,Apr-18(p),9787,9507,280,2.9
CN3110900000000,31,109,Lancaster County, NE,Mar-17,168932,164535,4397,2.6
CN3110900000000,31,109,Lancaster County, NE,Apr-17,168962,164693,4269,2.5
CN3110900000000,31,109,Lancaster County, NE,May-17,168593,164272,4321,2.6
CN3110900000000,31,109,Lancaster County, NE,Jun-17,167162,162290,4872,2.9
CN3110900000000,31,109,Lancaster County, NE,Jul-17,169122,164283,4839,2.9
CN3110900000000,31,109,Lancaster County, NE,Aug-17,169948,165365,4583,2.7
CN3110900000000,31,109,Lancaster County, NE,Sep-17,169234,164929,4305,2.5
CN3110900000000,31,109,Lancaster County, NE,Oct-17,169785,165750,4035,2.4
CN3110900000000,31,109,Lancaster County, NE,Nov-17,170062,166188,3874,2.3
CN3110900000000,31,109,Lancaster County, NE,Dec-17,169179,164985,4194,2.5
CN3110900000000,31,109,Lancaster County, NE,Jan-18,167106,162620,4486,2.7
CN3110900000000,31,109,Lancaster County, NE,Feb-18,170016,165627,4389,2.6
CN3110900000000,31,109,Lancaster County, NE,Mar-18,169655,165286,4369,2.6
CN3110900000000,31,109,Lancaster County, NE,Apr-18(p),170678,166252,4426,2.6
CN1909900000000,19,099,Jasper County, IA,Mar-17,19146,18456,690,3.6
CN1909900000000,19,099,Jasper County, IA,Apr-17,19318,18699,619,3.2
CN1909900000000,19,099,Jasper County, IA,May-17,19396,18805,591,3.0
CN1909900000000,19,099,Jasper County, IA,Jun-17,19586,18975,611,3.1
CN1909900000000,19,099,Jasper County, IA,Jul-17,19588,19018,570,2.9
CN1909900000000,19,099,Jasper County, IA,Aug-17,19143,18557,586,3.1
CN1909900000000,19,099,Jasper County, IA,Sep-17,19257,18720,537,2.8
CN1909900000000,19,099,Jasper County, IA,Oct-17,19250,18780,470,2.4
CN1909900000000,19,099,Jasper County, IA,Nov-17,19177,18716,461,2.4
CN1909900000000,19,099,Jasper County, IA,Dec-17,19074,18538,536,2.8
CN1909900000000,19,099,Jasper County, IA,Jan-18,19062,18368,694,3.6
CN1909900000000,19,099,Jasper County, IA,Feb-18,19131,18434,697,3.6
CN1909900000000,19,099,Jasper County, IA,Mar-18,19089,18503,586,3.1
CN1909900000000,19,099,Jasper County, IA,Apr-18(p),19160,18665,495,2.6
CN4802300000000,48,023,Baylor County, TX,Mar-17,1621,1560,61,3.8
CN4802300000000,48,023,Baylor County, TX,Apr-17,1592,1541,51,3.2
CN4802300000000,48,023,Baylor County, TX,May-17,1625,1575,50,3.1
CN4802300000000,48,023,Baylor County, TX,Jun-17,1656,1597,59,3.6
CN4802300000000,48,023,Baylor County, TX,Jul-17,1595,1533,62,3.9
CN4802300000000,48,023,Baylor County, TX,Aug-17,1595,1536,59,3.7
CN4802300000000,48,023,Baylor County, TX,Sep-17,1592,1544,48,3.0
CN4802300000000,48,023,Baylor County, TX,Oct-17,1601,1555,46,2.9
CN4802300000000,48,023,Baylor County, TX,Nov-17,1567,1519,48,3.1
CN4802300000000,48,023,Baylor County, TX,Dec-17,1575,1534,41,2.6
CN4802300000000,48,023,Baylor County, TX,Jan-18,1574,1528,46,2.9
CN4802300000000,48,023,Baylor County, TX,Feb-18,1590,1537,53,3.3
CN4802300000000,48,023,Baylor County, TX,Mar-18,1636,1581,55,3.4
CN4802300000000,48,023,Baylor County, TX,Apr-18(p),1584,1533,51,3.2
CN5505100000000,55,051,Iron County, WI,Mar-17,2636,2430,206,7.8
CN5505100000000,55,051,Iron County, WI,Apr-17,2585,2384,201,7.8
CN5505100000000,55,051,Iron County, WI,May-17,2601,2452,149,5.7
CN5505100000000,55,051,Iron County, WI,Jun-17,2696,2533,163,6.0
CN5505100000000,55,051,Iron County, WI,Jul-17,2608,2468,140,5.4
CN5505100000000,55,051,Iron County, WI,Aug-17,2606,2453,153,5.9
CN5505100000000,55,051,Iron County, WI,Sep-17,2606,2476,130,5.0
CN5505100000000,55,051,Iron County, WI,Oct-17,2614,2504,110,4.2
CN5505100000000,55,051,Iron County, WI,Nov-17,2605,2465,140,5.4
CN5505100000000,55,051,Iron County, WI,Dec-17,2600,2453,147,5.7
CN5505100000000,55,051,Iron County, WI,Jan-18,2650,2490,160,6.0
CN5505100000000,55,051,Iron County, WI,Feb-18,2655,2466,189,7.1
CN5505100000000,55,051,Iron County, WI,Mar-18,2634,2455,179,6.8
CN5505100000000,55,051,Iron County, WI,Apr-18(p),2595,2390,205,7.9
CN2500900000000,25,009,Essex County, MA,Mar-17,415992,398681,17311,4.2
CN2500900000000,25,009,Essex County, MA,Apr-17,414561,399235,15326,3.7
CN2500900000000,25,009,Essex County, MA,May-17,413205,397483,15722,3.8
CN2500900000000,25,009,Essex County, MA,Jun-17,418715,401655,17060,4.1
CN2500900000000,25,009,Essex County, MA,Jul-17,418813,402206,16607,4.0
CN2500900000000,25,009,Essex County, MA,Aug-17,416721,401352,15369,3.7
CN2500900000000,25,009,Essex County, MA,Sep-17,411924,397152,14772,3.6
CN2500900000000,25,009,Essex County, MA,Oct-17,412173,399135,13038,3.2
CN2500900000000,25,009,Essex County, MA,Nov-17,412997,400101,12896,3.1
CN2500900000000,25,009,Essex County, MA,Dec-17,412665,399564,13101,3.2
CN2500900000000,25,009,Essex County, MA,Jan-18,414598,398011,16587,4.0
CN2500900000000,25,009,Essex County, MA,Feb-18,420022,402969,17053,4.1
CN2500900000000,25,009,Essex County, MA,Mar-18,423434,407011,16423,3.9
CN2500900000000,25,009,Essex County, MA,Apr-18(p),425900,411489,14411,3.4
CN3607900000000,36,079,Putnam County, NY,Mar-17,51081,49003,2078,4.1
CN3607900000000,36,079,Putnam County, NY,Apr-17,51161,49196,1965,3.8
CN3607900000000,36,079,Putnam County, NY,May-17,51344,49298,2046,4.0
CN3607900000000,36,079,Putnam County, NY,Jun-17,52028,49801,2227,4.3
CN3607900000000,36,079,Putnam County, NY,Jul-17,52590,50273,2317,4.4
CN3607900000000,36,079,Putnam County, NY,Aug-17,51831,49548,2283,4.4
CN3607900000000,36,079,Putnam County, NY,Sep-17,51434,49189,2245,4.4
CN3607900000000,36,079,Putnam County, NY,Oct-17,51394,49273,2121,4.1
CN3607900000000,36,079,Putnam County, NY,Nov-17,51115,48982,2133,4.2
CN3607900000000,36,079,Putnam County, NY,Dec-17,50822,48722,2100,4.1
CN3607900000000,36,079,Putnam County, NY,Jan-18,50811,48405,2406,4.7
CN3607900000000,36,079,Putnam County, NY,Feb-18,50813,48284,2529,5.0
CN3607900000000,36,079,Putnam County, NY,Mar-18,50721,48465,2256,4.4
CN3607900000000,36,079,Putnam County, NY,Apr-18(p),50896,48873,2023,4.0
CN2611100000000,26,111,Midland County, MI,Mar-17,40578,38556,2022,5.0
CN2611100000000,26,111,Midland County, MI,Apr-17,40335,38665,1670,4.1
CN2611100000000,26,111,Midland County, MI,May-17,40665,38926,1739,4.3
CN2611100000000,26,111,Midland County, MI,Jun-17,41154,39265,1889,4.6
CN2611100000000,26,111,Midland County, MI,Jul-17,41057,38857,2200,5.4
CN2611100000000,26,111,Midland County, MI,Aug-17,40795,38758,2037,5.0
CN2611100000000,26,111,Midland County, MI,Sep-17,40219,38480,1739,4.3
CN2611100000000,26,111,Midland County, MI,Oct-17,39831,38210,1621,4.1
CN2611100000000,26,111,Midland County, MI,Nov-17,40201,38524,1677,4.2
CN2611100000000,26,111,Midland County, MI,Dec-17,39945,38093,1852,4.6
CN2611100000000,26,111,Midland County, MI,Jan-18,39778,37523,2255,5.7
CN2611100000000,26,111,Midland County, MI,Feb-18,40339,37997,2342,5.8
CN2611100000000,26,111,Midland County, MI,Mar-18,40307,38231,2076,5.2
CN2611100000000,26,111,Midland County, MI,Apr-18(p),40352,38575,1777,4.4
CN2016700000000,20,167,Russell County, KS,Mar-17,3459,3339,120,3.5
CN2016700000000,20,167,Russell County, KS,Apr-17,3446,3325,121,3.5
CN2016700000000,20,167,Russell County, KS,May-17,3447,3320,127,3.7
CN2016700000000,20,167,Russell County, KS,Jun-17,3566,3443,123,3.4
CN2016700000000,20,167,Russell County, KS,Jul-17,3579,3448,131,3.7
CN2016700000000,20,167,Russell County, KS,Aug-17,3504,3383,121,3.5
CN2016700000000,20,167,Russell County, KS,Sep-17,3469,3369,100,2.9
CN2016700000000,20,167,Russell County, KS,Oct-17,3544,3452,92,2.6
CN2016700000000,20,167,Russell County, KS,Nov-17,3526,3427,99,2.8
CN2016700000000,20,167,Russell County, KS,Dec-17,3493,3397,96,2.7
CN2016700000000,20,167,Russell County, KS,Jan-18,3467,3370,97,2.8
CN2016700000000,20,167,Russell County, KS,Feb-18,3462,3358,104,3.0
CN2016700000000,20,167,Russell County, KS,Mar-18,3477,3375,102,2.9
CN2016700000000,20,167,Russell County, KS,Apr-18(p),3406,3313,93,2.7
CN5307700000000,53,077,Yakima County, WA,Mar-17,123417,113478,9939,8.1
CN5307700000000,53,077,Yakima County, WA,Apr-17,124311,115968,8343,6.7
CN5307700000000,53,077,Yakima County, WA,May-17,124918,117136,7782,6.2
CN5307700000000,53,077,Yakima County, WA,Jun-17,132401,125418,6983,5.3
CN5307700000000,53,077,Yakima County, WA,Jul-17,135651,128962,6689,4.9
CN5307700000000,53,077,Yakima County, WA,Aug-17,131298,122933,8365,6.4
CN5307700000000,53,077,Yakima County, WA,Sep-17,135208,128993,6215,4.6
CN5307700000000,53,077,Yakima County, WA,Oct-17,131823,125526,6297,4.8
CN5307700000000,53,077,Yakima County, WA,Nov-17,122301,114820,7481,6.1
CN5307700000000,53,077,Yakima County, WA,Dec-17,121128,111286,9842,8.1
CN5307700000000,53,077,Yakima County, WA,Jan-18,119956,108959,10997,9.2
CN5307700000000,53,077,Yakima County, WA,Feb-18,123862,113459,10403,8.4
CN5307700000000,53,077,Yakima County, WA,Mar-18,126329,116845,9484,7.5
CN5307700000000,53,077,Yakima County, WA,Apr-18(p),127191,119057,8134,6.4
CN2115100000000,21,151,Madison County, KY,Mar-17,45625,43442,2183,4.8
CN2115100000000,21,151,Madison County, KY,Apr-17,45507,43586,1921,4.2
CN2115100000000,21,151,Madison County, KY,May-17,45539,43596,1943,4.3
CN2115100000000,21,151,Madison County, KY,Jun-17,46020,43656,2364,5.1
CN2115100000000,21,151,Madison County, KY,Jul-17,45021,42835,2186,4.9
CN2115100000000,21,151,Madison County, KY,Aug-17,44300,42343,1957,4.4
CN2115100000000,21,151,Madison County, KY,Sep-17,45622,43942,1680,3.7
CN2115100000000,21,151,Madison County, KY,Oct-17,45665,44128,1537,3.4
CN2115100000000,21,151,Madison County, KY,Nov-17,46066,44535,1531,3.3
CN2115100000000,21,151,Madison County, KY,Dec-17,46053,44524,1529,3.3
CN2115100000000,21,151,Madison County, KY,Jan-18,45247,43603,1644,3.6
CN2115100000000,21,151,Madison County, KY,Feb-18,45617,43686,1931,4.2
CN2115100000000,21,151,Madison County, KY,Mar-18,45697,43906,1791,3.9
CN2115100000000,21,151,Madison County, KY,Apr-18(p),45971,44392,1579,3.4
CN3501100000000,35,011,De Baca County, NM,Mar-17,824,790,34,4.1
CN3501100000000,35,011,De Baca County, NM,Apr-17,840,807,33,3.9
CN3501100000000,35,011,De Baca County, NM,May-17,835,798,37,4.4
CN3501100000000,35,011,De Baca County, NM,Jun-17,866,824,42,4.8
CN3501100000000,35,011,De Baca County, NM,Jul-17,851,807,44,5.2
CN3501100000000,35,011,De Baca County, NM,Aug-17,864,821,43,5.0
CN3501100000000,35,011,De Baca County, NM,Sep-17,859,816,43,5.0
CN3501100000000,35,011,De Baca County, NM,Oct-17,843,805,38,4.5
CN3501100000000,35,011,De Baca County, NM,Nov-17,831,793,38,4.6
CN3501100000000,35,011,De Baca County, NM,Dec-17,819,782,37,4.5
CN3501100000000,35,011,De Baca County, NM,Jan-18,815,779,36,4.4
CN3501100000000,35,011,De Baca County, NM,Feb-18,831,795,36,4.3
CN3501100000000,35,011,De Baca County, NM,Mar-18,832,798,34,4.1
CN3501100000000,35,011,De Baca County, NM,Apr-18(p),851,821,30,3.5
CN4210100000000,42,101,Philadelphia County/city, PA,Mar-17,704989,661512,43477,6.2
CN4210100000000,42,101,Philadelphia County/city, PA,Apr-17,703494,663052,40442,5.7
CN4210100000000,42,101,Philadelphia County/city, PA,May-17,703210,658857,44353,6.3
CN4210100000000,42,101,Philadelphia County/city, PA,Jun-17,699421,654896,44525,6.4
CN4210100000000,42,101,Philadelphia County/city, PA,Jul-17,707541,658962,48579,6.9
CN4210100000000,42,101,Philadelphia County/city, PA,Aug-17,702721,653754,48967,7.0
CN4210100000000,42,101,Philadelphia County/city, PA,Sep-17,705772,663396,42376,6.0
CN4210100000000,42,101,Philadelphia County/city, PA,Oct-17,705672,664317,41355,5.9
CN4210100000000,42,101,Philadelphia County/city, PA,Nov-17,706807,665510,41297,5.8
CN4210100000000,42,101,Philadelphia County/city, PA,Dec-17,699144,659824,39320,5.6
CN4210100000000,42,101,Philadelphia County/city, PA,Jan-18,700257,655987,44270,6.3
CN4210100000000,42,101,Philadelphia County/city, PA,Feb-18,703833,659323,44510,6.3
CN4210100000000,42,101,Philadelphia County/city, PA,Mar-18,696770,656427,40343,5.8
CN4210100000000,42,101,Philadelphia County/city, PA,Apr-18(p),698174,661967,36207,5.2
CN5406100000000,54,061,Monongalia County, WV,Mar-17,52169,50183,1986,3.8
CN5406100000000,54,061,Monongalia County, WV,Apr-17,52410,50651,1759,3.4
CN5406100000000,54,061,Monongalia County, WV,May-17,52375,50683,1692,3.2
CN5406100000000,54,061,Monongalia County, WV,Jun-17,50924,48803,2121,4.2
CN5406100000000,54,061,Monongalia County, WV,Jul-17,51597,49625,1972,3.8
CN5406100000000,54,061,Monongalia County, WV,Aug-17,51169,49031,2138,4.2
CN5406100000000,54,061,Monongalia County, WV,Sep-17,53085,51319,1766,3.3
CN5406100000000,54,061,Monongalia County, WV,Oct-17,53404,51618,1786,3.3
CN5406100000000,54,061,Monongalia County, WV,Nov-17,53094,51285,1809,3.4
CN5406100000000,54,061,Monongalia County, WV,Dec-17,52725,50859,1866,3.5
CN5406100000000,54,061,Monongalia County, WV,Jan-18,52603,50486,2117,4.0
CN5406100000000,54,061,Monongalia County, WV,Feb-18,53704,51263,2441,4.5
CN5406100000000,54,061,Monongalia County, WV,Mar-18,53431,51162,2269,4.2
CN5406100000000,54,061,Monongalia County, WV,Apr-18(p),53712,51648,2064,3.8
CN5114900000000,51,149,Prince George County, VA,Mar-17,15149,14455,694,4.6
CN5114900000000,51,149,Prince George County, VA,Apr-17,15158,14515,643,4.2
CN5114900000000,51,149,Prince George County, VA,May-17,15152,14523,629,4.2
CN5114900000000,51,149,Prince George County, VA,Jun-17,15252,14575,677,4.4
CN5114900000000,51,149,Prince George County, VA,Jul-17,15375,14685,690,4.5
CN5114900000000,51,149,Prince George County, VA,Aug-17,15234,14524,710,4.7
CN5114900000000,51,149,Prince George County, VA,Sep-17,15252,14603,649,4.3
CN5114900000000,51,149,Prince George County, VA,Oct-17,15165,14554,611,4.0
CN5114900000000,51,149,Prince George County, VA,Nov-17,15047,14426,621,4.1
CN5114900000000,51,149,Prince George County, VA,Dec-17,14991,14375,616,4.1
CN5114900000000,51,149,Prince George County, VA,Jan-18,14993,14359,634,4.2
CN5114900000000,51,149,Prince George County, VA,Feb-18,15152,14562,590,3.9
CN5114900000000,51,149,Prince George County, VA,Mar-18,15238,14644,594,3.9
CN5114900000000,51,149,Prince George County, VA,Apr-18(p),15243,14728,515,3.4
CN2004900000000,20,049,Elk County, KS,Mar-17,1210,1162,48,4.0
CN2004900000000,20,049,Elk County, KS,Apr-17,1187,1141,46,3.9
CN2004900000000,20,049,Elk County, KS,May-17,1172,1121,51,4.4
CN2004900000000,20,049,Elk County, KS,Jun-17,1237,1179,58,4.7
CN2004900000000,20,049,Elk County, KS,Jul-17,1103,1033,70,6.3
CN2004900000000,20,049,Elk County, KS,Aug-17,1118,1058,60,5.4
CN2004900000000,20,049,Elk County, KS,Sep-17,1206,1157,49,4.1
CN2004900000000,20,049,Elk County, KS,Oct-17,1239,1196,43,3.5
CN2004900000000,20,049,Elk County, KS,Nov-17,1222,1184,38,3.1
CN2004900000000,20,049,Elk County, KS,Dec-17,1224,1191,33,2.7
CN2004900000000,20,049,Elk County, KS,Jan-18,1195,1156,39,3.3
CN2004900000000,20,049,Elk County, KS,Feb-18,1188,1143,45,3.8
CN2004900000000,20,049,Elk County, KS,Mar-18,1211,1170,41,3.4
CN2004900000000,20,049,Elk County, KS,Apr-18(p),1165,1127,38,3.3
CN3251000000000,32,510,Carson City, NV,Mar-17,25128,23713,1415,5.6
CN3251000000000,32,510,Carson City, NV,Apr-17,25409,24060,1349,5.3
CN3251000000000,32,510,Carson City, NV,May-17,25596,24340,1256,4.9
CN3251000000000,32,510,Carson City, NV,Jun-17,25769,24545,1224,4.7
CN3251000000000,32,510,Carson City, NV,Jul-17,25907,24685,1222,4.7
CN3251000000000,32,510,Carson City, NV,Aug-17,25761,24601,1160,4.5
CN3251000000000,32,510,Carson City, NV,Sep-17,25785,24616,1169,4.5
CN3251000000000,32,510,Carson City, NV,Oct-17,25850,24690,1160,4.5
CN3251000000000,32,510,Carson City, NV,Nov-17,25897,24714,1183,4.6
CN3251000000000,32,510,Carson City, NV,Dec-17,26054,24837,1217,4.7
CN3251000000000,32,510,Carson City, NV,Jan-18,25860,24356,1504,5.8
CN3251000000000,32,510,Carson City, NV,Feb-18,26299,24749,1550,5.9
CN3251000000000,32,510,Carson City, NV,Mar-18,26285,24788,1497,5.7
CN3251000000000,32,510,Carson City, NV,Apr-18(p),26249,24872,1377,5.2
CN3607300000000,36,073,Orleans County, NY,Mar-17,17841,16710,1131,6.3
CN3607300000000,36,073,Orleans County, NY,Apr-17,17879,16887,992,5.5
CN3607300000000,36,073,Orleans County, NY,May-17,17574,16619,955,5.4
CN3607300000000,36,073,Orleans County, NY,Jun-17,17890,16878,1012,5.7
CN3607300000000,36,073,Orleans County, NY,Jul-17,17847,16782,1065,6.0
CN3607300000000,36,073,Orleans County, NY,Aug-17,17730,16675,1055,6.0
CN3607300000000,36,073,Orleans County, NY,Sep-17,17648,16735,913,5.2
CN3607300000000,36,073,Orleans County, NY,Oct-17,17674,16751,923,5.2
CN3607300000000,36,073,Orleans County, NY,Nov-17,17889,16864,1025,5.7
CN3607300000000,36,073,Orleans County, NY,Dec-17,17799,16701,1098,6.2
CN3607300000000,36,073,Orleans County, NY,Jan-18,18105,16795,1310,7.2
CN3607300000000,36,073,Orleans County, NY,Feb-18,18003,16675,1328,7.4
CN3607300000000,36,073,Orleans County, NY,Mar-18,17613,16433,1180,6.7
CN3607300000000,36,073,Orleans County, NY,Apr-18(p),17632,16628,1004,5.7
CN2810700000000,28,107,Panola County, MS,Mar-17,13072,12244,828,6.3
CN2810700000000,28,107,Panola County, MS,Apr-17,12968,12130,838,6.5
CN2810700000000,28,107,Panola County, MS,May-17,13038,12082,956,7.3
CN2810700000000,28,107,Panola County, MS,Jun-17,13187,12119,1068,8.1
CN2810700000000,28,107,Panola County, MS,Jul-17,13294,12246,1048,7.9
CN2810700000000,28,107,Panola County, MS,Aug-17,12987,12143,844,6.5
CN2810700000000,28,107,Panola County, MS,Sep-17,13003,12151,852,6.6
CN2810700000000,28,107,Panola County, MS,Oct-17,12884,12091,793,6.2
CN2810700000000,28,107,Panola County, MS,Nov-17,12932,12191,741,5.7
CN2810700000000,28,107,Panola County, MS,Dec-17,12950,12188,762,5.9
CN2810700000000,28,107,Panola County, MS,Jan-18,12705,11913,792,6.2
CN2810700000000,28,107,Panola County, MS,Feb-18,12713,11952,761,6.0
CN2810700000000,28,107,Panola County, MS,Mar-18,12742,11997,745,5.8
CN2810700000000,28,107,Panola County, MS,Apr-18(p),12773,12065,708,5.5
CN4200700000000,42,007,Beaver County, PA,Mar-17,84895,79788,5107,6.0
CN4200700000000,42,007,Beaver County, PA,Apr-17,84791,80415,4376,5.2
CN4200700000000,42,007,Beaver County, PA,May-17,85020,80379,4641,5.5
CN4200700000000,42,007,Beaver County, PA,Jun-17,85543,80665,4878,5.7
CN4200700000000,42,007,Beaver County, PA,Jul-17,86100,81044,5056,5.9
CN4200700000000,42,007,Beaver County, PA,Aug-17,85087,80131,4956,5.8
CN4200700000000,42,007,Beaver County, PA,Sep-17,84650,80636,4014,4.7
CN4200700000000,42,007,Beaver County, PA,Oct-17,84220,80288,3932,4.7
CN4200700000000,42,007,Beaver County, PA,Nov-17,84741,80659,4082,4.8
CN4200700000000,42,007,Beaver County, PA,Dec-17,84304,80181,4123,4.9
CN4200700000000,42,007,Beaver County, PA,Jan-18,84177,79195,4982,5.9
CN4200700000000,42,007,Beaver County, PA,Feb-18,84090,79211,4879,5.8
CN4200700000000,42,007,Beaver County, PA,Mar-18,83243,78987,4256,5.1
CN4200700000000,42,007,Beaver County, PA,Apr-18(p),83340,79786,3554,4.3
CN1201500000000,12,015,Charlotte County, FL,Mar-17,71265,68010,3255,4.6
CN1201500000000,12,015,Charlotte County, FL,Apr-17,70616,67554,3062,4.3
CN1201500000000,12,015,Charlotte County, FL,May-17,70321,67109,3212,4.6
CN1201500000000,12,015,Charlotte County, FL,Jun-17,70237,66896,3341,4.8
CN1201500000000,12,015,Charlotte County, FL,Jul-17,69814,66424,3390,4.9
CN1201500000000,12,015,Charlotte County, FL,Aug-17,69768,66358,3410,4.9
CN1201500000000,12,015,Charlotte County, FL,Sep-17,69607,66401,3206,4.6
CN1201500000000,12,015,Charlotte County, FL,Oct-17,70010,67015,2995,4.3
CN1201500000000,12,015,Charlotte County, FL,Nov-17,70596,67653,2943,4.2
CN1201500000000,12,015,Charlotte County, FL,Dec-17,70386,67593,2793,4.0
CN1201500000000,12,015,Charlotte County, FL,Jan-18,70670,67505,3165,4.5
CN1201500000000,12,015,Charlotte County, FL,Feb-18,71288,68401,2887,4.0
CN1201500000000,12,015,Charlotte County, FL,Mar-18,71663,68817,2846,4.0
CN1201500000000,12,015,Charlotte County, FL,Apr-18(p),71110,68510,2600,3.7
CN4812300000000,48,123,DeWitt County, TX,Mar-17,9604,9110,494,5.1
CN4812300000000,48,123,DeWitt County, TX,Apr-17,9568,9119,449,4.7
CN4812300000000,48,123,DeWitt County, TX,May-17,9537,9113,424,4.4
CN4812300000000,48,123,DeWitt County, TX,Jun-17,9672,9244,428,4.4
CN4812300000000,48,123,DeWitt County, TX,Jul-17,9707,9292,415,4.3
CN4812300000000,48,123,DeWitt County, TX,Aug-17,9663,9259,404,4.2
CN4812300000000,48,123,DeWitt County, TX,Sep-17,9694,9323,371,3.8
CN4812300000000,48,123,DeWitt County, TX,Oct-17,9597,9257,340,3.5
CN4812300000000,48,123,DeWitt County, TX,Nov-17,9492,9153,339,3.6
CN4812300000000,48,123,DeWitt County, TX,Dec-17,9478,9144,334,3.5
CN4812300000000,48,123,DeWitt County, TX,Jan-18,9546,9196,350,3.7
CN4812300000000,48,123,DeWitt County, TX,Feb-18,9718,9370,348,3.6
CN4812300000000,48,123,DeWitt County, TX,Mar-18,9759,9417,342,3.5
CN4812300000000,48,123,DeWitt County, TX,Apr-18(p),9736,9425,311,3.2
CN1803100000000,18,031,Decatur County, IN,Mar-17,14652,14184,468,3.2
CN1803100000000,18,031,Decatur County, IN,Apr-17,14568,14213,355,2.4
CN1803100000000,18,031,Decatur County, IN,May-17,14809,14422,387,2.6
CN1803100000000,18,031,Decatur County, IN,Jun-17,14992,14565,427,2.8
CN1803100000000,18,031,Decatur County, IN,Jul-17,14925,14483,442,3.0
CN1803100000000,18,031,Decatur County, IN,Aug-17,14798,14312,486,3.3
CN1803100000000,18,031,Decatur County, IN,Sep-17,14420,14053,367,2.5
CN1803100000000,18,031,Decatur County, IN,Oct-17,14606,14256,350,2.4
CN1803100000000,18,031,Decatur County, IN,Nov-17,14654,14287,367,2.5
CN1803100000000,18,031,Decatur County, IN,Dec-17,14564,14202,362,2.5
CN1803100000000,18,031,Decatur County, IN,Jan-18,14538,14071,467,3.2
CN1803100000000,18,031,Decatur County, IN,Feb-18,14488,13988,500,3.5
CN1803100000000,18,031,Decatur County, IN,Mar-18,14618,14179,439,3.0
CN1803100000000,18,031,Decatur County, IN,Apr-18(p),14638,14266,372,2.5
CN2705500000000,27,055,Houston County, MN,Mar-17,10756,10255,501,4.7
CN2705500000000,27,055,Houston County, MN,Apr-17,10718,10369,349,3.3
CN2705500000000,27,055,Houston County, MN,May-17,10603,10308,295,2.8
CN2705500000000,27,055,Houston County, MN,Jun-17,10522,10197,325,3.1
CN2705500000000,27,055,Houston County, MN,Jul-17,10447,10152,295,2.8
CN2705500000000,27,055,Houston County, MN,Aug-17,10316,10032,284,2.8
CN2705500000000,27,055,Houston County, MN,Sep-17,10423,10170,253,2.4
CN2705500000000,27,055,Houston County, MN,Oct-17,10688,10473,215,2.0
CN2705500000000,27,055,Houston County, MN,Nov-17,10712,10467,245,2.3
CN2705500000000,27,055,Houston County, MN,Dec-17,10703,10353,350,3.3
CN2705500000000,27,055,Houston County, MN,Jan-18,10728,10215,513,4.8
CN2705500000000,27,055,Houston County, MN,Feb-18,10944,10449,495,4.5
CN2705500000000,27,055,Houston County, MN,Mar-18,10782,10341,441,4.1
CN2705500000000,27,055,Houston County, MN,Apr-18(p),10901,10574,327,3.0
CN5511900000000,55,119,Taylor County, WI,Mar-17,11222,10686,536,4.8
CN5511900000000,55,119,Taylor County, WI,Apr-17,11152,10738,414,3.7
CN5511900000000,55,119,Taylor County, WI,May-17,11170,10859,311,2.8
CN5511900000000,55,119,Taylor County, WI,Jun-17,11724,11377,347,3.0
CN5511900000000,55,119,Taylor County, WI,Jul-17,11314,10982,332,2.9
CN5511900000000,55,119,Taylor County, WI,Aug-17,11099,10802,297,2.7
CN5511900000000,55,119,Taylor County, WI,Sep-17,11125,10846,279,2.5
CN5511900000000,55,119,Taylor County, WI,Oct-17,11340,11079,261,2.3
CN5511900000000,55,119,Taylor County, WI,Nov-17,11289,11012,277,2.5
CN5511900000000,55,119,Taylor County, WI,Dec-17,11349,10960,389,3.4
CN5511900000000,55,119,Taylor County, WI,Jan-18,11441,10998,443,3.9
CN5511900000000,55,119,Taylor County, WI,Feb-18,11272,10791,481,4.3
CN5511900000000,55,119,Taylor County, WI,Mar-18,11421,10942,479,4.2
CN5511900000000,55,119,Taylor County, WI,Apr-18(p),11416,11043,373,3.3
CN4840300000000,48,403,Sabine County, TX,Mar-17,3518,3191,327,9.3
CN4840300000000,48,403,Sabine County, TX,Apr-17,3533,3221,312,8.8
CN4840300000000,48,403,Sabine County, TX,May-17,3566,3285,281,7.9
CN4840300000000,48,403,Sabine County, TX,Jun-17,3588,3287,301,8.4
CN4840300000000,48,403,Sabine County, TX,Jul-17,3582,3281,301,8.4
CN4840300000000,48,403,Sabine County, TX,Aug-17,3541,3247,294,8.3
CN4840300000000,48,403,Sabine County, TX,Sep-17,3551,3289,262,7.4
CN4840300000000,48,403,Sabine County, TX,Oct-17,3493,3256,237,6.8
CN4840300000000,48,403,Sabine County, TX,Nov-17,3521,3258,263,7.5
CN4840300000000,48,403,Sabine County, TX,Dec-17,3518,3223,295,8.4
CN4840300000000,48,403,Sabine County, TX,Jan-18,3589,3249,340,9.5
CN4840300000000,48,403,Sabine County, TX,Feb-18,3585,3283,302,8.4
CN4840300000000,48,403,Sabine County, TX,Mar-18,3595,3295,300,8.3
CN4840300000000,48,403,Sabine County, TX,Apr-18(p),3696,3418,278,7.5
CN0202000000000,02,020,Anchorage Borough/municipality, AK,Mar-17,154761,145099,9662,6.2
CN0202000000000,02,020,Anchorage Borough/municipality, AK,Apr-17,154372,145041,9331,6.0
CN0202000000000,02,020,Anchorage Borough/municipality, AK,May-17,155891,146550,9341,6.0
CN0202000000000,02,020,Anchorage Borough/municipality, AK,Jun-17,156681,146947,9734,6.2
CN0202000000000,02,020,Anchorage Borough/municipality, AK,Jul-17,156520,147472,9048,5.8
CN0202000000000,02,020,Anchorage Borough/municipality, AK,Aug-17,153682,145057,8625,5.6
CN0202000000000,02,020,Anchorage Borough/municipality, AK,Sep-17,154363,145201,9162,5.9
CN0202000000000,02,020,Anchorage Borough/municipality, AK,Oct-17,155078,146083,8995,5.8
CN0202000000000,02,020,Anchorage Borough/municipality, AK,Nov-17,156453,147238,9215,5.9
CN0202000000000,02,020,Anchorage Borough/municipality, AK,Dec-17,156235,147186,9049,5.8
CN0202000000000,02,020,Anchorage Borough/municipality, AK,Jan-18,155127,145262,9865,6.4
CN0202000000000,02,020,Anchorage Borough/municipality, AK,Feb-18,154349,144071,10278,6.7
CN0202000000000,02,020,Anchorage Borough/municipality, AK,Mar-18,154127,144306,9821,6.4
CN0202000000000,02,020,Anchorage Borough/municipality, AK,Apr-18(p),153388,143857,9531,6.2
CN1307700000000,13,077,Coweta County, GA,Mar-17,72129,69031,3098,4.3
CN1307700000000,13,077,Coweta County, GA,Apr-17,72069,69174,2895,4.0
CN1307700000000,13,077,Coweta County, GA,May-17,72270,69318,2952,4.1
CN1307700000000,13,077,Coweta County, GA,Jun-17,72604,69267,3337,4.6
CN1307700000000,13,077,Coweta County, GA,Jul-17,73111,69724,3387,4.6
CN1307700000000,13,077,Coweta County, GA,Aug-17,72553,69397,3156,4.3
CN1307700000000,13,077,Coweta County, GA,Sep-17,73123,70317,2806,3.8
CN1307700000000,13,077,Coweta County, GA,Oct-17,72855,70064,2791,3.8
CN1307700000000,13,077,Coweta County, GA,Nov-17,72973,70314,2659,3.6
CN1307700000000,13,077,Coweta County, GA,Dec-17,72955,70288,2667,3.7
CN1307700000000,13,077,Coweta County, GA,Jan-18,72937,70166,2771,3.8
CN1307700000000,13,077,Coweta County, GA,Feb-18,74120,71273,2847,3.8
CN1307700000000,13,077,Coweta County, GA,Mar-18,74187,71526,2661,3.6
CN1307700000000,13,077,Coweta County, GA,Apr-18(p),73901,71313,2588,3.5
CN4830900000000,48,309,McLennan County, TX,Mar-17,118004,113470,4534,3.8
CN4830900000000,48,309,McLennan County, TX,Apr-17,117744,113685,4059,3.4
CN4830900000000,48,309,McLennan County, TX,May-17,117607,113336,4271,3.6
CN4830900000000,48,309,McLennan County, TX,Jun-17,118904,113598,5306,4.5
CN4830900000000,48,309,McLennan County, TX,Jul-17,118738,113439,5299,4.5
CN4830900000000,48,309,McLennan County, TX,Aug-17,118472,113402,5070,4.3
CN4830900000000,48,309,McLennan County, TX,Sep-17,118756,114370,4386,3.7
CN4830900000000,48,309,McLennan County, TX,Oct-17,117192,113180,4012,3.4
CN4830900000000,48,309,McLennan County, TX,Nov-17,117529,113435,4094,3.5
CN4830900000000,48,309,McLennan County, TX,Dec-17,117432,113594,3838,3.3
CN4830900000000,48,309,McLennan County, TX,Jan-18,117594,113204,4390,3.7
CN4830900000000,48,309,McLennan County, TX,Feb-18,118790,114373,4417,3.7
CN4830900000000,48,309,McLennan County, TX,Mar-18,119027,114578,4449,3.7
CN4830900000000,48,309,McLennan County, TX,Apr-18(p),119214,115118,4096,3.4
CN0107300000000,01,073,Jefferson County, AL,Mar-17,310767,295808,14959,4.8
CN0107300000000,01,073,Jefferson County, AL,Apr-17,309476,297037,12439,4.0
CN0107300000000,01,073,Jefferson County, AL,May-17,308850,296841,12009,3.9
CN0107300000000,01,073,Jefferson County, AL,Jun-17,311010,296557,14453,4.6
CN0107300000000,01,073,Jefferson County, AL,Jul-17,310540,296905,13635,4.4
CN0107300000000,01,073,Jefferson County, AL,Aug-17,307333,294626,12707,4.1
CN0107300000000,01,073,Jefferson County, AL,Sep-17,307641,296726,10915,3.5
CN0107300000000,01,073,Jefferson County, AL,Oct-17,307885,297065,10820,3.5
CN0107300000000,01,073,Jefferson County, AL,Nov-17,307309,297181,10128,3.3
CN0107300000000,01,073,Jefferson County, AL,Dec-17,306817,296984,9833,3.2
CN0107300000000,01,073,Jefferson County, AL,Jan-18,306504,294657,11847,3.9
CN0107300000000,01,073,Jefferson County, AL,Feb-18,310509,298247,12262,3.9
CN0107300000000,01,073,Jefferson County, AL,Mar-18,311021,299745,11276,3.6
CN0107300000000,01,073,Jefferson County, AL,Apr-18(p),314407,304020,10387,3.3
CN1211500000000,12,115,Sarasota County, FL,Mar-17,186581,179409,7172,3.8
CN1211500000000,12,115,Sarasota County, FL,Apr-17,185048,178254,6794,3.7
CN1211500000000,12,115,Sarasota County, FL,May-17,185643,178600,7043,3.8
CN1211500000000,12,115,Sarasota County, FL,Jun-17,185763,178389,7374,4.0
CN1211500000000,12,115,Sarasota County, FL,Jul-17,186060,178563,7497,4.0
CN1211500000000,12,115,Sarasota County, FL,Aug-17,185765,178310,7455,4.0
CN1211500000000,12,115,Sarasota County, FL,Sep-17,187055,180137,6918,3.7
CN1211500000000,12,115,Sarasota County, FL,Oct-17,186364,179793,6571,3.5
CN1211500000000,12,115,Sarasota County, FL,Nov-17,187098,180596,6502,3.5
CN1211500000000,12,115,Sarasota County, FL,Dec-17,186007,179881,6126,3.3
CN1211500000000,12,115,Sarasota County, FL,Jan-18,187160,179987,7173,3.8
CN1211500000000,12,115,Sarasota County, FL,Feb-18,189213,182646,6567,3.5
CN1211500000000,12,115,Sarasota County, FL,Mar-18,189892,183461,6431,3.4
CN1211500000000,12,115,Sarasota County, FL,Apr-18(p),188912,183081,5831,3.1
CN0502500000000,05,025,Cleveland County, AR,Mar-17,3321,3172,149,4.5
CN0502500000000,05,025,Cleveland County, AR,Apr-17,3344,3208,136,4.1
CN0502500000000,05,025,Cleveland County, AR,May-17,3349,3205,144,4.3
CN0502500000000,05,025,Cleveland County, AR,Jun-17,3367,3207,160,4.8
CN0502500000000,05,025,Cleveland County, AR,Jul-17,3372,3205,167,5.0
CN0502500000000,05,025,Cleveland County, AR,Aug-17,3305,3151,154,4.7
CN0502500000000,05,025,Cleveland County, AR,Sep-17,3311,3168,143,4.3
CN0502500000000,05,025,Cleveland County, AR,Oct-17,3319,3191,128,3.9
CN0502500000000,05,025,Cleveland County, AR,Nov-17,3294,3173,121,3.7
CN0502500000000,05,025,Cleveland County, AR,Dec-17,3259,3133,126,3.9
CN0502500000000,05,025,Cleveland County, AR,Jan-18,3172,3029,143,4.5
CN0502500000000,05,025,Cleveland County, AR,Feb-18,3245,3088,157,4.8
CN0502500000000,05,025,Cleveland County, AR,Mar-18,3252,3105,147,4.5
CN0502500000000,05,025,Cleveland County, AR,Apr-18(p),3246,3114,132,4.1
CN1205300000000,12,053,Hernando County, FL,Mar-17,69000,65438,3562,5.2
CN1205300000000,12,053,Hernando County, FL,Apr-17,68839,65467,3372,4.9
CN1205300000000,12,053,Hernando County, FL,May-17,69146,65646,3500,5.1
CN1205300000000,12,053,Hernando County, FL,Jun-17,69701,65994,3707,5.3
CN1205300000000,12,053,Hernando County, FL,Jul-17,69921,66186,3735,5.3
CN1205300000000,12,053,Hernando County, FL,Aug-17,69644,65956,3688,5.3
CN1205300000000,12,053,Hernando County, FL,Sep-17,70500,67120,3380,4.8
CN1205300000000,12,053,Hernando County, FL,Oct-17,69861,66595,3266,4.7
CN1205300000000,12,053,Hernando County, FL,Nov-17,69583,66287,3296,4.7
CN1205300000000,12,053,Hernando County, FL,Dec-17,69125,66001,3124,4.5
CN1205300000000,12,053,Hernando County, FL,Jan-18,69831,66176,3655,5.2
CN1205300000000,12,053,Hernando County, FL,Feb-18,70319,66984,3335,4.7
CN1205300000000,12,053,Hernando County, FL,Mar-18,70521,67206,3315,4.7
CN1205300000000,12,053,Hernando County, FL,Apr-18(p),70204,67256,2948,4.2
CN4600500000000,46,005,Beadle County, SD,Mar-17,9302,9005,297,3.2
CN4600500000000,46,005,Beadle County, SD,Apr-17,9267,9002,265,2.9
CN4600500000000,46,005,Beadle County, SD,May-17,9380,9124,256,2.7
CN4600500000000,46,005,Beadle County, SD,Jun-17,9631,9373,258,2.7
CN4600500000000,46,005,Beadle County, SD,Jul-17,9548,9296,252,2.6
CN4600500000000,46,005,Beadle County, SD,Aug-17,9467,9191,276,2.9
CN4600500000000,46,005,Beadle County, SD,Sep-17,9372,9137,235,2.5
CN4600500000000,46,005,Beadle County, SD,Oct-17,9318,9088,230,2.5
CN4600500000000,46,005,Beadle County, SD,Nov-17,9314,9053,261,2.8
CN4600500000000,46,005,Beadle County, SD,Dec-17,9275,9008,267,2.9
CN4600500000000,46,005,Beadle County, SD,Jan-18,9287,8980,307,3.3
CN4600500000000,46,005,Beadle County, SD,Feb-18,9288,8971,317,3.4
CN4600500000000,46,005,Beadle County, SD,Mar-18,9343,9040,303,3.2
CN4600500000000,46,005,Beadle County, SD,Apr-18(p),9384,9091,293,3.1
CN2701700000000,27,017,Carlton County, MN,Mar-17,17986,16850,1136,6.3
CN2701700000000,27,017,Carlton County, MN,Apr-17,17926,17003,923,5.1
CN2701700000000,27,017,Carlton County, MN,May-17,17774,17022,752,4.2
CN2701700000000,27,017,Carlton County, MN,Jun-17,17726,16965,761,4.3
CN2701700000000,27,017,Carlton County, MN,Jul-17,17784,17079,705,4.0
CN2701700000000,27,017,Carlton County, MN,Aug-17,17694,16956,738,4.2
CN2701700000000,27,017,Carlton County, MN,Sep-17,17853,17240,613,3.4
CN2701700000000,27,017,Carlton County, MN,Oct-17,17723,17181,542,3.1
CN2701700000000,27,017,Carlton County, MN,Nov-17,17928,17171,757,4.2
CN2701700000000,27,017,Carlton County, MN,Dec-17,17943,17022,921,5.1
CN2701700000000,27,017,Carlton County, MN,Jan-18,18207,17124,1083,5.9
CN2701700000000,27,017,Carlton County, MN,Feb-18,18408,17356,1052,5.7
CN2701700000000,27,017,Carlton County, MN,Mar-18,18325,17267,1058,5.8
CN2701700000000,27,017,Carlton County, MN,Apr-18(p),18196,17304,892,4.9
CN2910100000000,29,101,Johnson County, MO,Mar-17,23301,22117,1184,5.1
CN2910100000000,29,101,Johnson County, MO,Apr-17,23558,22676,882,3.7
CN2910100000000,29,101,Johnson County, MO,May-17,23196,22237,959,4.1
CN2910100000000,29,101,Johnson County, MO,Jun-17,23354,22306,1048,4.5
CN2910100000000,29,101,Johnson County, MO,Jul-17,22671,21561,1110,4.9
CN2910100000000,29,101,Johnson County, MO,Aug-17,22727,21537,1190,5.2
CN2910100000000,29,101,Johnson County, MO,Sep-17,23219,22319,900,3.9
CN2910100000000,29,101,Johnson County, MO,Oct-17,23364,22522,842,3.6
CN2910100000000,29,101,Johnson County, MO,Nov-17,23221,22326,895,3.9
CN2910100000000,29,101,Johnson County, MO,Dec-17,22915,22077,838,3.7
CN2910100000000,29,101,Johnson County, MO,Jan-18,23208,22064,1144,4.9
CN2910100000000,29,101,Johnson County, MO,Feb-18,23210,22188,1022,4.4
CN2910100000000,29,101,Johnson County, MO,Mar-18,23222,22201,1021,4.4
CN2910100000000,29,101,Johnson County, MO,Apr-18(p),23590,22729,861,3.6
CN3606900000000,36,069,Ontario County, NY,Mar-17,55477,52724,2753,5.0
CN3606900000000,36,069,Ontario County, NY,Apr-17,55545,53159,2386,4.3
CN3606900000000,36,069,Ontario County, NY,May-17,55065,52791,2274,4.1
CN3606900000000,36,069,Ontario County, NY,Jun-17,55701,53309,2392,4.3
CN3606900000000,36,069,Ontario County, NY,Jul-17,55247,52958,2289,4.1
CN3606900000000,36,069,Ontario County, NY,Aug-17,54691,52459,2232,4.1
CN3606900000000,36,069,Ontario County, NY,Sep-17,55127,52818,2309,4.2
CN3606900000000,36,069,Ontario County, NY,Oct-17,55005,52753,2252,4.1
CN3606900000000,36,069,Ontario County, NY,Nov-17,54902,52473,2429,4.4
CN3606900000000,36,069,Ontario County, NY,Dec-17,54697,52117,2580,4.7
CN3606900000000,36,069,Ontario County, NY,Jan-18,55263,52169,3094,5.6
CN3606900000000,36,069,Ontario County, NY,Feb-18,55260,51980,3280,5.9
CN3606900000000,36,069,Ontario County, NY,Mar-18,54793,51830,2963,5.4
CN3606900000000,36,069,Ontario County, NY,Apr-18(p),55009,52525,2484,4.5
CN1331300000000,13,313,Whitfield County, GA,Mar-17,45520,42918,2602,5.7
CN1331300000000,13,313,Whitfield County, GA,Apr-17,45187,42904,2283,5.1
CN1331300000000,13,313,Whitfield County, GA,May-17,45130,42881,2249,5.0
CN1331300000000,13,313,Whitfield County, GA,Jun-17,45204,42769,2435,5.4
CN1331300000000,13,313,Whitfield County, GA,Jul-17,45592,43129,2463,5.4
CN1331300000000,13,313,Whitfield County, GA,Aug-17,45164,42730,2434,5.4
CN1331300000000,13,313,Whitfield County, GA,Sep-17,45631,43265,2366,5.2
CN1331300000000,13,313,Whitfield County, GA,Oct-17,44886,42694,2192,4.9
CN1331300000000,13,313,Whitfield County, GA,Nov-17,45034,42705,2329,5.2
CN1331300000000,13,313,Whitfield County, GA,Dec-17,45260,42783,2477,5.5
CN1331300000000,13,313,Whitfield County, GA,Jan-18,46192,43152,3040,6.6
CN1331300000000,13,313,Whitfield County, GA,Feb-18,46249,43812,2437,5.3
CN1331300000000,13,313,Whitfield County, GA,Mar-18,46419,44010,2409,5.2
CN1331300000000,13,313,Whitfield County, GA,Apr-18(p),45793,43865,1928,4.2
CN5176000000000,51,760,Richmond city, VA,Mar-17,116650,111489,5161,4.4
CN5176000000000,51,760,Richmond city, VA,Apr-17,116424,111672,4752,4.1
CN5176000000000,51,760,Richmond city, VA,May-17,116651,111830,4821,4.1
CN5176000000000,51,760,Richmond city, VA,Jun-17,117381,112204,5177,4.4
CN5176000000000,51,760,Richmond city, VA,Jul-17,118253,112930,5323,4.5
CN5176000000000,51,760,Richmond city, VA,Aug-17,117295,111785,5510,4.7
CN5176000000000,51,760,Richmond city, VA,Sep-17,117340,112307,5033,4.3
CN5176000000000,51,760,Richmond city, VA,Oct-17,116692,111985,4707,4.0
CN5176000000000,51,760,Richmond city, VA,Nov-17,115927,111201,4726,4.1
CN5176000000000,51,760,Richmond city, VA,Dec-17,115459,110771,4688,4.1
CN5176000000000,51,760,Richmond city, VA,Jan-18,115750,110789,4961,4.3
CN5176000000000,51,760,Richmond city, VA,Feb-18,116990,112360,4630,4.0
CN5176000000000,51,760,Richmond city, VA,Mar-18,117778,113169,4609,3.9
CN5176000000000,51,760,Richmond city, VA,Apr-18(p),117611,113590,4021,3.4
CN5303300000000,53,033,King County, WA,Mar-17,1224700,1182117,42583,3.5
CN5303300000000,53,033,King County, WA,Apr-17,1227418,1189460,37958,3.1
CN5303300000000,53,033,King County, WA,May-17,1228019,1186109,41910,3.4
CN5303300000000,53,033,King County, WA,Jun-17,1230345,1182631,47714,3.9
CN5303300000000,53,033,King County, WA,Jul-17,1232519,1183889,48630,3.9
CN5303300000000,53,033,King County, WA,Aug-17,1234778,1185216,49562,4.0
CN5303300000000,53,033,King County, WA,Sep-17,1243541,1194503,49038,3.9
CN5303300000000,53,033,King County, WA,Oct-17,1233449,1187086,46363,3.8
CN5303300000000,53,033,King County, WA,Nov-17,1238402,1189433,48969,4.0
CN5303300000000,53,033,King County, WA,Dec-17,1238973,1194852,44121,3.6
CN5303300000000,53,033,King County, WA,Jan-18,1253814,1202575,51239,4.1
CN5303300000000,53,033,King County, WA,Feb-18,1273452,1225831,47621,3.7
CN5303300000000,53,033,King County, WA,Mar-18,1263381,1221014,42367,3.4
CN5303300000000,53,033,King County, WA,Apr-18(p),1255309,1217258,38051,3.0
CN1325100000000,13,251,Screven County, GA,Mar-17,5262,4916,346,6.6
CN1325100000000,13,251,Screven County, GA,Apr-17,5305,4969,336,6.3
CN1325100000000,13,251,Screven County, GA,May-17,5324,4980,344,6.5
CN1325100000000,13,251,Screven County, GA,Jun-17,5329,4967,362,6.8
CN1325100000000,13,251,Screven County, GA,Jul-17,5241,4889,352,6.7
CN1325100000000,13,251,Screven County, GA,Aug-17,5252,4922,330,6.3
CN1325100000000,13,251,Screven County, GA,Sep-17,5250,4936,314,6.0
CN1325100000000,13,251,Screven County, GA,Oct-17,5243,4952,291,5.6
CN1325100000000,13,251,Screven County, GA,Nov-17,5251,4961,290,5.5
CN1325100000000,13,251,Screven County, GA,Dec-17,5267,4955,312,5.9
CN1325100000000,13,251,Screven County, GA,Jan-18,5386,5026,360,6.7
CN1325100000000,13,251,Screven County, GA,Feb-18,5398,5086,312,5.8
CN1325100000000,13,251,Screven County, GA,Mar-18,5410,5094,316,5.8
CN1325100000000,13,251,Screven County, GA,Apr-18(p),5366,5116,250,4.7
CN7202100000000,72,021,Bayamon Municipio, PR,Mar-17,66637,61450,5187,7.8
CN7202100000000,72,021,Bayamon Municipio, PR,Apr-17,66265,60975,5290,8.0
CN7202100000000,72,021,Bayamon Municipio, PR,May-17,65115,60490,4625,7.1
CN7202100000000,72,021,Bayamon Municipio, PR,Jun-17,64379,60098,4281,6.6
CN7202100000000,72,021,Bayamon Municipio, PR,Jul-17,64518,59793,4725,7.3
CN7202100000000,72,021,Bayamon Municipio, PR,Aug-17,64280,59005,5275,8.2
CN7202100000000,72,021,Bayamon Municipio, PR,Sep-17(y),64782,59792,4990,7.7
CN7202100000000,72,021,Bayamon Municipio, PR,Oct-17,62082,57373,4709,7.6
CN7202100000000,72,021,Bayamon Municipio, PR,Nov-17,65400,60811,4589,7.0
CN7202100000000,72,021,Bayamon Municipio, PR,Dec-17,65702,61345,4357,6.6
CN7202100000000,72,021,Bayamon Municipio, PR,Jan-18,64978,60193,4785,7.4
CN7202100000000,72,021,Bayamon Municipio, PR,Feb-18,64883,60387,4496,6.9
CN7202100000000,72,021,Bayamon Municipio, PR,Mar-18,64857,60434,4423,6.8
CN7202100000000,72,021,Bayamon Municipio, PR,Apr-18(p),65257,60921,4336,6.6
CN1720300000000,17,203,Woodford County, IL,Mar-17,18758,17822,936,5.0
CN1720300000000,17,203,Woodford County, IL,Apr-17,19024,18279,745,3.9
CN1720300000000,17,203,Woodford County, IL,May-17,18950,18238,712,3.8
CN1720300000000,17,203,Woodford County, IL,Jun-17,19140,18369,771,4.0
CN1720300000000,17,203,Woodford County, IL,Jul-17,19025,18217,808,4.2
CN1720300000000,17,203,Woodford County, IL,Aug-17,18925,18142,783,4.1
CN1720300000000,17,203,Woodford County, IL,Sep-17,18738,18069,669,3.6
CN1720300000000,17,203,Woodford County, IL,Oct-17,18748,18081,667,3.6
CN1720300000000,17,203,Woodford County, IL,Nov-17,18714,18015,699,3.7
CN1720300000000,17,203,Woodford County, IL,Dec-17,18571,17872,699,3.8
CN1720300000000,17,203,Woodford County, IL,Jan-18,18420,17603,817,4.4
CN1720300000000,17,203,Woodford County, IL,Feb-18,18598,17840,758,4.1
CN1720300000000,17,203,Woodford County, IL,Mar-18,19029,18258,771,4.1
CN1720300000000,17,203,Woodford County, IL,Apr-18(p),19055,18458,597,3.1
CN4704900000000,47,049,Fentress County, TN,Mar-17,7118,6780,338,4.7
CN4704900000000,47,049,Fentress County, TN,Apr-17,7117,6825,292,4.1
CN4704900000000,47,049,Fentress County, TN,May-17,7053,6765,288,4.1
CN4704900000000,47,049,Fentress County, TN,Jun-17,7033,6682,351,5.0
CN4704900000000,47,049,Fentress County, TN,Jul-17,7083,6740,343,4.8
CN4704900000000,47,049,Fentress County, TN,Aug-17,7249,6927,322,4.4
CN4704900000000,47,049,Fentress County, TN,Sep-17,7243,6957,286,3.9
CN4704900000000,47,049,Fentress County, TN,Oct-17,7134,6866,268,3.8
CN4704900000000,47,049,Fentress County, TN,Nov-17,7092,6824,268,3.8
CN4704900000000,47,049,Fentress County, TN,Dec-17,7095,6821,274,3.9
CN4704900000000,47,049,Fentress County, TN,Jan-18,7050,6733,317,4.5
CN4704900000000,47,049,Fentress County, TN,Feb-18,7098,6794,304,4.3
CN4704900000000,47,049,Fentress County, TN,Mar-18,7048,6753,295,4.2
CN4704900000000,47,049,Fentress County, TN,Apr-18(p),7098,6850,248,3.5
CN4802900000000,48,029,Bexar County, TX,Mar-17,919684,885827,33857,3.7
CN4802900000000,48,029,Bexar County, TX,Apr-17,920596,890184,30412,3.3
CN4802900000000,48,029,Bexar County, TX,May-17,918701,887260,31441,3.4
CN4802900000000,48,029,Bexar County, TX,Jun-17,924596,889886,34710,3.8
CN4802900000000,48,029,Bexar County, TX,Jul-17,931436,896372,35064,3.8
CN4802900000000,48,029,Bexar County, TX,Aug-17,926317,892049,34268,3.7
CN4802900000000,48,029,Bexar County, TX,Sep-17,935530,905236,30294,3.2
CN4802900000000,48,029,Bexar County, TX,Oct-17,926764,898497,28267,3.1
CN4802900000000,48,029,Bexar County, TX,Nov-17,929074,899727,29347,3.2
CN4802900000000,48,029,Bexar County, TX,Dec-17,929498,901526,27972,3.0
CN4802900000000,48,029,Bexar County, TX,Jan-18,929605,897744,31861,3.4
CN4802900000000,48,029,Bexar County, TX,Feb-18,943677,911026,32651,3.5
CN4802900000000,48,029,Bexar County, TX,Mar-18,941377,908651,32726,3.5
CN4802900000000,48,029,Bexar County, TX,Apr-18(p),942333,912593,29740,3.2
CN5407700000000,54,077,Preston County, WV,Mar-17,15126,14311,815,5.4
CN5407700000000,54,077,Preston County, WV,Apr-17,15209,14507,702,4.6
CN5407700000000,54,077,Preston County, WV,May-17,15113,14478,635,4.2
CN5407700000000,54,077,Preston County, WV,Jun-17,14724,14017,707,4.8
CN5407700000000,54,077,Preston County, WV,Jul-17,14886,14170,716,4.8
CN5407700000000,54,077,Preston County, WV,Aug-17,14779,14039,740,5.0
CN5407700000000,54,077,Preston County, WV,Sep-17,15346,14681,665,4.3
CN5407700000000,54,077,Preston County, WV,Oct-17,15433,14774,659,4.3
CN5407700000000,54,077,Preston County, WV,Nov-17,15303,14585,718,4.7
CN5407700000000,54,077,Preston County, WV,Dec-17,15123,14344,779,5.2
CN5407700000000,54,077,Preston County, WV,Jan-18,15197,14327,870,5.7
CN5407700000000,54,077,Preston County, WV,Feb-18,15570,14624,946,6.1
CN5407700000000,54,077,Preston County, WV,Mar-18,15463,14588,875,5.7
CN5407700000000,54,077,Preston County, WV,Apr-18(p),15592,14767,825,5.3
CN5505700000000,55,057,Juneau County, WI,Mar-17,13528,12958,570,4.2
CN5505700000000,55,057,Juneau County, WI,Apr-17,13590,13172,418,3.1
CN5505700000000,55,057,Juneau County, WI,May-17,13688,13296,392,2.9
CN5505700000000,55,057,Juneau County, WI,Jun-17,14284,13807,477,3.3
CN5505700000000,55,057,Juneau County, WI,Jul-17,13939,13495,444,3.2
CN5505700000000,55,057,Juneau County, WI,Aug-17,13810,13364,446,3.2
CN5505700000000,55,057,Juneau County, WI,Sep-17,13657,13285,372,2.7
CN5505700000000,55,057,Juneau County, WI,Oct-17,13610,13260,350,2.6
CN5505700000000,55,057,Juneau County, WI,Nov-17,13479,13108,371,2.8
CN5505700000000,55,057,Juneau County, WI,Dec-17,13515,13112,403,3.0
CN5505700000000,55,057,Juneau County, WI,Jan-18,13506,13065,441,3.3
CN5505700000000,55,057,Juneau County, WI,Feb-18,13580,13076,504,3.7
CN5505700000000,55,057,Juneau County, WI,Mar-18,13724,13226,498,3.6
CN5505700000000,55,057,Juneau County, WI,Apr-18(p),13878,13494,384,2.8
CN2709900000000,27,099,Mower County, MN,Mar-17,20568,19829,739,3.6
CN2709900000000,27,099,Mower County, MN,Apr-17,20702,20109,593,2.9
CN2709900000000,27,099,Mower County, MN,May-17,20803,20262,541,2.6
CN2709900000000,27,099,Mower County, MN,Jun-17,21008,20400,608,2.9
CN2709900000000,27,099,Mower County, MN,Jul-17,20552,20006,546,2.7
CN2709900000000,27,099,Mower County, MN,Aug-17,20489,19934,555,2.7
CN2709900000000,27,099,Mower County, MN,Sep-17,20379,19914,465,2.3
CN2709900000000,27,099,Mower County, MN,Oct-17,20492,20103,389,1.9
CN2709900000000,27,099,Mower County, MN,Nov-17,20476,20041,435,2.1
CN2709900000000,27,099,Mower County, MN,Dec-17,20481,19939,542,2.6
CN2709900000000,27,099,Mower County, MN,Jan-18,20642,19921,721,3.5
CN2709900000000,27,099,Mower County, MN,Feb-18,20733,20026,707,3.4
CN2709900000000,27,099,Mower County, MN,Mar-18,20792,20097,695,3.3
CN2709900000000,27,099,Mower County, MN,Apr-18(p),20807,20256,551,2.6
CN4608700000000,46,087,McCook County, SD,Mar-17,3160,3057,103,3.3
CN4608700000000,46,087,McCook County, SD,Apr-17,3176,3087,89,2.8
CN4608700000000,46,087,McCook County, SD,May-17,3176,3093,83,2.6
CN4608700000000,46,087,McCook County, SD,Jun-17,3221,3137,84,2.6
CN4608700000000,46,087,McCook County, SD,Jul-17,3205,3129,76,2.4
CN4608700000000,46,087,McCook County, SD,Aug-17,3141,3057,84,2.7
CN4608700000000,46,087,McCook County, SD,Sep-17,3110,3042,68,2.2
CN4608700000000,46,087,McCook County, SD,Oct-17,3115,3045,70,2.2
CN4608700000000,46,087,McCook County, SD,Nov-17,3112,3029,83,2.7
CN4608700000000,46,087,McCook County, SD,Dec-17,3143,3045,98,3.1
CN4608700000000,46,087,McCook County, SD,Jan-18,3151,3043,108,3.4
CN4608700000000,46,087,McCook County, SD,Feb-18,3186,3074,112,3.5
CN4608700000000,46,087,McCook County, SD,Mar-18,3209,3109,100,3.1
CN4608700000000,46,087,McCook County, SD,Apr-18(p),3171,3077,94,3.0
CN1323900000000,13,239,Quitman County, GA,Mar-17,829,786,43,5.2
CN1323900000000,13,239,Quitman County, GA,Apr-17,823,783,40,4.9
CN1323900000000,13,239,Quitman County, GA,May-17,843,796,47,5.6
CN1323900000000,13,239,Quitman County, GA,Jun-17,829,776,53,6.4
CN1323900000000,13,239,Quitman County, GA,Jul-17,829,776,53,6.4
CN1323900000000,13,239,Quitman County, GA,Aug-17,827,772,55,6.7
CN1323900000000,13,239,Quitman County, GA,Sep-17,835,786,49,5.9
CN1323900000000,13,239,Quitman County, GA,Oct-17,827,776,51,6.2
CN1323900000000,13,239,Quitman County, GA,Nov-17,823,776,47,5.7
CN1323900000000,13,239,Quitman County, GA,Dec-17,829,780,49,5.9
CN1323900000000,13,239,Quitman County, GA,Jan-18,829,778,51,6.2
CN1323900000000,13,239,Quitman County, GA,Feb-18,827,781,46,5.6
CN1323900000000,13,239,Quitman County, GA,Mar-18,838,790,48,5.7
CN1323900000000,13,239,Quitman County, GA,Apr-18(p),833,794,39,4.7
CN2717300000000,27,173,Yellow Medicine County, MN,Mar-17,5405,5177,228,4.2
CN2717300000000,27,173,Yellow Medicine County, MN,Apr-17,5332,5163,169,3.2
CN2717300000000,27,173,Yellow Medicine County, MN,May-17,5345,5190,155,2.9
CN2717300000000,27,173,Yellow Medicine County, MN,Jun-17,5450,5255,195,3.6
CN2717300000000,27,173,Yellow Medicine County, MN,Jul-17,5296,5127,169,3.2
CN2717300000000,27,173,Yellow Medicine County, MN,Aug-17,5182,4997,185,3.6
CN2717300000000,27,173,Yellow Medicine County, MN,Sep-17,5183,5036,147,2.8
CN2717300000000,27,173,Yellow Medicine County, MN,Oct-17,5382,5252,130,2.4
CN2717300000000,27,173,Yellow Medicine County, MN,Nov-17,5339,5186,153,2.9
CN2717300000000,27,173,Yellow Medicine County, MN,Dec-17,5363,5158,205,3.8
CN2717300000000,27,173,Yellow Medicine County, MN,Jan-18,5291,5035,256,4.8
CN2717300000000,27,173,Yellow Medicine County, MN,Feb-18,5268,5038,230,4.4
CN2717300000000,27,173,Yellow Medicine County, MN,Mar-18,5289,5060,229,4.3
CN2717300000000,27,173,Yellow Medicine County, MN,Apr-18(p),5288,5123,165,3.1
CN5115300000000,51,153,Prince William County, VA,Mar-17,239470,230851,8619,3.6
CN5115300000000,51,153,Prince William County, VA,Apr-17,239364,231660,7704,3.2
CN5115300000000,51,153,Prince William County, VA,May-17,240523,232454,8069,3.4
CN5115300000000,51,153,Prince William County, VA,Jun-17,241811,233360,8451,3.5
CN5115300000000,51,153,Prince William County, VA,Jul-17,243455,234972,8483,3.5
CN5115300000000,51,153,Prince William County, VA,Aug-17,239953,231497,8456,3.5
CN5115300000000,51,153,Prince William County, VA,Sep-17,240225,232379,7846,3.3
CN5115300000000,51,153,Prince William County, VA,Oct-17,239792,232421,7371,3.1
CN5115300000000,51,153,Prince William County, VA,Nov-17,239683,232324,7359,3.1
CN5115300000000,51,153,Prince William County, VA,Dec-17,238780,231697,7083,3.0
CN5115300000000,51,153,Prince William County, VA,Jan-18,240980,233035,7945,3.3
CN5115300000000,51,153,Prince William County, VA,Feb-18,242955,235559,7396,3.0
CN5115300000000,51,153,Prince William County, VA,Mar-18,243568,236178,7390,3.0
CN5115300000000,51,153,Prince William County, VA,Apr-18(p),242835,236613,6222,2.6
CN7200900000000,72,009,Aibonito Municipio, PR,Mar-17,6636,5708,928,14.0
CN7200900000000,72,009,Aibonito Municipio, PR,Apr-17,6566,5600,966,14.7
CN7200900000000,72,009,Aibonito Municipio, PR,May-17,6523,5657,866,13.3
CN7200900000000,72,009,Aibonito Municipio, PR,Jun-17,6458,5658,800,12.4
CN7200900000000,72,009,Aibonito Municipio, PR,Jul-17,6626,5721,905,13.7
CN7200900000000,72,009,Aibonito Municipio, PR,Aug-17,6654,5659,995,15.0
CN7200900000000,72,009,Aibonito Municipio, PR,Sep-17(y),6565,5639,926,14.1
CN7200900000000,72,009,Aibonito Municipio, PR,Oct-17,6343,5359,984,15.5
CN7200900000000,72,009,Aibonito Municipio, PR,Nov-17,6739,5728,1011,15.0
CN7200900000000,72,009,Aibonito Municipio, PR,Dec-17,6735,5745,990,14.7
CN7200900000000,72,009,Aibonito Municipio, PR,Jan-18,6770,5601,1169,17.3
CN7200900000000,72,009,Aibonito Municipio, PR,Feb-18,6557,5552,1005,15.3
CN7200900000000,72,009,Aibonito Municipio, PR,Mar-18,6431,5579,852,13.2
CN7200900000000,72,009,Aibonito Municipio, PR,Apr-18(p),6403,5625,778,12.2
CN1812100000000,18,121,Parke County, IN,Mar-17,7079,6767,312,4.4
CN1812100000000,18,121,Parke County, IN,Apr-17,7151,6900,251,3.5
CN1812100000000,18,121,Parke County, IN,May-17,7442,7178,264,3.5
CN1812100000000,18,121,Parke County, IN,Jun-17,7490,7218,272,3.6
CN1812100000000,18,121,Parke County, IN,Jul-17,7325,7050,275,3.8
CN1812100000000,18,121,Parke County, IN,Aug-17,7275,6972,303,4.2
CN1812100000000,18,121,Parke County, IN,Sep-17,7136,6873,263,3.7
CN1812100000000,18,121,Parke County, IN,Oct-17,7173,6934,239,3.3
CN1812100000000,18,121,Parke County, IN,Nov-17,7124,6885,239,3.4
CN1812100000000,18,121,Parke County, IN,Dec-17,7025,6776,249,3.5
CN1812100000000,18,121,Parke County, IN,Jan-18,6854,6537,317,4.6
CN1812100000000,18,121,Parke County, IN,Feb-18,6902,6586,316,4.6
CN1812100000000,18,121,Parke County, IN,Mar-18,6975,6714,261,3.7
CN1812100000000,18,121,Parke County, IN,Apr-18(p),7070,6828,242,3.4
CN4001100000000,40,011,Blaine County, OK,Mar-17,4403,4265,138,3.1
CN4001100000000,40,011,Blaine County, OK,Apr-17,4442,4314,128,2.9
CN4001100000000,40,011,Blaine County, OK,May-17,4578,4430,148,3.2
CN4001100000000,40,011,Blaine County, OK,Jun-17,4665,4502,163,3.5
CN4001100000000,40,011,Blaine County, OK,Jul-17,4730,4580,150,3.2
CN4001100000000,40,011,Blaine County, OK,Aug-17,4869,4740,129,2.6
CN4001100000000,40,011,Blaine County, OK,Sep-17,4942,4816,126,2.5
CN4001100000000,40,011,Blaine County, OK,Oct-17,4599,4481,118,2.6
CN4001100000000,40,011,Blaine County, OK,Nov-17,4559,4456,103,2.3
CN4001100000000,40,011,Blaine County, OK,Dec-17,4516,4415,101,2.2
CN4001100000000,40,011,Blaine County, OK,Jan-18,4514,4403,111,2.5
CN4001100000000,40,011,Blaine County, OK,Feb-18,4932,4819,113,2.3
CN4001100000000,40,011,Blaine County, OK,Mar-18,4910,4806,104,2.1
CN4001100000000,40,011,Blaine County, OK,Apr-18(p),4886,4788,98,2.0
CN2102300000000,21,023,Bracken County, KY,Mar-17,3936,3648,288,7.3
CN2102300000000,21,023,Bracken County, KY,Apr-17,3928,3689,239,6.1
CN2102300000000,21,023,Bracken County, KY,May-17,3911,3696,215,5.5
CN2102300000000,21,023,Bracken County, KY,Jun-17,3947,3709,238,6.0
CN2102300000000,21,023,Bracken County, KY,Jul-17,3908,3689,219,5.6
CN2102300000000,21,023,Bracken County, KY,Aug-17,3852,3650,202,5.2
CN2102300000000,21,023,Bracken County, KY,Sep-17,3829,3658,171,4.5
CN2102300000000,21,023,Bracken County, KY,Oct-17,3808,3656,152,4.0
CN2102300000000,21,023,Bracken County, KY,Nov-17,3809,3648,161,4.2
CN2102300000000,21,023,Bracken County, KY,Dec-17,3803,3631,172,4.5
CN2102300000000,21,023,Bracken County, KY,Jan-18,3842,3607,235,6.1
CN2102300000000,21,023,Bracken County, KY,Feb-18,3863,3634,229,5.9
CN2102300000000,21,023,Bracken County, KY,Mar-18,3895,3687,208,5.3
CN2102300000000,21,023,Bracken County, KY,Apr-18(p),3877,3714,163,4.2
CN5601900000000,56,019,Johnson County, WY,Mar-17,4003,3786,217,5.4
CN5601900000000,56,019,Johnson County, WY,Apr-17,3998,3827,171,4.3
CN5601900000000,56,019,Johnson County, WY,May-17,4134,3976,158,3.8
CN5601900000000,56,019,Johnson County, WY,Jun-17,4483,4316,167,3.7
CN5601900000000,56,019,Johnson County, WY,Jul-17,4500,4356,144,3.2
CN5601900000000,56,019,Johnson County, WY,Aug-17,4405,4268,137,3.1
CN5601900000000,56,019,Johnson County, WY,Sep-17,4271,4129,142,3.3
CN5601900000000,56,019,Johnson County, WY,Oct-17,4242,4089,153,3.6
CN5601900000000,56,019,Johnson County, WY,Nov-17,4171,4025,146,3.5
CN5601900000000,56,019,Johnson County, WY,Dec-17,4070,3909,161,4.0
CN5601900000000,56,019,Johnson County, WY,Jan-18,4081,3867,214,5.2
CN5601900000000,56,019,Johnson County, WY,Feb-18,4057,3857,200,4.9
CN5601900000000,56,019,Johnson County, WY,Mar-18,4048,3875,173,4.3
CN5601900000000,56,019,Johnson County, WY,Apr-18(p),4031,3864,167,4.1
CN2206700000000,22,067,Morehouse Parish, LA,Mar-17,10483,9588,895,8.5
CN2206700000000,22,067,Morehouse Parish, LA,Apr-17,10395,9521,874,8.4
CN2206700000000,22,067,Morehouse Parish, LA,May-17,10439,9569,870,8.3
CN2206700000000,22,067,Morehouse Parish, LA,Jun-17,10587,9671,916,8.7
CN2206700000000,22,067,Morehouse Parish, LA,Jul-17,10482,9616,866,8.3
CN2206700000000,22,067,Morehouse Parish, LA,Aug-17,10357,9508,849,8.2
CN2206700000000,22,067,Morehouse Parish, LA,Sep-17,10389,9625,764,7.4
CN2206700000000,22,067,Morehouse Parish, LA,Oct-17,10346,9678,668,6.5
CN2206700000000,22,067,Morehouse Parish, LA,Nov-17,10297,9646,651,6.3
CN2206700000000,22,067,Morehouse Parish, LA,Dec-17,10305,9624,681,6.6
CN2206700000000,22,067,Morehouse Parish, LA,Jan-18,10408,9617,791,7.6
CN2206700000000,22,067,Morehouse Parish, LA,Feb-18,10465,9700,765,7.3
CN2206700000000,22,067,Morehouse Parish, LA,Mar-18,10576,9738,838,7.9
CN2206700000000,22,067,Morehouse Parish, LA,Apr-18(p),10435,9653,782,7.5
CN1700300000000,17,003,Alexander County, IL,Mar-17,2150,1987,163,7.6
CN1700300000000,17,003,Alexander County, IL,Apr-17,2145,2001,144,6.7
CN1700300000000,17,003,Alexander County, IL,May-17,2134,1978,156,7.3
CN1700300000000,17,003,Alexander County, IL,Jun-17,2187,1990,197,9.0
CN1700300000000,17,003,Alexander County, IL,Jul-17,2135,1933,202,9.5
CN1700300000000,17,003,Alexander County, IL,Aug-17,2163,1965,198,9.2
CN1700300000000,17,003,Alexander County, IL,Sep-17,2164,2002,162,7.5
CN1700300000000,17,003,Alexander County, IL,Oct-17,2160,2012,148,6.9
CN1700300000000,17,003,Alexander County, IL,Nov-17,2190,2025,165,7.5
CN1700300000000,17,003,Alexander County, IL,Dec-17,2182,2028,154,7.1
CN1700300000000,17,003,Alexander County, IL,Jan-18,2162,1998,164,7.6
CN1700300000000,17,003,Alexander County, IL,Feb-18,2184,2033,151,6.9
CN1700300000000,17,003,Alexander County, IL,Mar-18,2218,2060,158,7.1
CN1700300000000,17,003,Alexander County, IL,Apr-18(p),2205,2073,132,6.0
CN4105500000000,41,055,Sherman County, OR,Mar-17,895,848,47,5.3
CN4105500000000,41,055,Sherman County, OR,Apr-17,906,863,43,4.7
CN4105500000000,41,055,Sherman County, OR,May-17,901,862,39,4.3
CN4105500000000,41,055,Sherman County, OR,Jun-17,940,895,45,4.8
CN4105500000000,41,055,Sherman County, OR,Jul-17,940,895,45,4.8
CN4105500000000,41,055,Sherman County, OR,Aug-17,909,862,47,5.2
CN4105500000000,41,055,Sherman County, OR,Sep-17,917,877,40,4.4
CN4105500000000,41,055,Sherman County, OR,Oct-17,881,839,42,4.8
CN4105500000000,41,055,Sherman County, OR,Nov-17,857,822,35,4.1
CN4105500000000,41,055,Sherman County, OR,Dec-17,874,840,34,3.9
CN4105500000000,41,055,Sherman County, OR,Jan-18,866,827,39,4.5
CN4105500000000,41,055,Sherman County, OR,Feb-18,867,827,40,4.6
CN4105500000000,41,055,Sherman County, OR,Mar-18,874,835,39,4.5
CN4105500000000,41,055,Sherman County, OR,Apr-18(p),865,832,33,3.8
CN0510500000000,05,105,Perry County, AR,Mar-17,4184,4004,180,4.3
CN0510500000000,05,105,Perry County, AR,Apr-17,4194,4034,160,3.8
CN0510500000000,05,105,Perry County, AR,May-17,4212,4042,170,4.0
CN0510500000000,05,105,Perry County, AR,Jun-17,4254,4081,173,4.1
CN0510500000000,05,105,Perry County, AR,Jul-17,4302,4123,179,4.2
CN0510500000000,05,105,Perry County, AR,Aug-17,4221,4056,165,3.9
CN0510500000000,05,105,Perry County, AR,Sep-17,4195,4036,159,3.8
CN0510500000000,05,105,Perry County, AR,Oct-17,4190,4039,151,3.6
CN0510500000000,05,105,Perry County, AR,Nov-17,4186,4030,156,3.7
CN0510500000000,05,105,Perry County, AR,Dec-17,4160,3994,166,4.0
CN0510500000000,05,105,Perry County, AR,Jan-18,4121,3910,211,5.1
CN0510500000000,05,105,Perry County, AR,Feb-18,4173,3957,216,5.2
CN0510500000000,05,105,Perry County, AR,Mar-18,4181,3995,186,4.4
CN0510500000000,05,105,Perry County, AR,Apr-18(p),4153,3990,163,3.9
CN7209900000000,72,099,Moca Municipio, PR,Mar-17,10989,9341,1648,15.0
CN7209900000000,72,099,Moca Municipio, PR,Apr-17,10905,9193,1712,15.7
CN7209900000000,72,099,Moca Municipio, PR,May-17,10798,9247,1551,14.4
CN7209900000000,72,099,Moca Municipio, PR,Jun-17,10633,9211,1422,13.4
CN7209900000000,72,099,Moca Municipio, PR,Jul-17,10794,9223,1571,14.6
CN7209900000000,72,099,Moca Municipio, PR,Aug-17,10814,9154,1660,15.4
CN7209900000000,72,099,Moca Municipio, PR,Sep-17(y),10676,9136,1540,14.4
CN7209900000000,72,099,Moca Municipio, PR,Oct-17,10488,8834,1654,15.8
CN7209900000000,72,099,Moca Municipio, PR,Nov-17,10875,9371,1504,13.8
CN7209900000000,72,099,Moca Municipio, PR,Dec-17,10858,9451,1407,13.0
CN7209900000000,72,099,Moca Municipio, PR,Jan-18,10809,9303,1506,13.9
CN7209900000000,72,099,Moca Municipio, PR,Feb-18,10584,9226,1358,12.8
CN7209900000000,72,099,Moca Municipio, PR,Mar-18,10616,9279,1337,12.6
CN7209900000000,72,099,Moca Municipio, PR,Apr-18(p),10635,9343,1292,12.1
CN3907700000000,39,077,Huron County, OH,Mar-17,28485,26215,2270,8.0
CN3907700000000,39,077,Huron County, OH,Apr-17,28187,26448,1739,6.2
CN3907700000000,39,077,Huron County, OH,May-17,28172,26720,1452,5.2
CN3907700000000,39,077,Huron County, OH,Jun-17,28747,27104,1643,5.7
CN3907700000000,39,077,Huron County, OH,Jul-17,28418,26198,2220,7.8
CN3907700000000,39,077,Huron County, OH,Aug-17,29143,27660,1483,5.1
CN3907700000000,39,077,Huron County, OH,Sep-17,28008,26627,1381,4.9
CN3907700000000,39,077,Huron County, OH,Oct-17,27685,26371,1314,4.7
CN3907700000000,39,077,Huron County, OH,Nov-17,27404,25949,1455,5.3
CN3907700000000,39,077,Huron County, OH,Dec-17,26957,25195,1762,6.5
CN3907700000000,39,077,Huron County, OH,Jan-18,26710,24407,2303,8.6
CN3907700000000,39,077,Huron County, OH,Feb-18,27610,25564,2046,7.4
CN3907700000000,39,077,Huron County, OH,Mar-18,28092,26210,1882,6.7
CN3907700000000,39,077,Huron County, OH,Apr-18(p),27859,26411,1448,5.2
CN1902700000000,19,027,Carroll County, IA,Mar-17,10930,10661,269,2.5
CN1902700000000,19,027,Carroll County, IA,Apr-17,10967,10735,232,2.1
CN1902700000000,19,027,Carroll County, IA,May-17,11103,10867,236,2.1
CN1902700000000,19,027,Carroll County, IA,Jun-17,11348,11075,273,2.4
CN1902700000000,19,027,Carroll County, IA,Jul-17,11564,11289,275,2.4
CN1902700000000,19,027,Carroll County, IA,Aug-17,11230,10946,284,2.5
CN1902700000000,19,027,Carroll County, IA,Sep-17,10983,10733,250,2.3
CN1902700000000,19,027,Carroll County, IA,Oct-17,10960,10752,208,1.9
CN1902700000000,19,027,Carroll County, IA,Nov-17,10804,10596,208,1.9
CN1902700000000,19,027,Carroll County, IA,Dec-17,10863,10644,219,2.0
CN1902700000000,19,027,Carroll County, IA,Jan-18,10742,10471,271,2.5
CN1902700000000,19,027,Carroll County, IA,Feb-18,10760,10504,256,2.4
CN1902700000000,19,027,Carroll County, IA,Mar-18,10680,10464,216,2.0
CN1902700000000,19,027,Carroll County, IA,Apr-18(p),10627,10431,196,1.8
CN1810900000000,18,109,Morgan County, IN,Mar-17,35929,34592,1337,3.7
CN1810900000000,18,109,Morgan County, IN,Apr-17,36094,35029,1065,3.0
CN1810900000000,18,109,Morgan County, IN,May-17,36257,35130,1127,3.1
CN1810900000000,18,109,Morgan County, IN,Jun-17,36667,35440,1227,3.3
CN1810900000000,18,109,Morgan County, IN,Jul-17,36648,35388,1260,3.4
CN1810900000000,18,109,Morgan County, IN,Aug-17,36311,34958,1353,3.7
CN1810900000000,18,109,Morgan County, IN,Sep-17,36118,34966,1152,3.2
CN1810900000000,18,109,Morgan County, IN,Oct-17,35952,34851,1101,3.1
CN1810900000000,18,109,Morgan County, IN,Nov-17,36022,34892,1130,3.1
CN1810900000000,18,109,Morgan County, IN,Dec-17,35750,34632,1118,3.1
CN1810900000000,18,109,Morgan County, IN,Jan-18,35831,34524,1307,3.6
CN1810900000000,18,109,Morgan County, IN,Feb-18,36369,34966,1403,3.9
CN1810900000000,18,109,Morgan County, IN,Mar-18,36647,35425,1222,3.3
CN1810900000000,18,109,Morgan County, IN,Apr-18(p),36705,35621,1084,3.0
CN2917900000000,29,179,Reynolds County, MO,Mar-17,3050,2909,141,4.6
CN2917900000000,29,179,Reynolds County, MO,Apr-17,3090,2974,116,3.8
CN2917900000000,29,179,Reynolds County, MO,May-17,3157,3034,123,3.9
CN2917900000000,29,179,Reynolds County, MO,Jun-17,3265,3149,116,3.6
CN2917900000000,29,179,Reynolds County, MO,Jul-17,3087,2963,124,4.0
CN2917900000000,29,179,Reynolds County, MO,Aug-17,2965,2822,143,4.8
CN2917900000000,29,179,Reynolds County, MO,Sep-17,3081,2972,109,3.5
CN2917900000000,29,179,Reynolds County, MO,Oct-17,3017,2932,85,2.8
CN2917900000000,29,179,Reynolds County, MO,Nov-17,2971,2871,100,3.4
CN2917900000000,29,179,Reynolds County, MO,Dec-17,2942,2835,107,3.6
CN2917900000000,29,179,Reynolds County, MO,Jan-18,3125,3003,122,3.9
CN2917900000000,29,179,Reynolds County, MO,Feb-18,3161,3038,123,3.9
CN2917900000000,29,179,Reynolds County, MO,Mar-18,3171,3054,117,3.7
CN2917900000000,29,179,Reynolds County, MO,Apr-18(p),3219,3117,102,3.2
CN3718700000000,37,187,Washington County, NC,Mar-17,4817,4495,322,6.7
CN3718700000000,37,187,Washington County, NC,Apr-17,4852,4552,300,6.2
CN3718700000000,37,187,Washington County, NC,May-17,4853,4549,304,6.3
CN3718700000000,37,187,Washington County, NC,Jun-17,4870,4564,306,6.3
CN3718700000000,37,187,Washington County, NC,Jul-17,4940,4625,315,6.4
CN3718700000000,37,187,Washington County, NC,Aug-17,4799,4498,301,6.3
CN3718700000000,37,187,Washington County, NC,Sep-17,4838,4550,288,6.0
CN3718700000000,37,187,Washington County, NC,Oct-17,4799,4479,320,6.7
CN3718700000000,37,187,Washington County, NC,Nov-17,4718,4390,328,7.0
CN3718700000000,37,187,Washington County, NC,Dec-17,4681,4348,333,7.1
CN3718700000000,37,187,Washington County, NC,Jan-18,4683,4329,354,7.6
CN3718700000000,37,187,Washington County, NC,Feb-18,4748,4394,354,7.5
CN3718700000000,37,187,Washington County, NC,Mar-18,4742,4416,326,6.9
CN3718700000000,37,187,Washington County, NC,Apr-18(p),4750,4481,269,5.7
CN4816700000000,48,167,Galveston County, TX,Mar-17,161466,152826,8640,5.4
CN4816700000000,48,167,Galveston County, TX,Apr-17,161472,153442,8030,5.0
CN4816700000000,48,167,Galveston County, TX,May-17,161107,153141,7966,4.9
CN4816700000000,48,167,Galveston County, TX,Jun-17,161864,153102,8762,5.4
CN4816700000000,48,167,Galveston County, TX,Jul-17,162353,153658,8695,5.4
CN4816700000000,48,167,Galveston County, TX,Aug-17,161642,152807,8835,5.5
CN4816700000000,48,167,Galveston County, TX,Sep-17,162526,154031,8495,5.2
CN4816700000000,48,167,Galveston County, TX,Oct-17,161369,153846,7523,4.7
CN4816700000000,48,167,Galveston County, TX,Nov-17,162407,154758,7649,4.7
CN4816700000000,48,167,Galveston County, TX,Dec-17,162578,155012,7566,4.7
CN4816700000000,48,167,Galveston County, TX,Jan-18,162831,154437,8394,5.2
CN4816700000000,48,167,Galveston County, TX,Feb-18,164900,156714,8186,5.0
CN4816700000000,48,167,Galveston County, TX,Mar-18,164949,157001,7948,4.8
CN4816700000000,48,167,Galveston County, TX,Apr-18(p),165539,158117,7422,4.5
CN0803300000000,08,033,Dolores County, CO,Mar-17,1044,1008,36,3.4
CN0803300000000,08,033,Dolores County, CO,Apr-17,1089,1057,32,2.9
CN0803300000000,08,033,Dolores County, CO,May-17,1130,1099,31,2.7
CN0803300000000,08,033,Dolores County, CO,Jun-17,1142,1112,30,2.6
CN0803300000000,08,033,Dolores County, CO,Jul-17,1185,1156,29,2.4
CN0803300000000,08,033,Dolores County, CO,Aug-17,1156,1124,32,2.8
CN0803300000000,08,033,Dolores County, CO,Sep-17,1160,1127,33,2.8
CN0803300000000,08,033,Dolores County, CO,Oct-17,1228,1191,37,3.0
CN0803300000000,08,033,Dolores County, CO,Nov-17,1204,1166,38,3.2
CN0803300000000,08,033,Dolores County, CO,Dec-17,1178,1142,36,3.1
CN0803300000000,08,033,Dolores County, CO,Jan-18,1155,1118,37,3.2
CN0803300000000,08,033,Dolores County, CO,Feb-18,1108,1077,31,2.8
CN0803300000000,08,033,Dolores County, CO,Mar-18,1106,1076,30,2.7
CN0803300000000,08,033,Dolores County, CO,Apr-18(p),1145,1119,26,2.3
CN2702100000000,27,021,Cass County, MN,Mar-17,13756,12561,1195,8.7
CN2702100000000,27,021,Cass County, MN,Apr-17,13840,13004,836,6.0
CN2702100000000,27,021,Cass County, MN,May-17,14305,13677,628,4.4
CN2702100000000,27,021,Cass County, MN,Jun-17,15111,14464,647,4.3
CN2702100000000,27,021,Cass County, MN,Jul-17,15207,14567,640,4.2
CN2702100000000,27,021,Cass County, MN,Aug-17,15106,14454,652,4.3
CN2702100000000,27,021,Cass County, MN,Sep-17,14678,14157,521,3.5
CN2702100000000,27,021,Cass County, MN,Oct-17,14633,14151,482,3.3
CN2702100000000,27,021,Cass County, MN,Nov-17,15010,14131,879,5.9
CN2702100000000,27,021,Cass County, MN,Dec-17,15162,14111,1051,6.9
CN2702100000000,27,021,Cass County, MN,Jan-18,15303,14018,1285,8.4
CN2702100000000,27,021,Cass County, MN,Feb-18,15149,14027,1122,7.4
CN2702100000000,27,021,Cass County, MN,Mar-18,15076,13989,1087,7.2
CN2702100000000,27,021,Cass County, MN,Apr-18(p),15411,14570,841,5.5
CN2118500000000,21,185,Oldham County, KY,Mar-17,32372,31137,1235,3.8
CN2118500000000,21,185,Oldham County, KY,Apr-17,32412,31280,1132,3.5
CN2118500000000,21,185,Oldham County, KY,May-17,32487,31343,1144,3.5
CN2118500000000,21,185,Oldham County, KY,Jun-17,33078,31728,1350,4.1
CN2118500000000,21,185,Oldham County, KY,Jul-17,33210,31845,1365,4.1
CN2118500000000,21,185,Oldham County, KY,Aug-17,32700,31533,1167,3.6
CN2118500000000,21,185,Oldham County, KY,Sep-17,32763,31763,1000,3.1
CN2118500000000,21,185,Oldham County, KY,Oct-17,32463,31522,941,2.9
CN2118500000000,21,185,Oldham County, KY,Nov-17,32658,31728,930,2.8
CN2118500000000,21,185,Oldham County, KY,Dec-17,32649,31730,919,2.8
CN2118500000000,21,185,Oldham County, KY,Jan-18,32201,31209,992,3.1
CN2118500000000,21,185,Oldham County, KY,Feb-18,32676,31519,1157,3.5
CN2118500000000,21,185,Oldham County, KY,Mar-18,33011,31916,1095,3.3
CN2118500000000,21,185,Oldham County, KY,Apr-18(p),33065,32092,973,2.9
CN2006700000000,20,067,Grant County, KS,Mar-17,3473,3363,110,3.2
CN2006700000000,20,067,Grant County, KS,Apr-17,3429,3313,116,3.4
CN2006700000000,20,067,Grant County, KS,May-17,3417,3305,112,3.3
CN2006700000000,20,067,Grant County, KS,Jun-17,3567,3444,123,3.4
CN2006700000000,20,067,Grant County, KS,Jul-17,3441,3311,130,3.8
CN2006700000000,20,067,Grant County, KS,Aug-17,3508,3394,114,3.2
CN2006700000000,20,067,Grant County, KS,Sep-17,3546,3450,96,2.7
CN2006700000000,20,067,Grant County, KS,Oct-17,3547,3462,85,2.4
CN2006700000000,20,067,Grant County, KS,Nov-17,3478,3377,101,2.9
CN2006700000000,20,067,Grant County, KS,Dec-17,3428,3338,90,2.6
CN2006700000000,20,067,Grant County, KS,Jan-18,3412,3322,90,2.6
CN2006700000000,20,067,Grant County, KS,Feb-18,3418,3321,97,2.8
CN2006700000000,20,067,Grant County, KS,Mar-18,3430,3331,99,2.9
CN2006700000000,20,067,Grant County, KS,Apr-18(p),3260,3164,96,2.9
CN2611700000000,26,117,Montcalm County, MI,Mar-17,28276,26754,1522,5.4
CN2611700000000,26,117,Montcalm County, MI,Apr-17,27987,26818,1169,4.2
CN2611700000000,26,117,Montcalm County, MI,May-17,28119,26896,1223,4.3
CN2611700000000,26,117,Montcalm County, MI,Jun-17,28451,27035,1416,5.0
CN2611700000000,26,117,Montcalm County, MI,Jul-17,28434,26723,1711,6.0
CN2611700000000,26,117,Montcalm County, MI,Aug-17,28282,26776,1506,5.3
CN2611700000000,26,117,Montcalm County, MI,Sep-17,27932,26678,1254,4.5
CN2611700000000,26,117,Montcalm County, MI,Oct-17,27962,26763,1199,4.3
CN2611700000000,26,117,Montcalm County, MI,Nov-17,28120,26878,1242,4.4
CN2611700000000,26,117,Montcalm County, MI,Dec-17,28236,26823,1413,5.0
CN2611700000000,26,117,Montcalm County, MI,Jan-18,28228,26564,1664,5.9
CN2611700000000,26,117,Montcalm County, MI,Feb-18,28736,26976,1760,6.1
CN2611700000000,26,117,Montcalm County, MI,Mar-18,28732,27226,1506,5.2
CN2611700000000,26,117,Montcalm County, MI,Apr-18(p),28621,27367,1254,4.4
CN3809100000000,38,091,Steele County, ND,Mar-17,1049,1025,24,2.3
CN3809100000000,38,091,Steele County, ND,Apr-17,1070,1051,19,1.8
CN3809100000000,38,091,Steele County, ND,May-17,1086,1068,18,1.7
CN3809100000000,38,091,Steele County, ND,Jun-17,1138,1119,19,1.7
CN3809100000000,38,091,Steele County, ND,Jul-17,1101,1085,16,1.5
CN3809100000000,38,091,Steele County, ND,Aug-17,1117,1099,18,1.6
CN3809100000000,38,091,Steele County, ND,Sep-17,1114,1099,15,1.3
CN3809100000000,38,091,Steele County, ND,Oct-17,1115,1103,12,1.1
CN3809100000000,38,091,Steele County, ND,Nov-17,1073,1057,16,1.5
CN3809100000000,38,091,Steele County, ND,Dec-17,1066,1051,15,1.4
CN3809100000000,38,091,Steele County, ND,Jan-18,1059,1032,27,2.5
CN3809100000000,38,091,Steele County, ND,Feb-18,1036,1013,23,2.2
CN3809100000000,38,091,Steele County, ND,Mar-18,1046,1025,21,2.0
CN3809100000000,38,091,Steele County, ND,Apr-18(p),1055,1034,21,2.0
CN1900300000000,19,003,Adams County, IA,Mar-17,2126,2065,61,2.9
CN1900300000000,19,003,Adams County, IA,Apr-17,2145,2096,49,2.3
CN1900300000000,19,003,Adams County, IA,May-17,2152,2103,49,2.3
CN1900300000000,19,003,Adams County, IA,Jun-17,2161,2114,47,2.2
CN1900300000000,19,003,Adams County, IA,Jul-17,2187,2130,57,2.6
CN1900300000000,19,003,Adams County, IA,Aug-17,2150,2095,55,2.6
CN1900300000000,19,003,Adams County, IA,Sep-17,2115,2071,44,2.1
CN1900300000000,19,003,Adams County, IA,Oct-17,2125,2088,37,1.7
CN1900300000000,19,003,Adams County, IA,Nov-17,2088,2055,33,1.6
CN1900300000000,19,003,Adams County, IA,Dec-17,2086,2048,38,1.8
CN1900300000000,19,003,Adams County, IA,Jan-18,2067,2010,57,2.8
CN1900300000000,19,003,Adams County, IA,Feb-18,2087,2028,59,2.8
CN1900300000000,19,003,Adams County, IA,Mar-18,2064,2012,52,2.5
CN1900300000000,19,003,Adams County, IA,Apr-18(p),2053,2011,42,2.0
CN2302900000000,23,029,Washington County, ME,Mar-17,14129,13241,888,6.3
CN2302900000000,23,029,Washington County, ME,Apr-17,14409,13570,839,5.8
CN2302900000000,23,029,Washington County, ME,May-17,14193,13435,758,5.3
CN2302900000000,23,029,Washington County, ME,Jun-17,14369,13718,651,4.5
CN2302900000000,23,029,Washington County, ME,Jul-17,14489,13859,630,4.3
CN2302900000000,23,029,Washington County, ME,Aug-17,14333,13804,529,3.7
CN2302900000000,23,029,Washington County, ME,Sep-17,13513,13001,512,3.8
CN2302900000000,23,029,Washington County, ME,Oct-17,13941,13408,533,3.8
CN2302900000000,23,029,Washington County, ME,Nov-17,14202,13635,567,4.0
CN2302900000000,23,029,Washington County, ME,Dec-17,13971,13455,516,3.7
CN2302900000000,23,029,Washington County, ME,Jan-18,13462,12728,734,5.5
CN2302900000000,23,029,Washington County, ME,Feb-18,14060,13326,734,5.2
CN2302900000000,23,029,Washington County, ME,Mar-18,14034,13361,673,4.8
CN2302900000000,23,029,Washington County, ME,Apr-18(p),14003,13307,696,5.0
CN4201700000000,42,017,Bucks County, PA,Mar-17,340943,326080,14863,4.4
CN4201700000000,42,017,Bucks County, PA,Apr-17,341161,327928,13233,3.9
CN4201700000000,42,017,Bucks County, PA,May-17,341867,327421,14446,4.2
CN4201700000000,42,017,Bucks County, PA,Jun-17,344243,329705,14538,4.2
CN4201700000000,42,017,Bucks County, PA,Jul-17,346632,330757,15875,4.6
CN4201700000000,42,017,Bucks County, PA,Aug-17,343253,327456,15797,4.6
CN4201700000000,42,017,Bucks County, PA,Sep-17,340953,327342,13611,4.0
CN4201700000000,42,017,Bucks County, PA,Oct-17,339904,326900,13004,3.8
CN4201700000000,42,017,Bucks County, PA,Nov-17,339728,326552,13176,3.9
CN4201700000000,42,017,Bucks County, PA,Dec-17,337830,325162,12668,3.7
CN4201700000000,42,017,Bucks County, PA,Jan-18,337775,322560,15215,4.5
CN4201700000000,42,017,Bucks County, PA,Feb-18,338381,323123,15258,4.5
CN4201700000000,42,017,Bucks County, PA,Mar-18,335731,322372,13359,4.0
CN4201700000000,42,017,Bucks County, PA,Apr-18(p),336926,325305,11621,3.4
CN2004300000000,20,043,Doniphan County, KS,Mar-17,4218,4077,141,3.3
CN2004300000000,20,043,Doniphan County, KS,Apr-17,4214,4082,132,3.1
CN2004300000000,20,043,Doniphan County, KS,May-17,4205,4073,132,3.1
CN2004300000000,20,043,Doniphan County, KS,Jun-17,4320,4150,170,3.9
CN2004300000000,20,043,Doniphan County, KS,Jul-17,4357,4178,179,4.1
CN2004300000000,20,043,Doniphan County, KS,Aug-17,4260,4101,159,3.7
CN2004300000000,20,043,Doniphan County, KS,Sep-17,4232,4094,138,3.3
CN2004300000000,20,043,Doniphan County, KS,Oct-17,4259,4136,123,2.9
CN2004300000000,20,043,Doniphan County, KS,Nov-17,4254,4123,131,3.1
CN2004300000000,20,043,Doniphan County, KS,Dec-17,4240,4112,128,3.0
CN2004300000000,20,043,Doniphan County, KS,Jan-18,4227,4079,148,3.5
CN2004300000000,20,043,Doniphan County, KS,Feb-18,4245,4078,167,3.9
CN2004300000000,20,043,Doniphan County, KS,Mar-18,4242,4083,159,3.7
CN2004300000000,20,043,Doniphan County, KS,Apr-18(p),4167,4033,134,3.2
CN3905300000000,39,053,Gallia County, OH,Mar-17,12685,11810,875,6.9
CN3905300000000,39,053,Gallia County, OH,Apr-17,12349,11611,738,6.0
CN3905300000000,39,053,Gallia County, OH,May-17,11990,11283,707,5.9
CN3905300000000,39,053,Gallia County, OH,Jun-17,12041,11203,838,7.0
CN3905300000000,39,053,Gallia County, OH,Jul-17,11998,11163,835,7.0
CN3905300000000,39,053,Gallia County, OH,Aug-17,11997,11180,817,6.8
CN3905300000000,39,053,Gallia County, OH,Sep-17,11938,11231,707,5.9
CN3905300000000,39,053,Gallia County, OH,Oct-17,11914,11248,666,5.6
CN3905300000000,39,053,Gallia County, OH,Nov-17,12013,11285,728,6.1
CN3905300000000,39,053,Gallia County, OH,Dec-17,11921,11143,778,6.5
CN3905300000000,39,053,Gallia County, OH,Jan-18,11943,10987,956,8.0
CN3905300000000,39,053,Gallia County, OH,Feb-18,12284,11390,894,7.3
CN3905300000000,39,053,Gallia County, OH,Mar-18,12376,11573,803,6.5
CN3905300000000,39,053,Gallia County, OH,Apr-18(p),12187,11519,668,5.5
CN2116100000000,21,161,Mason County, KY,Mar-17,7409,6890,519,7.0
CN2116100000000,21,161,Mason County, KY,Apr-17,7462,7024,438,5.9
CN2116100000000,21,161,Mason County, KY,May-17,7502,7058,444,5.9
CN2116100000000,21,161,Mason County, KY,Jun-17,7514,7010,504,6.7
CN2116100000000,21,161,Mason County, KY,Jul-17,7363,6893,470,6.4
CN2116100000000,21,161,Mason County, KY,Aug-17,7318,6878,440,6.0
CN2116100000000,21,161,Mason County, KY,Sep-17,7329,6923,406,5.5
CN2116100000000,21,161,Mason County, KY,Oct-17,7257,6898,359,4.9
CN2116100000000,21,161,Mason County, KY,Nov-17,7295,6943,352,4.8
CN2116100000000,21,161,Mason County, KY,Dec-17,7250,6901,349,4.8
CN2116100000000,21,161,Mason County, KY,Jan-18,7299,6901,398,5.5
CN2116100000000,21,161,Mason County, KY,Feb-18,7344,6920,424,5.8
CN2116100000000,21,161,Mason County, KY,Mar-18,7377,6992,385,5.2
CN2116100000000,21,161,Mason County, KY,Apr-18(p),7370,7036,334,4.5
CN3719700000000,37,197,Yadkin County, NC,Mar-17,17913,17205,708,4.0
CN3719700000000,37,197,Yadkin County, NC,Apr-17,17771,17147,624,3.5
CN3719700000000,37,197,Yadkin County, NC,May-17,17741,17055,686,3.9
CN3719700000000,37,197,Yadkin County, NC,Jun-17,17665,16940,725,4.1
CN3719700000000,37,197,Yadkin County, NC,Jul-17,17904,17139,765,4.3
CN3719700000000,37,197,Yadkin County, NC,Aug-17,17638,16869,769,4.4
CN3719700000000,37,197,Yadkin County, NC,Sep-17,17894,17216,678,3.8
CN3719700000000,37,197,Yadkin County, NC,Oct-17,17842,17180,662,3.7
CN3719700000000,37,197,Yadkin County, NC,Nov-17,17713,17026,687,3.9
CN3719700000000,37,197,Yadkin County, NC,Dec-17,17653,16987,666,3.8
CN3719700000000,37,197,Yadkin County, NC,Jan-18,17716,17016,700,4.0
CN3719700000000,37,197,Yadkin County, NC,Feb-18,17953,17246,707,3.9
CN3719700000000,37,197,Yadkin County, NC,Mar-18,17955,17266,689,3.8
CN3719700000000,37,197,Yadkin County, NC,Apr-18(p),17965,17382,583,3.2
CN5106900000000,51,069,Frederick County, VA,Mar-17,45929,44399,1530,3.3
CN5106900000000,51,069,Frederick County, VA,Apr-17,46338,44965,1373,3.0
CN5106900000000,51,069,Frederick County, VA,May-17,46466,45001,1465,3.2
CN5106900000000,51,069,Frederick County, VA,Jun-17,46640,45102,1538,3.3
CN5106900000000,51,069,Frederick County, VA,Jul-17,46961,45392,1569,3.3
CN5106900000000,51,069,Frederick County, VA,Aug-17,46394,44860,1534,3.3
CN5106900000000,51,069,Frederick County, VA,Sep-17,46536,45108,1428,3.1
CN5106900000000,51,069,Frederick County, VA,Oct-17,46548,45215,1333,2.9
CN5106900000000,51,069,Frederick County, VA,Nov-17,46595,45264,1331,2.9
CN5106900000000,51,069,Frederick County, VA,Dec-17,46163,44890,1273,2.8
CN5106900000000,51,069,Frederick County, VA,Jan-18,46325,44863,1462,3.2
CN5106900000000,51,069,Frederick County, VA,Feb-18,47121,45728,1393,3.0
CN5106900000000,51,069,Frederick County, VA,Mar-18,47276,45915,1361,2.9
CN5106900000000,51,069,Frederick County, VA,Apr-18(p),47486,46370,1116,2.4
CN2603100000000,26,031,Cheboygan County, MI,Mar-17,10784,8810,1974,18.3
CN2603100000000,26,031,Cheboygan County, MI,Apr-17,10264,9012,1252,12.2
CN2603100000000,26,031,Cheboygan County, MI,May-17,10580,10054,526,5.0
CN2603100000000,26,031,Cheboygan County, MI,Jun-17,11378,10880,498,4.4
CN2603100000000,26,031,Cheboygan County, MI,Jul-17,11782,11176,606,5.1
CN2603100000000,26,031,Cheboygan County, MI,Aug-17,11526,10973,553,4.8
CN2603100000000,26,031,Cheboygan County, MI,Sep-17,11015,10523,492,4.5
CN2603100000000,26,031,Cheboygan County, MI,Oct-17,10574,10073,501,4.7
CN2603100000000,26,031,Cheboygan County, MI,Nov-17,10211,9193,1018,10.0
CN2603100000000,26,031,Cheboygan County, MI,Dec-17,10494,8830,1664,15.9
CN2603100000000,26,031,Cheboygan County, MI,Jan-18,10751,8722,2029,18.9
CN2603100000000,26,031,Cheboygan County, MI,Feb-18,11028,8721,2307,20.9
CN2603100000000,26,031,Cheboygan County, MI,Mar-18,10921,8879,2042,18.7
CN2603100000000,26,031,Cheboygan County, MI,Apr-18(p),10437,9084,1353,13.0
CN1303900000000,13,039,Camden County, GA,Mar-17,20887,19755,1132,5.4
CN1303900000000,13,039,Camden County, GA,Apr-17,20911,19873,1038,5.0
CN1303900000000,13,039,Camden County, GA,May-17,20922,19884,1038,5.0
CN1303900000000,13,039,Camden County, GA,Jun-17,20848,19726,1122,5.4
CN1303900000000,13,039,Camden County, GA,Jul-17,21036,19912,1124,5.3
CN1303900000000,13,039,Camden County, GA,Aug-17,20928,19825,1103,5.3
CN1303900000000,13,039,Camden County, GA,Sep-17,21023,19950,1073,5.1
CN1303900000000,13,039,Camden County, GA,Oct-17,20939,19924,1015,4.8
CN1303900000000,13,039,Camden County, GA,Nov-17,20927,19960,967,4.6
CN1303900000000,13,039,Camden County, GA,Dec-17,20931,19973,958,4.6
CN1303900000000,13,039,Camden County, GA,Jan-18,20874,19889,985,4.7
CN1303900000000,13,039,Camden County, GA,Feb-18,20810,19800,1010,4.9
CN1303900000000,13,039,Camden County, GA,Mar-18,20864,19907,957,4.6
CN1303900000000,13,039,Camden County, GA,Apr-18(p),20760,19938,822,4.0
CN2906300000000,29,063,DeKalb County, MO,Mar-17,5088,4859,229,4.5
CN2906300000000,29,063,DeKalb County, MO,Apr-17,5126,4951,175,3.4
CN2906300000000,29,063,DeKalb County, MO,May-17,5059,4882,177,3.5
CN2906300000000,29,063,DeKalb County, MO,Jun-17,5090,4891,199,3.9
CN2906300000000,29,063,DeKalb County, MO,Jul-17,5096,4880,216,4.2
CN2906300000000,29,063,DeKalb County, MO,Aug-17,4979,4764,215,4.3
CN2906300000000,29,063,DeKalb County, MO,Sep-17,4922,4768,154,3.1
CN2906300000000,29,063,DeKalb County, MO,Oct-17,4993,4851,142,2.8
CN2906300000000,29,063,DeKalb County, MO,Nov-17,4984,4836,148,3.0
CN2906300000000,29,063,DeKalb County, MO,Dec-17,4940,4789,151,3.1
CN2906300000000,29,063,DeKalb County, MO,Jan-18,4966,4754,212,4.3
CN2906300000000,29,063,DeKalb County, MO,Feb-18,5041,4831,210,4.2
CN2906300000000,29,063,DeKalb County, MO,Mar-18,5036,4842,194,3.9
CN2906300000000,29,063,DeKalb County, MO,Apr-18(p),5057,4892,165,3.3
CN4009900000000,40,099,Murray County, OK,Mar-17,6341,6087,254,4.0
CN4009900000000,40,099,Murray County, OK,Apr-17,6319,6103,216,3.4
CN4009900000000,40,099,Murray County, OK,May-17,6376,6131,245,3.8
CN4009900000000,40,099,Murray County, OK,Jun-17,6623,6363,260,3.9
CN4009900000000,40,099,Murray County, OK,Jul-17,6543,6303,240,3.7
CN4009900000000,40,099,Murray County, OK,Aug-17,6385,6158,227,3.6
CN4009900000000,40,099,Murray County, OK,Sep-17,6523,6296,227,3.5
CN4009900000000,40,099,Murray County, OK,Oct-17,6521,6311,210,3.2
CN4009900000000,40,099,Murray County, OK,Nov-17,6533,6313,220,3.4
CN4009900000000,40,099,Murray County, OK,Dec-17,6460,6239,221,3.4
CN4009900000000,40,099,Murray County, OK,Jan-18,6461,6225,236,3.7
CN4009900000000,40,099,Murray County, OK,Feb-18,6506,6271,235,3.6
CN4009900000000,40,099,Murray County, OK,Mar-18,6554,6328,226,3.4
CN4009900000000,40,099,Murray County, OK,Apr-18(p),6522,6304,218,3.3
CN4204500000000,42,045,Delaware County, PA,Mar-17,295016,281784,13232,4.5
CN4204500000000,42,045,Delaware County, PA,Apr-17,295605,283058,12547,4.2
CN4204500000000,42,045,Delaware County, PA,May-17,295180,281610,13570,4.6
CN4204500000000,42,045,Delaware County, PA,Jun-17,294911,281277,13634,4.6
CN4204500000000,42,045,Delaware County, PA,Jul-17,296500,281605,14895,5.0
CN4204500000000,42,045,Delaware County, PA,Aug-17,293311,278542,14769,5.0
CN4204500000000,42,045,Delaware County, PA,Sep-17,295250,282518,12732,4.3
CN4204500000000,42,045,Delaware County, PA,Oct-17,294506,282223,12283,4.2
CN4204500000000,42,045,Delaware County, PA,Nov-17,294956,282771,12185,4.1
CN4204500000000,42,045,Delaware County, PA,Dec-17,293413,281897,11516,3.9
CN4204500000000,42,045,Delaware County, PA,Jan-18,291279,277873,13406,4.6
CN4204500000000,42,045,Delaware County, PA,Feb-18,293249,279529,13720,4.7
CN4204500000000,42,045,Delaware County, PA,Mar-18,290951,278901,12050,4.1
CN4204500000000,42,045,Delaware County, PA,Apr-18(p),291806,280992,10814,3.7
CN1604100000000,16,041,Franklin County, ID,Mar-17,6714,6521,193,2.9
CN1604100000000,16,041,Franklin County, ID,Apr-17,6771,6626,145,2.1
CN1604100000000,16,041,Franklin County, ID,May-17,6828,6698,130,1.9
CN1604100000000,16,041,Franklin County, ID,Jun-17,6770,6634,136,2.0
CN1604100000000,16,041,Franklin County, ID,Jul-17,6556,6414,142,2.2
CN1604100000000,16,041,Franklin County, ID,Aug-17,6567,6428,139,2.1
CN1604100000000,16,041,Franklin County, ID,Sep-17,6748,6623,125,1.9
CN1604100000000,16,041,Franklin County, ID,Oct-17,6997,6873,124,1.8
CN1604100000000,16,041,Franklin County, ID,Nov-17,6796,6655,141,2.1
CN1604100000000,16,041,Franklin County, ID,Dec-17,6763,6622,141,2.1
CN1604100000000,16,041,Franklin County, ID,Jan-18,6702,6515,187,2.8
CN1604100000000,16,041,Franklin County, ID,Feb-18,6732,6570,162,2.4
CN1604100000000,16,041,Franklin County, ID,Mar-18,6850,6701,149,2.2
CN1604100000000,16,041,Franklin County, ID,Apr-18(p),6954,6807,147,2.1
CN4822900000000,48,229,Hudspeth County, TX,Mar-17,1587,1488,99,6.2
CN4822900000000,48,229,Hudspeth County, TX,Apr-17,1582,1486,96,6.1
CN4822900000000,48,229,Hudspeth County, TX,May-17,1575,1486,89,5.7
CN4822900000000,48,229,Hudspeth County, TX,Jun-17,1552,1452,100,6.4
CN4822900000000,48,229,Hudspeth County, TX,Jul-17,1511,1405,106,7.0
CN4822900000000,48,229,Hudspeth County, TX,Aug-17,1521,1428,93,6.1
CN4822900000000,48,229,Hudspeth County, TX,Sep-17,1509,1428,81,5.4
CN4822900000000,48,229,Hudspeth County, TX,Oct-17,1525,1451,74,4.9
CN4822900000000,48,229,Hudspeth County, TX,Nov-17,1508,1430,78,5.2
CN4822900000000,48,229,Hudspeth County, TX,Dec-17,1509,1436,73,4.8
CN4822900000000,48,229,Hudspeth County, TX,Jan-18,1493,1415,78,5.2
CN4822900000000,48,229,Hudspeth County, TX,Feb-18,1535,1450,85,5.5
CN4822900000000,48,229,Hudspeth County, TX,Mar-18,1583,1500,83,5.2
CN4822900000000,48,229,Hudspeth County, TX,Apr-18(p),1551,1474,77,5.0
CN3500100000000,35,001,Bernalillo County, NM,Mar-17,324423,306657,17766,5.5
CN3500100000000,35,001,Bernalillo County, NM,Apr-17,325388,308861,16527,5.1
CN3500100000000,35,001,Bernalillo County, NM,May-17,323142,306331,16811,5.2
CN3500100000000,35,001,Bernalillo County, NM,Jun-17,326702,306956,19746,6.0
CN3500100000000,35,001,Bernalillo County, NM,Jul-17,326361,306744,19617,6.0
CN3500100000000,35,001,Bernalillo County, NM,Aug-17,324779,306170,18609,5.7
CN3500100000000,35,001,Bernalillo County, NM,Sep-17,327083,309104,17979,5.5
CN3500100000000,35,001,Bernalillo County, NM,Oct-17,328117,310828,17289,5.3
CN3500100000000,35,001,Bernalillo County, NM,Nov-17,331154,314279,16875,5.1
CN3500100000000,35,001,Bernalillo County, NM,Dec-17,330411,314286,16125,4.9
CN3500100000000,35,001,Bernalillo County, NM,Jan-18,328792,312103,16689,5.1
CN3500100000000,35,001,Bernalillo County, NM,Feb-18,331133,315182,15951,4.8
CN3500100000000,35,001,Bernalillo County, NM,Mar-18,330212,315476,14736,4.5
CN3500100000000,35,001,Bernalillo County, NM,Apr-18(p),330115,317125,12990,3.9
CN1602900000000,16,029,Caribou County, ID,Mar-17,3781,3620,161,4.3
CN1602900000000,16,029,Caribou County, ID,Apr-17,3834,3716,118,3.1
CN1602900000000,16,029,Caribou County, ID,May-17,3931,3828,103,2.6
CN1602900000000,16,029,Caribou County, ID,Jun-17,3949,3850,99,2.5
CN1602900000000,16,029,Caribou County, ID,Jul-17,3844,3746,98,2.5
CN1602900000000,16,029,Caribou County, ID,Aug-17,3842,3741,101,2.6
CN1602900000000,16,029,Caribou County, ID,Sep-17,3796,3698,98,2.6
CN1602900000000,16,029,Caribou County, ID,Oct-17,3944,3854,90,2.3
CN1602900000000,16,029,Caribou County, ID,Nov-17,3734,3614,120,3.2
CN1602900000000,16,029,Caribou County, ID,Dec-17,3704,3567,137,3.7
CN1602900000000,16,029,Caribou County, ID,Jan-18,3708,3554,154,4.2
CN1602900000000,16,029,Caribou County, ID,Feb-18,3716,3594,122,3.3
CN1602900000000,16,029,Caribou County, ID,Mar-18,3806,3675,131,3.4
CN1602900000000,16,029,Caribou County, ID,Apr-18(p),3857,3749,108,2.8
CN4002100000000,40,021,Cherokee County, OK,Mar-17,19247,18215,1032,5.4
CN4002100000000,40,021,Cherokee County, OK,Apr-17,19164,18228,936,4.9
CN4002100000000,40,021,Cherokee County, OK,May-17,19180,18089,1091,5.7
CN4002100000000,40,021,Cherokee County, OK,Jun-17,19028,17833,1195,6.3
CN4002100000000,40,021,Cherokee County, OK,Jul-17,18969,17889,1080,5.7
CN4002100000000,40,021,Cherokee County, OK,Aug-17,19144,18093,1051,5.5
CN4002100000000,40,021,Cherokee County, OK,Sep-17,19239,18247,992,5.2
CN4002100000000,40,021,Cherokee County, OK,Oct-17,18886,17950,936,5.0
CN4002100000000,40,021,Cherokee County, OK,Nov-17,18940,18016,924,4.9
CN4002100000000,40,021,Cherokee County, OK,Dec-17,18657,17719,938,5.0
CN4002100000000,40,021,Cherokee County, OK,Jan-18,18753,17739,1014,5.4
CN4002100000000,40,021,Cherokee County, OK,Feb-18,19135,18217,918,4.8
CN4002100000000,40,021,Cherokee County, OK,Mar-18,19199,18301,898,4.7
CN4002100000000,40,021,Cherokee County, OK,Apr-18(p),19050,18187,863,4.5
CN1322900000000,13,229,Pierce County, GA,Mar-17,8870,8475,395,4.5
CN1322900000000,13,229,Pierce County, GA,Apr-17,8805,8425,380,4.3
CN1322900000000,13,229,Pierce County, GA,May-17,8771,8390,381,4.3
CN1322900000000,13,229,Pierce County, GA,Jun-17,8885,8452,433,4.9
CN1322900000000,13,229,Pierce County, GA,Jul-17,8867,8437,430,4.8
CN1322900000000,13,229,Pierce County, GA,Aug-17,8784,8377,407,4.6
CN1322900000000,13,229,Pierce County, GA,Sep-17,8857,8463,394,4.4
CN1322900000000,13,229,Pierce County, GA,Oct-17,8856,8485,371,4.2
CN1322900000000,13,229,Pierce County, GA,Nov-17,8814,8462,352,4.0
CN1322900000000,13,229,Pierce County, GA,Dec-17,8870,8510,360,4.1
CN1322900000000,13,229,Pierce County, GA,Jan-18,9003,8623,380,4.2
CN1322900000000,13,229,Pierce County, GA,Feb-18,8862,8476,386,4.4
CN1322900000000,13,229,Pierce County, GA,Mar-18,8858,8512,346,3.9
CN1322900000000,13,229,Pierce County, GA,Apr-18(p),8832,8528,304,3.4
CN5002500000000,50,025,Windham County, VT,Mar-17,23224,22487,737,3.2
CN5002500000000,50,025,Windham County, VT,Apr-17,22647,21854,793,3.5
CN5002500000000,50,025,Windham County, VT,May-17,22718,21905,813,3.6
CN5002500000000,50,025,Windham County, VT,Jun-17,23226,22462,764,3.3
CN5002500000000,50,025,Windham County, VT,Jul-17,23181,22449,732,3.2
CN5002500000000,50,025,Windham County, VT,Aug-17,22886,22204,682,3.0
CN5002500000000,50,025,Windham County, VT,Sep-17,22500,21794,706,3.1
CN5002500000000,50,025,Windham County, VT,Oct-17,22704,22172,532,2.3
CN5002500000000,50,025,Windham County, VT,Nov-17,22811,22164,647,2.8
CN5002500000000,50,025,Windham County, VT,Dec-17,23094,22518,576,2.5
CN5002500000000,50,025,Windham County, VT,Jan-18,23251,22595,656,2.8
CN5002500000000,50,025,Windham County, VT,Feb-18,23354,22705,649,2.8
CN5002500000000,50,025,Windham County, VT,Mar-18,23509,22833,676,2.9
CN5002500000000,50,025,Windham County, VT,Apr-18(p),22903,22111,792,3.5
CN2400900000000,24,009,Calvert County, MD,Mar-17,49943,48207,1736,3.5
CN2400900000000,24,009,Calvert County, MD,Apr-17,49806,48208,1598,3.2
CN2400900000000,24,009,Calvert County, MD,May-17,49944,48250,1694,3.4
CN2400900000000,24,009,Calvert County, MD,Jun-17,50134,48149,1985,4.0
CN2400900000000,24,009,Calvert County, MD,Jul-17,50673,48687,1986,3.9
CN2400900000000,24,009,Calvert County, MD,Aug-17,49997,48130,1867,3.7
CN2400900000000,24,009,Calvert County, MD,Sep-17,50039,48343,1696,3.4
CN2400900000000,24,009,Calvert County, MD,Oct-17,49972,48238,1734,3.5
CN2400900000000,24,009,Calvert County, MD,Nov-17,49848,48077,1771,3.6
CN2400900000000,24,009,Calvert County, MD,Dec-17,49539,47902,1637,3.3
CN2400900000000,24,009,Calvert County, MD,Jan-18,49388,47360,2028,4.1
CN2400900000000,24,009,Calvert County, MD,Feb-18,49793,47768,2025,4.1
CN2400900000000,24,009,Calvert County, MD,Mar-18,49839,47840,1999,4.0
CN2400900000000,24,009,Calvert County, MD,Apr-18(p),49510,47786,1724,3.5
CN3808700000000,38,087,Slope County, ND,Mar-17,422,413,9,2.1
CN3808700000000,38,087,Slope County, ND,Apr-17,430,421,9,2.1
CN3808700000000,38,087,Slope County, ND,May-17,424,417,7,1.7
CN3808700000000,38,087,Slope County, ND,Jun-17,447,438,9,2.0
CN3808700000000,38,087,Slope County, ND,Jul-17,438,430,8,1.8
CN3808700000000,38,087,Slope County, ND,Aug-17,440,431,9,2.0
CN3808700000000,38,087,Slope County, ND,Sep-17,450,441,9,2.0
CN3808700000000,38,087,Slope County, ND,Oct-17,455,448,7,1.5
CN3808700000000,38,087,Slope County, ND,Nov-17,423,415,8,1.9
CN3808700000000,38,087,Slope County, ND,Dec-17,412,405,7,1.7
CN3808700000000,38,087,Slope County, ND,Jan-18,390,381,9,2.3
CN3808700000000,38,087,Slope County, ND,Feb-18,374,365,9,2.4
CN3808700000000,38,087,Slope County, ND,Mar-18,379,369,10,2.6
CN3808700000000,38,087,Slope County, ND,Apr-18(p),384,376,8,2.1
CN3914300000000,39,143,Sandusky County, OH,Mar-17,31563,29981,1582,5.0
CN3914300000000,39,143,Sandusky County, OH,Apr-17,31529,30114,1415,4.5
CN3914300000000,39,143,Sandusky County, OH,May-17,31426,30106,1320,4.2
CN3914300000000,39,143,Sandusky County, OH,Jun-17,31900,30458,1442,4.5
CN3914300000000,39,143,Sandusky County, OH,Jul-17,31793,30228,1565,4.9
CN3914300000000,39,143,Sandusky County, OH,Aug-17,31985,30546,1439,4.5
CN3914300000000,39,143,Sandusky County, OH,Sep-17,31369,30020,1349,4.3
CN3914300000000,39,143,Sandusky County, OH,Oct-17,31198,29923,1275,4.1
CN3914300000000,39,143,Sandusky County, OH,Nov-17,30858,29531,1327,4.3
CN3914300000000,39,143,Sandusky County, OH,Dec-17,30640,29173,1467,4.8
CN3914300000000,39,143,Sandusky County, OH,Jan-18,30369,28707,1662,5.5
CN3914300000000,39,143,Sandusky County, OH,Feb-18,30899,29384,1515,4.9
CN3914300000000,39,143,Sandusky County, OH,Mar-18,31230,29884,1346,4.3
CN3914300000000,39,143,Sandusky County, OH,Apr-18(p),31194,29908,1286,4.1
CN1204900000000,12,049,Hardee County, FL,Mar-17,9880,9372,508,5.1
CN1204900000000,12,049,Hardee County, FL,Apr-17,9784,9302,482,4.9
CN1204900000000,12,049,Hardee County, FL,May-17,9753,9274,479,4.9
CN1204900000000,12,049,Hardee County, FL,Jun-17,8976,8429,547,6.1
CN1204900000000,12,049,Hardee County, FL,Jul-17,8686,8113,573,6.6
CN1204900000000,12,049,Hardee County, FL,Aug-17,8919,8358,561,6.3
CN1204900000000,12,049,Hardee County, FL,Sep-17,8997,8473,524,5.8
CN1204900000000,12,049,Hardee County, FL,Oct-17,8920,8433,487,5.5
CN1204900000000,12,049,Hardee County, FL,Nov-17,9165,8680,485,5.3
CN1204900000000,12,049,Hardee County, FL,Dec-17,9785,9336,449,4.6
CN1204900000000,12,049,Hardee County, FL,Jan-18,9963,9442,521,5.2
CN1204900000000,12,049,Hardee County, FL,Feb-18,10125,9652,473,4.7
CN1204900000000,12,049,Hardee County, FL,Mar-18,10057,9596,461,4.6
CN1204900000000,12,049,Hardee County, FL,Apr-18(p),9908,9489,419,4.2
CN2807300000000,28,073,Lamar County, MS,Mar-17,30187,29020,1167,3.9
CN2807300000000,28,073,Lamar County, MS,Apr-17,30049,28986,1063,3.5
CN2807300000000,28,073,Lamar County, MS,May-17,30032,28756,1276,4.2
CN2807300000000,28,073,Lamar County, MS,Jun-17,30192,28789,1403,4.6
CN2807300000000,28,073,Lamar County, MS,Jul-17,30110,28782,1328,4.4
CN2807300000000,28,073,Lamar County, MS,Aug-17,29704,28604,1100,3.7
CN2807300000000,28,073,Lamar County, MS,Sep-17,30018,28975,1043,3.5
CN2807300000000,28,073,Lamar County, MS,Oct-17,30292,29299,993,3.3
CN2807300000000,28,073,Lamar County, MS,Nov-17,30626,29675,951,3.1
CN2807300000000,28,073,Lamar County, MS,Dec-17,30583,29610,973,3.2
CN2807300000000,28,073,Lamar County, MS,Jan-18,30044,29035,1009,3.4
CN2807300000000,28,073,Lamar County, MS,Feb-18,30451,29431,1020,3.3
CN2807300000000,28,073,Lamar County, MS,Mar-18,30286,29294,992,3.3
CN2807300000000,28,073,Lamar County, MS,Apr-18(p),30408,29405,1003,3.3
CN5506700000000,55,067,Langlade County, WI,Mar-17,9643,9161,482,5.0
CN5506700000000,55,067,Langlade County, WI,Apr-17,9717,9283,434,4.5
CN5506700000000,55,067,Langlade County, WI,May-17,9701,9358,343,3.5
CN5506700000000,55,067,Langlade County, WI,Jun-17,10082,9602,480,4.8
CN5506700000000,55,067,Langlade County, WI,Jul-17,9819,9390,429,4.4
CN5506700000000,55,067,Langlade County, WI,Aug-17,9725,9293,432,4.4
CN5506700000000,55,067,Langlade County, WI,Sep-17,9654,9326,328,3.4
CN5506700000000,55,067,Langlade County, WI,Oct-17,9641,9343,298,3.1
CN5506700000000,55,067,Langlade County, WI,Nov-17,9711,9393,318,3.3
CN5506700000000,55,067,Langlade County, WI,Dec-17,9693,9327,366,3.8
CN5506700000000,55,067,Langlade County, WI,Jan-18,9707,9321,386,4.0
CN5506700000000,55,067,Langlade County, WI,Feb-18,9728,9264,464,4.8
CN5506700000000,55,067,Langlade County, WI,Mar-18,9766,9341,425,4.4
CN5506700000000,55,067,Langlade County, WI,Apr-18(p),9767,9375,392,4.0
CN4825100000000,48,251,Johnson County, TX,Mar-17,77102,73859,3243,4.2
CN4825100000000,48,251,Johnson County, TX,Apr-17,77018,74273,2745,3.6
CN4825100000000,48,251,Johnson County, TX,May-17,76936,74130,2806,3.6
CN4825100000000,48,251,Johnson County, TX,Jun-17,77392,74274,3118,4.0
CN4825100000000,48,251,Johnson County, TX,Jul-17,77866,74720,3146,4.0
CN4825100000000,48,251,Johnson County, TX,Aug-17,77663,74614,3049,3.9
CN4825100000000,48,251,Johnson County, TX,Sep-17,78197,75556,2641,3.4
CN4825100000000,48,251,Johnson County, TX,Oct-17,77623,75172,2451,3.2
CN4825100000000,48,251,Johnson County, TX,Nov-17,77979,75419,2560,3.3
CN4825100000000,48,251,Johnson County, TX,Dec-17,77845,75372,2473,3.2
CN4825100000000,48,251,Johnson County, TX,Jan-18,77779,74940,2839,3.7
CN4825100000000,48,251,Johnson County, TX,Feb-18,78756,75907,2849,3.6
CN4825100000000,48,251,Johnson County, TX,Mar-18,78915,76017,2898,3.7
CN4825100000000,48,251,Johnson County, TX,Apr-18(p),79240,76666,2574,3.2
CN2010500000000,20,105,Lincoln County, KS,Mar-17,1681,1633,48,2.9
CN2010500000000,20,105,Lincoln County, KS,Apr-17,1690,1644,46,2.7
CN2010500000000,20,105,Lincoln County, KS,May-17,1678,1632,46,2.7
CN2010500000000,20,105,Lincoln County, KS,Jun-17,1734,1680,54,3.1
CN2010500000000,20,105,Lincoln County, KS,Jul-17,1689,1636,53,3.1
CN2010500000000,20,105,Lincoln County, KS,Aug-17,1637,1582,55,3.4
CN2010500000000,20,105,Lincoln County, KS,Sep-17,1667,1625,42,2.5
CN2010500000000,20,105,Lincoln County, KS,Oct-17,1733,1694,39,2.3
CN2010500000000,20,105,Lincoln County, KS,Nov-17,1707,1665,42,2.5
CN2010500000000,20,105,Lincoln County, KS,Dec-17,1684,1648,36,2.1
CN2010500000000,20,105,Lincoln County, KS,Jan-18,1657,1611,46,2.8
CN2010500000000,20,105,Lincoln County, KS,Feb-18,1641,1592,49,3.0
CN2010500000000,20,105,Lincoln County, KS,Mar-18,1619,1575,44,2.7
CN2010500000000,20,105,Lincoln County, KS,Apr-18(p),1559,1519,40,2.6
CN3911500000000,39,115,Morgan County, OH,Mar-17,6823,6267,556,8.1
CN3911500000000,39,115,Morgan County, OH,Apr-17,6664,6236,428,6.4
CN3911500000000,39,115,Morgan County, OH,May-17,6634,6268,366,5.5
CN3911500000000,39,115,Morgan County, OH,Jun-17,6717,6317,400,6.0
CN3911500000000,39,115,Morgan County, OH,Jul-17,6676,6263,413,6.2
CN3911500000000,39,115,Morgan County, OH,Aug-17,6749,6373,376,5.6
CN3911500000000,39,115,Morgan County, OH,Sep-17,6628,6296,332,5.0
CN3911500000000,39,115,Morgan County, OH,Oct-17,6582,6249,333,5.1
CN3911500000000,39,115,Morgan County, OH,Nov-17,6599,6180,419,6.3
CN3911500000000,39,115,Morgan County, OH,Dec-17,6568,6046,522,7.9
CN3911500000000,39,115,Morgan County, OH,Jan-18,6549,5949,600,9.2
CN3911500000000,39,115,Morgan County, OH,Feb-18,6733,6180,553,8.2
CN3911500000000,39,115,Morgan County, OH,Mar-18,6866,6370,496,7.2
CN3911500000000,39,115,Morgan County, OH,Apr-18(p),6758,6363,395,5.8
CN4712300000000,47,123,Monroe County, TN,Mar-17,19617,18775,842,4.3
CN4712300000000,47,123,Monroe County, TN,Apr-17,19686,18976,710,3.6
CN4712300000000,47,123,Monroe County, TN,May-17,19579,18905,674,3.4
CN4712300000000,47,123,Monroe County, TN,Jun-17,19711,18820,891,4.5
CN4712300000000,47,123,Monroe County, TN,Jul-17,19924,19080,844,4.2
CN4712300000000,47,123,Monroe County, TN,Aug-17,19828,19044,784,4.0
CN4712300000000,47,123,Monroe County, TN,Sep-17,19901,19225,676,3.4
CN4712300000000,47,123,Monroe County, TN,Oct-17,19824,19158,666,3.4
CN4712300000000,47,123,Monroe County, TN,Nov-17,19775,19121,654,3.3
CN4712300000000,47,123,Monroe County, TN,Dec-17,19715,19061,654,3.3
CN4712300000000,47,123,Monroe County, TN,Jan-18,19721,18935,786,4.0
CN4712300000000,47,123,Monroe County, TN,Feb-18,19981,19210,771,3.9
CN4712300000000,47,123,Monroe County, TN,Mar-18,19913,19192,721,3.6
CN4712300000000,47,123,Monroe County, TN,Apr-18(p),20063,19457,606,3.0
CN2403100000000,24,031,Montgomery County, MD,Mar-17,555518,537917,17601,3.2
CN2403100000000,24,031,Montgomery County, MD,Apr-17,550642,534706,15936,2.9
CN2403100000000,24,031,Montgomery County, MD,May-17,552561,534613,17948,3.2
CN2403100000000,24,031,Montgomery County, MD,Jun-17,562402,542303,20099,3.6
CN2403100000000,24,031,Montgomery County, MD,Jul-17,564380,544580,19800,3.5
CN2403100000000,24,031,Montgomery County, MD,Aug-17,560372,542044,18328,3.3
CN2403100000000,24,031,Montgomery County, MD,Sep-17,561723,543919,17804,3.2
CN2403100000000,24,031,Montgomery County, MD,Oct-17,558385,539901,18484,3.3
CN2403100000000,24,031,Montgomery County, MD,Nov-17,558584,540174,18410,3.3
CN2403100000000,24,031,Montgomery County, MD,Dec-17,554732,538708,16024,2.9
CN2403100000000,24,031,Montgomery County, MD,Jan-18,558272,538011,20261,3.6
CN2403100000000,24,031,Montgomery County, MD,Feb-18,561158,540812,20346,3.6
CN2403100000000,24,031,Montgomery County, MD,Mar-18,561702,541405,20297,3.6
CN2403100000000,24,031,Montgomery County, MD,Apr-18(p),556220,539341,16879,3.0
CN0108300000000,01,083,Limestone County, AL,Mar-17,41165,39289,1876,4.6
CN0108300000000,01,083,Limestone County, AL,Apr-17,41076,39561,1515,3.7
CN0108300000000,01,083,Limestone County, AL,May-17,40923,39429,1494,3.7
CN0108300000000,01,083,Limestone County, AL,Jun-17,41247,39464,1783,4.3
CN0108300000000,01,083,Limestone County, AL,Jul-17,41093,39420,1673,4.1
CN0108300000000,01,083,Limestone County, AL,Aug-17,40925,39325,1600,3.9
CN0108300000000,01,083,Limestone County, AL,Sep-17,41139,39779,1360,3.3
CN0108300000000,01,083,Limestone County, AL,Oct-17,41262,39881,1381,3.3
CN0108300000000,01,083,Limestone County, AL,Nov-17,41403,40108,1295,3.1
CN0108300000000,01,083,Limestone County, AL,Dec-17,41057,39773,1284,3.1
CN0108300000000,01,083,Limestone County, AL,Jan-18,40878,39303,1575,3.9
CN0108300000000,01,083,Limestone County, AL,Feb-18,41762,40144,1618,3.9
CN0108300000000,01,083,Limestone County, AL,Mar-18,41790,40326,1464,3.5
CN0108300000000,01,083,Limestone County, AL,Apr-18(p),42103,40802,1301,3.1
CN1804700000000,18,047,Franklin County, IN,Mar-17,11182,10757,425,3.8
CN1804700000000,18,047,Franklin County, IN,Apr-17,11166,10859,307,2.7
CN1804700000000,18,047,Franklin County, IN,May-17,11521,11179,342,3.0
CN1804700000000,18,047,Franklin County, IN,Jun-17,11421,11035,386,3.4
CN1804700000000,18,047,Franklin County, IN,Jul-17,11334,10933,401,3.5
CN1804700000000,18,047,Franklin County, IN,Aug-17,11365,10940,425,3.7
CN1804700000000,18,047,Franklin County, IN,Sep-17,11140,10766,374,3.4
CN1804700000000,18,047,Franklin County, IN,Oct-17,11024,10664,360,3.3
CN1804700000000,18,047,Franklin County, IN,Nov-17,11030,10628,402,3.6
CN1804700000000,18,047,Franklin County, IN,Dec-17,10859,10461,398,3.7
CN1804700000000,18,047,Franklin County, IN,Jan-18,10663,10179,484,4.5
CN1804700000000,18,047,Franklin County, IN,Feb-18,10946,10439,507,4.6
CN1804700000000,18,047,Franklin County, IN,Mar-18,11074,10646,428,3.9
CN1804700000000,18,047,Franklin County, IN,Apr-18(p),11154,10785,369,3.3
CN2605500000000,26,055,Grand Traverse County, MI,Mar-17,47899,45475,2424,5.1
CN2605500000000,26,055,Grand Traverse County, MI,Apr-17,47894,46070,1824,3.8
CN2605500000000,26,055,Grand Traverse County, MI,May-17,49549,47709,1840,3.7
CN2605500000000,26,055,Grand Traverse County, MI,Jun-17,52184,50174,2010,3.9
CN2605500000000,26,055,Grand Traverse County, MI,Jul-17,53649,51299,2350,4.4
CN2605500000000,26,055,Grand Traverse County, MI,Aug-17,52467,50346,2121,4.0
CN2605500000000,26,055,Grand Traverse County, MI,Sep-17,50319,48499,1820,3.6
CN2605500000000,26,055,Grand Traverse County, MI,Oct-17,49694,48008,1686,3.4
CN2605500000000,26,055,Grand Traverse County, MI,Nov-17,49402,47571,1831,3.7
CN2605500000000,26,055,Grand Traverse County, MI,Dec-17,49171,47037,2134,4.3
CN2605500000000,26,055,Grand Traverse County, MI,Jan-18,48572,45989,2583,5.3
CN2605500000000,26,055,Grand Traverse County, MI,Feb-18,48912,46151,2761,5.6
CN2605500000000,26,055,Grand Traverse County, MI,Mar-18,48791,46345,2446,5.0
CN2605500000000,26,055,Grand Traverse County, MI,Apr-18(p),48993,46968,2025,4.1
CN5602300000000,56,023,Lincoln County, WY,Mar-17,8578,8190,388,4.5
CN5602300000000,56,023,Lincoln County, WY,Apr-17,8592,8251,341,4.0
CN5602300000000,56,023,Lincoln County, WY,May-17,8681,8377,304,3.5
CN5602300000000,56,023,Lincoln County, WY,Jun-17,9221,8924,297,3.2
CN5602300000000,56,023,Lincoln County, WY,Jul-17,8981,8714,267,3.0
CN5602300000000,56,023,Lincoln County, WY,Aug-17,8825,8560,265,3.0
CN5602300000000,56,023,Lincoln County, WY,Sep-17,8871,8597,274,3.1
CN5602300000000,56,023,Lincoln County, WY,Oct-17,8709,8428,281,3.2
CN5602300000000,56,023,Lincoln County, WY,Nov-17,8522,8198,324,3.8
CN5602300000000,56,023,Lincoln County, WY,Dec-17,8530,8201,329,3.9
CN5602300000000,56,023,Lincoln County, WY,Jan-18,8554,8171,383,4.5
CN5602300000000,56,023,Lincoln County, WY,Feb-18,8521,8165,356,4.2
CN5602300000000,56,023,Lincoln County, WY,Mar-18,8633,8275,358,4.1
CN5602300000000,56,023,Lincoln County, WY,Apr-18(p),8497,8142,355,4.2
CN4844100000000,48,441,Taylor County, TX,Mar-17,64107,61786,2321,3.6
CN4844100000000,48,441,Taylor County, TX,Apr-17,64159,62051,2108,3.3
CN4844100000000,48,441,Taylor County, TX,May-17,64051,61767,2284,3.6
CN4844100000000,48,441,Taylor County, TX,Jun-17,63904,61395,2509,3.9
CN4844100000000,48,441,Taylor County, TX,Jul-17,63736,61261,2475,3.9
CN4844100000000,48,441,Taylor County, TX,Aug-17,63770,61318,2452,3.8
CN4844100000000,48,441,Taylor County, TX,Sep-17,64505,62365,2140,3.3
CN4844100000000,48,441,Taylor County, TX,Oct-17,64076,62088,1988,3.1
CN4844100000000,48,441,Taylor County, TX,Nov-17,64565,62558,2007,3.1
CN4844100000000,48,441,Taylor County, TX,Dec-17,64364,62455,1909,3.0
CN4844100000000,48,441,Taylor County, TX,Jan-18,64357,62168,2189,3.4
CN4844100000000,48,441,Taylor County, TX,Feb-18,65476,63274,2202,3.4
CN4844100000000,48,441,Taylor County, TX,Mar-18,65447,63219,2228,3.4
CN4844100000000,48,441,Taylor County, TX,Apr-18(p),65576,63562,2014,3.1
CN5109100000000,51,091,Highland County, VA,Mar-17,1206,1162,44,3.6
CN5109100000000,51,091,Highland County, VA,Apr-17,1285,1243,42,3.3
CN5109100000000,51,091,Highland County, VA,May-17,1255,1212,43,3.4
CN5109100000000,51,091,Highland County, VA,Jun-17,1316,1275,41,3.1
CN5109100000000,51,091,Highland County, VA,Jul-17,1340,1296,44,3.3
CN5109100000000,51,091,Highland County, VA,Aug-17,1276,1234,42,3.3
CN5109100000000,51,091,Highland County, VA,Sep-17,1261,1222,39,3.1
CN5109100000000,51,091,Highland County, VA,Oct-17,1190,1152,38,3.2
CN5109100000000,51,091,Highland County, VA,Nov-17,1174,1134,40,3.4
CN5109100000000,51,091,Highland County, VA,Dec-17,1229,1182,47,3.8
CN5109100000000,51,091,Highland County, VA,Jan-18,1118,1073,45,4.0
CN5109100000000,51,091,Highland County, VA,Feb-18,1164,1121,43,3.7
CN5109100000000,51,091,Highland County, VA,Mar-18,1145,1099,46,4.0
CN5109100000000,51,091,Highland County, VA,Apr-18(p),1206,1172,34,2.8
CN3112100000000,31,121,Merrick County, NE,Mar-17,3972,3858,114,2.9
CN3112100000000,31,121,Merrick County, NE,Apr-17,4035,3922,113,2.8
CN3112100000000,31,121,Merrick County, NE,May-17,4032,3931,101,2.5
CN3112100000000,31,121,Merrick County, NE,Jun-17,4135,4022,113,2.7
CN3112100000000,31,121,Merrick County, NE,Jul-17,4101,3991,110,2.7
CN3112100000000,31,121,Merrick County, NE,Aug-17,4011,3908,103,2.6
CN3112100000000,31,121,Merrick County, NE,Sep-17,3973,3875,98,2.5
CN3112100000000,31,121,Merrick County, NE,Oct-17,3955,3856,99,2.5
CN3112100000000,31,121,Merrick County, NE,Nov-17,3941,3855,86,2.2
CN3112100000000,31,121,Merrick County, NE,Dec-17,3925,3830,95,2.4
CN3112100000000,31,121,Merrick County, NE,Jan-18,4002,3851,151,3.8
CN3112100000000,31,121,Merrick County, NE,Feb-18,3948,3840,108,2.7
CN3112100000000,31,121,Merrick County, NE,Mar-18,4010,3893,117,2.9
CN3112100000000,31,121,Merrick County, NE,Apr-18(p),4024,3911,113,2.8
CN1708500000000,17,085,Jo Daviess County, IL,Mar-17,10792,10200,592,5.5
CN1708500000000,17,085,Jo Daviess County, IL,Apr-17,10969,10576,393,3.6
CN1708500000000,17,085,Jo Daviess County, IL,May-17,11153,10802,351,3.1
CN1708500000000,17,085,Jo Daviess County, IL,Jun-17,11492,11053,439,3.8
CN1708500000000,17,085,Jo Daviess County, IL,Jul-17,11479,11033,446,3.9
CN1708500000000,17,085,Jo Daviess County, IL,Aug-17,11238,10784,454,4.0
CN1708500000000,17,085,Jo Daviess County, IL,Sep-17,11076,10658,418,3.8
CN1708500000000,17,085,Jo Daviess County, IL,Oct-17,10954,10553,401,3.7
CN1708500000000,17,085,Jo Daviess County, IL,Nov-17,10672,10241,431,4.0
CN1708500000000,17,085,Jo Daviess County, IL,Dec-17,10563,10082,481,4.6
CN1708500000000,17,085,Jo Daviess County, IL,Jan-18,10564,9992,572,5.4
CN1708500000000,17,085,Jo Daviess County, IL,Feb-18,10646,10117,529,5.0
CN1708500000000,17,085,Jo Daviess County, IL,Mar-18,10728,10191,537,5.0
CN1708500000000,17,085,Jo Daviess County, IL,Apr-18(p),10980,10593,387,3.5
CN2012900000000,20,129,Morton County, KS,Mar-17,1229,1180,49,4.0
CN2012900000000,20,129,Morton County, KS,Apr-17,1209,1163,46,3.8
CN2012900000000,20,129,Morton County, KS,May-17,1202,1148,54,4.5
CN2012900000000,20,129,Morton County, KS,Jun-17,1220,1169,51,4.2
CN2012900000000,20,129,Morton County, KS,Jul-17,1164,1114,50,4.3
CN2012900000000,20,129,Morton County, KS,Aug-17,1161,1114,47,4.0
CN2012900000000,20,129,Morton County, KS,Sep-17,1210,1176,34,2.8
CN2012900000000,20,129,Morton County, KS,Oct-17,1247,1214,33,2.6
CN2012900000000,20,129,Morton County, KS,Nov-17,1228,1192,36,2.9
CN2012900000000,20,129,Morton County, KS,Dec-17,1200,1168,32,2.7
CN2012900000000,20,129,Morton County, KS,Jan-18,1171,1140,31,2.6
CN2012900000000,20,129,Morton County, KS,Feb-18,1173,1138,35,3.0
CN2012900000000,20,129,Morton County, KS,Mar-18,1138,1098,40,3.5
CN2012900000000,20,129,Morton County, KS,Apr-18(p),1088,1054,34,3.1
CN1207700000000,12,077,Liberty County, FL,Mar-17,2650,2523,127,4.8
CN1207700000000,12,077,Liberty County, FL,Apr-17,2642,2521,121,4.6
CN1207700000000,12,077,Liberty County, FL,May-17,2655,2541,114,4.3
CN1207700000000,12,077,Liberty County, FL,Jun-17,2594,2472,122,4.7
CN1207700000000,12,077,Liberty County, FL,Jul-17,2592,2469,123,4.7
CN1207700000000,12,077,Liberty County, FL,Aug-17,2587,2465,122,4.7
CN1207700000000,12,077,Liberty County, FL,Sep-17,2721,2611,110,4.0
CN1207700000000,12,077,Liberty County, FL,Oct-17,2654,2552,102,3.8
CN1207700000000,12,077,Liberty County, FL,Nov-17,2629,2524,105,4.0
CN1207700000000,12,077,Liberty County, FL,Dec-17,2594,2493,101,3.9
CN1207700000000,12,077,Liberty County, FL,Jan-18,2623,2501,122,4.7
CN1207700000000,12,077,Liberty County, FL,Feb-18,2643,2528,115,4.4
CN1207700000000,12,077,Liberty County, FL,Mar-18,2647,2535,112,4.2
CN1207700000000,12,077,Liberty County, FL,Apr-18(p),2621,2521,100,3.8
CN5101500000000,51,015,Augusta County, VA,Mar-17,36863,35547,1316,3.6
CN5101500000000,51,015,Augusta County, VA,Apr-17,37223,36057,1166,3.1
CN5101500000000,51,015,Augusta County, VA,May-17,36993,35701,1292,3.5
CN5101500000000,51,015,Augusta County, VA,Jun-17,37165,35826,1339,3.6
CN5101500000000,51,015,Augusta County, VA,Jul-17,37207,35859,1348,3.6
CN5101500000000,51,015,Augusta County, VA,Aug-17,36574,35268,1306,3.6
CN5101500000000,51,015,Augusta County, VA,Sep-17,37015,35800,1215,3.3
CN5101500000000,51,015,Augusta County, VA,Oct-17,36755,35580,1175,3.2
CN5101500000000,51,015,Augusta County, VA,Nov-17,36672,35533,1139,3.1
CN5101500000000,51,015,Augusta County, VA,Dec-17,36696,35586,1110,3.0
CN5101500000000,51,015,Augusta County, VA,Jan-18,36468,35206,1262,3.5
CN5101500000000,51,015,Augusta County, VA,Feb-18,37061,35967,1094,3.0
CN5101500000000,51,015,Augusta County, VA,Mar-18,37174,36065,1109,3.0
CN5101500000000,51,015,Augusta County, VA,Apr-18(p),37460,36508,952,2.5
CN3610700000000,36,107,Tioga County, NY,Mar-17,23310,21952,1358,5.8
CN3610700000000,36,107,Tioga County, NY,Apr-17,23107,21982,1125,4.9
CN3610700000000,36,107,Tioga County, NY,May-17,23158,22081,1077,4.7
CN3610700000000,36,107,Tioga County, NY,Jun-17,23245,22122,1123,4.8
CN3610700000000,36,107,Tioga County, NY,Jul-17,22902,21777,1125,4.9
CN3610700000000,36,107,Tioga County, NY,Aug-17,22778,21672,1106,4.9
CN3610700000000,36,107,Tioga County, NY,Sep-17,22969,21884,1085,4.7
CN3610700000000,36,107,Tioga County, NY,Oct-17,22810,21787,1023,4.5
CN3610700000000,36,107,Tioga County, NY,Nov-17,22689,21620,1069,4.7
CN3610700000000,36,107,Tioga County, NY,Dec-17,22608,21444,1164,5.1
CN3610700000000,36,107,Tioga County, NY,Jan-18,22840,21329,1511,6.6
CN3610700000000,36,107,Tioga County, NY,Feb-18,22765,21256,1509,6.6
CN3610700000000,36,107,Tioga County, NY,Mar-18,22624,21268,1356,6.0
CN3610700000000,36,107,Tioga County, NY,Apr-18(p),22493,21386,1107,4.9
CN2901700000000,29,017,Bollinger County, MO,Mar-17,5384,5114,270,5.0
CN2901700000000,29,017,Bollinger County, MO,Apr-17,5477,5241,236,4.3
CN2901700000000,29,017,Bollinger County, MO,May-17,5390,5146,244,4.5
CN2901700000000,29,017,Bollinger County, MO,Jun-17,5446,5194,252,4.6
CN2901700000000,29,017,Bollinger County, MO,Jul-17,5299,5049,250,4.7
CN2901700000000,29,017,Bollinger County, MO,Aug-17,5336,5098,238,4.5
CN2901700000000,29,017,Bollinger County, MO,Sep-17,5341,5138,203,3.8
CN2901700000000,29,017,Bollinger County, MO,Oct-17,5364,5221,143,2.7
CN2901700000000,29,017,Bollinger County, MO,Nov-17,5403,5212,191,3.5
CN2901700000000,29,017,Bollinger County, MO,Dec-17,5387,5178,209,3.9
CN2901700000000,29,017,Bollinger County, MO,Jan-18,5374,5090,284,5.3
CN2901700000000,29,017,Bollinger County, MO,Feb-18,5459,5197,262,4.8
CN2901700000000,29,017,Bollinger County, MO,Mar-18,5432,5190,242,4.5
CN2901700000000,29,017,Bollinger County, MO,Apr-18(p),5451,5253,198,3.6
CN7213700000000,72,137,Toa Baja Municipio, PR,Mar-17,29864,27542,2322,7.8
CN7213700000000,72,137,Toa Baja Municipio, PR,Apr-17,29881,27283,2598,8.7
CN7213700000000,72,137,Toa Baja Municipio, PR,May-17,29387,27114,2273,7.7
CN7213700000000,72,137,Toa Baja Municipio, PR,Jun-17,28944,26938,2006,6.9
CN7213700000000,72,137,Toa Baja Municipio, PR,Jul-17,29134,26824,2310,7.9
CN7213700000000,72,137,Toa Baja Municipio, PR,Aug-17,29146,26466,2680,9.2
CN7213700000000,72,137,Toa Baja Municipio, PR,Sep-17(y),29403,26798,2605,8.9
CN7213700000000,72,137,Toa Baja Municipio, PR,Oct-17,28042,25744,2298,8.2
CN7213700000000,72,137,Toa Baja Municipio, PR,Nov-17,29392,27213,2179,7.4
CN7213700000000,72,137,Toa Baja Municipio, PR,Dec-17,29547,27410,2137,7.2
CN7213700000000,72,137,Toa Baja Municipio, PR,Jan-18,29171,26888,2283,7.8
CN7213700000000,72,137,Toa Baja Municipio, PR,Feb-18,29074,27002,2072,7.1
CN7213700000000,72,137,Toa Baja Municipio, PR,Mar-18,29066,27037,2029,7.0
CN7213700000000,72,137,Toa Baja Municipio, PR,Apr-18(p),29151,27205,1946,6.7
CN3913900000000,39,139,Richland County, OH,Mar-17,53299,50196,3103,5.8
CN3913900000000,39,139,Richland County, OH,Apr-17,52729,49991,2738,5.2
CN3913900000000,39,139,Richland County, OH,May-17,53156,50549,2607,4.9
CN3913900000000,39,139,Richland County, OH,Jun-17,53856,50912,2944,5.5
CN3913900000000,39,139,Richland County, OH,Jul-17,54010,50810,3200,5.9
CN3913900000000,39,139,Richland County, OH,Aug-17,53450,50584,2866,5.4
CN3913900000000,39,139,Richland County, OH,Sep-17,53109,50439,2670,5.0
CN3913900000000,39,139,Richland County, OH,Oct-17,53071,50504,2567,4.8
CN3913900000000,39,139,Richland County, OH,Nov-17,52865,50174,2691,5.1
CN3913900000000,39,139,Richland County, OH,Dec-17,52962,50160,2802,5.3
CN3913900000000,39,139,Richland County, OH,Jan-18,52519,49526,2993,5.7
CN3913900000000,39,139,Richland County, OH,Feb-18,53015,50259,2756,5.2
CN3913900000000,39,139,Richland County, OH,Mar-18,53450,50872,2578,4.8
CN3913900000000,39,139,Richland County, OH,Apr-18(p),53072,50691,2381,4.5
CN4846500000000,48,465,Val Verde County, TX,Mar-17,20167,19053,1114,5.5
CN4846500000000,48,465,Val Verde County, TX,Apr-17,20119,19103,1016,5.0
CN4846500000000,48,465,Val Verde County, TX,May-17,20100,19127,973,4.8
CN4846500000000,48,465,Val Verde County, TX,Jun-17,20217,19215,1002,5.0
CN4846500000000,48,465,Val Verde County, TX,Jul-17,19772,18602,1170,5.9
CN4846500000000,48,465,Val Verde County, TX,Aug-17,19806,18816,990,5.0
CN4846500000000,48,465,Val Verde County, TX,Sep-17,20019,19137,882,4.4
CN4846500000000,48,465,Val Verde County, TX,Oct-17,19829,19009,820,4.1
CN4846500000000,48,465,Val Verde County, TX,Nov-17,19889,19033,856,4.3
CN4846500000000,48,465,Val Verde County, TX,Dec-17,19825,18983,842,4.2
CN4846500000000,48,465,Val Verde County, TX,Jan-18,20101,19141,960,4.8
CN4846500000000,48,465,Val Verde County, TX,Feb-18,20329,19336,993,4.9
CN4846500000000,48,465,Val Verde County, TX,Mar-18,20424,19414,1010,4.9
CN4846500000000,48,465,Val Verde County, TX,Apr-18(p),20692,19764,928,4.5
CN3117500000000,31,175,Valley County, NE,Mar-17,2083,2023,60,2.9
CN3117500000000,31,175,Valley County, NE,Apr-17,2119,2062,57,2.7
CN3117500000000,31,175,Valley County, NE,May-17,2151,2094,57,2.6
CN3117500000000,31,175,Valley County, NE,Jun-17,2239,2177,62,2.8
CN3117500000000,31,175,Valley County, NE,Jul-17,2185,2131,54,2.5
CN3117500000000,31,175,Valley County, NE,Aug-17,2115,2061,54,2.6
CN3117500000000,31,175,Valley County, NE,Sep-17,2039,1993,46,2.3
CN3117500000000,31,175,Valley County, NE,Oct-17,2053,2006,47,2.3
CN3117500000000,31,175,Valley County, NE,Nov-17,2059,2008,51,2.5
CN3117500000000,31,175,Valley County, NE,Dec-17,2065,2012,53,2.6
CN3117500000000,31,175,Valley County, NE,Jan-18,2107,2041,66,3.1
CN3117500000000,31,175,Valley County, NE,Feb-18,2090,2020,70,3.3
CN3117500000000,31,175,Valley County, NE,Mar-18,2108,2039,69,3.3
CN3117500000000,31,175,Valley County, NE,Apr-18(p),2104,2038,66,3.1
CN1301500000000,13,015,Bartow County, GA,Mar-17,49519,47181,2338,4.7
CN1301500000000,13,015,Bartow County, GA,Apr-17,49466,47273,2193,4.4
CN1301500000000,13,015,Bartow County, GA,May-17,49643,47388,2255,4.5
CN1301500000000,13,015,Bartow County, GA,Jun-17,49771,47374,2397,4.8
CN1301500000000,13,015,Bartow County, GA,Jul-17,50149,47652,2497,5.0
CN1301500000000,13,015,Bartow County, GA,Aug-17,49798,47435,2363,4.7
CN1301500000000,13,015,Bartow County, GA,Sep-17,50126,48042,2084,4.2
CN1301500000000,13,015,Bartow County, GA,Oct-17,49952,47902,2050,4.1
CN1301500000000,13,015,Bartow County, GA,Nov-17,50078,48076,2002,4.0
CN1301500000000,13,015,Bartow County, GA,Dec-17,50122,48067,2055,4.1
CN1301500000000,13,015,Bartow County, GA,Jan-18,50200,48000,2200,4.4
CN1301500000000,13,015,Bartow County, GA,Feb-18,50864,48682,2182,4.3
CN1301500000000,13,015,Bartow County, GA,Mar-18,50827,48854,1973,3.9
CN1301500000000,13,015,Bartow County, GA,Apr-18(p),50477,48709,1768,3.5
CN5402300000000,54,023,Grant County, WV,Mar-17,5844,5492,352,6.0
CN5402300000000,54,023,Grant County, WV,Apr-17,5930,5649,281,4.7
CN5402300000000,54,023,Grant County, WV,May-17,5913,5647,266,4.5
CN5402300000000,54,023,Grant County, WV,Jun-17,6013,5672,341,5.7
CN5402300000000,54,023,Grant County, WV,Jul-17,5970,5634,336,5.6
CN5402300000000,54,023,Grant County, WV,Aug-17,5932,5605,327,5.5
CN5402300000000,54,023,Grant County, WV,Sep-17,5873,5601,272,4.6
CN5402300000000,54,023,Grant County, WV,Oct-17,5902,5619,283,4.8
CN5402300000000,54,023,Grant County, WV,Nov-17,5792,5484,308,5.3
CN5402300000000,54,023,Grant County, WV,Dec-17,5668,5311,357,6.3
CN5402300000000,54,023,Grant County, WV,Jan-18,5804,5409,395,6.8
CN5402300000000,54,023,Grant County, WV,Feb-18,5862,5450,412,7.0
CN5402300000000,54,023,Grant County, WV,Mar-18,5881,5514,367,6.2
CN5402300000000,54,023,Grant County, WV,Apr-18(p),5990,5677,313,5.2
CN0811900000000,08,119,Teller County, CO,Mar-17,12068,11659,409,3.4
CN0811900000000,08,119,Teller County, CO,Apr-17,12070,11699,371,3.1
CN0811900000000,08,119,Teller County, CO,May-17,12105,11758,347,2.9
CN0811900000000,08,119,Teller County, CO,Jun-17,12272,11853,419,3.4
CN0811900000000,08,119,Teller County, CO,Jul-17,12258,11871,387,3.2
CN0811900000000,08,119,Teller County, CO,Aug-17,12258,11870,388,3.2
CN0811900000000,08,119,Teller County, CO,Sep-17,12367,11997,370,3.0
CN0811900000000,08,119,Teller County, CO,Oct-17,12290,11916,374,3.0
CN0811900000000,08,119,Teller County, CO,Nov-17,12286,11914,372,3.0
CN0811900000000,08,119,Teller County, CO,Dec-17,12223,11822,401,3.3
CN0811900000000,08,119,Teller County, CO,Jan-18,12204,11748,456,3.7
CN0811900000000,08,119,Teller County, CO,Feb-18,12441,11980,461,3.7
CN0811900000000,08,119,Teller County, CO,Mar-18,12502,12098,404,3.2
CN0811900000000,08,119,Teller County, CO,Apr-18(p),12557,12192,365,2.9
CN0805700000000,08,057,Jackson County, CO,Mar-17,852,834,18,2.1
CN0805700000000,08,057,Jackson County, CO,Apr-17,896,879,17,1.9
CN0805700000000,08,057,Jackson County, CO,May-17,927,909,18,1.9
CN0805700000000,08,057,Jackson County, CO,Jun-17,1002,984,18,1.8
CN0805700000000,08,057,Jackson County, CO,Jul-17,1031,1018,13,1.3
CN0805700000000,08,057,Jackson County, CO,Aug-17,999,986,13,1.3
CN0805700000000,08,057,Jackson County, CO,Sep-17,993,978,15,1.5
CN0805700000000,08,057,Jackson County, CO,Oct-17,1066,1050,16,1.5
CN0805700000000,08,057,Jackson County, CO,Nov-17,1017,996,21,2.1
CN0805700000000,08,057,Jackson County, CO,Dec-17,989,970,19,1.9
CN0805700000000,08,057,Jackson County, CO,Jan-18,974,952,22,2.3
CN0805700000000,08,057,Jackson County, CO,Feb-18,946,922,24,2.5
CN0805700000000,08,057,Jackson County, CO,Mar-18,924,897,27,2.9
CN0805700000000,08,057,Jackson County, CO,Apr-18(p),955,928,27,2.8
CN2704500000000,27,045,Fillmore County, MN,Mar-17,11536,10979,557,4.8
CN2704500000000,27,045,Fillmore County, MN,Apr-17,11474,11102,372,3.2
CN2704500000000,27,045,Fillmore County, MN,May-17,11444,11131,313,2.7
CN2704500000000,27,045,Fillmore County, MN,Jun-17,11562,11212,350,3.0
CN2704500000000,27,045,Fillmore County, MN,Jul-17,11655,11306,349,3.0
CN2704500000000,27,045,Fillmore County, MN,Aug-17,11486,11137,349,3.0
CN2704500000000,27,045,Fillmore County, MN,Sep-17,11241,10956,285,2.5
CN2704500000000,27,045,Fillmore County, MN,Oct-17,11582,11335,247,2.1
CN2704500000000,27,045,Fillmore County, MN,Nov-17,11511,11196,315,2.7
CN2704500000000,27,045,Fillmore County, MN,Dec-17,11534,11124,410,3.6
CN2704500000000,27,045,Fillmore County, MN,Jan-18,11599,11016,583,5.0
CN2704500000000,27,045,Fillmore County, MN,Feb-18,11645,11060,585,5.0
CN2704500000000,27,045,Fillmore County, MN,Mar-18,11615,11082,533,4.6
CN2704500000000,27,045,Fillmore County, MN,Apr-18(p),11526,11125,401,3.5
CN3802500000000,38,025,Dunn County, ND,Mar-17,3097,3015,82,2.6
CN3802500000000,38,025,Dunn County, ND,Apr-17,3167,3090,77,2.4
CN3802500000000,38,025,Dunn County, ND,May-17,3253,3192,61,1.9
CN3802500000000,38,025,Dunn County, ND,Jun-17,3391,3318,73,2.2
CN3802500000000,38,025,Dunn County, ND,Jul-17,3377,3318,59,1.7
CN3802500000000,38,025,Dunn County, ND,Aug-17,3442,3380,62,1.8
CN3802500000000,38,025,Dunn County, ND,Sep-17,3379,3329,50,1.5
CN3802500000000,38,025,Dunn County, ND,Oct-17,3295,3247,48,1.5
CN3802500000000,38,025,Dunn County, ND,Nov-17,3165,3110,55,1.7
CN3802500000000,38,025,Dunn County, ND,Dec-17,3063,3011,52,1.7
CN3802500000000,38,025,Dunn County, ND,Jan-18,2946,2887,59,2.0
CN3802500000000,38,025,Dunn County, ND,Feb-18,2901,2839,62,2.1
CN3802500000000,38,025,Dunn County, ND,Mar-18,2932,2874,58,2.0
CN3802500000000,38,025,Dunn County, ND,Apr-18(p),2938,2888,50,1.7
CN4505300000000,45,053,Jasper County, SC,Mar-17,12017,11601,416,3.5
CN4505300000000,45,053,Jasper County, SC,Apr-17,12197,11819,378,3.1
CN4505300000000,45,053,Jasper County, SC,May-17,12429,12024,405,3.3
CN4505300000000,45,053,Jasper County, SC,Jun-17,12706,12228,478,3.8
CN4505300000000,45,053,Jasper County, SC,Jul-17,12697,12232,465,3.7
CN4505300000000,45,053,Jasper County, SC,Aug-17,12568,12073,495,3.9
CN4505300000000,45,053,Jasper County, SC,Sep-17,12159,11720,439,3.6
CN4505300000000,45,053,Jasper County, SC,Oct-17,12099,11665,434,3.6
CN4505300000000,45,053,Jasper County, SC,Nov-17,12044,11632,412,3.4
CN4505300000000,45,053,Jasper County, SC,Dec-17,12048,11610,438,3.6
CN4505300000000,45,053,Jasper County, SC,Jan-18,12089,11544,545,4.5
CN4505300000000,45,053,Jasper County, SC,Feb-18,12203,11703,500,4.1
CN4505300000000,45,053,Jasper County, SC,Mar-18,12251,11807,444,3.6
CN4505300000000,45,053,Jasper County, SC,Apr-18(p),12275,11984,291,2.4
CN2808900000000,28,089,Madison County, MS,Mar-17,53887,51753,2134,4.0
CN2808900000000,28,089,Madison County, MS,Apr-17,53739,51840,1899,3.5
CN2808900000000,28,089,Madison County, MS,May-17,53787,51553,2234,4.2
CN2808900000000,28,089,Madison County, MS,Jun-17,54274,51730,2544,4.7
CN2808900000000,28,089,Madison County, MS,Jul-17,54343,51890,2453,4.5
CN2808900000000,28,089,Madison County, MS,Aug-17,53280,51255,2025,3.8
CN2808900000000,28,089,Madison County, MS,Sep-17,53547,51621,1926,3.6
CN2808900000000,28,089,Madison County, MS,Oct-17,53947,52124,1823,3.4
CN2808900000000,28,089,Madison County, MS,Nov-17,54124,52342,1782,3.3
CN2808900000000,28,089,Madison County, MS,Dec-17,54190,52416,1774,3.3
CN2808900000000,28,089,Madison County, MS,Jan-18,53549,51756,1793,3.3
CN2808900000000,28,089,Madison County, MS,Feb-18,53953,52119,1834,3.4
CN2808900000000,28,089,Madison County, MS,Mar-18,54050,52209,1841,3.4
CN2808900000000,28,089,Madison County, MS,Apr-18(p),54119,52324,1795,3.3
CN1817500000000,18,175,Washington County, IN,Mar-17,13602,13065,537,3.9
CN1817500000000,18,175,Washington County, IN,Apr-17,13576,13156,420,3.1
CN1817500000000,18,175,Washington County, IN,May-17,13912,13456,456,3.3
CN1817500000000,18,175,Washington County, IN,Jun-17,13965,13481,484,3.5
CN1817500000000,18,175,Washington County, IN,Jul-17,13913,13400,513,3.7
CN1817500000000,18,175,Washington County, IN,Aug-17,13720,13143,577,4.2
CN1817500000000,18,175,Washington County, IN,Sep-17,13519,13042,477,3.5
CN1817500000000,18,175,Washington County, IN,Oct-17,13547,13081,466,3.4
CN1817500000000,18,175,Washington County, IN,Nov-17,13686,13232,454,3.3
CN1817500000000,18,175,Washington County, IN,Dec-17,13551,13105,446,3.3
CN1817500000000,18,175,Washington County, IN,Jan-18,13353,12812,541,4.1
CN1817500000000,18,175,Washington County, IN,Feb-18,13587,13044,543,4.0
CN1817500000000,18,175,Washington County, IN,Mar-18,13722,13246,476,3.5
CN1817500000000,18,175,Washington County, IN,Apr-18(p),13752,13320,432,3.1
CN0110700000000,01,107,Pickens County, AL,Mar-17,7802,7329,473,6.1
CN0110700000000,01,107,Pickens County, AL,Apr-17,7733,7344,389,5.0
CN0110700000000,01,107,Pickens County, AL,May-17,7649,7281,368,4.8
CN0110700000000,01,107,Pickens County, AL,Jun-17,7744,7252,492,6.4
CN0110700000000,01,107,Pickens County, AL,Jul-17,7830,7349,481,6.1
CN0110700000000,01,107,Pickens County, AL,Aug-17,7812,7410,402,5.1
CN0110700000000,01,107,Pickens County, AL,Sep-17,7937,7600,337,4.2
CN0110700000000,01,107,Pickens County, AL,Oct-17,7894,7567,327,4.1
CN0110700000000,01,107,Pickens County, AL,Nov-17,7808,7497,311,4.0
CN0110700000000,01,107,Pickens County, AL,Dec-17,7666,7382,284,3.7
CN0110700000000,01,107,Pickens County, AL,Jan-18,7673,7313,360,4.7
CN0110700000000,01,107,Pickens County, AL,Feb-18,7833,7445,388,5.0
CN0110700000000,01,107,Pickens County, AL,Mar-18,7844,7504,340,4.3
CN0110700000000,01,107,Pickens County, AL,Apr-18(p),7852,7552,300,3.8
CN0104500000000,01,045,Dale County, AL,Mar-17,19951,18947,1004,5.0
CN0104500000000,01,045,Dale County, AL,Apr-17,19912,19089,823,4.1
CN0104500000000,01,045,Dale County, AL,May-17,19780,18987,793,4.0
CN0104500000000,01,045,Dale County, AL,Jun-17,19894,18915,979,4.9
CN0104500000000,01,045,Dale County, AL,Jul-17,19946,19052,894,4.5
CN0104500000000,01,045,Dale County, AL,Aug-17,19865,19023,842,4.2
CN0104500000000,01,045,Dale County, AL,Sep-17,19976,19221,755,3.8
CN0104500000000,01,045,Dale County, AL,Oct-17,19983,19226,757,3.8
CN0104500000000,01,045,Dale County, AL,Nov-17,19777,19050,727,3.7
CN0104500000000,01,045,Dale County, AL,Dec-17,19614,18901,713,3.6
CN0104500000000,01,045,Dale County, AL,Jan-18,19564,18705,859,4.4
CN0104500000000,01,045,Dale County, AL,Feb-18,19898,19011,887,4.5
CN0104500000000,01,045,Dale County, AL,Mar-18,19975,19143,832,4.2
CN0104500000000,01,045,Dale County, AL,Apr-18(p),20048,19322,726,3.6
CN1713100000000,17,131,Mercer County, IL,Mar-17,8060,7578,482,6.0
CN1713100000000,17,131,Mercer County, IL,Apr-17,8062,7708,354,4.4
CN1713100000000,17,131,Mercer County, IL,May-17,8060,7737,323,4.0
CN1713100000000,17,131,Mercer County, IL,Jun-17,8194,7842,352,4.3
CN1713100000000,17,131,Mercer County, IL,Jul-17,8204,7838,366,4.5
CN1713100000000,17,131,Mercer County, IL,Aug-17,8099,7741,358,4.4
CN1713100000000,17,131,Mercer County, IL,Sep-17,8006,7665,341,4.3
CN1713100000000,17,131,Mercer County, IL,Oct-17,7981,7655,326,4.1
CN1713100000000,17,131,Mercer County, IL,Nov-17,8014,7695,319,4.0
CN1713100000000,17,131,Mercer County, IL,Dec-17,7945,7577,368,4.6
CN1713100000000,17,131,Mercer County, IL,Jan-18,8068,7557,511,6.3
CN1713100000000,17,131,Mercer County, IL,Feb-18,8073,7588,485,6.0
CN1713100000000,17,131,Mercer County, IL,Mar-18,8227,7768,459,5.6
CN1713100000000,17,131,Mercer County, IL,Apr-18(p),8195,7862,333,4.1
CN2107700000000,21,077,Gallatin County, KY,Mar-17,3952,3740,212,5.4
CN2107700000000,21,077,Gallatin County, KY,Apr-17,3974,3795,179,4.5
CN2107700000000,21,077,Gallatin County, KY,May-17,3987,3805,182,4.6
CN2107700000000,21,077,Gallatin County, KY,Jun-17,4034,3828,206,5.1
CN2107700000000,21,077,Gallatin County, KY,Jul-17,4004,3816,188,4.7
CN2107700000000,21,077,Gallatin County, KY,Aug-17,3949,3779,170,4.3
CN2107700000000,21,077,Gallatin County, KY,Sep-17,3938,3779,159,4.0
CN2107700000000,21,077,Gallatin County, KY,Oct-17,3909,3767,142,3.6
CN2107700000000,21,077,Gallatin County, KY,Nov-17,3918,3773,145,3.7
CN2107700000000,21,077,Gallatin County, KY,Dec-17,3874,3741,133,3.4
CN2107700000000,21,077,Gallatin County, KY,Jan-18,3867,3712,155,4.0
CN2107700000000,21,077,Gallatin County, KY,Feb-18,3912,3732,180,4.6
CN2107700000000,21,077,Gallatin County, KY,Mar-18,3935,3768,167,4.2
CN2107700000000,21,077,Gallatin County, KY,Apr-18(p),3962,3802,160,4.0
CN3101300000000,31,013,Box Butte County, NE,Mar-17,5542,5351,191,3.4
CN3101300000000,31,013,Box Butte County, NE,Apr-17,5585,5406,179,3.2
CN3101300000000,31,013,Box Butte County, NE,May-17,5639,5476,163,2.9
CN3101300000000,31,013,Box Butte County, NE,Jun-17,5704,5521,183,3.2
CN3101300000000,31,013,Box Butte County, NE,Jul-17,5705,5515,190,3.3
CN3101300000000,31,013,Box Butte County, NE,Aug-17,5557,5383,174,3.1
CN3101300000000,31,013,Box Butte County, NE,Sep-17,5459,5312,147,2.7
CN3101300000000,31,013,Box Butte County, NE,Oct-17,5539,5391,148,2.7
CN3101300000000,31,013,Box Butte County, NE,Nov-17,5510,5339,171,3.1
CN3101300000000,31,013,Box Butte County, NE,Dec-17,5467,5283,184,3.4
CN3101300000000,31,013,Box Butte County, NE,Jan-18,5452,5278,174,3.2
CN3101300000000,31,013,Box Butte County, NE,Feb-18,5455,5296,159,2.9
CN3101300000000,31,013,Box Butte County, NE,Mar-18,5469,5314,155,2.8
CN3101300000000,31,013,Box Butte County, NE,Apr-18(p),5457,5300,157,2.9
CN4827500000000,48,275,Knox County, TX,Mar-17,1556,1499,57,3.7
CN4827500000000,48,275,Knox County, TX,Apr-17,1546,1488,58,3.8
CN4827500000000,48,275,Knox County, TX,May-17,1550,1494,56,3.6
CN4827500000000,48,275,Knox County, TX,Jun-17,1517,1451,66,4.4
CN4827500000000,48,275,Knox County, TX,Jul-17,1462,1398,64,4.4
CN4827500000000,48,275,Knox County, TX,Aug-17,1505,1441,64,4.3
CN4827500000000,48,275,Knox County, TX,Sep-17,1458,1400,58,4.0
CN4827500000000,48,275,Knox County, TX,Oct-17,1496,1446,50,3.3
CN4827500000000,48,275,Knox County, TX,Nov-17,1456,1401,55,3.8
CN4827500000000,48,275,Knox County, TX,Dec-17,1468,1421,47,3.2
CN4827500000000,48,275,Knox County, TX,Jan-18,1431,1375,56,3.9
CN4827500000000,48,275,Knox County, TX,Feb-18,1460,1404,56,3.8
CN4827500000000,48,275,Knox County, TX,Mar-18,1534,1478,56,3.7
CN4827500000000,48,275,Knox County, TX,Apr-18(p),1493,1438,55,3.7
CN0201600000000,02,016,Aleutians West Census Area, AK,Mar-17,4757,4642,115,2.4
CN0201600000000,02,016,Aleutians West Census Area, AK,Apr-17,4311,4161,150,3.5
CN0201600000000,02,016,Aleutians West Census Area, AK,May-17,3063,2897,166,5.4
CN0201600000000,02,016,Aleutians West Census Area, AK,Jun-17,3572,3426,146,4.1
CN0201600000000,02,016,Aleutians West Census Area, AK,Jul-17,3867,3754,113,2.9
CN0201600000000,02,016,Aleutians West Census Area, AK,Aug-17,3881,3767,114,2.9
CN0201600000000,02,016,Aleutians West Census Area, AK,Sep-17,3545,3372,173,4.9
CN0201600000000,02,016,Aleutians West Census Area, AK,Oct-17,3737,3568,169,4.5
CN0201600000000,02,016,Aleutians West Census Area, AK,Nov-17,3269,3133,136,4.2
CN0201600000000,02,016,Aleutians West Census Area, AK,Dec-17,3006,2852,154,5.1
CN0201600000000,02,016,Aleutians West Census Area, AK,Jan-18,4559,4424,135,3.0
CN0201600000000,02,016,Aleutians West Census Area, AK,Feb-18,4927,4806,121,2.5
CN0201600000000,02,016,Aleutians West Census Area, AK,Mar-18,4768,4651,117,2.5
CN0201600000000,02,016,Aleutians West Census Area, AK,Apr-18(p),4364,4236,128,2.9
CN2602700000000,26,027,Cass County, MI,Mar-17,24592,23425,1167,4.7
CN2602700000000,26,027,Cass County, MI,Apr-17,24379,23434,945,3.9
CN2602700000000,26,027,Cass County, MI,May-17,24556,23513,1043,4.2
CN2602700000000,26,027,Cass County, MI,Jun-17,24333,23237,1096,4.5
CN2602700000000,26,027,Cass County, MI,Jul-17,24126,22806,1320,5.5
CN2602700000000,26,027,Cass County, MI,Aug-17,23980,22796,1184,4.9
CN2602700000000,26,027,Cass County, MI,Sep-17,24487,23432,1055,4.3
CN2602700000000,26,027,Cass County, MI,Oct-17,24403,23429,974,4.0
CN2602700000000,26,027,Cass County, MI,Nov-17,24591,23530,1061,4.3
CN2602700000000,26,027,Cass County, MI,Dec-17,24586,23460,1126,4.6
CN2602700000000,26,027,Cass County, MI,Jan-18,24567,23253,1314,5.3
CN2602700000000,26,027,Cass County, MI,Feb-18,24964,23586,1378,5.5
CN2602700000000,26,027,Cass County, MI,Mar-18,24973,23766,1207,4.8
CN2602700000000,26,027,Cass County, MI,Apr-18(p),24776,23808,968,3.9
CN2714500000000,27,145,Stearns County, MN,Mar-17,90609,86798,3811,4.2
CN2714500000000,27,145,Stearns County, MN,Apr-17,90684,87709,2975,3.3
CN2714500000000,27,145,Stearns County, MN,May-17,90260,87566,2694,3.0
CN2714500000000,27,145,Stearns County, MN,Jun-17,89846,86854,2992,3.3
CN2714500000000,27,145,Stearns County, MN,Jul-17,89910,87154,2756,3.1
CN2714500000000,27,145,Stearns County, MN,Aug-17,89572,86780,2792,3.1
CN2714500000000,27,145,Stearns County, MN,Sep-17,89586,87180,2406,2.7
CN2714500000000,27,145,Stearns County, MN,Oct-17,90215,88227,1988,2.2
CN2714500000000,27,145,Stearns County, MN,Nov-17,90412,88024,2388,2.6
CN2714500000000,27,145,Stearns County, MN,Dec-17,90360,87287,3073,3.4
CN2714500000000,27,145,Stearns County, MN,Jan-18,91110,87227,3883,4.3
CN2714500000000,27,145,Stearns County, MN,Feb-18,91969,88236,3733,4.1
CN2714500000000,27,145,Stearns County, MN,Mar-18,92061,88461,3600,3.9
CN2714500000000,27,145,Stearns County, MN,Apr-18(p),91931,89030,2901,3.2
CN5502900000000,55,029,Door County, WI,Mar-17,14202,13358,844,5.9
CN5502900000000,55,029,Door County, WI,Apr-17,14594,13959,635,4.4
CN5502900000000,55,029,Door County, WI,May-17,15606,15121,485,3.1
CN5502900000000,55,029,Door County, WI,Jun-17,17410,16857,553,3.2
CN5502900000000,55,029,Door County, WI,Jul-17,17690,17206,484,2.7
CN5502900000000,55,029,Door County, WI,Aug-17,17458,16996,462,2.6
CN5502900000000,55,029,Door County, WI,Sep-17,16813,16374,439,2.6
CN5502900000000,55,029,Door County, WI,Oct-17,16393,15979,414,2.5
CN5502900000000,55,029,Door County, WI,Nov-17,14953,14435,518,3.5
CN5502900000000,55,029,Door County, WI,Dec-17,14564,13978,586,4.0
CN5502900000000,55,029,Door County, WI,Jan-18,14295,13618,677,4.7
CN5502900000000,55,029,Door County, WI,Feb-18,14259,13469,790,5.5
CN5502900000000,55,029,Door County, WI,Mar-18,14366,13580,786,5.5
CN5502900000000,55,029,Door County, WI,Apr-18(p),14810,14218,592,4.0
CN1304300000000,13,043,Candler County, GA,Mar-17,5281,5061,220,4.2
CN1304300000000,13,043,Candler County, GA,Apr-17,5281,5062,219,4.1
CN1304300000000,13,043,Candler County, GA,May-17,5334,5114,220,4.1
CN1304300000000,13,043,Candler County, GA,Jun-17,5359,5126,233,4.3
CN1304300000000,13,043,Candler County, GA,Jul-17,5263,5021,242,4.6
CN1304300000000,13,043,Candler County, GA,Aug-17,5249,5025,224,4.3
CN1304300000000,13,043,Candler County, GA,Sep-17,5228,5000,228,4.4
CN1304300000000,13,043,Candler County, GA,Oct-17,5253,5052,201,3.8
CN1304300000000,13,043,Candler County, GA,Nov-17,5240,5055,185,3.5
CN1304300000000,13,043,Candler County, GA,Dec-17,5214,5018,196,3.8
CN1304300000000,13,043,Candler County, GA,Jan-18,5362,5153,209,3.9
CN1304300000000,13,043,Candler County, GA,Feb-18,5327,5117,210,3.9
CN1304300000000,13,043,Candler County, GA,Mar-18,5317,5121,196,3.7
CN1304300000000,13,043,Candler County, GA,Apr-18(p),5409,5239,170,3.1
CN4833700000000,48,337,Montague County, TX,Mar-17,8995,8601,394,4.4
CN4833700000000,48,337,Montague County, TX,Apr-17,9178,8808,370,4.0
CN4833700000000,48,337,Montague County, TX,May-17,9219,8860,359,3.9
CN4833700000000,48,337,Montague County, TX,Jun-17,9222,8844,378,4.1
CN4833700000000,48,337,Montague County, TX,Jul-17,9098,8709,389,4.3
CN4833700000000,48,337,Montague County, TX,Aug-17,9055,8685,370,4.1
CN4833700000000,48,337,Montague County, TX,Sep-17,9123,8798,325,3.6
CN4833700000000,48,337,Montague County, TX,Oct-17,9057,8757,300,3.3
CN4833700000000,48,337,Montague County, TX,Nov-17,9045,8731,314,3.5
CN4833700000000,48,337,Montague County, TX,Dec-17,9046,8751,295,3.3
CN4833700000000,48,337,Montague County, TX,Jan-18,8970,8649,321,3.6
CN4833700000000,48,337,Montague County, TX,Feb-18,9072,8750,322,3.5
CN4833700000000,48,337,Montague County, TX,Mar-18,9061,8755,306,3.4
CN4833700000000,48,337,Montague County, TX,Apr-18(p),9271,8995,276,3.0
CN2007100000000,20,071,Greeley County, KS,Mar-17,844,829,15,1.8
CN2007100000000,20,071,Greeley County, KS,Apr-17,853,838,15,1.8
CN2007100000000,20,071,Greeley County, KS,May-17,850,833,17,2.0
CN2007100000000,20,071,Greeley County, KS,Jun-17,887,869,18,2.0
CN2007100000000,20,071,Greeley County, KS,Jul-17,881,861,20,2.3
CN2007100000000,20,071,Greeley County, KS,Aug-17,893,873,20,2.2
CN2007100000000,20,071,Greeley County, KS,Sep-17,911,897,14,1.5
CN2007100000000,20,071,Greeley County, KS,Oct-17,927,914,13,1.4
CN2007100000000,20,071,Greeley County, KS,Nov-17,897,882,15,1.7
CN2007100000000,20,071,Greeley County, KS,Dec-17,894,877,17,1.9
CN2007100000000,20,071,Greeley County, KS,Jan-18,879,863,16,1.8
CN2007100000000,20,071,Greeley County, KS,Feb-18,879,861,18,2.0
CN2007100000000,20,071,Greeley County, KS,Mar-18,868,849,19,2.2
CN2007100000000,20,071,Greeley County, KS,Apr-18(p),821,802,19,2.3
CN4501500000000,45,015,Berkeley County, SC,Mar-17,98135,94600,3535,3.6
CN4501500000000,45,015,Berkeley County, SC,Apr-17,98268,94971,3297,3.4
CN4501500000000,45,015,Berkeley County, SC,May-17,98639,95213,3426,3.5
CN4501500000000,45,015,Berkeley County, SC,Jun-17,99584,95564,4020,4.0
CN4501500000000,45,015,Berkeley County, SC,Jul-17,100090,96159,3931,3.9
CN4501500000000,45,015,Berkeley County, SC,Aug-17,99213,95024,4189,4.2
CN4501500000000,45,015,Berkeley County, SC,Sep-17,98550,94759,3791,3.8
CN4501500000000,45,015,Berkeley County, SC,Oct-17,98557,94930,3627,3.7
CN4501500000000,45,015,Berkeley County, SC,Nov-17,98290,94812,3478,3.5
CN4501500000000,45,015,Berkeley County, SC,Dec-17,97244,93704,3540,3.6
CN4501500000000,45,015,Berkeley County, SC,Jan-18,97383,93051,4332,4.4
CN4501500000000,45,015,Berkeley County, SC,Feb-18,98312,94281,4031,4.1
CN4501500000000,45,015,Berkeley County, SC,Mar-18,98735,95149,3586,3.6
CN4501500000000,45,015,Berkeley County, SC,Apr-18(p),97282,94863,2419,2.5
CN1807500000000,18,075,Jay County, IN,Mar-17,9885,9524,361,3.7
CN1807500000000,18,075,Jay County, IN,Apr-17,9877,9585,292,3.0
CN1807500000000,18,075,Jay County, IN,May-17,9985,9674,311,3.1
CN1807500000000,18,075,Jay County, IN,Jun-17,9862,9509,353,3.6
CN1807500000000,18,075,Jay County, IN,Jul-17,9768,9409,359,3.7
CN1807500000000,18,075,Jay County, IN,Aug-17,9747,9349,398,4.1
CN1807500000000,18,075,Jay County, IN,Sep-17,9590,9271,319,3.3
CN1807500000000,18,075,Jay County, IN,Oct-17,9546,9240,306,3.2
CN1807500000000,18,075,Jay County, IN,Nov-17,9578,9269,309,3.2
CN1807500000000,18,075,Jay County, IN,Dec-17,9466,9180,286,3.0
CN1807500000000,18,075,Jay County, IN,Jan-18,9284,8951,333,3.6
CN1807500000000,18,075,Jay County, IN,Feb-18,9480,9113,367,3.9
CN1807500000000,18,075,Jay County, IN,Mar-18,9596,9269,327,3.4
CN1807500000000,18,075,Jay County, IN,Apr-18(p),9580,9304,276,2.9
CN5157000000000,51,570,Colonial Heights city, VA,Mar-17,8872,8486,386,4.4
CN5157000000000,51,570,Colonial Heights city, VA,Apr-17,8865,8502,363,4.1
CN5157000000000,51,570,Colonial Heights city, VA,May-17,8867,8514,353,4.0
CN5157000000000,51,570,Colonial Heights city, VA,Jun-17,8900,8540,360,4.0
CN5157000000000,51,570,Colonial Heights city, VA,Jul-17,8964,8597,367,4.1
CN5157000000000,51,570,Colonial Heights city, VA,Aug-17,8876,8512,364,4.1
CN5157000000000,51,570,Colonial Heights city, VA,Sep-17,8889,8552,337,3.8
CN5157000000000,51,570,Colonial Heights city, VA,Oct-17,8847,8528,319,3.6
CN5157000000000,51,570,Colonial Heights city, VA,Nov-17,8785,8464,321,3.7
CN5157000000000,51,570,Colonial Heights city, VA,Dec-17,8757,8430,327,3.7
CN5157000000000,51,570,Colonial Heights city, VA,Jan-18,8774,8433,341,3.9
CN5157000000000,51,570,Colonial Heights city, VA,Feb-18,8863,8551,312,3.5
CN5157000000000,51,570,Colonial Heights city, VA,Mar-18,8939,8611,328,3.7
CN5157000000000,51,570,Colonial Heights city, VA,Apr-18(p),8919,8645,274,3.1
CN2801100000000,28,011,Bolivar County, MS,Mar-17,13292,12439,853,6.4
CN2801100000000,28,011,Bolivar County, MS,Apr-17,13167,12433,734,5.6
CN2801100000000,28,011,Bolivar County, MS,May-17,13198,12354,844,6.4
CN2801100000000,28,011,Bolivar County, MS,Jun-17,13147,12083,1064,8.1
CN2801100000000,28,011,Bolivar County, MS,Jul-17,12930,11929,1001,7.7
CN2801100000000,28,011,Bolivar County, MS,Aug-17,12779,11894,885,6.9
CN2801100000000,28,011,Bolivar County, MS,Sep-17,13046,12322,724,5.5
CN2801100000000,28,011,Bolivar County, MS,Oct-17,12845,12154,691,5.4
CN2801100000000,28,011,Bolivar County, MS,Nov-17,12678,11989,689,5.4
CN2801100000000,28,011,Bolivar County, MS,Dec-17,12668,11948,720,5.7
CN2801100000000,28,011,Bolivar County, MS,Jan-18,12419,11669,750,6.0
CN2801100000000,28,011,Bolivar County, MS,Feb-18,12605,11871,734,5.8
CN2801100000000,28,011,Bolivar County, MS,Mar-18,12778,12077,701,5.5
CN2801100000000,28,011,Bolivar County, MS,Apr-18(p),12847,12186,661,5.1
CN2013300000000,20,133,Neosho County, KS,Mar-17,6038,5713,325,5.4
CN2013300000000,20,133,Neosho County, KS,Apr-17,5972,5673,299,5.0
CN2013300000000,20,133,Neosho County, KS,May-17,5964,5669,295,4.9
CN2013300000000,20,133,Neosho County, KS,Jun-17,6138,5791,347,5.7
CN2013300000000,20,133,Neosho County, KS,Jul-17,6208,5842,366,5.9
CN2013300000000,20,133,Neosho County, KS,Aug-17,6113,5768,345,5.6
CN2013300000000,20,133,Neosho County, KS,Sep-17,6077,5790,287,4.7
CN2013300000000,20,133,Neosho County, KS,Oct-17,6045,5798,247,4.1
CN2013300000000,20,133,Neosho County, KS,Nov-17,6025,5753,272,4.5
CN2013300000000,20,133,Neosho County, KS,Dec-17,5991,5733,258,4.3
CN2013300000000,20,133,Neosho County, KS,Jan-18,5924,5653,271,4.6
CN2013300000000,20,133,Neosho County, KS,Feb-18,5960,5668,292,4.9
CN2013300000000,20,133,Neosho County, KS,Mar-18,5971,5650,321,5.4
CN2013300000000,20,133,Neosho County, KS,Apr-18(p),5853,5580,273,4.7
CN3301700000000,33,017,Strafford County, NH,Mar-17,72675,70772,1903,2.6
CN3301700000000,33,017,Strafford County, NH,Apr-17,72692,71118,1574,2.2
CN3301700000000,33,017,Strafford County, NH,May-17,72870,71238,1632,2.2
CN3301700000000,33,017,Strafford County, NH,Jun-17,72048,70326,1722,2.4
CN3301700000000,33,017,Strafford County, NH,Jul-17,72532,70773,1759,2.4
CN3301700000000,33,017,Strafford County, NH,Aug-17,72073,70385,1688,2.3
CN3301700000000,33,017,Strafford County, NH,Sep-17,72041,70418,1623,2.3
CN3301700000000,33,017,Strafford County, NH,Oct-17,73095,71612,1483,2.0
CN3301700000000,33,017,Strafford County, NH,Nov-17,73292,71727,1565,2.1
CN3301700000000,33,017,Strafford County, NH,Dec-17,72756,71315,1441,2.0
CN3301700000000,33,017,Strafford County, NH,Jan-18,71365,69440,1925,2.7
CN3301700000000,33,017,Strafford County, NH,Feb-18,73150,71226,1924,2.6
CN3301700000000,33,017,Strafford County, NH,Mar-18,73567,71653,1914,2.6
CN3301700000000,33,017,Strafford County, NH,Apr-18(p),73711,72001,1710,2.3
CN4010700000000,40,107,Okfuskee County, OK,Mar-17,4492,4215,277,6.2
CN4010700000000,40,107,Okfuskee County, OK,Apr-17,4493,4240,253,5.6
CN4010700000000,40,107,Okfuskee County, OK,May-17,4458,4188,270,6.1
CN4010700000000,40,107,Okfuskee County, OK,Jun-17,4460,4180,280,6.3
CN4010700000000,40,107,Okfuskee County, OK,Jul-17,4345,4081,264,6.1
CN4010700000000,40,107,Okfuskee County, OK,Aug-17,4428,4151,277,6.3
CN4010700000000,40,107,Okfuskee County, OK,Sep-17,4533,4269,264,5.8
CN4010700000000,40,107,Okfuskee County, OK,Oct-17,4531,4259,272,6.0
CN4010700000000,40,107,Okfuskee County, OK,Nov-17,4501,4249,252,5.6
CN4010700000000,40,107,Okfuskee County, OK,Dec-17,4439,4201,238,5.4
CN4010700000000,40,107,Okfuskee County, OK,Jan-18,4460,4182,278,6.2
CN4010700000000,40,107,Okfuskee County, OK,Feb-18,4507,4248,259,5.7
CN4010700000000,40,107,Okfuskee County, OK,Mar-18,4506,4259,247,5.5
CN4010700000000,40,107,Okfuskee County, OK,Apr-18(p),4486,4240,246,5.5
CN4843700000000,48,437,Swisher County, TX,Mar-17,2785,2661,124,4.5
CN4843700000000,48,437,Swisher County, TX,Apr-17,2738,2628,110,4.0
CN4843700000000,48,437,Swisher County, TX,May-17,2745,2634,111,4.0
CN4843700000000,48,437,Swisher County, TX,Jun-17,2725,2610,115,4.2
CN4843700000000,48,437,Swisher County, TX,Jul-17,2641,2531,110,4.2
CN4843700000000,48,437,Swisher County, TX,Aug-17,2664,2557,107,4.0
CN4843700000000,48,437,Swisher County, TX,Sep-17,2629,2526,103,3.9
CN4843700000000,48,437,Swisher County, TX,Oct-17,2664,2565,99,3.7
CN4843700000000,48,437,Swisher County, TX,Nov-17,2628,2529,99,3.8
CN4843700000000,48,437,Swisher County, TX,Dec-17,2633,2542,91,3.5
CN4843700000000,48,437,Swisher County, TX,Jan-18,2615,2507,108,4.1
CN4843700000000,48,437,Swisher County, TX,Feb-18,2665,2554,111,4.2
CN4843700000000,48,437,Swisher County, TX,Mar-18,2744,2623,121,4.4
CN4843700000000,48,437,Swisher County, TX,Apr-18(p),2720,2602,118,4.3
CN5117700000000,51,177,Spotsylvania County, VA,Mar-17,65950,63399,2551,3.9
CN5117700000000,51,177,Spotsylvania County, VA,Apr-17,65957,63687,2270,3.4
CN5117700000000,51,177,Spotsylvania County, VA,May-17,66289,63879,2410,3.6
CN5117700000000,51,177,Spotsylvania County, VA,Jun-17,66712,64202,2510,3.8
CN5117700000000,51,177,Spotsylvania County, VA,Jul-17,67246,64616,2630,3.9
CN5117700000000,51,177,Spotsylvania County, VA,Aug-17,66275,63608,2667,4.0
CN5117700000000,51,177,Spotsylvania County, VA,Sep-17,66232,63874,2358,3.6
CN5117700000000,51,177,Spotsylvania County, VA,Oct-17,66046,63835,2211,3.3
CN5117700000000,51,177,Spotsylvania County, VA,Nov-17,66072,63820,2252,3.4
CN5117700000000,51,177,Spotsylvania County, VA,Dec-17,65916,63716,2200,3.3
CN5117700000000,51,177,Spotsylvania County, VA,Jan-18,66439,63971,2468,3.7
CN5117700000000,51,177,Spotsylvania County, VA,Feb-18,66986,64697,2289,3.4
CN5117700000000,51,177,Spotsylvania County, VA,Mar-18,67071,64832,2239,3.3
CN5117700000000,51,177,Spotsylvania County, VA,Apr-18(p),66963,65029,1934,2.9
CN5512900000000,55,129,Washburn County, WI,Mar-17,7800,7397,403,5.2
CN5512900000000,55,129,Washburn County, WI,Apr-17,7844,7539,305,3.9
CN5512900000000,55,129,Washburn County, WI,May-17,7992,7725,267,3.3
CN5512900000000,55,129,Washburn County, WI,Jun-17,8438,8126,312,3.7
CN5512900000000,55,129,Washburn County, WI,Jul-17,8346,8059,287,3.4
CN5512900000000,55,129,Washburn County, WI,Aug-17,8246,7947,299,3.6
CN5512900000000,55,129,Washburn County, WI,Sep-17,8067,7835,232,2.9
CN5512900000000,55,129,Washburn County, WI,Oct-17,8019,7795,224,2.8
CN5512900000000,55,129,Washburn County, WI,Nov-17,7911,7667,244,3.1
CN5512900000000,55,129,Washburn County, WI,Dec-17,7869,7599,270,3.4
CN5512900000000,55,129,Washburn County, WI,Jan-18,7850,7510,340,4.3
CN5512900000000,55,129,Washburn County, WI,Feb-18,7855,7461,394,5.0
CN5512900000000,55,129,Washburn County, WI,Mar-18,7908,7528,380,4.8
CN5512900000000,55,129,Washburn County, WI,Apr-18(p),7973,7638,335,4.2
CN4803900000000,48,039,Brazoria County, TX,Mar-17,171564,162362,9202,5.4
CN4803900000000,48,039,Brazoria County, TX,Apr-17,171744,163058,8686,5.1
CN4803900000000,48,039,Brazoria County, TX,May-17,171337,162711,8626,5.0
CN4803900000000,48,039,Brazoria County, TX,Jun-17,172202,162621,9581,5.6
CN4803900000000,48,039,Brazoria County, TX,Jul-17,172901,163367,9534,5.5
CN4803900000000,48,039,Brazoria County, TX,Aug-17,172017,162434,9583,5.6
CN4803900000000,48,039,Brazoria County, TX,Sep-17,173042,163805,9237,5.3
CN4803900000000,48,039,Brazoria County, TX,Oct-17,171518,163531,7987,4.7
CN4803900000000,48,039,Brazoria County, TX,Nov-17,172637,164483,8154,4.7
CN4803900000000,48,039,Brazoria County, TX,Dec-17,172687,164631,8056,4.7
CN4803900000000,48,039,Brazoria County, TX,Jan-18,173014,164016,8998,5.2
CN4803900000000,48,039,Brazoria County, TX,Feb-18,175176,166492,8684,5.0
CN4803900000000,48,039,Brazoria County, TX,Mar-18,175084,166653,8431,4.8
CN4803900000000,48,039,Brazoria County, TX,Apr-18(p),175659,167895,7764,4.4
CN1314300000000,13,143,Haralson County, GA,Mar-17,12447,11823,624,5.0
CN1314300000000,13,143,Haralson County, GA,Apr-17,12441,11865,576,4.6
CN1314300000000,13,143,Haralson County, GA,May-17,12463,11881,582,4.7
CN1314300000000,13,143,Haralson County, GA,Jun-17,12503,11872,631,5.0
CN1314300000000,13,143,Haralson County, GA,Jul-17,12587,11953,634,5.0
CN1314300000000,13,143,Haralson County, GA,Aug-17,12507,11885,622,5.0
CN1314300000000,13,143,Haralson County, GA,Sep-17,12602,12050,552,4.4
CN1314300000000,13,143,Haralson County, GA,Oct-17,12543,11999,544,4.3
CN1314300000000,13,143,Haralson County, GA,Nov-17,12552,12031,521,4.2
CN1314300000000,13,143,Haralson County, GA,Dec-17,12561,12026,535,4.3
CN1314300000000,13,143,Haralson County, GA,Jan-18,12571,12017,554,4.4
CN1314300000000,13,143,Haralson County, GA,Feb-18,12773,12207,566,4.4
CN1314300000000,13,143,Haralson County, GA,Mar-18,12750,12243,507,4.0
CN1314300000000,13,143,Haralson County, GA,Apr-18(p),12686,12231,455,3.6
CN5304900000000,53,049,Pacific County, WA,Mar-17,8205,7577,628,7.7
CN5304900000000,53,049,Pacific County, WA,Apr-17,8253,7645,608,7.4
CN5304900000000,53,049,Pacific County, WA,May-17,8306,7716,590,7.1
CN5304900000000,53,049,Pacific County, WA,Jun-17,8403,7834,569,6.8
CN5304900000000,53,049,Pacific County, WA,Jul-17,8687,8121,566,6.5
CN5304900000000,53,049,Pacific County, WA,Aug-17,8612,8047,565,6.6
CN5304900000000,53,049,Pacific County, WA,Sep-17,8492,7954,538,6.3
CN5304900000000,53,049,Pacific County, WA,Oct-17,8410,7881,529,6.3
CN5304900000000,53,049,Pacific County, WA,Nov-17,8360,7793,567,6.8
CN5304900000000,53,049,Pacific County, WA,Dec-17,8417,7804,613,7.3
CN5304900000000,53,049,Pacific County, WA,Jan-18,8332,7639,693,8.3
CN5304900000000,53,049,Pacific County, WA,Feb-18,8133,7465,668,8.2
CN5304900000000,53,049,Pacific County, WA,Mar-18,8133,7453,680,8.4
CN5304900000000,53,049,Pacific County, WA,Apr-18(p),8161,7528,633,7.8
CN3004700000000,30,047,Lake County, MT,Mar-17,12965,12302,663,5.1
CN3004700000000,30,047,Lake County, MT,Apr-17,13043,12487,556,4.3
CN3004700000000,30,047,Lake County, MT,May-17,13246,12776,470,3.5
CN3004700000000,30,047,Lake County, MT,Jun-17,13583,13008,575,4.2
CN3004700000000,30,047,Lake County, MT,Jul-17,13385,12840,545,4.1
CN3004700000000,30,047,Lake County, MT,Aug-17,13352,12787,565,4.2
CN3004700000000,30,047,Lake County, MT,Sep-17,13254,12754,500,3.8
CN3004700000000,30,047,Lake County, MT,Oct-17,13292,12770,522,3.9
CN3004700000000,30,047,Lake County, MT,Nov-17,13219,12655,564,4.3
CN3004700000000,30,047,Lake County, MT,Dec-17,13165,12561,604,4.6
CN3004700000000,30,047,Lake County, MT,Jan-18,13191,12410,781,5.9
CN3004700000000,30,047,Lake County, MT,Feb-18,13264,12503,761,5.7
CN3004700000000,30,047,Lake County, MT,Mar-18,13281,12616,665,5.0
CN3004700000000,30,047,Lake County, MT,Apr-18(p),13284,12764,520,3.9
CN4905700000000,49,057,Weber County, UT,Mar-17,122831,118112,4719,3.8
CN4905700000000,49,057,Weber County, UT,Apr-17,123170,118909,4261,3.5
CN4905700000000,49,057,Weber County, UT,May-17,124504,120325,4179,3.4
CN4905700000000,49,057,Weber County, UT,Jun-17,125238,120361,4877,3.9
CN4905700000000,49,057,Weber County, UT,Jul-17,126269,121551,4718,3.7
CN4905700000000,49,057,Weber County, UT,Aug-17,125662,120986,4676,3.7
CN4905700000000,49,057,Weber County, UT,Sep-17,124971,120784,4187,3.4
CN4905700000000,49,057,Weber County, UT,Oct-17,125552,121025,4527,3.6
CN4905700000000,49,057,Weber County, UT,Nov-17,125310,121154,4156,3.3
CN4905700000000,49,057,Weber County, UT,Dec-17,124696,120500,4196,3.4
CN4905700000000,49,057,Weber County, UT,Jan-18,124418,119678,4740,3.8
CN4905700000000,49,057,Weber County, UT,Feb-18,125418,120620,4798,3.8
CN4905700000000,49,057,Weber County, UT,Mar-18,125435,120740,4695,3.7
CN4905700000000,49,057,Weber County, UT,Apr-18(p),125310,121082,4228,3.4
CN4607100000000,46,071,Jackson County, SD,Mar-17,1235,1144,91,7.4
CN4607100000000,46,071,Jackson County, SD,Apr-17,1303,1224,79,6.1
CN4607100000000,46,071,Jackson County, SD,May-17,1395,1324,71,5.1
CN4607100000000,46,071,Jackson County, SD,Jun-17,1532,1462,70,4.6
CN4607100000000,46,071,Jackson County, SD,Jul-17,1486,1423,63,4.2
CN4607100000000,46,071,Jackson County, SD,Aug-17,1425,1362,63,4.4
CN4607100000000,46,071,Jackson County, SD,Sep-17,1361,1293,68,5.0
CN4607100000000,46,071,Jackson County, SD,Oct-17,1241,1186,55,4.4
CN4607100000000,46,071,Jackson County, SD,Nov-17,1185,1111,74,6.2
CN4607100000000,46,071,Jackson County, SD,Dec-17,1256,1175,81,6.4
CN4607100000000,46,071,Jackson County, SD,Jan-18,1218,1119,99,8.1
CN4607100000000,46,071,Jackson County, SD,Feb-18,1215,1119,96,7.9
CN4607100000000,46,071,Jackson County, SD,Mar-18,1245,1165,80,6.4
CN4607100000000,46,071,Jackson County, SD,Apr-18(p),1218,1151,67,5.5
CN2201300000000,22,013,Bienville Parish, LA,Mar-17,5653,5303,350,6.2
CN2201300000000,22,013,Bienville Parish, LA,Apr-17,5644,5299,345,6.1
CN2201300000000,22,013,Bienville Parish, LA,May-17,5649,5313,336,5.9
CN2201300000000,22,013,Bienville Parish, LA,Jun-17,5738,5362,376,6.6
CN2201300000000,22,013,Bienville Parish, LA,Jul-17,5766,5389,377,6.5
CN2201300000000,22,013,Bienville Parish, LA,Aug-17,5647,5297,350,6.2
CN2201300000000,22,013,Bienville Parish, LA,Sep-17,5682,5350,332,5.8
CN2201300000000,22,013,Bienville Parish, LA,Oct-17,5527,5242,285,5.2
CN2201300000000,22,013,Bienville Parish, LA,Nov-17,5530,5244,286,5.2
CN2201300000000,22,013,Bienville Parish, LA,Dec-17,5511,5233,278,5.0
CN2201300000000,22,013,Bienville Parish, LA,Jan-18,5550,5260,290,5.2
CN2201300000000,22,013,Bienville Parish, LA,Feb-18,5684,5405,279,4.9
CN2201300000000,22,013,Bienville Parish, LA,Mar-18,5707,5415,292,5.1
CN2201300000000,22,013,Bienville Parish, LA,Apr-18(p),5683,5383,300,5.3
CN4904100000000,49,041,Sevier County, UT,Mar-17,10026,9587,439,4.4
CN4904100000000,49,041,Sevier County, UT,Apr-17,9890,9510,380,3.8
CN4904100000000,49,041,Sevier County, UT,May-17,9850,9492,358,3.6
CN4904100000000,49,041,Sevier County, UT,Jun-17,10008,9587,421,4.2
CN4904100000000,49,041,Sevier County, UT,Jul-17,10023,9622,401,4.0
CN4904100000000,49,041,Sevier County, UT,Aug-17,10001,9617,384,3.8
CN4904100000000,49,041,Sevier County, UT,Sep-17,9980,9653,327,3.3
CN4904100000000,49,041,Sevier County, UT,Oct-17,10022,9703,319,3.2
CN4904100000000,49,041,Sevier County, UT,Nov-17,9796,9490,306,3.1
CN4904100000000,49,041,Sevier County, UT,Dec-17,9866,9531,335,3.4
CN4904100000000,49,041,Sevier County, UT,Jan-18,9945,9514,431,4.3
CN4904100000000,49,041,Sevier County, UT,Feb-18,9851,9396,455,4.6
CN4904100000000,49,041,Sevier County, UT,Mar-18,10048,9636,412,4.1
CN4904100000000,49,041,Sevier County, UT,Apr-18(p),9826,9484,342,3.5
CN2708300000000,27,083,Lyon County, MN,Mar-17,15232,14615,617,4.1
CN2708300000000,27,083,Lyon County, MN,Apr-17,15233,14737,496,3.3
CN2708300000000,27,083,Lyon County, MN,May-17,15121,14694,427,2.8
CN2708300000000,27,083,Lyon County, MN,Jun-17,15141,14654,487,3.2
CN2708300000000,27,083,Lyon County, MN,Jul-17,14667,14220,447,3.0
CN2708300000000,27,083,Lyon County, MN,Aug-17,14499,14033,466,3.2
CN2708300000000,27,083,Lyon County, MN,Sep-17,14685,14324,361,2.5
CN2708300000000,27,083,Lyon County, MN,Oct-17,14985,14710,275,1.8
CN2708300000000,27,083,Lyon County, MN,Nov-17,14901,14593,308,2.1
CN2708300000000,27,083,Lyon County, MN,Dec-17,14970,14510,460,3.1
CN2708300000000,27,083,Lyon County, MN,Jan-18,14931,14300,631,4.2
CN2708300000000,27,083,Lyon County, MN,Feb-18,15012,14407,605,4.0
CN2708300000000,27,083,Lyon County, MN,Mar-18,15062,14485,577,3.8
CN2708300000000,27,083,Lyon County, MN,Apr-18(p),15223,14734,489,3.2
CN1705700000000,17,057,Fulton County, IL,Mar-17,15592,14521,1071,6.9
CN1705700000000,17,057,Fulton County, IL,Apr-17,15647,14749,898,5.7
CN1705700000000,17,057,Fulton County, IL,May-17,15523,14704,819,5.3
CN1705700000000,17,057,Fulton County, IL,Jun-17,15472,14531,941,6.1
CN1705700000000,17,057,Fulton County, IL,Jul-17,15462,14475,987,6.4
CN1705700000000,17,057,Fulton County, IL,Aug-17,15383,14415,968,6.3
CN1705700000000,17,057,Fulton County, IL,Sep-17,15337,14495,842,5.5
CN1705700000000,17,057,Fulton County, IL,Oct-17,15205,14417,788,5.2
CN1705700000000,17,057,Fulton County, IL,Nov-17,15225,14412,813,5.3
CN1705700000000,17,057,Fulton County, IL,Dec-17,15161,14271,890,5.9
CN1705700000000,17,057,Fulton County, IL,Jan-18,15042,14056,986,6.6
CN1705700000000,17,057,Fulton County, IL,Feb-18,15196,14279,917,6.0
CN1705700000000,17,057,Fulton County, IL,Mar-18,15543,14610,933,6.0
CN1705700000000,17,057,Fulton County, IL,Apr-18(p),15567,14824,743,4.8
CN3604500000000,36,045,Jefferson County, NY,Mar-17,44853,41451,3402,7.6
CN3604500000000,36,045,Jefferson County, NY,Apr-17,45020,42037,2983,6.6
CN3604500000000,36,045,Jefferson County, NY,May-17,45475,42747,2728,6.0
CN3604500000000,36,045,Jefferson County, NY,Jun-17,46811,44242,2569,5.5
CN3604500000000,36,045,Jefferson County, NY,Jul-17,47338,44675,2663,5.6
CN3604500000000,36,045,Jefferson County, NY,Aug-17,46875,44242,2633,5.6
CN3604500000000,36,045,Jefferson County, NY,Sep-17,45544,43030,2514,5.5
CN3604500000000,36,045,Jefferson County, NY,Oct-17,44692,42204,2488,5.6
CN3604500000000,36,045,Jefferson County, NY,Nov-17,44802,41801,3001,6.7
CN3604500000000,36,045,Jefferson County, NY,Dec-17,44552,41295,3257,7.3
CN3604500000000,36,045,Jefferson County, NY,Jan-18,45218,41417,3801,8.4
CN3604500000000,36,045,Jefferson County, NY,Feb-18,44557,40689,3868,8.7
CN3604500000000,36,045,Jefferson County, NY,Mar-18,44284,40729,3555,8.0
CN3604500000000,36,045,Jefferson County, NY,Apr-18(p),44267,41337,2930,6.6
CN4811300000000,48,113,Dallas County, TX,Mar-17,1322366,1268234,54132,4.1
CN4811300000000,48,113,Dallas County, TX,Apr-17,1326476,1276579,49897,3.8
CN4811300000000,48,113,Dallas County, TX,May-17,1323632,1273406,50226,3.8
CN4811300000000,48,113,Dallas County, TX,Jun-17,1330747,1276741,54006,4.1
CN4811300000000,48,113,Dallas County, TX,Jul-17,1340338,1286380,53958,4.0
CN4811300000000,48,113,Dallas County, TX,Aug-17,1337100,1282923,54177,4.1
CN4811300000000,48,113,Dallas County, TX,Sep-17,1347145,1299078,48067,3.6
CN4811300000000,48,113,Dallas County, TX,Oct-17,1340573,1295436,45137,3.4
CN4811300000000,48,113,Dallas County, TX,Nov-17,1352130,1305961,46169,3.4
CN4811300000000,48,113,Dallas County, TX,Dec-17,1346137,1301231,44906,3.3
CN4811300000000,48,113,Dallas County, TX,Jan-18,1348530,1297315,51215,3.8
CN4811300000000,48,113,Dallas County, TX,Feb-18,1368034,1314973,53061,3.9
CN4811300000000,48,113,Dallas County, TX,Mar-18,1368909,1316005,52904,3.9
CN4811300000000,48,113,Dallas County, TX,Apr-18(p),1374236,1325033,49203,3.6
CN2912500000000,29,125,Maries County, MO,Mar-17,3929,3742,187,4.8
CN2912500000000,29,125,Maries County, MO,Apr-17,3991,3812,179,4.5
CN2912500000000,29,125,Maries County, MO,May-17,3926,3762,164,4.2
CN2912500000000,29,125,Maries County, MO,Jun-17,3937,3764,173,4.4
CN2912500000000,29,125,Maries County, MO,Jul-17,3737,3563,174,4.7
CN2912500000000,29,125,Maries County, MO,Aug-17,3753,3563,190,5.1
CN2912500000000,29,125,Maries County, MO,Sep-17,3817,3673,144,3.8
CN2912500000000,29,125,Maries County, MO,Oct-17,3833,3710,123,3.2
CN2912500000000,29,125,Maries County, MO,Nov-17,3834,3690,144,3.8
CN2912500000000,29,125,Maries County, MO,Dec-17,3775,3644,131,3.5
CN2912500000000,29,125,Maries County, MO,Jan-18,3775,3617,158,4.2
CN2912500000000,29,125,Maries County, MO,Feb-18,3835,3676,159,4.1
CN2912500000000,29,125,Maries County, MO,Mar-18,3835,3689,146,3.8
CN2912500000000,29,125,Maries County, MO,Apr-18(p),3885,3746,139,3.6
CN0507100000000,05,071,Johnson County, AR,Mar-17,10634,10237,397,3.7
CN0507100000000,05,071,Johnson County, AR,Apr-17,10614,10264,350,3.3
CN0507100000000,05,071,Johnson County, AR,May-17,10728,10315,413,3.8
CN0507100000000,05,071,Johnson County, AR,Jun-17,10853,10369,484,4.5
CN0507100000000,05,071,Johnson County, AR,Jul-17,10452,9898,554,5.3
CN0507100000000,05,071,Johnson County, AR,Aug-17,10338,9843,495,4.8
CN0507100000000,05,071,Johnson County, AR,Sep-17,10631,10178,453,4.3
CN0507100000000,05,071,Johnson County, AR,Oct-17,10723,10317,406,3.8
CN0507100000000,05,071,Johnson County, AR,Nov-17,10767,10361,406,3.8
CN0507100000000,05,071,Johnson County, AR,Dec-17,10689,10255,434,4.1
CN0507100000000,05,071,Johnson County, AR,Jan-18,10562,9990,572,5.4
CN0507100000000,05,071,Johnson County, AR,Feb-18,10479,9950,529,5.0
CN0507100000000,05,071,Johnson County, AR,Mar-18,10475,10007,468,4.5
CN0507100000000,05,071,Johnson County, AR,Apr-18(p),10410,10015,395,3.8
CN7207500000000,72,075,Juana Diaz Municipio, PR,Mar-17,15202,13329,1873,12.3
CN7207500000000,72,075,Juana Diaz Municipio, PR,Apr-17,15097,13140,1957,13.0
CN7207500000000,72,075,Juana Diaz Municipio, PR,May-17,14988,13121,1867,12.5
CN7207500000000,72,075,Juana Diaz Municipio, PR,Jun-17,14653,13024,1629,11.1
CN7207500000000,72,075,Juana Diaz Municipio, PR,Jul-17,14937,13028,1909,12.8
CN7207500000000,72,075,Juana Diaz Municipio, PR,Aug-17,15117,12792,2325,15.4
CN7207500000000,72,075,Juana Diaz Municipio, PR,Sep-17(y),15078,12866,2212,14.7
CN7207500000000,72,075,Juana Diaz Municipio, PR,Oct-17,14585,12558,2027,13.9
CN7207500000000,72,075,Juana Diaz Municipio, PR,Nov-17,15099,13247,1852,12.3
CN7207500000000,72,075,Juana Diaz Municipio, PR,Dec-17,15139,13383,1756,11.6
CN7207500000000,72,075,Juana Diaz Municipio, PR,Jan-18,14878,13099,1779,12.0
CN7207500000000,72,075,Juana Diaz Municipio, PR,Feb-18,14609,13034,1575,10.8
CN7207500000000,72,075,Juana Diaz Municipio, PR,Mar-18,14620,13043,1577,10.8
CN7207500000000,72,075,Juana Diaz Municipio, PR,Apr-18(p),14709,13181,1528,10.4
CN2205100000000,22,051,Jefferson Parish, LA,Mar-17,214489,204691,9798,4.6
CN2205100000000,22,051,Jefferson Parish, LA,Apr-17,215805,206318,9487,4.4
CN2205100000000,22,051,Jefferson Parish, LA,May-17,215367,205728,9639,4.5
CN2205100000000,22,051,Jefferson Parish, LA,Jun-17,217046,205814,11232,5.2
CN2205100000000,22,051,Jefferson Parish, LA,Jul-17,217110,206222,10888,5.0
CN2205100000000,22,051,Jefferson Parish, LA,Aug-17,215925,205020,10905,5.1
CN2205100000000,22,051,Jefferson Parish, LA,Sep-17,216612,206828,9784,4.5
CN2205100000000,22,051,Jefferson Parish, LA,Oct-17,216873,208395,8478,3.9
CN2205100000000,22,051,Jefferson Parish, LA,Nov-17,216939,208809,8130,3.7
CN2205100000000,22,051,Jefferson Parish, LA,Dec-17,215928,208233,7695,3.6
CN2205100000000,22,051,Jefferson Parish, LA,Jan-18,216752,208279,8473,3.9
CN2205100000000,22,051,Jefferson Parish, LA,Feb-18,218214,210424,7790,3.6
CN2205100000000,22,051,Jefferson Parish, LA,Mar-18,218814,210325,8489,3.9
CN2205100000000,22,051,Jefferson Parish, LA,Apr-18(p),220012,211484,8528,3.9
CN1918900000000,19,189,Winnebago County, IA,Mar-17,5111,4922,189,3.7
CN1918900000000,19,189,Winnebago County, IA,Apr-17,5256,5082,174,3.3
CN1918900000000,19,189,Winnebago County, IA,May-17,5241,5078,163,3.1
CN1918900000000,19,189,Winnebago County, IA,Jun-17,5328,5156,172,3.2
CN1918900000000,19,189,Winnebago County, IA,Jul-17,5345,5180,165,3.1
CN1918900000000,19,189,Winnebago County, IA,Aug-17,5206,5046,160,3.1
CN1918900000000,19,189,Winnebago County, IA,Sep-17,5179,5039,140,2.7
CN1918900000000,19,189,Winnebago County, IA,Oct-17,5185,5064,121,2.3
CN1918900000000,19,189,Winnebago County, IA,Nov-17,5093,4978,115,2.3
CN1918900000000,19,189,Winnebago County, IA,Dec-17,5058,4928,130,2.6
CN1918900000000,19,189,Winnebago County, IA,Jan-18,5048,4899,149,3.0
CN1918900000000,19,189,Winnebago County, IA,Feb-18,5091,4945,146,2.9
CN1918900000000,19,189,Winnebago County, IA,Mar-18,5067,4939,128,2.5
CN1918900000000,19,189,Winnebago County, IA,Apr-18(p),5131,4998,133,2.6
CN1606700000000,16,067,Minidoka County, ID,Mar-17,10661,10348,313,2.9
CN1606700000000,16,067,Minidoka County, ID,Apr-17,10894,10646,248,2.3
CN1606700000000,16,067,Minidoka County, ID,May-17,11030,10765,265,2.4
CN1606700000000,16,067,Minidoka County, ID,Jun-17,11118,10831,287,2.6
CN1606700000000,16,067,Minidoka County, ID,Jul-17,11124,10847,277,2.5
CN1606700000000,16,067,Minidoka County, ID,Aug-17,11160,10885,275,2.5
CN1606700000000,16,067,Minidoka County, ID,Sep-17,11370,11122,248,2.2
CN1606700000000,16,067,Minidoka County, ID,Oct-17,11568,11334,234,2.0
CN1606700000000,16,067,Minidoka County, ID,Nov-17,11131,10866,265,2.4
CN1606700000000,16,067,Minidoka County, ID,Dec-17,10806,10504,302,2.8
CN1606700000000,16,067,Minidoka County, ID,Jan-18,10598,10221,377,3.6
CN1606700000000,16,067,Minidoka County, ID,Feb-18,10876,10541,335,3.1
CN1606700000000,16,067,Minidoka County, ID,Mar-18,11022,10715,307,2.8
CN1606700000000,16,067,Minidoka County, ID,Apr-18(p),11258,10979,279,2.5
CN4208300000000,42,083,McKean County, PA,Mar-17,18326,17088,1238,6.8
CN4208300000000,42,083,McKean County, PA,Apr-17,18280,17180,1100,6.0
CN4208300000000,42,083,McKean County, PA,May-17,18365,17230,1135,6.2
CN4208300000000,42,083,McKean County, PA,Jun-17,18363,17191,1172,6.4
CN4208300000000,42,083,McKean County, PA,Jul-17,18327,17149,1178,6.4
CN4208300000000,42,083,McKean County, PA,Aug-17,18088,16943,1145,6.3
CN4208300000000,42,083,McKean County, PA,Sep-17,17958,17044,914,5.1
CN4208300000000,42,083,McKean County, PA,Oct-17,17778,16891,887,5.0
CN4208300000000,42,083,McKean County, PA,Nov-17,17840,16876,964,5.4
CN4208300000000,42,083,McKean County, PA,Dec-17,17800,16822,978,5.5
CN4208300000000,42,083,McKean County, PA,Jan-18,17888,16798,1090,6.1
CN4208300000000,42,083,McKean County, PA,Feb-18,17932,16843,1089,6.1
CN4208300000000,42,083,McKean County, PA,Mar-18,17693,16742,951,5.4
CN4208300000000,42,083,McKean County, PA,Apr-18(p),17710,16858,852,4.8
CN3003100000000,30,031,Gallatin County, MT,Mar-17,62696,60851,1845,2.9
CN3003100000000,30,031,Gallatin County, MT,Apr-17,62944,61294,1650,2.6
CN3003100000000,30,031,Gallatin County, MT,May-17,63396,61610,1786,2.8
CN3003100000000,30,031,Gallatin County, MT,Jun-17,65177,63468,1709,2.6
CN3003100000000,30,031,Gallatin County, MT,Jul-17,68197,66606,1591,2.3
CN3003100000000,30,031,Gallatin County, MT,Aug-17,66762,65283,1479,2.2
CN3003100000000,30,031,Gallatin County, MT,Sep-17,65093,63576,1517,2.3
CN3003100000000,30,031,Gallatin County, MT,Oct-17,64468,62559,1909,3.0
CN3003100000000,30,031,Gallatin County, MT,Nov-17,64183,62031,2152,3.4
CN3003100000000,30,031,Gallatin County, MT,Dec-17,64392,62443,1949,3.0
CN3003100000000,30,031,Gallatin County, MT,Jan-18,63962,61933,2029,3.2
CN3003100000000,30,031,Gallatin County, MT,Feb-18,63986,62010,1976,3.1
CN3003100000000,30,031,Gallatin County, MT,Mar-18,63981,62072,1909,3.0
CN3003100000000,30,031,Gallatin County, MT,Apr-18(p),63962,62405,1557,2.4
CN0801400000000,08,014,Broomfield County/city, CO,Mar-17,37381,36398,983,2.6
CN0801400000000,08,014,Broomfield County/city, CO,Apr-17,37433,36517,916,2.4
CN0801400000000,08,014,Broomfield County/city, CO,May-17,37682,36801,881,2.3
CN0801400000000,08,014,Broomfield County/city, CO,Jun-17,38190,37154,1036,2.7
CN0801400000000,08,014,Broomfield County/city, CO,Jul-17,38343,37343,1000,2.6
CN0801400000000,08,014,Broomfield County/city, CO,Aug-17,38340,37353,987,2.6
CN0801400000000,08,014,Broomfield County/city, CO,Sep-17,38578,37569,1009,2.6
CN0801400000000,08,014,Broomfield County/city, CO,Oct-17,38474,37462,1012,2.6
CN0801400000000,08,014,Broomfield County/city, CO,Nov-17,38508,37480,1028,2.7
CN0801400000000,08,014,Broomfield County/city, CO,Dec-17,38345,37336,1009,2.6
CN0801400000000,08,014,Broomfield County/city, CO,Jan-18,38171,37057,1114,2.9
CN0801400000000,08,014,Broomfield County/city, CO,Feb-18,38772,37644,1128,2.9
CN0801400000000,08,014,Broomfield County/city, CO,Mar-18,38737,37750,987,2.5
CN0801400000000,08,014,Broomfield County/city, CO,Apr-18(p),38648,37769,879,2.3
CN2300300000000,23,003,Aroostook County, ME,Mar-17,31942,30238,1704,5.3
CN2300300000000,23,003,Aroostook County, ME,Apr-17,31830,29999,1831,5.8
CN2300300000000,23,003,Aroostook County, ME,May-17,31596,29777,1819,5.8
CN2300300000000,23,003,Aroostook County, ME,Jun-17,31877,30307,1570,4.9
CN2300300000000,23,003,Aroostook County, ME,Jul-17,32317,30755,1562,4.8
CN2300300000000,23,003,Aroostook County, ME,Aug-17,31964,30734,1230,3.8
CN2300300000000,23,003,Aroostook County, ME,Sep-17,31077,29886,1191,3.8
CN2300300000000,23,003,Aroostook County, ME,Oct-17,31439,30203,1236,3.9
CN2300300000000,23,003,Aroostook County, ME,Nov-17,31144,29871,1273,4.1
CN2300300000000,23,003,Aroostook County, ME,Dec-17,31148,29873,1275,4.1
CN2300300000000,23,003,Aroostook County, ME,Jan-18,31235,29795,1440,4.6
CN2300300000000,23,003,Aroostook County, ME,Feb-18,31706,30290,1416,4.5
CN2300300000000,23,003,Aroostook County, ME,Mar-18,31755,30421,1334,4.2
CN2300300000000,23,003,Aroostook County, ME,Apr-18(p),31539,30022,1517,4.8
CN2122300000000,21,223,Trimble County, KY,Mar-17,3907,3689,218,5.6
CN2122300000000,21,223,Trimble County, KY,Apr-17,3924,3729,195,5.0
CN2122300000000,21,223,Trimble County, KY,May-17,3931,3732,199,5.1
CN2122300000000,21,223,Trimble County, KY,Jun-17,3985,3771,214,5.4
CN2122300000000,21,223,Trimble County, KY,Jul-17,3970,3758,212,5.3
CN2122300000000,21,223,Trimble County, KY,Aug-17,3907,3717,190,4.9
CN2122300000000,21,223,Trimble County, KY,Sep-17,3905,3734,171,4.4
CN2122300000000,21,223,Trimble County, KY,Oct-17,3887,3726,161,4.1
CN2122300000000,21,223,Trimble County, KY,Nov-17,3914,3759,155,4.0
CN2122300000000,21,223,Trimble County, KY,Dec-17,3906,3752,154,3.9
CN2122300000000,21,223,Trimble County, KY,Jan-18,3850,3693,157,4.1
CN2122300000000,21,223,Trimble County, KY,Feb-18,3884,3704,180,4.6
CN2122300000000,21,223,Trimble County, KY,Mar-18,3907,3749,158,4.0
CN2122300000000,21,223,Trimble County, KY,Apr-18(p),3932,3778,154,3.9
CN4805100000000,48,051,Burleson County, TX,Mar-17,8112,7767,345,4.3
CN4805100000000,48,051,Burleson County, TX,Apr-17,8043,7738,305,3.8
CN4805100000000,48,051,Burleson County, TX,May-17,7991,7683,308,3.9
CN4805100000000,48,051,Burleson County, TX,Jun-17,7694,7348,346,4.5
CN4805100000000,48,051,Burleson County, TX,Jul-17,7735,7387,348,4.5
CN4805100000000,48,051,Burleson County, TX,Aug-17,7661,7321,340,4.4
CN4805100000000,48,051,Burleson County, TX,Sep-17,8146,7830,316,3.9
CN4805100000000,48,051,Burleson County, TX,Oct-17,8224,7938,286,3.5
CN4805100000000,48,051,Burleson County, TX,Nov-17,8232,7923,309,3.8
CN4805100000000,48,051,Burleson County, TX,Dec-17,8165,7868,297,3.6
CN4805100000000,48,051,Burleson County, TX,Jan-18,8116,7799,317,3.9
CN4805100000000,48,051,Burleson County, TX,Feb-18,8363,8042,321,3.8
CN4805100000000,48,051,Burleson County, TX,Mar-18,8432,8109,323,3.8
CN4805100000000,48,051,Burleson County, TX,Apr-18(p),8319,8025,294,3.5
CN2211300000000,22,113,Vermilion Parish, LA,Mar-17,24387,22771,1616,6.6
CN2211300000000,22,113,Vermilion Parish, LA,Apr-17,24444,22962,1482,6.1
CN2211300000000,22,113,Vermilion Parish, LA,May-17,24512,23041,1471,6.0
CN2211300000000,22,113,Vermilion Parish, LA,Jun-17,24897,23255,1642,6.6
CN2211300000000,22,113,Vermilion Parish, LA,Jul-17,24871,23322,1549,6.2
CN2211300000000,22,113,Vermilion Parish, LA,Aug-17,24409,22916,1493,6.1
CN2211300000000,22,113,Vermilion Parish, LA,Sep-17,24197,22884,1313,5.4
CN2211300000000,22,113,Vermilion Parish, LA,Oct-17,24174,22997,1177,4.9
CN2211300000000,22,113,Vermilion Parish, LA,Nov-17,24129,23001,1128,4.7
CN2211300000000,22,113,Vermilion Parish, LA,Dec-17,23959,22860,1099,4.6
CN2211300000000,22,113,Vermilion Parish, LA,Jan-18,24112,22896,1216,5.0
CN2211300000000,22,113,Vermilion Parish, LA,Feb-18,24223,23085,1138,4.7
CN2211300000000,22,113,Vermilion Parish, LA,Mar-18,24398,23178,1220,5.0
CN2211300000000,22,113,Vermilion Parish, LA,Apr-18(p),24448,23264,1184,4.8
CN3113700000000,31,137,Phelps County, NE,Mar-17,4911,4801,110,2.2
CN3113700000000,31,137,Phelps County, NE,Apr-17,4959,4856,103,2.1
CN3113700000000,31,137,Phelps County, NE,May-17,5023,4911,112,2.2
CN3113700000000,31,137,Phelps County, NE,Jun-17,5176,5039,137,2.6
CN3113700000000,31,137,Phelps County, NE,Jul-17,5085,4951,134,2.6
CN3113700000000,31,137,Phelps County, NE,Aug-17,4912,4787,125,2.5
CN3113700000000,31,137,Phelps County, NE,Sep-17,4750,4640,110,2.3
CN3113700000000,31,137,Phelps County, NE,Oct-17,4793,4694,99,2.1
CN3113700000000,31,137,Phelps County, NE,Nov-17,4811,4714,97,2.0
CN3113700000000,31,137,Phelps County, NE,Dec-17,4828,4717,111,2.3
CN3113700000000,31,137,Phelps County, NE,Jan-18,4897,4788,109,2.2
CN3113700000000,31,137,Phelps County, NE,Feb-18,4851,4743,108,2.2
CN3113700000000,31,137,Phelps County, NE,Mar-18,4922,4813,109,2.2
CN3113700000000,31,137,Phelps County, NE,Apr-18(p),4910,4797,113,2.3
CN1719300000000,17,193,White County, IL,Mar-17,6658,6306,352,5.3
CN1719300000000,17,193,White County, IL,Apr-17,6714,6422,292,4.3
CN1719300000000,17,193,White County, IL,May-17,6652,6363,289,4.3
CN1719300000000,17,193,White County, IL,Jun-17,6724,6421,303,4.5
CN1719300000000,17,193,White County, IL,Jul-17,6676,6364,312,4.7
CN1719300000000,17,193,White County, IL,Aug-17,6627,6301,326,4.9
CN1719300000000,17,193,White County, IL,Sep-17,6716,6430,286,4.3
CN1719300000000,17,193,White County, IL,Oct-17,6713,6442,271,4.0
CN1719300000000,17,193,White County, IL,Nov-17,6595,6320,275,4.2
CN1719300000000,17,193,White County, IL,Dec-17,6481,6220,261,4.0
CN1719300000000,17,193,White County, IL,Jan-18,6497,6224,273,4.2
CN1719300000000,17,193,White County, IL,Feb-18,6537,6279,258,3.9
CN1719300000000,17,193,White County, IL,Mar-18,6695,6419,276,4.1
CN1719300000000,17,193,White County, IL,Apr-18(p),6693,6463,230,3.4
CN2404700000000,24,047,Worcester County, MD,Mar-17,25560,22819,2741,10.7
CN2404700000000,24,047,Worcester County, MD,Apr-17,25406,23296,2110,8.3
CN2404700000000,24,047,Worcester County, MD,May-17,25319,23676,1643,6.5
CN2404700000000,24,047,Worcester County, MD,Jun-17,26633,25075,1558,5.8
CN2404700000000,24,047,Worcester County, MD,Jul-17,27066,25619,1447,5.3
CN2404700000000,24,047,Worcester County, MD,Aug-17,26406,24966,1440,5.5
CN2404700000000,24,047,Worcester County, MD,Sep-17,25377,24084,1293,5.1
CN2404700000000,24,047,Worcester County, MD,Oct-17,24938,23362,1576,6.3
CN2404700000000,24,047,Worcester County, MD,Nov-17,24987,22611,2376,9.5
CN2404700000000,24,047,Worcester County, MD,Dec-17,25724,22563,3161,12.3
CN2404700000000,24,047,Worcester County, MD,Jan-18,25608,22296,3312,12.9
CN2404700000000,24,047,Worcester County, MD,Feb-18,25837,22621,3216,12.4
CN2404700000000,24,047,Worcester County, MD,Mar-18,25717,22915,2802,10.9
CN2404700000000,24,047,Worcester County, MD,Apr-18(p),25561,23367,2194,8.6
CN4716100000000,47,161,Stewart County, TN,Mar-17,5224,4933,291,5.6
CN4716100000000,47,161,Stewart County, TN,Apr-17,5209,4953,256,4.9
CN4716100000000,47,161,Stewart County, TN,May-17,5176,4946,230,4.4
CN4716100000000,47,161,Stewart County, TN,Jun-17,5165,4877,288,5.6
CN4716100000000,47,161,Stewart County, TN,Jul-17,5179,4897,282,5.4
CN4716100000000,47,161,Stewart County, TN,Aug-17,5230,4966,264,5.0
CN4716100000000,47,161,Stewart County, TN,Sep-17,5245,5015,230,4.4
CN4716100000000,47,161,Stewart County, TN,Oct-17,5191,4951,240,4.6
CN4716100000000,47,161,Stewart County, TN,Nov-17,5148,4914,234,4.5
CN4716100000000,47,161,Stewart County, TN,Dec-17,5125,4897,228,4.4
CN4716100000000,47,161,Stewart County, TN,Jan-18,5168,4873,295,5.7
CN4716100000000,47,161,Stewart County, TN,Feb-18,5247,4962,285,5.4
CN4716100000000,47,161,Stewart County, TN,Mar-18,5225,4963,262,5.0
CN4716100000000,47,161,Stewart County, TN,Apr-18(p),5235,5013,222,4.2
CN1701900000000,17,019,Champaign County, IL,Mar-17,106147,101443,4704,4.4
CN1701900000000,17,019,Champaign County, IL,Apr-17,106552,102709,3843,3.6
CN1701900000000,17,019,Champaign County, IL,May-17,104332,100376,3956,3.8
CN1701900000000,17,019,Champaign County, IL,Jun-17,101191,96639,4552,4.5
CN1701900000000,17,019,Champaign County, IL,Jul-17,102560,97816,4744,4.6
CN1701900000000,17,019,Champaign County, IL,Aug-17,99897,95402,4495,4.5
CN1701900000000,17,019,Champaign County, IL,Sep-17,106089,102190,3899,3.7
CN1701900000000,17,019,Champaign County, IL,Oct-17,106337,102262,4075,3.8
CN1701900000000,17,019,Champaign County, IL,Nov-17,105916,101722,4194,4.0
CN1701900000000,17,019,Champaign County, IL,Dec-17,104993,101135,3858,3.7
CN1701900000000,17,019,Champaign County, IL,Jan-18,103811,99526,4285,4.1
CN1701900000000,17,019,Champaign County, IL,Feb-18,106045,102162,3883,3.7
CN1701900000000,17,019,Champaign County, IL,Mar-18,108202,104122,4080,3.8
CN1701900000000,17,019,Champaign County, IL,Apr-18(p),108632,105139,3493,3.2
CN2009500000000,20,095,Kingman County, KS,Mar-17,3422,3287,135,3.9
CN2009500000000,20,095,Kingman County, KS,Apr-17,3404,3277,127,3.7
CN2009500000000,20,095,Kingman County, KS,May-17,3387,3261,126,3.7
CN2009500000000,20,095,Kingman County, KS,Jun-17,3462,3328,134,3.9
CN2009500000000,20,095,Kingman County, KS,Jul-17,3509,3364,145,4.1
CN2009500000000,20,095,Kingman County, KS,Aug-17,3474,3345,129,3.7
CN2009500000000,20,095,Kingman County, KS,Sep-17,3445,3338,107,3.1
CN2009500000000,20,095,Kingman County, KS,Oct-17,3476,3376,100,2.9
CN2009500000000,20,095,Kingman County, KS,Nov-17,3437,3333,104,3.0
CN2009500000000,20,095,Kingman County, KS,Dec-17,3418,3319,99,2.9
CN2009500000000,20,095,Kingman County, KS,Jan-18,3393,3287,106,3.1
CN2009500000000,20,095,Kingman County, KS,Feb-18,3398,3278,120,3.5
CN2009500000000,20,095,Kingman County, KS,Mar-18,3381,3266,115,3.4
CN2009500000000,20,095,Kingman County, KS,Apr-18(p),3300,3191,109,3.3
CN4821300000000,48,213,Henderson County, TX,Mar-17,35590,33989,1601,4.5
CN4821300000000,48,213,Henderson County, TX,Apr-17,35557,34155,1402,3.9
CN4821300000000,48,213,Henderson County, TX,May-17,35611,34204,1407,4.0
CN4821300000000,48,213,Henderson County, TX,Jun-17,35795,34219,1576,4.4
CN4821300000000,48,213,Henderson County, TX,Jul-17,35555,33999,1556,4.4
CN4821300000000,48,213,Henderson County, TX,Aug-17,35318,33801,1517,4.3
CN4821300000000,48,213,Henderson County, TX,Sep-17,35667,34293,1374,3.9
CN4821300000000,48,213,Henderson County, TX,Oct-17,35503,34210,1293,3.6
CN4821300000000,48,213,Henderson County, TX,Nov-17,35716,34410,1306,3.7
CN4821300000000,48,213,Henderson County, TX,Dec-17,35555,34299,1256,3.5
CN4821300000000,48,213,Henderson County, TX,Jan-18,35622,34221,1401,3.9
CN4821300000000,48,213,Henderson County, TX,Feb-18,36007,34601,1406,3.9
CN4821300000000,48,213,Henderson County, TX,Mar-18,36306,34827,1479,4.1
CN4821300000000,48,213,Henderson County, TX,Apr-18(p),36287,34991,1296,3.6
CN3804900000000,38,049,McHenry County, ND,Mar-17,3332,3129,203,6.1
CN3804900000000,38,049,McHenry County, ND,Apr-17,3366,3206,160,4.8
CN3804900000000,38,049,McHenry County, ND,May-17,3344,3232,112,3.3
CN3804900000000,38,049,McHenry County, ND,Jun-17,3458,3332,126,3.6
CN3804900000000,38,049,McHenry County, ND,Jul-17,3392,3289,103,3.0
CN3804900000000,38,049,McHenry County, ND,Aug-17,3379,3273,106,3.1
CN3804900000000,38,049,McHenry County, ND,Sep-17,3355,3265,90,2.7
CN3804900000000,38,049,McHenry County, ND,Oct-17,3355,3272,83,2.5
CN3804900000000,38,049,McHenry County, ND,Nov-17,3253,3144,109,3.4
CN3804900000000,38,049,McHenry County, ND,Dec-17,3263,3112,151,4.6
CN3804900000000,38,049,McHenry County, ND,Jan-18,3199,3005,194,6.1
CN3804900000000,38,049,McHenry County, ND,Feb-18,3187,2981,206,6.5
CN3804900000000,38,049,McHenry County, ND,Mar-18,3193,3017,176,5.5
CN3804900000000,38,049,McHenry County, ND,Apr-18(p),3211,3053,158,4.9
CN1601300000000,16,013,Blaine County, ID,Mar-17,12016,11647,369,3.1
CN1601300000000,16,013,Blaine County, ID,Apr-17,11654,11339,315,2.7
CN1601300000000,16,013,Blaine County, ID,May-17,11645,11337,308,2.6
CN1601300000000,16,013,Blaine County, ID,Jun-17,12592,12312,280,2.2
CN1601300000000,16,013,Blaine County, ID,Jul-17,13120,12850,270,2.1
CN1601300000000,16,013,Blaine County, ID,Aug-17,12844,12573,271,2.1
CN1601300000000,16,013,Blaine County, ID,Sep-17,12333,12073,260,2.1
CN1601300000000,16,013,Blaine County, ID,Oct-17,12205,11941,264,2.2
CN1601300000000,16,013,Blaine County, ID,Nov-17,12028,11709,319,2.7
CN1601300000000,16,013,Blaine County, ID,Dec-17,12602,12293,309,2.5
CN1601300000000,16,013,Blaine County, ID,Jan-18,12491,12127,364,2.9
CN1601300000000,16,013,Blaine County, ID,Feb-18,12397,12028,369,3.0
CN1601300000000,16,013,Blaine County, ID,Mar-18,12293,11946,347,2.8
CN1601300000000,16,013,Blaine County, ID,Apr-18(p),11753,11474,279,2.4
CN3715900000000,37,159,Rowan County, NC,Mar-17,65543,62472,3071,4.7
CN3715900000000,37,159,Rowan County, NC,Apr-17,65360,62563,2797,4.3
CN3715900000000,37,159,Rowan County, NC,May-17,65631,62732,2899,4.4
CN3715900000000,37,159,Rowan County, NC,Jun-17,65887,62851,3036,4.6
CN3715900000000,37,159,Rowan County, NC,Jul-17,66426,63231,3195,4.8
CN3715900000000,37,159,Rowan County, NC,Aug-17,65806,62585,3221,4.9
CN3715900000000,37,159,Rowan County, NC,Sep-17,66608,63676,2932,4.4
CN3715900000000,37,159,Rowan County, NC,Oct-17,66826,63796,3030,4.5
CN3715900000000,37,159,Rowan County, NC,Nov-17,66625,63516,3109,4.7
CN3715900000000,37,159,Rowan County, NC,Dec-17,66348,63410,2938,4.4
CN3715900000000,37,159,Rowan County, NC,Jan-18,66359,63224,3135,4.7
CN3715900000000,37,159,Rowan County, NC,Feb-18,66798,63733,3065,4.6
CN3715900000000,37,159,Rowan County, NC,Mar-18,67214,64276,2938,4.4
CN3715900000000,37,159,Rowan County, NC,Apr-18(p),66859,64363,2496,3.7
CN3008500000000,30,085,Roosevelt County, MT,Mar-17,4595,4355,240,5.2
CN3008500000000,30,085,Roosevelt County, MT,Apr-17,4613,4401,212,4.6
CN3008500000000,30,085,Roosevelt County, MT,May-17,4686,4493,193,4.1
CN3008500000000,30,085,Roosevelt County, MT,Jun-17,4734,4479,255,5.4
CN3008500000000,30,085,Roosevelt County, MT,Jul-17,4622,4377,245,5.3
CN3008500000000,30,085,Roosevelt County, MT,Aug-17,4496,4253,243,5.4
CN3008500000000,30,085,Roosevelt County, MT,Sep-17,4568,4389,179,3.9
CN3008500000000,30,085,Roosevelt County, MT,Oct-17,4563,4385,178,3.9
CN3008500000000,30,085,Roosevelt County, MT,Nov-17,4589,4413,176,3.8
CN3008500000000,30,085,Roosevelt County, MT,Dec-17,4580,4394,186,4.1
CN3008500000000,30,085,Roosevelt County, MT,Jan-18,4583,4340,243,5.3
CN3008500000000,30,085,Roosevelt County, MT,Feb-18,4553,4318,235,5.2
CN3008500000000,30,085,Roosevelt County, MT,Mar-18,4518,4268,250,5.5
CN3008500000000,30,085,Roosevelt County, MT,Apr-18(p),4499,4287,212,4.7
CN0102100000000,01,021,Chilton County, AL,Mar-17,19154,18258,896,4.7
CN0102100000000,01,021,Chilton County, AL,Apr-17,19025,18293,732,3.8
CN0102100000000,01,021,Chilton County, AL,May-17,19000,18287,713,3.8
CN0102100000000,01,021,Chilton County, AL,Jun-17,19158,18319,839,4.4
CN0102100000000,01,021,Chilton County, AL,Jul-17,19300,18499,801,4.2
CN0102100000000,01,021,Chilton County, AL,Aug-17,19151,18391,760,4.0
CN0102100000000,01,021,Chilton County, AL,Sep-17,19281,18644,637,3.3
CN0102100000000,01,021,Chilton County, AL,Oct-17,19218,18592,626,3.3
CN0102100000000,01,021,Chilton County, AL,Nov-17,19078,18478,600,3.1
CN0102100000000,01,021,Chilton County, AL,Dec-17,18883,18295,588,3.1
CN0102100000000,01,021,Chilton County, AL,Jan-18,18865,18147,718,3.8
CN0102100000000,01,021,Chilton County, AL,Feb-18,19186,18433,753,3.9
CN0102100000000,01,021,Chilton County, AL,Mar-18,19165,18491,674,3.5
CN0102100000000,01,021,Chilton County, AL,Apr-18(p),19378,18752,626,3.2
CN1316700000000,13,167,Johnson County, GA,Mar-17,4007,3783,224,5.6
CN1316700000000,13,167,Johnson County, GA,Apr-17,3980,3776,204,5.1
CN1316700000000,13,167,Johnson County, GA,May-17,4001,3809,192,4.8
CN1316700000000,13,167,Johnson County, GA,Jun-17,4001,3806,195,4.9
CN1316700000000,13,167,Johnson County, GA,Jul-17,3982,3779,203,5.1
CN1316700000000,13,167,Johnson County, GA,Aug-17,3964,3768,196,4.9
CN1316700000000,13,167,Johnson County, GA,Sep-17,4029,3817,212,5.3
CN1316700000000,13,167,Johnson County, GA,Oct-17,4017,3816,201,5.0
CN1316700000000,13,167,Johnson County, GA,Nov-17,3998,3830,168,4.2
CN1316700000000,13,167,Johnson County, GA,Dec-17,4033,3845,188,4.7
CN1316700000000,13,167,Johnson County, GA,Jan-18,4052,3854,198,4.9
CN1316700000000,13,167,Johnson County, GA,Feb-18,4044,3849,195,4.8
CN1316700000000,13,167,Johnson County, GA,Mar-18,4046,3866,180,4.4
CN1316700000000,13,167,Johnson County, GA,Apr-18(p),4007,3848,159,4.0
CN3103700000000,31,037,Colfax County, NE,Mar-17,5522,5394,128,2.3
CN3103700000000,31,037,Colfax County, NE,Apr-17,5593,5466,127,2.3
CN3103700000000,31,037,Colfax County, NE,May-17,5615,5479,136,2.4
CN3103700000000,31,037,Colfax County, NE,Jun-17,5690,5541,149,2.6
CN3103700000000,31,037,Colfax County, NE,Jul-17,5654,5506,148,2.6
CN3103700000000,31,037,Colfax County, NE,Aug-17,5559,5423,136,2.4
CN3103700000000,31,037,Colfax County, NE,Sep-17,5497,5375,122,2.2
CN3103700000000,31,037,Colfax County, NE,Oct-17,5496,5380,116,2.1
CN3103700000000,31,037,Colfax County, NE,Nov-17,5475,5363,112,2.0
CN3103700000000,31,037,Colfax County, NE,Dec-17,5457,5328,129,2.4
CN3103700000000,31,037,Colfax County, NE,Jan-18,5510,5380,130,2.4
CN3103700000000,31,037,Colfax County, NE,Feb-18,5534,5407,127,2.3
CN3103700000000,31,037,Colfax County, NE,Mar-18,5558,5428,130,2.3
CN3103700000000,31,037,Colfax County, NE,Apr-18(p),5526,5393,133,2.4
CN0605300000000,06,053,Monterey County, CA,Mar-17,213696,190302,23394,10.9
CN0605300000000,06,053,Monterey County, CA,Apr-17,223576,205970,17606,7.9
CN0605300000000,06,053,Monterey County, CA,May-17,225251,211888,13363,5.9
CN0605300000000,06,053,Monterey County, CA,Jun-17,228389,215708,12681,5.6
CN0605300000000,06,053,Monterey County, CA,Jul-17,230918,218351,12567,5.4
CN0605300000000,06,053,Monterey County, CA,Aug-17,228608,216839,11769,5.1
CN0605300000000,06,053,Monterey County, CA,Sep-17,227600,217556,10044,4.4
CN0605300000000,06,053,Monterey County, CA,Oct-17,223229,213149,10080,4.5
CN0605300000000,06,053,Monterey County, CA,Nov-17,216118,204196,11922,5.5
CN0605300000000,06,053,Monterey County, CA,Dec-17,205620,188075,17545,8.5
CN0605300000000,06,053,Monterey County, CA,Jan-18,208764,188434,20330,9.7
CN0605300000000,06,053,Monterey County, CA,Feb-18,212729,190832,21897,10.3
CN0605300000000,06,053,Monterey County, CA,Mar-18,214016,193951,20065,9.4
CN0605300000000,06,053,Monterey County, CA,Apr-18(p),222240,207243,14997,6.7
CN1308100000000,13,081,Crisp County, GA,Mar-17,9392,8891,501,5.3
CN1308100000000,13,081,Crisp County, GA,Apr-17,9451,8964,487,5.2
CN1308100000000,13,081,Crisp County, GA,May-17,9539,9040,499,5.2
CN1308100000000,13,081,Crisp County, GA,Jun-17,9606,9071,535,5.6
CN1308100000000,13,081,Crisp County, GA,Jul-17,9574,9027,547,5.7
CN1308100000000,13,081,Crisp County, GA,Aug-17,9455,8948,507,5.4
CN1308100000000,13,081,Crisp County, GA,Sep-17,9431,8981,450,4.8
CN1308100000000,13,081,Crisp County, GA,Oct-17,9462,8997,465,4.9
CN1308100000000,13,081,Crisp County, GA,Nov-17,9447,9008,439,4.6
CN1308100000000,13,081,Crisp County, GA,Dec-17,9459,9024,435,4.6
CN1308100000000,13,081,Crisp County, GA,Jan-18,9571,9068,503,5.3
CN1308100000000,13,081,Crisp County, GA,Feb-18,9485,9012,473,5.0
CN1308100000000,13,081,Crisp County, GA,Mar-18,9479,9046,433,4.6
CN1308100000000,13,081,Crisp County, GA,Apr-18(p),9450,9058,392,4.1
CN4706100000000,47,061,Grundy County, TN,Mar-17,4857,4600,257,5.3
CN4706100000000,47,061,Grundy County, TN,Apr-17,4860,4641,219,4.5
CN4706100000000,47,061,Grundy County, TN,May-17,4842,4621,221,4.6
CN4706100000000,47,061,Grundy County, TN,Jun-17,4687,4421,266,5.7
CN4706100000000,47,061,Grundy County, TN,Jul-17,4687,4414,273,5.8
CN4706100000000,47,061,Grundy County, TN,Aug-17,4903,4671,232,4.7
CN4706100000000,47,061,Grundy County, TN,Sep-17,4921,4709,212,4.3
CN4706100000000,47,061,Grundy County, TN,Oct-17,4907,4704,203,4.1
CN4706100000000,47,061,Grundy County, TN,Nov-17,4866,4660,206,4.2
CN4706100000000,47,061,Grundy County, TN,Dec-17,4844,4642,202,4.2
CN4706100000000,47,061,Grundy County, TN,Jan-18,4884,4641,243,5.0
CN4706100000000,47,061,Grundy County, TN,Feb-18,4901,4684,217,4.4
CN4706100000000,47,061,Grundy County, TN,Mar-18,4831,4627,204,4.2
CN4706100000000,47,061,Grundy County, TN,Apr-18(p),4867,4691,176,3.6
CN0228200000000,02,282,Yakutat Borough/city, AK,Mar-17,221,199,22,10.0
CN0228200000000,02,282,Yakutat Borough/city, AK,Apr-17,241,221,20,8.3
CN0228200000000,02,282,Yakutat Borough/city, AK,May-17,238,219,19,8.0
CN0228200000000,02,282,Yakutat Borough/city, AK,Jun-17,253,229,24,9.5
CN0228200000000,02,282,Yakutat Borough/city, AK,Jul-17,248,227,21,8.5
CN0228200000000,02,282,Yakutat Borough/city, AK,Aug-17,255,234,21,8.2
CN0228200000000,02,282,Yakutat Borough/city, AK,Sep-17,261,240,21,8.0
CN0228200000000,02,282,Yakutat Borough/city, AK,Oct-17,235,212,23,9.8
CN0228200000000,02,282,Yakutat Borough/city, AK,Nov-17,221,197,24,10.9
CN0228200000000,02,282,Yakutat Borough/city, AK,Dec-17,221,199,22,10.0
CN0228200000000,02,282,Yakutat Borough/city, AK,Jan-18,205,180,25,12.2
CN0228200000000,02,282,Yakutat Borough/city, AK,Feb-18,222,195,27,12.2
CN0228200000000,02,282,Yakutat Borough/city, AK,Mar-18,224,202,22,9.8
CN0228200000000,02,282,Yakutat Borough/city, AK,Apr-18(p),241,220,21,8.7
CN2019500000000,20,195,Trego County, KS,Mar-17,1437,1385,52,3.6
CN2019500000000,20,195,Trego County, KS,Apr-17,1402,1362,40,2.9
CN2019500000000,20,195,Trego County, KS,May-17,1416,1368,48,3.4
CN2019500000000,20,195,Trego County, KS,Jun-17,1502,1454,48,3.2
CN2019500000000,20,195,Trego County, KS,Jul-17,1459,1403,56,3.8
CN2019500000000,20,195,Trego County, KS,Aug-17,1447,1398,49,3.4
CN2019500000000,20,195,Trego County, KS,Sep-17,1422,1384,38,2.7
CN2019500000000,20,195,Trego County, KS,Oct-17,1427,1385,42,2.9
CN2019500000000,20,195,Trego County, KS,Nov-17,1421,1376,45,3.2
CN2019500000000,20,195,Trego County, KS,Dec-17,1414,1364,50,3.5
CN2019500000000,20,195,Trego County, KS,Jan-18,1391,1345,46,3.3
CN2019500000000,20,195,Trego County, KS,Feb-18,1397,1346,51,3.7
CN2019500000000,20,195,Trego County, KS,Mar-18,1381,1331,50,3.6
CN2019500000000,20,195,Trego County, KS,Apr-18(p),1317,1273,44,3.3
CN3908100000000,39,081,Jefferson County, OH,Mar-17,28325,26071,2254,8.0
CN3908100000000,39,081,Jefferson County, OH,Apr-17,28358,26335,2023,7.1
CN3908100000000,39,081,Jefferson County, OH,May-17,28400,26477,1923,6.8
CN3908100000000,39,081,Jefferson County, OH,Jun-17,28625,26562,2063,7.2
CN3908100000000,39,081,Jefferson County, OH,Jul-17,28743,26670,2073,7.2
CN3908100000000,39,081,Jefferson County, OH,Aug-17,28435,26475,1960,6.9
CN3908100000000,39,081,Jefferson County, OH,Sep-17,28346,26535,1811,6.4
CN3908100000000,39,081,Jefferson County, OH,Oct-17,28305,26537,1768,6.2
CN3908100000000,39,081,Jefferson County, OH,Nov-17,28076,26274,1802,6.4
CN3908100000000,39,081,Jefferson County, OH,Dec-17,28024,26179,1845,6.6
CN3908100000000,39,081,Jefferson County, OH,Jan-18,27535,25444,2091,7.6
CN3908100000000,39,081,Jefferson County, OH,Feb-18,27833,25939,1894,6.8
CN3908100000000,39,081,Jefferson County, OH,Mar-18,27979,26222,1757,6.3
CN3908100000000,39,081,Jefferson County, OH,Apr-18(p),27902,26291,1611,5.8
CN4831300000000,48,313,Madison County, TX,Mar-17,4812,4576,236,4.9
CN4831300000000,48,313,Madison County, TX,Apr-17,4781,4563,218,4.6
CN4831300000000,48,313,Madison County, TX,May-17,4744,4537,207,4.4
CN4831300000000,48,313,Madison County, TX,Jun-17,4650,4410,240,5.2
CN4831300000000,48,313,Madison County, TX,Jul-17,4581,4343,238,5.2
CN4831300000000,48,313,Madison County, TX,Aug-17,4656,4416,240,5.2
CN4831300000000,48,313,Madison County, TX,Sep-17,4681,4481,200,4.3
CN4831300000000,48,313,Madison County, TX,Oct-17,4650,4473,177,3.8
CN4831300000000,48,313,Madison County, TX,Nov-17,4623,4443,180,3.9
CN4831300000000,48,313,Madison County, TX,Dec-17,4598,4418,180,3.9
CN4831300000000,48,313,Madison County, TX,Jan-18,4567,4362,205,4.5
CN4831300000000,48,313,Madison County, TX,Feb-18,4630,4426,204,4.4
CN4831300000000,48,313,Madison County, TX,Mar-18,4746,4528,218,4.6
CN4831300000000,48,313,Madison County, TX,Apr-18(p),4658,4467,191,4.1
CN5105300000000,51,053,Dinwiddie County, VA,Mar-17,13606,12937,669,4.9
CN5105300000000,51,053,Dinwiddie County, VA,Apr-17,13616,13014,602,4.4
CN5105300000000,51,053,Dinwiddie County, VA,May-17,13597,13013,584,4.3
CN5105300000000,51,053,Dinwiddie County, VA,Jun-17,13751,13126,625,4.5
CN5105300000000,51,053,Dinwiddie County, VA,Jul-17,13817,13179,638,4.6
CN5105300000000,51,053,Dinwiddie County, VA,Aug-17,13619,12994,625,4.6
CN5105300000000,51,053,Dinwiddie County, VA,Sep-17,13655,13074,581,4.3
CN5105300000000,51,053,Dinwiddie County, VA,Oct-17,13535,12991,544,4.0
CN5105300000000,51,053,Dinwiddie County, VA,Nov-17,13468,12923,545,4.0
CN5105300000000,51,053,Dinwiddie County, VA,Dec-17,13467,12938,529,3.9
CN5105300000000,51,053,Dinwiddie County, VA,Jan-18,13420,12839,581,4.3
CN5105300000000,51,053,Dinwiddie County, VA,Feb-18,13596,13054,542,4.0
CN5105300000000,51,053,Dinwiddie County, VA,Mar-18,13632,13114,518,3.8
CN5105300000000,51,053,Dinwiddie County, VA,Apr-18(p),13681,13232,449,3.3
CN0513300000000,05,133,Sevier County, AR,Mar-17,5616,5375,241,4.3
CN0513300000000,05,133,Sevier County, AR,Apr-17,5639,5424,215,3.8
CN0513300000000,05,133,Sevier County, AR,May-17,5679,5434,245,4.3
CN0513300000000,05,133,Sevier County, AR,Jun-17,5796,5534,262,4.5
CN0513300000000,05,133,Sevier County, AR,Jul-17,5612,5339,273,4.9
CN0513300000000,05,133,Sevier County, AR,Aug-17,5594,5332,262,4.7
CN0513300000000,05,133,Sevier County, AR,Sep-17,5646,5394,252,4.5
CN0513300000000,05,133,Sevier County, AR,Oct-17,5724,5499,225,3.9
CN0513300000000,05,133,Sevier County, AR,Nov-17,5716,5485,231,4.0
CN0513300000000,05,133,Sevier County, AR,Dec-17,5681,5433,248,4.4
CN0513300000000,05,133,Sevier County, AR,Jan-18,5603,5304,299,5.3
CN0513300000000,05,133,Sevier County, AR,Feb-18,5626,5342,284,5.0
CN0513300000000,05,133,Sevier County, AR,Mar-18,5664,5401,263,4.6
CN0513300000000,05,133,Sevier County, AR,Apr-18(p),5653,5425,228,4.0
CN1911100000000,19,111,Lee County, IA,Mar-17,16397,15512,885,5.4
CN1911100000000,19,111,Lee County, IA,Apr-17,16252,15412,840,5.2
CN1911100000000,19,111,Lee County, IA,May-17,16076,15218,858,5.3
CN1911100000000,19,111,Lee County, IA,Jun-17,16293,15301,992,6.1
CN1911100000000,19,111,Lee County, IA,Jul-17,16143,15174,969,6.0
CN1911100000000,19,111,Lee County, IA,Aug-17,16093,15085,1008,6.3
CN1911100000000,19,111,Lee County, IA,Sep-17,15788,14928,860,5.4
CN1911100000000,19,111,Lee County, IA,Oct-17,15770,15107,663,4.2
CN1911100000000,19,111,Lee County, IA,Nov-17,15874,15123,751,4.7
CN1911100000000,19,111,Lee County, IA,Dec-17,15897,15091,806,5.1
CN1911100000000,19,111,Lee County, IA,Jan-18,15804,14944,860,5.4
CN1911100000000,19,111,Lee County, IA,Feb-18,16069,15265,804,5.0
CN1911100000000,19,111,Lee County, IA,Mar-18,16056,15369,687,4.3
CN1911100000000,19,111,Lee County, IA,Apr-18(p),15935,15335,600,3.8
CN5500500000000,55,005,Barron County, WI,Mar-17,24498,23348,1150,4.7
CN5500500000000,55,005,Barron County, WI,Apr-17,24680,23797,883,3.6
CN5500500000000,55,005,Barron County, WI,May-17,24923,24206,717,2.9
CN5500500000000,55,005,Barron County, WI,Jun-17,25599,24773,826,3.2
CN5500500000000,55,005,Barron County, WI,Jul-17,24913,24154,759,3.0
CN5500500000000,55,005,Barron County, WI,Aug-17,24741,23998,743,3.0
CN5500500000000,55,005,Barron County, WI,Sep-17,24949,24286,663,2.7
CN5500500000000,55,005,Barron County, WI,Oct-17,24913,24274,639,2.6
CN5500500000000,55,005,Barron County, WI,Nov-17,24901,24179,722,2.9
CN5500500000000,55,005,Barron County, WI,Dec-17,24840,24020,820,3.3
CN5500500000000,55,005,Barron County, WI,Jan-18,24799,23818,981,4.0
CN5500500000000,55,005,Barron County, WI,Feb-18,24815,23675,1140,4.6
CN5500500000000,55,005,Barron County, WI,Mar-18,24987,23917,1070,4.3
CN5500500000000,55,005,Barron County, WI,Apr-18(p),25102,24192,910,3.6
CN2813500000000,28,135,Tallahatchie County, MS,Mar-17,5859,5529,330,5.6
CN2813500000000,28,135,Tallahatchie County, MS,Apr-17,5797,5543,254,4.4
CN2813500000000,28,135,Tallahatchie County, MS,May-17,5677,5387,290,5.1
CN2813500000000,28,135,Tallahatchie County, MS,Jun-17,5691,5362,329,5.8
CN2813500000000,28,135,Tallahatchie County, MS,Jul-17,5664,5318,346,6.1
CN2813500000000,28,135,Tallahatchie County, MS,Aug-17,5570,5302,268,4.8
CN2813500000000,28,135,Tallahatchie County, MS,Sep-17,5576,5334,242,4.3
CN2813500000000,28,135,Tallahatchie County, MS,Oct-17,5495,5270,225,4.1
CN2813500000000,28,135,Tallahatchie County, MS,Nov-17,5429,5196,233,4.3
CN2813500000000,28,135,Tallahatchie County, MS,Dec-17,5432,5182,250,4.6
CN2813500000000,28,135,Tallahatchie County, MS,Jan-18,5424,5098,326,6.0
CN2813500000000,28,135,Tallahatchie County, MS,Feb-18,5487,5169,318,5.8
CN2813500000000,28,135,Tallahatchie County, MS,Mar-18,5596,5311,285,5.1
CN2813500000000,28,135,Tallahatchie County, MS,Apr-18(p),5640,5396,244,4.3
CN0607700000000,06,077,San Joaquin County, CA,Mar-17,324152,297642,26510,8.2
CN0607700000000,06,077,San Joaquin County, CA,Apr-17,322663,299341,23322,7.2
CN0607700000000,06,077,San Joaquin County, CA,May-17,327397,306727,20670,6.3
CN0607700000000,06,077,San Joaquin County, CA,Jun-17,323523,301377,22146,6.8
CN0607700000000,06,077,San Joaquin County, CA,Jul-17,324981,302019,22962,7.1
CN0607700000000,06,077,San Joaquin County, CA,Aug-17,327057,305334,21723,6.6
CN0607700000000,06,077,San Joaquin County, CA,Sep-17,327730,308568,19162,5.8
CN0607700000000,06,077,San Joaquin County, CA,Oct-17,326507,307522,18985,5.8
CN0607700000000,06,077,San Joaquin County, CA,Nov-17,324104,304142,19962,6.2
CN0607700000000,06,077,San Joaquin County, CA,Dec-17,325110,304340,20770,6.4
CN0607700000000,06,077,San Joaquin County, CA,Jan-18,326231,303397,22834,7.0
CN0607700000000,06,077,San Joaquin County, CA,Feb-18,327446,304544,22902,7.0
CN0607700000000,06,077,San Joaquin County, CA,Mar-18,326749,305183,21566,6.6
CN0607700000000,06,077,San Joaquin County, CA,Apr-18(p),324417,305608,18809,5.8
CN2017100000000,20,171,Scott County, KS,Mar-17,2784,2720,64,2.3
CN2017100000000,20,171,Scott County, KS,Apr-17,2759,2699,60,2.2
CN2017100000000,20,171,Scott County, KS,May-17,2806,2742,64,2.3
CN2017100000000,20,171,Scott County, KS,Jun-17,2957,2889,68,2.3
CN2017100000000,20,171,Scott County, KS,Jul-17,2916,2846,70,2.4
CN2017100000000,20,171,Scott County, KS,Aug-17,2853,2786,67,2.3
CN2017100000000,20,171,Scott County, KS,Sep-17,2880,2825,55,1.9
CN2017100000000,20,171,Scott County, KS,Oct-17,2944,2892,52,1.8
CN2017100000000,20,171,Scott County, KS,Nov-17,2882,2826,56,1.9
CN2017100000000,20,171,Scott County, KS,Dec-17,2873,2821,52,1.8
CN2017100000000,20,171,Scott County, KS,Jan-18,2800,2746,54,1.9
CN2017100000000,20,171,Scott County, KS,Feb-18,2800,2744,56,2.0
CN2017100000000,20,171,Scott County, KS,Mar-18,2799,2736,63,2.3
CN2017100000000,20,171,Scott County, KS,Apr-18(p),2624,2561,63,2.4
CN2106100000000,21,061,Edmonson County, KY,Mar-17,4928,4603,325,6.6
CN2106100000000,21,061,Edmonson County, KY,Apr-17,4955,4677,278,5.6
CN2106100000000,21,061,Edmonson County, KY,May-17,4933,4647,286,5.8
CN2106100000000,21,061,Edmonson County, KY,Jun-17,4954,4641,313,6.3
CN2106100000000,21,061,Edmonson County, KY,Jul-17,4808,4505,303,6.3
CN2106100000000,21,061,Edmonson County, KY,Aug-17,4787,4508,279,5.8
CN2106100000000,21,061,Edmonson County, KY,Sep-17,4897,4623,274,5.6
CN2106100000000,21,061,Edmonson County, KY,Oct-17,4857,4611,246,5.1
CN2106100000000,21,061,Edmonson County, KY,Nov-17,4879,4651,228,4.7
CN2106100000000,21,061,Edmonson County, KY,Dec-17,4887,4651,236,4.8
CN2106100000000,21,061,Edmonson County, KY,Jan-18,4841,4560,281,5.8
CN2106100000000,21,061,Edmonson County, KY,Feb-18,4973,4660,313,6.3
CN2106100000000,21,061,Edmonson County, KY,Mar-18,5006,4726,280,5.6
CN2106100000000,21,061,Edmonson County, KY,Apr-18(p),5006,4775,231,4.6
CN3703500000000,37,035,Catawba County, NC,Mar-17,78778,75494,3284,4.2
CN3703500000000,37,035,Catawba County, NC,Apr-17,78723,75749,2974,3.8
CN3703500000000,37,035,Catawba County, NC,May-17,78652,75532,3120,4.0
CN3703500000000,37,035,Catawba County, NC,Jun-17,78735,75375,3360,4.3
CN3703500000000,37,035,Catawba County, NC,Jul-17,78513,74989,3524,4.5
CN3703500000000,37,035,Catawba County, NC,Aug-17,77841,74364,3477,4.5
CN3703500000000,37,035,Catawba County, NC,Sep-17,78859,75777,3082,3.9
CN3703500000000,37,035,Catawba County, NC,Oct-17,78376,75273,3103,4.0
CN3703500000000,37,035,Catawba County, NC,Nov-17,78539,75284,3255,4.1
CN3703500000000,37,035,Catawba County, NC,Dec-17,77859,74768,3091,4.0
CN3703500000000,37,035,Catawba County, NC,Jan-18,78585,75338,3247,4.1
CN3703500000000,37,035,Catawba County, NC,Feb-18,79075,75899,3176,4.0
CN3703500000000,37,035,Catawba County, NC,Mar-18,79253,76186,3067,3.9
CN3703500000000,37,035,Catawba County, NC,Apr-18(p),78921,76305,2616,3.3
CN1326700000000,13,267,Tattnall County, GA,Mar-17,9562,9069,493,5.2
CN1326700000000,13,267,Tattnall County, GA,Apr-17,9556,9096,460,4.8
CN1326700000000,13,267,Tattnall County, GA,May-17,9663,9226,437,4.5
CN1326700000000,13,267,Tattnall County, GA,Jun-17,9692,9194,498,5.1
CN1326700000000,13,267,Tattnall County, GA,Jul-17,9638,9126,512,5.3
CN1326700000000,13,267,Tattnall County, GA,Aug-17,9602,9103,499,5.2
CN1326700000000,13,267,Tattnall County, GA,Sep-17,9625,9184,441,4.6
CN1326700000000,13,267,Tattnall County, GA,Oct-17,9614,9176,438,4.6
CN1326700000000,13,267,Tattnall County, GA,Nov-17,9608,9176,432,4.5
CN1326700000000,13,267,Tattnall County, GA,Dec-17,9641,9203,438,4.5
CN1326700000000,13,267,Tattnall County, GA,Jan-18,9840,9349,491,5.0
CN1326700000000,13,267,Tattnall County, GA,Feb-18,9546,9063,483,5.1
CN1326700000000,13,267,Tattnall County, GA,Mar-18,9515,9056,459,4.8
CN1326700000000,13,267,Tattnall County, GA,Apr-18(p),9510,9133,377,4.0
CN4102700000000,41,027,Hood River County, OR,Mar-17,13616,13105,511,3.8
CN4102700000000,41,027,Hood River County, OR,Apr-17,14001,13531,470,3.4
CN4102700000000,41,027,Hood River County, OR,May-17,13872,13409,463,3.3
CN4102700000000,41,027,Hood River County, OR,Jun-17,14519,13933,586,4.0
CN4102700000000,41,027,Hood River County, OR,Jul-17,16215,15601,614,3.8
CN4102700000000,41,027,Hood River County, OR,Aug-17,16266,15655,611,3.8
CN4102700000000,41,027,Hood River County, OR,Sep-17,15858,15406,452,2.9
CN4102700000000,41,027,Hood River County, OR,Oct-17,13792,13380,412,3.0
CN4102700000000,41,027,Hood River County, OR,Nov-17,14012,13563,449,3.2
CN4102700000000,41,027,Hood River County, OR,Dec-17,13882,13461,421,3.0
CN4102700000000,41,027,Hood River County, OR,Jan-18,13186,12672,514,3.9
CN4102700000000,41,027,Hood River County, OR,Feb-18,13775,13269,506,3.7
CN4102700000000,41,027,Hood River County, OR,Mar-18,14038,13563,475,3.4
CN4102700000000,41,027,Hood River County, OR,Apr-18(p),14184,13745,439,3.1
CN1916500000000,19,165,Shelby County, IA,Mar-17,6629,6434,195,2.9
CN1916500000000,19,165,Shelby County, IA,Apr-17,6640,6481,159,2.4
CN1916500000000,19,165,Shelby County, IA,May-17,6700,6546,154,2.3
CN1916500000000,19,165,Shelby County, IA,Jun-17,6834,6679,155,2.3
CN1916500000000,19,165,Shelby County, IA,Jul-17,6910,6757,153,2.2
CN1916500000000,19,165,Shelby County, IA,Aug-17,6795,6637,158,2.3
CN1916500000000,19,165,Shelby County, IA,Sep-17,6625,6488,137,2.1
CN1916500000000,19,165,Shelby County, IA,Oct-17,6618,6513,105,1.6
CN1916500000000,19,165,Shelby County, IA,Nov-17,6570,6447,123,1.9
CN1916500000000,19,165,Shelby County, IA,Dec-17,6552,6408,144,2.2
CN1916500000000,19,165,Shelby County, IA,Jan-18,6510,6317,193,3.0
CN1916500000000,19,165,Shelby County, IA,Feb-18,6538,6354,184,2.8
CN1916500000000,19,165,Shelby County, IA,Mar-18,6501,6343,158,2.4
CN1916500000000,19,165,Shelby County, IA,Apr-18(p),6493,6365,128,2.0
CN2811100000000,28,111,Perry County, MS,Mar-17,4424,4165,259,5.9
CN2811100000000,28,111,Perry County, MS,Apr-17,4402,4163,239,5.4
CN2811100000000,28,111,Perry County, MS,May-17,4415,4122,293,6.6
CN2811100000000,28,111,Perry County, MS,Jun-17,4455,4122,333,7.5
CN2811100000000,28,111,Perry County, MS,Jul-17,4442,4115,327,7.4
CN2811100000000,28,111,Perry County, MS,Aug-17,4385,4093,292,6.7
CN2811100000000,28,111,Perry County, MS,Sep-17,4409,4151,258,5.9
CN2811100000000,28,111,Perry County, MS,Oct-17,4408,4187,221,5.0
CN2811100000000,28,111,Perry County, MS,Nov-17,4444,4221,223,5.0
CN2811100000000,28,111,Perry County, MS,Dec-17,4474,4215,259,5.8
CN2811100000000,28,111,Perry County, MS,Jan-18,4394,4131,263,6.0
CN2811100000000,28,111,Perry County, MS,Feb-18,4422,4196,226,5.1
CN2811100000000,28,111,Perry County, MS,Mar-18,4407,4198,209,4.7
CN2811100000000,28,111,Perry County, MS,Apr-18(p),4430,4209,221,5.0
CN3202700000000,32,027,Pershing County, NV,Mar-17,2985,2853,132,4.4
CN3202700000000,32,027,Pershing County, NV,Apr-17,2754,2635,119,4.3
CN3202700000000,32,027,Pershing County, NV,May-17,2750,2637,113,4.1
CN3202700000000,32,027,Pershing County, NV,Jun-17,2793,2675,118,4.2
CN3202700000000,32,027,Pershing County, NV,Jul-17,2655,2540,115,4.3
CN3202700000000,32,027,Pershing County, NV,Aug-17,2617,2503,114,4.4
CN3202700000000,32,027,Pershing County, NV,Sep-17,2592,2478,114,4.4
CN3202700000000,32,027,Pershing County, NV,Oct-17,2472,2370,102,4.1
CN3202700000000,32,027,Pershing County, NV,Nov-17,2512,2405,107,4.3
CN3202700000000,32,027,Pershing County, NV,Dec-17,2596,2483,113,4.4
CN3202700000000,32,027,Pershing County, NV,Jan-18,2557,2428,129,5.0
CN3202700000000,32,027,Pershing County, NV,Feb-18,2682,2547,135,5.0
CN3202700000000,32,027,Pershing County, NV,Mar-18,2850,2718,132,4.6
CN3202700000000,32,027,Pershing County, NV,Apr-18(p),2550,2434,116,4.5
CN2907900000000,29,079,Grundy County, MO,Mar-17,4830,4635,195,4.0
CN2907900000000,29,079,Grundy County, MO,Apr-17,4983,4805,178,3.6
CN2907900000000,29,079,Grundy County, MO,May-17,4831,4662,169,3.5
CN2907900000000,29,079,Grundy County, MO,Jun-17,4784,4611,173,3.6
CN2907900000000,29,079,Grundy County, MO,Jul-17,4535,4357,178,3.9
CN2907900000000,29,079,Grundy County, MO,Aug-17,4471,4283,188,4.2
CN2907900000000,29,079,Grundy County, MO,Sep-17,4636,4492,144,3.1
CN2907900000000,29,079,Grundy County, MO,Oct-17,4763,4651,112,2.4
CN2907900000000,29,079,Grundy County, MO,Nov-17,4745,4607,138,2.9
CN2907900000000,29,079,Grundy County, MO,Dec-17,4684,4545,139,3.0
CN2907900000000,29,079,Grundy County, MO,Jan-18,4672,4510,162,3.5
CN2907900000000,29,079,Grundy County, MO,Feb-18,4738,4564,174,3.7
CN2907900000000,29,079,Grundy County, MO,Mar-18,4707,4542,165,3.5
CN2907900000000,29,079,Grundy County, MO,Apr-18(p),4849,4652,197,4.1
CN5403900000000,54,039,Kanawha County, WV,Mar-17,83316,79046,4270,5.1
CN5403900000000,54,039,Kanawha County, WV,Apr-17,84020,79987,4033,4.8
CN5403900000000,54,039,Kanawha County, WV,May-17,84043,80248,3795,4.5
CN5403900000000,54,039,Kanawha County, WV,Jun-17,86018,81716,4302,5.0
CN5403900000000,54,039,Kanawha County, WV,Jul-17,85435,81298,4137,4.8
CN5403900000000,54,039,Kanawha County, WV,Aug-17,84893,80466,4427,5.2
CN5403900000000,54,039,Kanawha County, WV,Sep-17,84845,80950,3895,4.6
CN5403900000000,54,039,Kanawha County, WV,Oct-17,84238,80297,3941,4.7
CN5403900000000,54,039,Kanawha County, WV,Nov-17,83930,79705,4225,5.0
CN5403900000000,54,039,Kanawha County, WV,Dec-17,83710,79472,4238,5.1
CN5403900000000,54,039,Kanawha County, WV,Jan-18,83959,79406,4553,5.4
CN5403900000000,54,039,Kanawha County, WV,Feb-18,84778,79717,5061,6.0
CN5403900000000,54,039,Kanawha County, WV,Mar-18,84293,79380,4913,5.8
CN5403900000000,54,039,Kanawha County, WV,Apr-18(p),84440,80029,4411,5.2
CN3200300000000,32,003,Clark County, NV,Mar-17,1062091,1006213,55878,5.3
CN3200300000000,32,003,Clark County, NV,Apr-17,1064509,1007939,56570,5.3
CN3200300000000,32,003,Clark County, NV,May-17,1066716,1011746,54970,5.2
CN3200300000000,32,003,Clark County, NV,Jun-17,1069843,1010499,59344,5.5
CN3200300000000,32,003,Clark County, NV,Jul-17,1077241,1018892,58349,5.4
CN3200300000000,32,003,Clark County, NV,Aug-17,1075167,1018719,56448,5.3
CN3200300000000,32,003,Clark County, NV,Sep-17,1079780,1023918,55862,5.2
CN3200300000000,32,003,Clark County, NV,Oct-17,1081602,1028379,53223,4.9
CN3200300000000,32,003,Clark County, NV,Nov-17,1083795,1030437,53358,4.9
CN3200300000000,32,003,Clark County, NV,Dec-17,1082372,1028603,53769,5.0
CN3200300000000,32,003,Clark County, NV,Jan-18,1084970,1026553,58417,5.4
CN3200300000000,32,003,Clark County, NV,Feb-18,1095597,1038660,56937,5.2
CN3200300000000,32,003,Clark County, NV,Mar-18,1094655,1038375,56280,5.1
CN3200300000000,32,003,Clark County, NV,Apr-18(p),1097334,1042410,54924,5.0
CN4605900000000,46,059,Hand County, SD,Mar-17,1819,1775,44,2.4
CN4605900000000,46,059,Hand County, SD,Apr-17,1829,1784,45,2.5
CN4605900000000,46,059,Hand County, SD,May-17,1895,1846,49,2.6
CN4605900000000,46,059,Hand County, SD,Jun-17,1920,1872,48,2.5
CN4605900000000,46,059,Hand County, SD,Jul-17,1852,1805,47,2.5
CN4605900000000,46,059,Hand County, SD,Aug-17,1790,1741,49,2.7
CN4605900000000,46,059,Hand County, SD,Sep-17,1778,1735,43,2.4
CN4605900000000,46,059,Hand County, SD,Oct-17,1813,1771,42,2.3
CN4605900000000,46,059,Hand County, SD,Nov-17,1793,1744,49,2.7
CN4605900000000,46,059,Hand County, SD,Dec-17,1833,1784,49,2.7
CN4605900000000,46,059,Hand County, SD,Jan-18,1816,1761,55,3.0
CN4605900000000,46,059,Hand County, SD,Feb-18,1810,1762,48,2.7
CN4605900000000,46,059,Hand County, SD,Mar-18,1847,1800,47,2.5
CN4605900000000,46,059,Hand County, SD,Apr-18(p),1768,1722,46,2.6
CN5514100000000,55,141,Wood County, WI,Mar-17,35178,33610,1568,4.5
CN5514100000000,55,141,Wood County, WI,Apr-17,35119,33909,1210,3.4
CN5514100000000,55,141,Wood County, WI,May-17,35076,33913,1163,3.3
CN5514100000000,55,141,Wood County, WI,Jun-17,35981,34498,1483,4.1
CN5514100000000,55,141,Wood County, WI,Jul-17,35432,34044,1388,3.9
CN5514100000000,55,141,Wood County, WI,Aug-17,34990,33637,1353,3.9
CN5514100000000,55,141,Wood County, WI,Sep-17,35263,34154,1109,3.1
CN5514100000000,55,141,Wood County, WI,Oct-17,35338,34326,1012,2.9
CN5514100000000,55,141,Wood County, WI,Nov-17,35390,34338,1052,3.0
CN5514100000000,55,141,Wood County, WI,Dec-17,35350,34250,1100,3.1
CN5514100000000,55,141,Wood County, WI,Jan-18,35249,33927,1322,3.8
CN5514100000000,55,141,Wood County, WI,Feb-18,35322,33858,1464,4.1
CN5514100000000,55,141,Wood County, WI,Mar-18,35562,34101,1461,4.1
CN5514100000000,55,141,Wood County, WI,Apr-18(p),35957,34765,1192,3.3
CN3705900000000,37,059,Davie County, NC,Mar-17,20423,19609,814,4.0
CN3705900000000,37,059,Davie County, NC,Apr-17,20300,19574,726,3.6
CN3705900000000,37,059,Davie County, NC,May-17,20286,19523,763,3.8
CN3705900000000,37,059,Davie County, NC,Jun-17,20264,19447,817,4.0
CN3705900000000,37,059,Davie County, NC,Jul-17,20435,19573,862,4.2
CN3705900000000,37,059,Davie County, NC,Aug-17,20185,19327,858,4.3
CN3705900000000,37,059,Davie County, NC,Sep-17,20518,19737,781,3.8
CN3705900000000,37,059,Davie County, NC,Oct-17,20449,19667,782,3.8
CN3705900000000,37,059,Davie County, NC,Nov-17,20391,19557,834,4.1
CN3705900000000,37,059,Davie County, NC,Dec-17,20291,19466,825,4.1
CN3705900000000,37,059,Davie County, NC,Jan-18,20362,19506,856,4.2
CN3705900000000,37,059,Davie County, NC,Feb-18,20528,19715,813,4.0
CN3705900000000,37,059,Davie County, NC,Mar-18,20554,19772,782,3.8
CN3705900000000,37,059,Davie County, NC,Apr-18(p),20565,19895,670,3.3
CN1800900000000,18,009,Blackford County, IN,Mar-17,5383,5147,236,4.4
CN1800900000000,18,009,Blackford County, IN,Apr-17,5385,5192,193,3.6
CN1800900000000,18,009,Blackford County, IN,May-17,5346,5155,191,3.6
CN1800900000000,18,009,Blackford County, IN,Jun-17,5438,5238,200,3.7
CN1800900000000,18,009,Blackford County, IN,Jul-17,5502,5299,203,3.7
CN1800900000000,18,009,Blackford County, IN,Aug-17,5444,5213,231,4.2
CN1800900000000,18,009,Blackford County, IN,Sep-17,5335,5138,197,3.7
CN1800900000000,18,009,Blackford County, IN,Oct-17,5367,5180,187,3.5
CN1800900000000,18,009,Blackford County, IN,Nov-17,5317,5128,189,3.6
CN1800900000000,18,009,Blackford County, IN,Dec-17,5265,5082,183,3.5
CN1800900000000,18,009,Blackford County, IN,Jan-18,5261,5043,218,4.1
CN1800900000000,18,009,Blackford County, IN,Feb-18,5336,5093,243,4.6
CN1800900000000,18,009,Blackford County, IN,Mar-18,5379,5184,195,3.6
CN1800900000000,18,009,Blackford County, IN,Apr-18(p),5452,5268,184,3.4
CN7212100000000,72,121,Sabana Grande Municipio, PR,Mar-17,6578,5525,1053,16.0
CN7212100000000,72,121,Sabana Grande Municipio, PR,Apr-17,6423,5309,1114,17.3
CN7212100000000,72,121,Sabana Grande Municipio, PR,May-17,6426,5414,1012,15.7
CN7212100000000,72,121,Sabana Grande Municipio, PR,Jun-17,6432,5435,997,15.5
CN7212100000000,72,121,Sabana Grande Municipio, PR,Jul-17,6473,5323,1150,17.8
CN7212100000000,72,121,Sabana Grande Municipio, PR,Aug-17,6481,5244,1237,19.1
CN7212100000000,72,121,Sabana Grande Municipio, PR,Sep-17(y),6385,5225,1160,18.2
CN7212100000000,72,121,Sabana Grande Municipio, PR,Oct-17,6272,5052,1220,19.5
CN7212100000000,72,121,Sabana Grande Municipio, PR,Nov-17,6302,5342,960,15.2
CN7212100000000,72,121,Sabana Grande Municipio, PR,Dec-17,6335,5394,941,14.9
CN7212100000000,72,121,Sabana Grande Municipio, PR,Jan-18,6266,5259,1007,16.1
CN7212100000000,72,121,Sabana Grande Municipio, PR,Feb-18,6017,5120,897,14.9
CN7212100000000,72,121,Sabana Grande Municipio, PR,Mar-18,6071,5169,902,14.9
CN7212100000000,72,121,Sabana Grande Municipio, PR,Apr-18(p),6061,5200,861,14.2
CN1711900000000,17,119,Madison County, IL,Mar-17,133379,127073,6306,4.7
CN1711900000000,17,119,Madison County, IL,Apr-17,133614,128017,5597,4.2
CN1711900000000,17,119,Madison County, IL,May-17,132373,126823,5550,4.2
CN1711900000000,17,119,Madison County, IL,Jun-17,133930,127591,6339,4.7
CN1711900000000,17,119,Madison County, IL,Jul-17,134320,127684,6636,4.9
CN1711900000000,17,119,Madison County, IL,Aug-17,133164,126646,6518,4.9
CN1711900000000,17,119,Madison County, IL,Sep-17,133242,127429,5813,4.4
CN1711900000000,17,119,Madison County, IL,Oct-17,133147,127655,5492,4.1
CN1711900000000,17,119,Madison County, IL,Nov-17,133522,127913,5609,4.2
CN1711900000000,17,119,Madison County, IL,Dec-17,132522,127178,5344,4.0
CN1711900000000,17,119,Madison County, IL,Jan-18,132051,126321,5730,4.3
CN1711900000000,17,119,Madison County, IL,Feb-18,133294,128113,5181,3.9
CN1711900000000,17,119,Madison County, IL,Mar-18,135411,129995,5416,4.0
CN1711900000000,17,119,Madison County, IL,Apr-18(p),135655,131092,4563,3.4
CN2915900000000,29,159,Pettis County, MO,Mar-17,20462,19584,878,4.3
CN2915900000000,29,159,Pettis County, MO,Apr-17,20700,19922,778,3.8
CN2915900000000,29,159,Pettis County, MO,May-17,20447,19659,788,3.9
CN2915900000000,29,159,Pettis County, MO,Jun-17,20665,19666,999,4.8
CN2915900000000,29,159,Pettis County, MO,Jul-17,20091,19024,1067,5.3
CN2915900000000,29,159,Pettis County, MO,Aug-17,20580,19521,1059,5.1
CN2915900000000,29,159,Pettis County, MO,Sep-17,20363,19640,723,3.6
CN2915900000000,29,159,Pettis County, MO,Oct-17,20286,19717,569,2.8
CN2915900000000,29,159,Pettis County, MO,Nov-17,20297,19556,741,3.7
CN2915900000000,29,159,Pettis County, MO,Dec-17,20211,19440,771,3.8
CN2915900000000,29,159,Pettis County, MO,Jan-18,19898,18990,908,4.6
CN2915900000000,29,159,Pettis County, MO,Feb-18,20220,19341,879,4.3
CN2915900000000,29,159,Pettis County, MO,Mar-18,20876,19400,1476,7.1
CN2915900000000,29,159,Pettis County, MO,Apr-18(p),20903,19712,1191,5.7
CN4814700000000,48,147,Fannin County, TX,Mar-17,15985,15406,579,3.6
CN4814700000000,48,147,Fannin County, TX,Apr-17,15971,15454,517,3.2
CN4814700000000,48,147,Fannin County, TX,May-17,15976,15448,528,3.3
CN4814700000000,48,147,Fannin County, TX,Jun-17,15921,15369,552,3.5
CN4814700000000,48,147,Fannin County, TX,Jul-17,16024,15475,549,3.4
CN4814700000000,48,147,Fannin County, TX,Aug-17,15986,15439,547,3.4
CN4814700000000,48,147,Fannin County, TX,Sep-17,16022,15544,478,3.0
CN4814700000000,48,147,Fannin County, TX,Oct-17,15889,15449,440,2.8
CN4814700000000,48,147,Fannin County, TX,Nov-17,15933,15471,462,2.9
CN4814700000000,48,147,Fannin County, TX,Dec-17,15894,15442,452,2.8
CN4814700000000,48,147,Fannin County, TX,Jan-18,16024,15499,525,3.3
CN4814700000000,48,147,Fannin County, TX,Feb-18,16299,15766,533,3.3
CN4814700000000,48,147,Fannin County, TX,Mar-18,16372,15835,537,3.3
CN4814700000000,48,147,Fannin County, TX,Apr-18(p),16227,15727,500,3.1
CN3909700000000,39,097,Madison County, OH,Mar-17,20729,19922,807,3.9
CN3909700000000,39,097,Madison County, OH,Apr-17,20649,19942,707,3.4
CN3909700000000,39,097,Madison County, OH,May-17,20673,19949,724,3.5
CN3909700000000,39,097,Madison County, OH,Jun-17,20830,19991,839,4.0
CN3909700000000,39,097,Madison County, OH,Jul-17,20828,19978,850,4.1
CN3909700000000,39,097,Madison County, OH,Aug-17,21017,20190,827,3.9
CN3909700000000,39,097,Madison County, OH,Sep-17,20709,19967,742,3.6
CN3909700000000,39,097,Madison County, OH,Oct-17,20638,19942,696,3.4
CN3909700000000,39,097,Madison County, OH,Nov-17,20681,19962,719,3.5
CN3909700000000,39,097,Madison County, OH,Dec-17,20506,19790,716,3.5
CN3909700000000,39,097,Madison County, OH,Jan-18,20205,19414,791,3.9
CN3909700000000,39,097,Madison County, OH,Feb-18,20626,19871,755,3.7
CN3909700000000,39,097,Madison County, OH,Mar-18,20962,20242,720,3.4
CN3909700000000,39,097,Madison County, OH,Apr-18(p),20780,20104,676,3.3
CN5119100000000,51,191,Washington County, VA,Mar-17,27081,25903,1178,4.3
CN5119100000000,51,191,Washington County, VA,Apr-17,27107,26084,1023,3.8
CN5119100000000,51,191,Washington County, VA,May-17,27133,26062,1071,3.9
CN5119100000000,51,191,Washington County, VA,Jun-17,26877,25729,1148,4.3
CN5119100000000,51,191,Washington County, VA,Jul-17,26954,25777,1177,4.4
CN5119100000000,51,191,Washington County, VA,Aug-17,26899,25768,1131,4.2
CN5119100000000,51,191,Washington County, VA,Sep-17,27031,25996,1035,3.8
CN5119100000000,51,191,Washington County, VA,Oct-17,26805,25848,957,3.6
CN5119100000000,51,191,Washington County, VA,Nov-17,26682,25735,947,3.5
CN5119100000000,51,191,Washington County, VA,Dec-17,26622,25676,946,3.6
CN5119100000000,51,191,Washington County, VA,Jan-18,26747,25637,1110,4.1
CN5119100000000,51,191,Washington County, VA,Feb-18,27000,26002,998,3.7
CN5119100000000,51,191,Washington County, VA,Mar-18,27157,26142,1015,3.7
CN5119100000000,51,191,Washington County, VA,Apr-18(p),27217,26378,839,3.1
CN3903300000000,39,033,Crawford County, OH,Mar-17,19205,18097,1108,5.8
CN3903300000000,39,033,Crawford County, OH,Apr-17,19139,18099,1040,5.4
CN3903300000000,39,033,Crawford County, OH,May-17,19180,18210,970,5.1
CN3903300000000,39,033,Crawford County, OH,Jun-17,19304,18117,1187,6.1
CN3903300000000,39,033,Crawford County, OH,Jul-17,19184,17989,1195,6.2
CN3903300000000,39,033,Crawford County, OH,Aug-17,19190,18122,1068,5.6
CN3903300000000,39,033,Crawford County, OH,Sep-17,18908,17888,1020,5.4
CN3903300000000,39,033,Crawford County, OH,Oct-17,18773,17847,926,4.9
CN3903300000000,39,033,Crawford County, OH,Nov-17,18675,17747,928,5.0
CN3903300000000,39,033,Crawford County, OH,Dec-17,18544,17557,987,5.3
CN3903300000000,39,033,Crawford County, OH,Jan-18,18354,17258,1096,6.0
CN3903300000000,39,033,Crawford County, OH,Feb-18,18735,17744,991,5.3
CN3903300000000,39,033,Crawford County, OH,Mar-18,18969,18065,904,4.8
CN3903300000000,39,033,Crawford County, OH,Apr-18(p),18815,17972,843,4.5
CN0606100000000,06,061,Placer County, CA,Mar-17,181611,174036,7575,4.2
CN0606100000000,06,061,Placer County, CA,Apr-17,180689,173831,6858,3.8
CN0606100000000,06,061,Placer County, CA,May-17,180644,174195,6449,3.6
CN0606100000000,06,061,Placer County, CA,Jun-17,181797,174519,7278,4.0
CN0606100000000,06,061,Placer County, CA,Jul-17,183894,176210,7684,4.2
CN0606100000000,06,061,Placer County, CA,Aug-17,183222,175860,7362,4.0
CN0606100000000,06,061,Placer County, CA,Sep-17,183680,177279,6401,3.5
CN0606100000000,06,061,Placer County, CA,Oct-17,182815,176605,6210,3.4
CN0606100000000,06,061,Placer County, CA,Nov-17,183196,177168,6028,3.3
CN0606100000000,06,061,Placer County, CA,Dec-17,182619,176781,5838,3.2
CN0606100000000,06,061,Placer County, CA,Jan-18,183207,176759,6448,3.5
CN0606100000000,06,061,Placer County, CA,Feb-18,183579,177283,6296,3.4
CN0606100000000,06,061,Placer County, CA,Mar-18,182247,176389,5858,3.2
CN0606100000000,06,061,Placer County, CA,Apr-18(p),180792,175521,5271,2.9
CN2802100000000,28,021,Claiborne County, MS,Mar-17,3017,2711,306,10.1
CN2802100000000,28,021,Claiborne County, MS,Apr-17,3021,2741,280,9.3
CN2802100000000,28,021,Claiborne County, MS,May-17,3038,2739,299,9.8
CN2802100000000,28,021,Claiborne County, MS,Jun-17,3115,2745,370,11.9
CN2802100000000,28,021,Claiborne County, MS,Jul-17,3115,2770,345,11.1
CN2802100000000,28,021,Claiborne County, MS,Aug-17,3039,2733,306,10.1
CN2802100000000,28,021,Claiborne County, MS,Sep-17,3018,2752,266,8.8
CN2802100000000,28,021,Claiborne County, MS,Oct-17,2963,2731,232,7.8
CN2802100000000,28,021,Claiborne County, MS,Nov-17,2968,2734,234,7.9
CN2802100000000,28,021,Claiborne County, MS,Dec-17,3003,2748,255,8.5
CN2802100000000,28,021,Claiborne County, MS,Jan-18,2957,2700,257,8.7
CN2802100000000,28,021,Claiborne County, MS,Feb-18,3012,2749,263,8.7
CN2802100000000,28,021,Claiborne County, MS,Mar-18,3023,2771,252,8.3
CN2802100000000,28,021,Claiborne County, MS,Apr-18(p),3032,2794,238,7.8
CN1802100000000,18,021,Clay County, IN,Mar-17,12245,11756,489,4.0
CN1802100000000,18,021,Clay County, IN,Apr-17,12293,11897,396,3.2
CN1802100000000,18,021,Clay County, IN,May-17,12353,11931,422,3.4
CN1802100000000,18,021,Clay County, IN,Jun-17,12292,11836,456,3.7
CN1802100000000,18,021,Clay County, IN,Jul-17,12206,11737,469,3.8
CN1802100000000,18,021,Clay County, IN,Aug-17,12094,11595,499,4.1
CN1802100000000,18,021,Clay County, IN,Sep-17,12192,11779,413,3.4
CN1802100000000,18,021,Clay County, IN,Oct-17,12132,11740,392,3.2
CN1802100000000,18,021,Clay County, IN,Nov-17,12127,11726,401,3.3
CN1802100000000,18,021,Clay County, IN,Dec-17,12114,11715,399,3.3
CN1802100000000,18,021,Clay County, IN,Jan-18,11959,11485,474,4.0
CN1802100000000,18,021,Clay County, IN,Feb-18,12183,11677,506,4.2
CN1802100000000,18,021,Clay County, IN,Mar-18,12289,11850,439,3.6
CN1802100000000,18,021,Clay County, IN,Apr-18(p),12293,11908,385,3.1
CN7210900000000,72,109,Patillas Municipio, PR,Mar-17,4891,3850,1041,21.3
CN7210900000000,72,109,Patillas Municipio, PR,Apr-17,4806,3772,1034,21.5
CN7210900000000,72,109,Patillas Municipio, PR,May-17,4679,3780,899,19.2
CN7210900000000,72,109,Patillas Municipio, PR,Jun-17,4492,3724,768,17.1
CN7210900000000,72,109,Patillas Municipio, PR,Jul-17,4598,3763,835,18.2
CN7210900000000,72,109,Patillas Municipio, PR,Aug-17,4609,3711,898,19.5
CN7210900000000,72,109,Patillas Municipio, PR,Sep-17(y),4541,3726,815,17.9
CN7210900000000,72,109,Patillas Municipio, PR,Oct-17,4374,3596,778,17.8
CN7210900000000,72,109,Patillas Municipio, PR,Nov-17,4671,3789,882,18.9
CN7210900000000,72,109,Patillas Municipio, PR,Dec-17,4768,3825,943,19.8
CN7210900000000,72,109,Patillas Municipio, PR,Jan-18,4797,3756,1041,21.7
CN7210900000000,72,109,Patillas Municipio, PR,Feb-18,4686,3747,939,20.0
CN7210900000000,72,109,Patillas Municipio, PR,Mar-18,4692,3768,924,19.7
CN7210900000000,72,109,Patillas Municipio, PR,Apr-18(p),4649,3802,847,18.2
CN0400700000000,04,007,Gila County, AZ,Mar-17,21023,19662,1361,6.5
CN0400700000000,04,007,Gila County, AZ,Apr-17,21371,20093,1278,6.0
CN0400700000000,04,007,Gila County, AZ,May-17,21572,20355,1217,5.6
CN0400700000000,04,007,Gila County, AZ,Jun-17,21744,20455,1289,5.9
CN0400700000000,04,007,Gila County, AZ,Jul-17,21385,20090,1295,6.1
CN0400700000000,04,007,Gila County, AZ,Aug-17,21636,20335,1301,6.0
CN0400700000000,04,007,Gila County, AZ,Sep-17,21571,20306,1265,5.9
CN0400700000000,04,007,Gila County, AZ,Oct-17,21361,20165,1196,5.6
CN0400700000000,04,007,Gila County, AZ,Nov-17,21308,20121,1187,5.6
CN0400700000000,04,007,Gila County, AZ,Dec-17,21357,20127,1230,5.8
CN0400700000000,04,007,Gila County, AZ,Jan-18,21278,19903,1375,6.5
CN0400700000000,04,007,Gila County, AZ,Feb-18,21409,20049,1360,6.4
CN0400700000000,04,007,Gila County, AZ,Mar-18,21435,20188,1247,5.8
CN0400700000000,04,007,Gila County, AZ,Apr-18(p),21475,20309,1166,5.4
CN0103500000000,01,035,Conecuh County, AL,Mar-17,4461,4154,307,6.9
CN0103500000000,01,035,Conecuh County, AL,Apr-17,4424,4168,256,5.8
CN0103500000000,01,035,Conecuh County, AL,May-17,4387,4154,233,5.3
CN0103500000000,01,035,Conecuh County, AL,Jun-17,4515,4206,309,6.8
CN0103500000000,01,035,Conecuh County, AL,Jul-17,4505,4210,295,6.5
CN0103500000000,01,035,Conecuh County, AL,Aug-17,4467,4209,258,5.8
CN0103500000000,01,035,Conecuh County, AL,Sep-17,4488,4263,225,5.0
CN0103500000000,01,035,Conecuh County, AL,Oct-17,4441,4231,210,4.7
CN0103500000000,01,035,Conecuh County, AL,Nov-17,4380,4181,199,4.5
CN0103500000000,01,035,Conecuh County, AL,Dec-17,4352,4146,206,4.7
CN0103500000000,01,035,Conecuh County, AL,Jan-18,4299,4068,231,5.4
CN0103500000000,01,035,Conecuh County, AL,Feb-18,4398,4153,245,5.6
CN0103500000000,01,035,Conecuh County, AL,Mar-18,4418,4191,227,5.1
CN0103500000000,01,035,Conecuh County, AL,Apr-18(p),4461,4241,220,4.9
CN2002300000000,20,023,Cheyenne County, KS,Mar-17,1268,1231,37,2.9
CN2002300000000,20,023,Cheyenne County, KS,Apr-17,1255,1220,35,2.8
CN2002300000000,20,023,Cheyenne County, KS,May-17,1238,1201,37,3.0
CN2002300000000,20,023,Cheyenne County, KS,Jun-17,1360,1325,35,2.6
CN2002300000000,20,023,Cheyenne County, KS,Jul-17,1373,1335,38,2.8
CN2002300000000,20,023,Cheyenne County, KS,Aug-17,1345,1308,37,2.8
CN2002300000000,20,023,Cheyenne County, KS,Sep-17,1339,1308,31,2.3
CN2002300000000,20,023,Cheyenne County, KS,Oct-17,1367,1340,27,2.0
CN2002300000000,20,023,Cheyenne County, KS,Nov-17,1334,1305,29,2.2
CN2002300000000,20,023,Cheyenne County, KS,Dec-17,1366,1338,28,2.0
CN2002300000000,20,023,Cheyenne County, KS,Jan-18,1317,1290,27,2.1
CN2002300000000,20,023,Cheyenne County, KS,Feb-18,1309,1281,28,2.1
CN2002300000000,20,023,Cheyenne County, KS,Mar-18,1283,1254,29,2.3
CN2002300000000,20,023,Cheyenne County, KS,Apr-18(p),1197,1167,30,2.5
CN2601100000000,26,011,Arenac County, MI,Mar-17,6045,5434,611,10.1
CN2601100000000,26,011,Arenac County, MI,Apr-17,6020,5552,468,7.8
CN2601100000000,26,011,Arenac County, MI,May-17,6119,5719,400,6.5
CN2601100000000,26,011,Arenac County, MI,Jun-17,6268,5841,427,6.8
CN2601100000000,26,011,Arenac County, MI,Jul-17,6290,5778,512,8.1
CN2601100000000,26,011,Arenac County, MI,Aug-17,6171,5719,452,7.3
CN2601100000000,26,011,Arenac County, MI,Sep-17,6123,5735,388,6.3
CN2601100000000,26,011,Arenac County, MI,Oct-17,5979,5603,376,6.3
CN2601100000000,26,011,Arenac County, MI,Nov-17,5997,5566,431,7.2
CN2601100000000,26,011,Arenac County, MI,Dec-17,6064,5512,552,9.1
CN2601100000000,26,011,Arenac County, MI,Jan-18,6017,5340,677,11.3
CN2601100000000,26,011,Arenac County, MI,Feb-18,6094,5379,715,11.7
CN2601100000000,26,011,Arenac County, MI,Mar-18,6074,5449,625,10.3
CN2601100000000,26,011,Arenac County, MI,Apr-18(p),6098,5564,534,8.8
CN4003700000000,40,037,Creek County, OK,Mar-17,31330,29732,1598,5.1
CN4003700000000,40,037,Creek County, OK,Apr-17,31140,29682,1458,4.7
CN4003700000000,40,037,Creek County, OK,May-17,31254,29642,1612,5.2
CN4003700000000,40,037,Creek County, OK,Jun-17,31807,30089,1718,5.4
CN4003700000000,40,037,Creek County, OK,Jul-17,31869,30250,1619,5.1
CN4003700000000,40,037,Creek County, OK,Aug-17,31399,29811,1588,5.1
CN4003700000000,40,037,Creek County, OK,Sep-17,31595,30093,1502,4.8
CN4003700000000,40,037,Creek County, OK,Oct-17,31810,30314,1496,4.7
CN4003700000000,40,037,Creek County, OK,Nov-17,32007,30559,1448,4.5
CN4003700000000,40,037,Creek County, OK,Dec-17,31848,30396,1452,4.6
CN4003700000000,40,037,Creek County, OK,Jan-18,31606,30059,1547,4.9
CN4003700000000,40,037,Creek County, OK,Feb-18,31674,30238,1436,4.5
CN4003700000000,40,037,Creek County, OK,Mar-18,31828,30446,1382,4.3
CN4003700000000,40,037,Creek County, OK,Apr-18(p),31879,30527,1352,4.2
CN2300900000000,23,009,Hancock County, ME,Mar-17,27739,26190,1549,5.6
CN2300900000000,23,009,Hancock County, ME,Apr-17,28274,27068,1206,4.3
CN2300900000000,23,009,Hancock County, ME,May-17,29261,28219,1042,3.6
CN2300900000000,23,009,Hancock County, ME,Jun-17,31228,30297,931,3.0
CN2300900000000,23,009,Hancock County, ME,Jul-17,32104,31188,916,2.9
CN2300900000000,23,009,Hancock County, ME,Aug-17,32613,31829,784,2.4
CN2300900000000,23,009,Hancock County, ME,Sep-17,30787,30030,757,2.5
CN2300900000000,23,009,Hancock County, ME,Oct-17,30175,29417,758,2.5
CN2300900000000,23,009,Hancock County, ME,Nov-17,28359,27318,1041,3.7
CN2300900000000,23,009,Hancock County, ME,Dec-17,28000,26944,1056,3.8
CN2300900000000,23,009,Hancock County, ME,Jan-18,27119,25738,1381,5.1
CN2300900000000,23,009,Hancock County, ME,Feb-18,27621,26254,1367,4.9
CN2300900000000,23,009,Hancock County, ME,Mar-18,27727,26515,1212,4.4
CN2300900000000,23,009,Hancock County, ME,Apr-18(p),28335,27243,1092,3.9
CN3114100000000,31,141,Platte County, NE,Mar-17,17060,16530,530,3.1
CN3114100000000,31,141,Platte County, NE,Apr-17,17184,16696,488,2.8
CN3114100000000,31,141,Platte County, NE,May-17,17119,16632,487,2.8
CN3114100000000,31,141,Platte County, NE,Jun-17,17443,16910,533,3.1
CN3114100000000,31,141,Platte County, NE,Jul-17,17500,16987,513,2.9
CN3114100000000,31,141,Platte County, NE,Aug-17,17348,16878,470,2.7
CN3114100000000,31,141,Platte County, NE,Sep-17,17103,16677,426,2.5
CN3114100000000,31,141,Platte County, NE,Oct-17,17116,16698,418,2.4
CN3114100000000,31,141,Platte County, NE,Nov-17,17076,16665,411,2.4
CN3114100000000,31,141,Platte County, NE,Dec-17,17005,16546,459,2.7
CN3114100000000,31,141,Platte County, NE,Jan-18,17211,16748,463,2.7
CN3114100000000,31,141,Platte County, NE,Feb-18,17363,16899,464,2.7
CN3114100000000,31,141,Platte County, NE,Mar-18,17237,16763,474,2.7
CN3114100000000,31,141,Platte County, NE,Apr-18(p),17256,16768,488,2.8
CN4506300000000,45,063,Lexington County, SC,Mar-17,148042,143137,4905,3.3
CN4506300000000,45,063,Lexington County, SC,Apr-17,148057,143543,4514,3.0
CN4506300000000,45,063,Lexington County, SC,May-17,148276,143519,4757,3.2
CN4506300000000,45,063,Lexington County, SC,Jun-17,149484,143810,5674,3.8
CN4506300000000,45,063,Lexington County, SC,Jul-17,149680,144180,5500,3.7
CN4506300000000,45,063,Lexington County, SC,Aug-17,147715,141550,6165,4.2
CN4506300000000,45,063,Lexington County, SC,Sep-17,147445,141967,5478,3.7
CN4506300000000,45,063,Lexington County, SC,Oct-17,147384,141980,5404,3.7
CN4506300000000,45,063,Lexington County, SC,Nov-17,146334,141173,5161,3.5
CN4506300000000,45,063,Lexington County, SC,Dec-17,146160,140908,5252,3.6
CN4506300000000,45,063,Lexington County, SC,Jan-18,146364,140178,6186,4.2
CN4506300000000,45,063,Lexington County, SC,Feb-18,147577,141885,5692,3.9
CN4506300000000,45,063,Lexington County, SC,Mar-18,147252,142178,5074,3.4
CN4506300000000,45,063,Lexington County, SC,Apr-18(p),145614,142173,3441,2.4
CN5405100000000,54,051,Marshall County, WV,Mar-17,13794,12797,997,7.2
CN5405100000000,54,051,Marshall County, WV,Apr-17,13868,13045,823,5.9
CN5405100000000,54,051,Marshall County, WV,May-17,13831,13128,703,5.1
CN5405100000000,54,051,Marshall County, WV,Jun-17,13972,13211,761,5.4
CN5405100000000,54,051,Marshall County, WV,Jul-17,13945,13209,736,5.3
CN5405100000000,54,051,Marshall County, WV,Aug-17,13822,13029,793,5.7
CN5405100000000,54,051,Marshall County, WV,Sep-17,13777,13099,678,4.9
CN5405100000000,54,051,Marshall County, WV,Oct-17,13802,13095,707,5.1
CN5405100000000,54,051,Marshall County, WV,Nov-17,13803,13024,779,5.6
CN5405100000000,54,051,Marshall County, WV,Dec-17,13771,12950,821,6.0
CN5405100000000,54,051,Marshall County, WV,Jan-18,13807,12754,1053,7.6
CN5405100000000,54,051,Marshall County, WV,Feb-18,13978,12836,1142,8.2
CN5405100000000,54,051,Marshall County, WV,Mar-18,13793,12824,969,7.0
CN5405100000000,54,051,Marshall County, WV,Apr-18(p),13873,12987,886,6.4
CN3708700000000,37,087,Haywood County, NC,Mar-17,28904,27693,1211,4.2
CN3708700000000,37,087,Haywood County, NC,Apr-17,28805,27754,1051,3.6
CN3708700000000,37,087,Haywood County, NC,May-17,28955,27840,1115,3.9
CN3708700000000,37,087,Haywood County, NC,Jun-17,28969,27813,1156,4.0
CN3708700000000,37,087,Haywood County, NC,Jul-17,29255,28019,1236,4.2
CN3708700000000,37,087,Haywood County, NC,Aug-17,28908,27659,1249,4.3
CN3708700000000,37,087,Haywood County, NC,Sep-17,29380,28259,1121,3.8
CN3708700000000,37,087,Haywood County, NC,Oct-17,29306,28218,1088,3.7
CN3708700000000,37,087,Haywood County, NC,Nov-17,29307,28161,1146,3.9
CN3708700000000,37,087,Haywood County, NC,Dec-17,29046,27949,1097,3.8
CN3708700000000,37,087,Haywood County, NC,Jan-18,29163,27945,1218,4.2
CN3708700000000,37,087,Haywood County, NC,Feb-18,29278,28091,1187,4.1
CN3708700000000,37,087,Haywood County, NC,Mar-18,29315,28171,1144,3.9
CN3708700000000,37,087,Haywood County, NC,Apr-18(p),29317,28361,956,3.3
CN1315100000000,13,151,Henry County, GA,Mar-17,111626,106152,5474,4.9
CN1315100000000,13,151,Henry County, GA,Apr-17,111446,106252,5194,4.7
CN1315100000000,13,151,Henry County, GA,May-17,111789,106503,5286,4.7
CN1315100000000,13,151,Henry County, GA,Jun-17,112187,106392,5795,5.2
CN1315100000000,13,151,Henry County, GA,Jul-17,112939,107137,5802,5.1
CN1315100000000,13,151,Henry County, GA,Aug-17,112434,106715,5719,5.1
CN1315100000000,13,151,Henry County, GA,Sep-17,113355,108109,5246,4.6
CN1315100000000,13,151,Henry County, GA,Oct-17,112791,107720,5071,4.5
CN1315100000000,13,151,Henry County, GA,Nov-17,113108,108179,4929,4.4
CN1315100000000,13,151,Henry County, GA,Dec-17,113123,108123,5000,4.4
CN1315100000000,13,151,Henry County, GA,Jan-18,113096,107825,5271,4.7
CN1315100000000,13,151,Henry County, GA,Feb-18,115011,109656,5355,4.7
CN1315100000000,13,151,Henry County, GA,Mar-18,115034,110097,4937,4.3
CN1315100000000,13,151,Henry County, GA,Apr-18(p),113984,109592,4392,3.9
CN2920100000000,29,201,Scott County, MO,Mar-17,19844,18905,939,4.7
CN2920100000000,29,201,Scott County, MO,Apr-17,20207,19317,890,4.4
CN2920100000000,29,201,Scott County, MO,May-17,19950,19091,859,4.3
CN2920100000000,29,201,Scott County, MO,Jun-17,20122,19083,1039,5.2
CN2920100000000,29,201,Scott County, MO,Jul-17,19789,18704,1085,5.5
CN2920100000000,29,201,Scott County, MO,Aug-17,19710,18756,954,4.8
CN2920100000000,29,201,Scott County, MO,Sep-17,19664,18906,758,3.9
CN2920100000000,29,201,Scott County, MO,Oct-17,19518,18909,609,3.1
CN2920100000000,29,201,Scott County, MO,Nov-17,19544,18836,708,3.6
CN2920100000000,29,201,Scott County, MO,Dec-17,19479,18720,759,3.9
CN2920100000000,29,201,Scott County, MO,Jan-18,19382,18585,797,4.1
CN2920100000000,29,201,Scott County, MO,Feb-18,19778,18963,815,4.1
CN2920100000000,29,201,Scott County, MO,Mar-18,19728,18957,771,3.9
CN2920100000000,29,201,Scott County, MO,Apr-18(p),19914,19209,705,3.5
CN4708700000000,47,087,Jackson County, TN,Mar-17,4609,4323,286,6.2
CN4708700000000,47,087,Jackson County, TN,Apr-17,4597,4354,243,5.3
CN4708700000000,47,087,Jackson County, TN,May-17,4580,4357,223,4.9
CN4708700000000,47,087,Jackson County, TN,Jun-17,4520,4266,254,5.6
CN4708700000000,47,087,Jackson County, TN,Jul-17,4536,4279,257,5.7
CN4708700000000,47,087,Jackson County, TN,Aug-17,4600,4377,223,4.8
CN4708700000000,47,087,Jackson County, TN,Sep-17,4634,4437,197,4.3
CN4708700000000,47,087,Jackson County, TN,Oct-17,4587,4398,189,4.1
CN4708700000000,47,087,Jackson County, TN,Nov-17,4585,4394,191,4.2
CN4708700000000,47,087,Jackson County, TN,Dec-17,4577,4391,186,4.1
CN4708700000000,47,087,Jackson County, TN,Jan-18,4574,4340,234,5.1
CN4708700000000,47,087,Jackson County, TN,Feb-18,4669,4415,254,5.4
CN4708700000000,47,087,Jackson County, TN,Mar-18,4628,4409,219,4.7
CN4708700000000,47,087,Jackson County, TN,Apr-18(p),4620,4450,170,3.7
CN0109900000000,01,099,Monroe County, AL,Mar-17,7318,6746,572,7.8
CN0109900000000,01,099,Monroe County, AL,Apr-17,7144,6677,467,6.5
CN0109900000000,01,099,Monroe County, AL,May-17,7064,6643,421,6.0
CN0109900000000,01,099,Monroe County, AL,Jun-17,7255,6717,538,7.4
CN0109900000000,01,099,Monroe County, AL,Jul-17,7190,6688,502,7.0
CN0109900000000,01,099,Monroe County, AL,Aug-17,7115,6661,454,6.4
CN0109900000000,01,099,Monroe County, AL,Sep-17,7152,6757,395,5.5
CN0109900000000,01,099,Monroe County, AL,Oct-17,7090,6700,390,5.5
CN0109900000000,01,099,Monroe County, AL,Nov-17,7015,6649,366,5.2
CN0109900000000,01,099,Monroe County, AL,Dec-17,6990,6595,395,5.7
CN0109900000000,01,099,Monroe County, AL,Jan-18,6959,6504,455,6.5
CN0109900000000,01,099,Monroe County, AL,Feb-18,7079,6603,476,6.7
CN0109900000000,01,099,Monroe County, AL,Mar-18,7055,6608,447,6.3
CN0109900000000,01,099,Monroe County, AL,Apr-18(p),7074,6674,400,5.7
CN2008700000000,20,087,Jefferson County, KS,Mar-17,10105,9714,391,3.9
CN2008700000000,20,087,Jefferson County, KS,Apr-17,10004,9648,356,3.6
CN2008700000000,20,087,Jefferson County, KS,May-17,10007,9668,339,3.4
CN2008700000000,20,087,Jefferson County, KS,Jun-17,10188,9821,367,3.6
CN2008700000000,20,087,Jefferson County, KS,Jul-17,10361,9971,390,3.8
CN2008700000000,20,087,Jefferson County, KS,Aug-17,10196,9805,391,3.8
CN2008700000000,20,087,Jefferson County, KS,Sep-17,10030,9724,306,3.1
CN2008700000000,20,087,Jefferson County, KS,Oct-17,10007,9723,284,2.8
CN2008700000000,20,087,Jefferson County, KS,Nov-17,10059,9755,304,3.0
CN2008700000000,20,087,Jefferson County, KS,Dec-17,9977,9679,298,3.0
CN2008700000000,20,087,Jefferson County, KS,Jan-18,10053,9655,398,4.0
CN2008700000000,20,087,Jefferson County, KS,Feb-18,10060,9663,397,3.9
CN2008700000000,20,087,Jefferson County, KS,Mar-18,10013,9670,343,3.4
CN2008700000000,20,087,Jefferson County, KS,Apr-18(p),9922,9615,307,3.1
CN1910900000000,19,109,Kossuth County, IA,Mar-17,8701,8457,244,2.8
CN1910900000000,19,109,Kossuth County, IA,Apr-17,8836,8637,199,2.3
CN1910900000000,19,109,Kossuth County, IA,May-17,8960,8764,196,2.2
CN1910900000000,19,109,Kossuth County, IA,Jun-17,9090,8883,207,2.3
CN1910900000000,19,109,Kossuth County, IA,Jul-17,8948,8738,210,2.3
CN1910900000000,19,109,Kossuth County, IA,Aug-17,8677,8463,214,2.5
CN1910900000000,19,109,Kossuth County, IA,Sep-17,8635,8455,180,2.1
CN1910900000000,19,109,Kossuth County, IA,Oct-17,8593,8441,152,1.8
CN1910900000000,19,109,Kossuth County, IA,Nov-17,8472,8313,159,1.9
CN1910900000000,19,109,Kossuth County, IA,Dec-17,8516,8338,178,2.1
CN1910900000000,19,109,Kossuth County, IA,Jan-18,8412,8150,262,3.1
CN1910900000000,19,109,Kossuth County, IA,Feb-18,8414,8158,256,3.0
CN1910900000000,19,109,Kossuth County, IA,Mar-18,8333,8113,220,2.6
CN1910900000000,19,109,Kossuth County, IA,Apr-18(p),8376,8197,179,2.1
CN5501900000000,55,019,Clark County, WI,Mar-17,17711,17011,700,4.0
CN5501900000000,55,019,Clark County, WI,Apr-17,18029,17487,542,3.0
CN5501900000000,55,019,Clark County, WI,May-17,18124,17617,507,2.8
CN5501900000000,55,019,Clark County, WI,Jun-17,18826,18256,570,3.0
CN5501900000000,55,019,Clark County, WI,Jul-17,18012,17486,526,2.9
CN5501900000000,55,019,Clark County, WI,Aug-17,17579,17129,450,2.6
CN5501900000000,55,019,Clark County, WI,Sep-17,17744,17327,417,2.4
CN5501900000000,55,019,Clark County, WI,Oct-17,18056,17647,409,2.3
CN5501900000000,55,019,Clark County, WI,Nov-17,18281,17857,424,2.3
CN5501900000000,55,019,Clark County, WI,Dec-17,18466,17968,498,2.7
CN5501900000000,55,019,Clark County, WI,Jan-18,18418,17827,591,3.2
CN5501900000000,55,019,Clark County, WI,Feb-18,18077,17422,655,3.6
CN5501900000000,55,019,Clark County, WI,Mar-18,18418,17768,650,3.5
CN5501900000000,55,019,Clark County, WI,Apr-18(p),18642,18081,561,3.0
CN2501900000000,25,019,Nantucket County/town, MA,Mar-17,5722,5205,517,9.0
CN2501900000000,25,019,Nantucket County/town, MA,Apr-17,6088,5786,302,5.0
CN2501900000000,25,019,Nantucket County/town, MA,May-17,6923,6688,235,3.4
CN2501900000000,25,019,Nantucket County/town, MA,Jun-17,8523,8320,203,2.4
CN2501900000000,25,019,Nantucket County/town, MA,Jul-17,9511,9332,179,1.9
CN2501900000000,25,019,Nantucket County/town, MA,Aug-17,9532,9369,163,1.7
CN2501900000000,25,019,Nantucket County/town, MA,Sep-17,8023,7865,158,2.0
CN2501900000000,25,019,Nantucket County/town, MA,Oct-17,7131,6968,163,2.3
CN2501900000000,25,019,Nantucket County/town, MA,Nov-17,6377,6137,240,3.8
CN2501900000000,25,019,Nantucket County/town, MA,Dec-17,6298,5936,362,5.7
CN2501900000000,25,019,Nantucket County/town, MA,Jan-18,5828,5193,635,10.9
CN2501900000000,25,019,Nantucket County/town, MA,Feb-18,5804,5149,655,11.3
CN2501900000000,25,019,Nantucket County/town, MA,Mar-18,5873,5312,561,9.6
CN2501900000000,25,019,Nantucket County/town, MA,Apr-18(p),6352,6021,331,5.2
CN2713500000000,27,135,Roseau County, MN,Mar-17,8167,7727,440,5.4
CN2713500000000,27,135,Roseau County, MN,Apr-17,8124,7754,370,4.6
CN2713500000000,27,135,Roseau County, MN,May-17,8135,7851,284,3.5
CN2713500000000,27,135,Roseau County, MN,Jun-17,8260,7943,317,3.8
CN2713500000000,27,135,Roseau County, MN,Jul-17,8051,7750,301,3.7
CN2713500000000,27,135,Roseau County, MN,Aug-17,7925,7619,306,3.9
CN2713500000000,27,135,Roseau County, MN,Sep-17,7968,7720,248,3.1
CN2713500000000,27,135,Roseau County, MN,Oct-17,8001,7800,201,2.5
CN2713500000000,27,135,Roseau County, MN,Nov-17,8102,7773,329,4.1
CN2713500000000,27,135,Roseau County, MN,Dec-17,8097,7738,359,4.4
CN2713500000000,27,135,Roseau County, MN,Jan-18,8063,7592,471,5.8
CN2713500000000,27,135,Roseau County, MN,Feb-18,7997,7633,364,4.6
CN2713500000000,27,135,Roseau County, MN,Mar-18,8013,7628,385,4.8
CN2713500000000,27,135,Roseau County, MN,Apr-18(p),7967,7623,344,4.3
CN4400700000000,44,007,Providence County, RI,Mar-17,320741,304366,16375,5.1
CN4400700000000,44,007,Providence County, RI,Apr-17,320417,306283,14134,4.4
CN4400700000000,44,007,Providence County, RI,May-17,320827,306790,14037,4.4
CN4400700000000,44,007,Providence County, RI,Jun-17,326002,310902,15100,4.6
CN4400700000000,44,007,Providence County, RI,Jul-17,328266,311386,16880,5.1
CN4400700000000,44,007,Providence County, RI,Aug-17,327075,311008,16067,4.9
CN4400700000000,44,007,Providence County, RI,Sep-17,324697,310332,14365,4.4
CN4400700000000,44,007,Providence County, RI,Oct-17,325226,310779,14447,4.4
CN4400700000000,44,007,Providence County, RI,Nov-17,326597,311808,14789,4.5
CN4400700000000,44,007,Providence County, RI,Dec-17,325072,310691,14381,4.4
CN4400700000000,44,007,Providence County, RI,Jan-18,323502,305457,18045,5.6
CN4400700000000,44,007,Providence County, RI,Feb-18,324856,306873,17983,5.5
CN4400700000000,44,007,Providence County, RI,Mar-18,324644,308077,16567,5.1
CN4400700000000,44,007,Providence County, RI,Apr-18(p),324866,310714,14152,4.4
CN4612300000000,46,123,Tripp County, SD,Mar-17,2990,2899,91,3.0
CN4612300000000,46,123,Tripp County, SD,Apr-17,3038,2952,86,2.8
CN4612300000000,46,123,Tripp County, SD,May-17,3058,2975,83,2.7
CN4612300000000,46,123,Tripp County, SD,Jun-17,3187,3104,83,2.6
CN4612300000000,46,123,Tripp County, SD,Jul-17,3115,3036,79,2.5
CN4612300000000,46,123,Tripp County, SD,Aug-17,3033,2941,92,3.0
CN4612300000000,46,123,Tripp County, SD,Sep-17,2962,2876,86,2.9
CN4612300000000,46,123,Tripp County, SD,Oct-17,2948,2867,81,2.7
CN4612300000000,46,123,Tripp County, SD,Nov-17,2942,2853,89,3.0
CN4612300000000,46,123,Tripp County, SD,Dec-17,2990,2895,95,3.2
CN4612300000000,46,123,Tripp County, SD,Jan-18,3003,2897,106,3.5
CN4612300000000,46,123,Tripp County, SD,Feb-18,3004,2906,98,3.3
CN4612300000000,46,123,Tripp County, SD,Mar-18,3044,2953,91,3.0
CN4612300000000,46,123,Tripp County, SD,Apr-18(p),2951,2855,96,3.3
CN2204700000000,22,047,Iberville Parish, LA,Mar-17,14128,13260,868,6.1
CN2204700000000,22,047,Iberville Parish, LA,Apr-17,14098,13247,851,6.0
CN2204700000000,22,047,Iberville Parish, LA,May-17,14070,13213,857,6.1
CN2204700000000,22,047,Iberville Parish, LA,Jun-17,14306,13283,1023,7.2
CN2204700000000,22,047,Iberville Parish, LA,Jul-17,14286,13341,945,6.6
CN2204700000000,22,047,Iberville Parish, LA,Aug-17,14223,13282,941,6.6
CN2204700000000,22,047,Iberville Parish, LA,Sep-17,14212,13376,836,5.9
CN2204700000000,22,047,Iberville Parish, LA,Oct-17,14142,13373,769,5.4
CN2204700000000,22,047,Iberville Parish, LA,Nov-17,14164,13434,730,5.2
CN2204700000000,22,047,Iberville Parish, LA,Dec-17,14079,13338,741,5.3
CN2204700000000,22,047,Iberville Parish, LA,Jan-18,14149,13310,839,5.9
CN2204700000000,22,047,Iberville Parish, LA,Feb-18,14328,13533,795,5.5
CN2204700000000,22,047,Iberville Parish, LA,Mar-18,14422,13596,826,5.7
CN2204700000000,22,047,Iberville Parish, LA,Apr-18(p),14395,13606,789,5.5
CN4103500000000,41,035,Klamath County, OR,Mar-17,29086,27120,1966,6.8
CN4103500000000,41,035,Klamath County, OR,Apr-17,29498,27847,1651,5.6
CN4103500000000,41,035,Klamath County, OR,May-17,29787,28325,1462,4.9
CN4103500000000,41,035,Klamath County, OR,Jun-17,30329,28696,1633,5.4
CN4103500000000,41,035,Klamath County, OR,Jul-17,30069,28373,1696,5.6
CN4103500000000,41,035,Klamath County, OR,Aug-17,30311,28581,1730,5.7
CN4103500000000,41,035,Klamath County, OR,Sep-17,30496,28970,1526,5.0
CN4103500000000,41,035,Klamath County, OR,Oct-17,30693,29089,1604,5.2
CN4103500000000,41,035,Klamath County, OR,Nov-17,30291,28540,1751,5.8
CN4103500000000,41,035,Klamath County, OR,Dec-17,30051,28128,1923,6.4
CN4103500000000,41,035,Klamath County, OR,Jan-18,30299,28011,2288,7.6
CN4103500000000,41,035,Klamath County, OR,Feb-18,30286,28065,2221,7.3
CN4103500000000,41,035,Klamath County, OR,Mar-18,30113,27956,2157,7.2
CN4103500000000,41,035,Klamath County, OR,Apr-18(p),29843,28064,1779,6.0
CN2120300000000,21,203,Rockcastle County, KY,Mar-17,6774,6309,465,6.9
CN2120300000000,21,203,Rockcastle County, KY,Apr-17,6713,6335,378,5.6
CN2120300000000,21,203,Rockcastle County, KY,May-17,6725,6334,391,5.8
CN2120300000000,21,203,Rockcastle County, KY,Jun-17,6765,6341,424,6.3
CN2120300000000,21,203,Rockcastle County, KY,Jul-17,6634,6215,419,6.3
CN2120300000000,21,203,Rockcastle County, KY,Aug-17,6503,6142,361,5.6
CN2120300000000,21,203,Rockcastle County, KY,Sep-17,6704,6371,333,5.0
CN2120300000000,21,203,Rockcastle County, KY,Oct-17,6715,6403,312,4.6
CN2120300000000,21,203,Rockcastle County, KY,Nov-17,6764,6463,301,4.5
CN2120300000000,21,203,Rockcastle County, KY,Dec-17,6767,6462,305,4.5
CN2120300000000,21,203,Rockcastle County, KY,Jan-18,6678,6329,349,5.2
CN2120300000000,21,203,Rockcastle County, KY,Feb-18,6726,6336,390,5.8
CN2120300000000,21,203,Rockcastle County, KY,Mar-18,6721,6369,352,5.2
CN2120300000000,21,203,Rockcastle County, KY,Apr-18(p),6743,6440,303,4.5
CN3713500000000,37,135,Orange County, NC,Mar-17,76201,73203,2998,3.9
CN3713500000000,37,135,Orange County, NC,Apr-17,76001,73446,2555,3.4
CN3713500000000,37,135,Orange County, NC,May-17,76454,73702,2752,3.6
CN3713500000000,37,135,Orange County, NC,Jun-17,76740,73673,3067,4.0
CN3713500000000,37,135,Orange County, NC,Jul-17,77669,74387,3282,4.2
CN3713500000000,37,135,Orange County, NC,Aug-17,76722,73403,3319,4.3
CN3713500000000,37,135,Orange County, NC,Sep-17,77258,74548,2710,3.5
CN3713500000000,37,135,Orange County, NC,Oct-17,76747,74100,2647,3.4
CN3713500000000,37,135,Orange County, NC,Nov-17,76794,74028,2766,3.6
CN3713500000000,37,135,Orange County, NC,Dec-17,75900,73195,2705,3.6
CN3713500000000,37,135,Orange County, NC,Jan-18,76092,73225,2867,3.8
CN3713500000000,37,135,Orange County, NC,Feb-18,77187,74276,2911,3.8
CN3713500000000,37,135,Orange County, NC,Mar-18,77552,74760,2792,3.6
CN3713500000000,37,135,Orange County, NC,Apr-18(p),77120,74743,2377,3.1
CN1814700000000,18,147,Spencer County, IN,Mar-17,10436,10054,382,3.7
CN1814700000000,18,147,Spencer County, IN,Apr-17,11383,11070,313,2.7
CN1814700000000,18,147,Spencer County, IN,May-17,11597,11281,316,2.7
CN1814700000000,18,147,Spencer County, IN,Jun-17,11857,11477,380,3.2
CN1814700000000,18,147,Spencer County, IN,Jul-17,11615,11230,385,3.3
CN1814700000000,18,147,Spencer County, IN,Aug-17,11428,11007,421,3.7
CN1814700000000,18,147,Spencer County, IN,Sep-17,10892,10582,310,2.8
CN1814700000000,18,147,Spencer County, IN,Oct-17,10673,10379,294,2.8
CN1814700000000,18,147,Spencer County, IN,Nov-17,10308,9985,323,3.1
CN1814700000000,18,147,Spencer County, IN,Dec-17,10199,9881,318,3.1
CN1814700000000,18,147,Spencer County, IN,Jan-18,10095,9707,388,3.8
CN1814700000000,18,147,Spencer County, IN,Feb-18,10236,9830,406,4.0
CN1814700000000,18,147,Spencer County, IN,Mar-18,10418,10077,341,3.3
CN1814700000000,18,147,Spencer County, IN,Apr-18(p),11254,10967,287,2.6
CN2712100000000,27,121,Pope County, MN,Mar-17,6298,6031,267,4.2
CN2712100000000,27,121,Pope County, MN,Apr-17,6450,6264,186,2.9
CN2712100000000,27,121,Pope County, MN,May-17,6474,6327,147,2.3
CN2712100000000,27,121,Pope County, MN,Jun-17,6541,6375,166,2.5
CN2712100000000,27,121,Pope County, MN,Jul-17,6416,6255,161,2.5
CN2712100000000,27,121,Pope County, MN,Aug-17,6314,6164,150,2.4
CN2712100000000,27,121,Pope County, MN,Sep-17,6196,6065,131,2.1
CN2712100000000,27,121,Pope County, MN,Oct-17,6338,6224,114,1.8
CN2712100000000,27,121,Pope County, MN,Nov-17,6335,6174,161,2.5
CN2712100000000,27,121,Pope County, MN,Dec-17,6364,6142,222,3.5
CN2712100000000,27,121,Pope County, MN,Jan-18,6365,6092,273,4.3
CN2712100000000,27,121,Pope County, MN,Feb-18,6371,6120,251,3.9
CN2712100000000,27,121,Pope County, MN,Mar-18,6366,6130,236,3.7
CN2712100000000,27,121,Pope County, MN,Apr-18(p),6507,6312,195,3.0
CN0807100000000,08,071,Las Animas County, CO,Mar-17,6126,5888,238,3.9
CN0807100000000,08,071,Las Animas County, CO,Apr-17,6234,6006,228,3.7
CN0807100000000,08,071,Las Animas County, CO,May-17,6232,6020,212,3.4
CN0807100000000,08,071,Las Animas County, CO,Jun-17,6177,5924,253,4.1
CN0807100000000,08,071,Las Animas County, CO,Jul-17,6303,6031,272,4.3
CN0807100000000,08,071,Las Animas County, CO,Aug-17,6223,5972,251,4.0
CN0807100000000,08,071,Las Animas County, CO,Sep-17,6342,6096,246,3.9
CN0807100000000,08,071,Las Animas County, CO,Oct-17,6575,6332,243,3.7
CN0807100000000,08,071,Las Animas County, CO,Nov-17,6538,6273,265,4.1
CN0807100000000,08,071,Las Animas County, CO,Dec-17,6282,6002,280,4.5
CN0807100000000,08,071,Las Animas County, CO,Jan-18,6302,5991,311,4.9
CN0807100000000,08,071,Las Animas County, CO,Feb-18,6334,6026,308,4.9
CN0807100000000,08,071,Las Animas County, CO,Mar-18,6320,6039,281,4.4
CN0807100000000,08,071,Las Animas County, CO,Apr-18(p),6391,6153,238,3.7
CN1908300000000,19,083,Hardin County, IA,Mar-17,8377,8059,318,3.8
CN1908300000000,19,083,Hardin County, IA,Apr-17,8478,8211,267,3.1
CN1908300000000,19,083,Hardin County, IA,May-17,8516,8262,254,3.0
CN1908300000000,19,083,Hardin County, IA,Jun-17,8698,8427,271,3.1
CN1908300000000,19,083,Hardin County, IA,Jul-17,8740,8478,262,3.0
CN1908300000000,19,083,Hardin County, IA,Aug-17,8510,8254,256,3.0
CN1908300000000,19,083,Hardin County, IA,Sep-17,8475,8246,229,2.7
CN1908300000000,19,083,Hardin County, IA,Oct-17,8458,8269,189,2.2
CN1908300000000,19,083,Hardin County, IA,Nov-17,8375,8157,218,2.6
CN1908300000000,19,083,Hardin County, IA,Dec-17,8365,8100,265,3.2
CN1908300000000,19,083,Hardin County, IA,Jan-18,8183,7822,361,4.4
CN1908300000000,19,083,Hardin County, IA,Feb-18,8279,7946,333,4.0
CN1908300000000,19,083,Hardin County, IA,Mar-18,8196,7906,290,3.5
CN1908300000000,19,083,Hardin County, IA,Apr-18(p),8222,7972,250,3.0
CN3807100000000,38,071,Ramsey County, ND,Mar-17,5828,5623,205,3.5
CN3807100000000,38,071,Ramsey County, ND,Apr-17,5845,5685,160,2.7
CN3807100000000,38,071,Ramsey County, ND,May-17,5983,5852,131,2.2
CN3807100000000,38,071,Ramsey County, ND,Jun-17,6135,5978,157,2.6
CN3807100000000,38,071,Ramsey County, ND,Jul-17,6095,5965,130,2.1
CN3807100000000,38,071,Ramsey County, ND,Aug-17,6037,5907,130,2.2
CN3807100000000,38,071,Ramsey County, ND,Sep-17,5951,5842,109,1.8
CN3807100000000,38,071,Ramsey County, ND,Oct-17,5854,5749,105,1.8
CN3807100000000,38,071,Ramsey County, ND,Nov-17,5582,5448,134,2.4
CN3807100000000,38,071,Ramsey County, ND,Dec-17,5355,5179,176,3.3
CN3807100000000,38,071,Ramsey County, ND,Jan-18,5320,5110,210,3.9
CN3807100000000,38,071,Ramsey County, ND,Feb-18,5318,5092,226,4.2
CN3807100000000,38,071,Ramsey County, ND,Mar-18,5316,5112,204,3.8
CN3807100000000,38,071,Ramsey County, ND,Apr-18(p),5316,5128,188,3.5
CN5174000000000,51,740,Portsmouth city, VA,Mar-17,44494,42072,2422,5.4
CN5174000000000,51,740,Portsmouth city, VA,Apr-17,44640,42359,2281,5.1
CN5174000000000,51,740,Portsmouth city, VA,May-17,44641,42350,2291,5.1
CN5174000000000,51,740,Portsmouth city, VA,Jun-17,45132,42606,2526,5.6
CN5174000000000,51,740,Portsmouth city, VA,Jul-17,45556,42968,2588,5.7
CN5174000000000,51,740,Portsmouth city, VA,Aug-17,45143,42556,2587,5.7
CN5174000000000,51,740,Portsmouth city, VA,Sep-17,44739,42440,2299,5.1
CN5174000000000,51,740,Portsmouth city, VA,Oct-17,44342,42146,2196,5.0
CN5174000000000,51,740,Portsmouth city, VA,Nov-17,44011,41841,2170,4.9
CN5174000000000,51,740,Portsmouth city, VA,Dec-17,43827,41573,2254,5.1
CN5174000000000,51,740,Portsmouth city, VA,Jan-18,43642,41441,2201,5.0
CN5174000000000,51,740,Portsmouth city, VA,Feb-18,44152,42094,2058,4.7
CN5174000000000,51,740,Portsmouth city, VA,Mar-18,44454,42426,2028,4.6
CN5174000000000,51,740,Portsmouth city, VA,Apr-18(p),44365,42632,1733,3.9
CN2914500000000,29,145,Newton County, MO,Mar-17,27922,26852,1070,3.8
CN2914500000000,29,145,Newton County, MO,Apr-17,28095,27112,983,3.5
CN2914500000000,29,145,Newton County, MO,May-17,27804,26796,1008,3.6
CN2914500000000,29,145,Newton County, MO,Jun-17,27973,26838,1135,4.1
CN2914500000000,29,145,Newton County, MO,Jul-17,27904,26696,1208,4.3
CN2914500000000,29,145,Newton County, MO,Aug-17,27342,26211,1131,4.1
CN2914500000000,29,145,Newton County, MO,Sep-17,27624,26738,886,3.2
CN2914500000000,29,145,Newton County, MO,Oct-17,27517,26847,670,2.4
CN2914500000000,29,145,Newton County, MO,Nov-17,27686,26877,809,2.9
CN2914500000000,29,145,Newton County, MO,Dec-17,27598,26793,805,2.9
CN2914500000000,29,145,Newton County, MO,Jan-18,27469,26514,955,3.5
CN2914500000000,29,145,Newton County, MO,Feb-18,27797,26853,944,3.4
CN2914500000000,29,145,Newton County, MO,Mar-18,27687,26778,909,3.3
CN2914500000000,29,145,Newton County, MO,Apr-18(p),27752,26907,845,3.0
CN4813300000000,48,133,Eastland County, TX,Mar-17,7953,7587,366,4.6
CN4813300000000,48,133,Eastland County, TX,Apr-17,7847,7522,325,4.1
CN4813300000000,48,133,Eastland County, TX,May-17,7864,7542,322,4.1
CN4813300000000,48,133,Eastland County, TX,Jun-17,7842,7477,365,4.7
CN4813300000000,48,133,Eastland County, TX,Jul-17,7785,7429,356,4.6
CN4813300000000,48,133,Eastland County, TX,Aug-17,7791,7435,356,4.6
CN4813300000000,48,133,Eastland County, TX,Sep-17,7984,7678,306,3.8
CN4813300000000,48,133,Eastland County, TX,Oct-17,7958,7680,278,3.5
CN4813300000000,48,133,Eastland County, TX,Nov-17,7974,7689,285,3.6
CN4813300000000,48,133,Eastland County, TX,Dec-17,7894,7623,271,3.4
CN4813300000000,48,133,Eastland County, TX,Jan-18,7941,7628,313,3.9
CN4813300000000,48,133,Eastland County, TX,Feb-18,8209,7894,315,3.8
CN4813300000000,48,133,Eastland County, TX,Mar-18,8305,7984,321,3.9
CN4813300000000,48,133,Eastland County, TX,Apr-18(p),8439,8147,292,3.5
CN4013500000000,40,135,Sequoyah County, OK,Mar-17,16644,15718,926,5.6
CN4013500000000,40,135,Sequoyah County, OK,Apr-17,16507,15673,834,5.1
CN4013500000000,40,135,Sequoyah County, OK,May-17,16516,15620,896,5.4
CN4013500000000,40,135,Sequoyah County, OK,Jun-17,16611,15674,937,5.6
CN4013500000000,40,135,Sequoyah County, OK,Jul-17,16496,15606,890,5.4
CN4013500000000,40,135,Sequoyah County, OK,Aug-17,16565,15642,923,5.6
CN4013500000000,40,135,Sequoyah County, OK,Sep-17,16615,15739,876,5.3
CN4013500000000,40,135,Sequoyah County, OK,Oct-17,16558,15685,873,5.3
CN4013500000000,40,135,Sequoyah County, OK,Nov-17,16651,15786,865,5.2
CN4013500000000,40,135,Sequoyah County, OK,Dec-17,16473,15578,895,5.4
CN4013500000000,40,135,Sequoyah County, OK,Jan-18,16381,15444,937,5.7
CN4013500000000,40,135,Sequoyah County, OK,Feb-18,16477,15619,858,5.2
CN4013500000000,40,135,Sequoyah County, OK,Mar-18,16517,15698,819,5.0
CN4013500000000,40,135,Sequoyah County, OK,Apr-18(p),16340,15535,805,4.9
CN2809900000000,28,099,Neshoba County, MS,Mar-17,10619,10083,536,5.0
CN2809900000000,28,099,Neshoba County, MS,Apr-17,10496,10016,480,4.6
CN2809900000000,28,099,Neshoba County, MS,May-17,10629,10058,571,5.4
CN2809900000000,28,099,Neshoba County, MS,Jun-17,10758,10128,630,5.9
CN2809900000000,28,099,Neshoba County, MS,Jul-17,10992,10391,601,5.5
CN2809900000000,28,099,Neshoba County, MS,Aug-17,10727,10192,535,5.0
CN2809900000000,28,099,Neshoba County, MS,Sep-17,10713,10204,509,4.8
CN2809900000000,28,099,Neshoba County, MS,Oct-17,10360,9885,475,4.6
CN2809900000000,28,099,Neshoba County, MS,Nov-17,10270,9811,459,4.5
CN2809900000000,28,099,Neshoba County, MS,Dec-17,10351,9875,476,4.6
CN2809900000000,28,099,Neshoba County, MS,Jan-18,10381,9899,482,4.6
CN2809900000000,28,099,Neshoba County, MS,Feb-18,10478,9998,480,4.6
CN2809900000000,28,099,Neshoba County, MS,Mar-18,10586,10136,450,4.3
CN2809900000000,28,099,Neshoba County, MS,Apr-18(p),10617,10175,442,4.2
CN3114700000000,31,147,Richardson County, NE,Mar-17,4205,4062,143,3.4
CN3114700000000,31,147,Richardson County, NE,Apr-17,4234,4103,131,3.1
CN3114700000000,31,147,Richardson County, NE,May-17,4292,4159,133,3.1
CN3114700000000,31,147,Richardson County, NE,Jun-17,4376,4227,149,3.4
CN3114700000000,31,147,Richardson County, NE,Jul-17,4317,4162,155,3.6
CN3114700000000,31,147,Richardson County, NE,Aug-17,4193,4062,131,3.1
CN3114700000000,31,147,Richardson County, NE,Sep-17,4132,4020,112,2.7
CN3114700000000,31,147,Richardson County, NE,Oct-17,4131,4018,113,2.7
CN3114700000000,31,147,Richardson County, NE,Nov-17,4139,4020,119,2.9
CN3114700000000,31,147,Richardson County, NE,Dec-17,4156,4015,141,3.4
CN3114700000000,31,147,Richardson County, NE,Jan-18,4171,4027,144,3.5
CN3114700000000,31,147,Richardson County, NE,Feb-18,4184,4044,140,3.3
CN3114700000000,31,147,Richardson County, NE,Mar-18,4221,4093,128,3.0
CN3114700000000,31,147,Richardson County, NE,Apr-18(p),4193,4065,128,3.1
CN1809900000000,18,099,Marshall County, IN,Mar-17,23626,22878,748,3.2
CN1809900000000,18,099,Marshall County, IN,Apr-17,23571,22972,599,2.5
CN1809900000000,18,099,Marshall County, IN,May-17,24062,23412,650,2.7
CN1809900000000,18,099,Marshall County, IN,Jun-17,24694,23969,725,2.9
CN1809900000000,18,099,Marshall County, IN,Jul-17,24119,23384,735,3.0
CN1809900000000,18,099,Marshall County, IN,Aug-17,23747,22907,840,3.5
CN1809900000000,18,099,Marshall County, IN,Sep-17,23309,22648,661,2.8
CN1809900000000,18,099,Marshall County, IN,Oct-17,23848,23219,629,2.6
CN1809900000000,18,099,Marshall County, IN,Nov-17,23799,23136,663,2.8
CN1809900000000,18,099,Marshall County, IN,Dec-17,23557,22945,612,2.6
CN1809900000000,18,099,Marshall County, IN,Jan-18,23239,22473,766,3.3
CN1809900000000,18,099,Marshall County, IN,Feb-18,22818,21995,823,3.6
CN1809900000000,18,099,Marshall County, IN,Mar-18,22998,22286,712,3.1
CN1809900000000,18,099,Marshall County, IN,Apr-18(p),23131,22501,630,2.7
CN2114700000000,21,147,McCreary County, KY,Mar-17,4953,4586,367,7.4
CN2114700000000,21,147,McCreary County, KY,Apr-17,4951,4642,309,6.2
CN2114700000000,21,147,McCreary County, KY,May-17,4957,4629,328,6.6
CN2114700000000,21,147,McCreary County, KY,Jun-17,4961,4602,359,7.2
CN2114700000000,21,147,McCreary County, KY,Jul-17,4857,4512,345,7.1
CN2114700000000,21,147,McCreary County, KY,Aug-17,4777,4478,299,6.3
CN2114700000000,21,147,McCreary County, KY,Sep-17,4862,4583,279,5.7
CN2114700000000,21,147,McCreary County, KY,Oct-17,4809,4549,260,5.4
CN2114700000000,21,147,McCreary County, KY,Nov-17,4813,4554,259,5.4
CN2114700000000,21,147,McCreary County, KY,Dec-17,4793,4527,266,5.5
CN2114700000000,21,147,McCreary County, KY,Jan-18,4905,4613,292,6.0
CN2114700000000,21,147,McCreary County, KY,Feb-18,4962,4611,351,7.1
CN2114700000000,21,147,McCreary County, KY,Mar-18,4958,4649,309,6.2
CN2114700000000,21,147,McCreary County, KY,Apr-18(p),4959,4679,280,5.6
CN5405700000000,54,057,Mineral County, WV,Mar-17,11816,11127,689,5.8
CN5405700000000,54,057,Mineral County, WV,Apr-17,11928,11338,590,4.9
CN5405700000000,54,057,Mineral County, WV,May-17,11897,11349,548,4.6
CN5405700000000,54,057,Mineral County, WV,Jun-17,11912,11255,657,5.5
CN5405700000000,54,057,Mineral County, WV,Jul-17,11945,11337,608,5.1
CN5405700000000,54,057,Mineral County, WV,Aug-17,11854,11192,662,5.6
CN5405700000000,54,057,Mineral County, WV,Sep-17,12076,11508,568,4.7
CN5405700000000,54,057,Mineral County, WV,Oct-17,12113,11532,581,4.8
CN5405700000000,54,057,Mineral County, WV,Nov-17,11960,11336,624,5.2
CN5405700000000,54,057,Mineral County, WV,Dec-17,11851,11199,652,5.5
CN5405700000000,54,057,Mineral County, WV,Jan-18,11922,11162,760,6.4
CN5405700000000,54,057,Mineral County, WV,Feb-18,12170,11383,787,6.5
CN5405700000000,54,057,Mineral County, WV,Mar-18,12018,11264,754,6.3
CN5405700000000,54,057,Mineral County, WV,Apr-18(p),12120,11425,695,5.7
CN2607500000000,26,075,Jackson County, MI,Mar-17,74281,70829,3452,4.6
CN2607500000000,26,075,Jackson County, MI,Apr-17,73967,71042,2925,4.0
CN2607500000000,26,075,Jackson County, MI,May-17,74489,71389,3100,4.2
CN2607500000000,26,075,Jackson County, MI,Jun-17,74811,71206,3605,4.8
CN2607500000000,26,075,Jackson County, MI,Jul-17,74366,70075,4291,5.8
CN2607500000000,26,075,Jackson County, MI,Aug-17,74389,70529,3860,5.2
CN2607500000000,26,075,Jackson County, MI,Sep-17,74088,70797,3291,4.4
CN2607500000000,26,075,Jackson County, MI,Oct-17,74076,71041,3035,4.1
CN2607500000000,26,075,Jackson County, MI,Nov-17,74757,71643,3114,4.2
CN2607500000000,26,075,Jackson County, MI,Dec-17,74214,70943,3271,4.4
CN2607500000000,26,075,Jackson County, MI,Jan-18,74008,69999,4009,5.4
CN2607500000000,26,075,Jackson County, MI,Feb-18,74781,70809,3972,5.3
CN2607500000000,26,075,Jackson County, MI,Mar-18,74937,71518,3419,4.6
CN2607500000000,26,075,Jackson County, MI,Apr-18(p),74809,71818,2991,4.0
CN0506300000000,05,063,Independence County, AR,Mar-17,16244,15595,649,4.0
CN0506300000000,05,063,Independence County, AR,Apr-17,16217,15649,568,3.5
CN0506300000000,05,063,Independence County, AR,May-17,16320,15705,615,3.8
CN0506300000000,05,063,Independence County, AR,Jun-17,16535,15779,756,4.6
CN0506300000000,05,063,Independence County, AR,Jul-17,16133,15303,830,5.1
CN0506300000000,05,063,Independence County, AR,Aug-17,15824,15097,727,4.6
CN0506300000000,05,063,Independence County, AR,Sep-17,16320,15686,634,3.9
CN0506300000000,05,063,Independence County, AR,Oct-17,16295,15706,589,3.6
CN0506300000000,05,063,Independence County, AR,Nov-17,16283,15690,593,3.6
CN0506300000000,05,063,Independence County, AR,Dec-17,16282,15672,610,3.7
CN0506300000000,05,063,Independence County, AR,Jan-18,16137,15359,778,4.8
CN0506300000000,05,063,Independence County, AR,Feb-18,16134,15418,716,4.4
CN0506300000000,05,063,Independence County, AR,Mar-18,16186,15540,646,4.0
CN0506300000000,05,063,Independence County, AR,Apr-18(p),16156,15592,564,3.5
CN4400100000000,44,001,Bristol County, RI,Mar-17,25946,24845,1101,4.2
CN4400100000000,44,001,Bristol County, RI,Apr-17,25856,24999,857,3.3
CN4400100000000,44,001,Bristol County, RI,May-17,25921,25042,879,3.4
CN4400100000000,44,001,Bristol County, RI,Jun-17,26296,25378,918,3.5
CN4400100000000,44,001,Bristol County, RI,Jul-17,26431,25417,1014,3.8
CN4400100000000,44,001,Bristol County, RI,Aug-17,26392,25386,1006,3.8
CN4400100000000,44,001,Bristol County, RI,Sep-17,26186,25330,856,3.3
CN4400100000000,44,001,Bristol County, RI,Oct-17,26285,25366,919,3.5
CN4400100000000,44,001,Bristol County, RI,Nov-17,26451,25451,1000,3.8
CN4400100000000,44,001,Bristol County, RI,Dec-17,26336,25360,976,3.7
CN4400100000000,44,001,Bristol County, RI,Jan-18,26186,24933,1253,4.8
CN4400100000000,44,001,Bristol County, RI,Feb-18,26265,25049,1216,4.6
CN4400100000000,44,001,Bristol County, RI,Mar-18,26243,25147,1096,4.2
CN4400100000000,44,001,Bristol County, RI,Apr-18(p),26238,25362,876,3.3
CN0804900000000,08,049,Grand County, CO,Mar-17,9853,9627,226,2.3
CN0804900000000,08,049,Grand County, CO,Apr-17,9126,8915,211,2.3
CN0804900000000,08,049,Grand County, CO,May-17,8294,8091,203,2.4
CN0804900000000,08,049,Grand County, CO,Jun-17,9811,9599,212,2.2
CN0804900000000,08,049,Grand County, CO,Jul-17,10107,9918,189,1.9
CN0804900000000,08,049,Grand County, CO,Aug-17,10025,9832,193,1.9
CN0804900000000,08,049,Grand County, CO,Sep-17,9535,9338,197,2.1
CN0804900000000,08,049,Grand County, CO,Oct-17,9031,8821,210,2.3
CN0804900000000,08,049,Grand County, CO,Nov-17,9101,8875,226,2.5
CN0804900000000,08,049,Grand County, CO,Dec-17,10448,10216,232,2.2
CN0804900000000,08,049,Grand County, CO,Jan-18,10534,10263,271,2.6
CN0804900000000,08,049,Grand County, CO,Feb-18,10523,10246,277,2.6
CN0804900000000,08,049,Grand County, CO,Mar-18,10465,10215,250,2.4
CN0804900000000,08,049,Grand County, CO,Apr-18(p),9672,9440,232,2.4
CN2107100000000,21,071,Floyd County, KY,Mar-17,11985,10806,1179,9.8
CN2107100000000,21,071,Floyd County, KY,Apr-17,11924,10934,990,8.3
CN2107100000000,21,071,Floyd County, KY,May-17,11911,10922,989,8.3
CN2107100000000,21,071,Floyd County, KY,Jun-17,11939,10901,1038,8.7
CN2107100000000,21,071,Floyd County, KY,Jul-17,11713,10754,959,8.2
CN2107100000000,21,071,Floyd County, KY,Aug-17,11558,10705,853,7.4
CN2107100000000,21,071,Floyd County, KY,Sep-17,11760,10979,781,6.6
CN2107100000000,21,071,Floyd County, KY,Oct-17,11591,10868,723,6.2
CN2107100000000,21,071,Floyd County, KY,Nov-17,11633,10914,719,6.2
CN2107100000000,21,071,Floyd County, KY,Dec-17,11523,10829,694,6.0
CN2107100000000,21,071,Floyd County, KY,Jan-18,11511,10739,772,6.7
CN2107100000000,21,071,Floyd County, KY,Feb-18,11727,10903,824,7.0
CN2107100000000,21,071,Floyd County, KY,Mar-18,11822,11038,784,6.6
CN2107100000000,21,071,Floyd County, KY,Apr-18(p),11768,11090,678,5.8
CN3701500000000,37,015,Bertie County, NC,Mar-17,8359,7861,498,6.0
CN3701500000000,37,015,Bertie County, NC,Apr-17,8227,7775,452,5.5
CN3701500000000,37,015,Bertie County, NC,May-17,8169,7688,481,5.9
CN3701500000000,37,015,Bertie County, NC,Jun-17,8183,7684,499,6.1
CN3701500000000,37,015,Bertie County, NC,Jul-17,8193,7676,517,6.3
CN3701500000000,37,015,Bertie County, NC,Aug-17,8000,7491,509,6.4
CN3701500000000,37,015,Bertie County, NC,Sep-17,8105,7652,453,5.6
CN3701500000000,37,015,Bertie County, NC,Oct-17,8171,7724,447,5.5
CN3701500000000,37,015,Bertie County, NC,Nov-17,8088,7605,483,6.0
CN3701500000000,37,015,Bertie County, NC,Dec-17,8132,7658,474,5.8
CN3701500000000,37,015,Bertie County, NC,Jan-18,8063,7558,505,6.3
CN3701500000000,37,015,Bertie County, NC,Feb-18,8060,7577,483,6.0
CN3701500000000,37,015,Bertie County, NC,Mar-18,8005,7535,470,5.9
CN3701500000000,37,015,Bertie County, NC,Apr-18(p),7933,7536,397,5.0
CN2600300000000,26,003,Alger County, MI,Mar-17,3221,2893,328,10.2
CN2600300000000,26,003,Alger County, MI,Apr-17,3146,2828,318,10.1
CN2600300000000,26,003,Alger County, MI,May-17,3276,3012,264,8.1
CN2600300000000,26,003,Alger County, MI,Jun-17,3531,3292,239,6.8
CN2600300000000,26,003,Alger County, MI,Jul-17,3605,3338,267,7.4
CN2600300000000,26,003,Alger County, MI,Aug-17,3569,3326,243,6.8
CN2600300000000,26,003,Alger County, MI,Sep-17,3420,3224,196,5.7
CN2600300000000,26,003,Alger County, MI,Oct-17,3298,3106,192,5.8
CN2600300000000,26,003,Alger County, MI,Nov-17,3230,2957,273,8.5
CN2600300000000,26,003,Alger County, MI,Dec-17,3251,2903,348,10.7
CN2600300000000,26,003,Alger County, MI,Jan-18,3252,2912,340,10.5
CN2600300000000,26,003,Alger County, MI,Feb-18,3373,2987,386,11.4
CN2600300000000,26,003,Alger County, MI,Mar-18,3326,2960,366,11.0
CN2600300000000,26,003,Alger County, MI,Apr-18(p),3224,2887,337,10.5
CN3300300000000,33,003,Carroll County, NH,Mar-17,22712,21975,737,3.2
CN3300300000000,33,003,Carroll County, NH,Apr-17,21641,21032,609,2.8
CN3300300000000,33,003,Carroll County, NH,May-17,22282,21714,568,2.5
CN3300300000000,33,003,Carroll County, NH,Jun-17,24130,23552,578,2.4
CN3300300000000,33,003,Carroll County, NH,Jul-17,25615,25049,566,2.2
CN3300300000000,33,003,Carroll County, NH,Aug-17,25581,24995,586,2.3
CN3300300000000,33,003,Carroll County, NH,Sep-17,23726,23132,594,2.5
CN3300300000000,33,003,Carroll County, NH,Oct-17,23229,22712,517,2.2
CN3300300000000,33,003,Carroll County, NH,Nov-17,22646,22083,563,2.5
CN3300300000000,33,003,Carroll County, NH,Dec-17,22597,22078,519,2.3
CN3300300000000,33,003,Carroll County, NH,Jan-18,23187,22457,730,3.1
CN3300300000000,33,003,Carroll County, NH,Feb-18,23078,22380,698,3.0
CN3300300000000,33,003,Carroll County, NH,Mar-18,22720,22009,711,3.1
CN3300300000000,33,003,Carroll County, NH,Apr-18(p),22019,21356,663,3.0
CN3505500000000,35,055,Taos County, NM,Mar-17,15199,14072,1127,7.4
CN3505500000000,35,055,Taos County, NM,Apr-17,14374,13178,1196,8.3
CN3505500000000,35,055,Taos County, NM,May-17,14382,13147,1235,8.6
CN3505500000000,35,055,Taos County, NM,Jun-17,14851,13552,1299,8.7
CN3505500000000,35,055,Taos County, NM,Jul-17,14904,13668,1236,8.3
CN3505500000000,35,055,Taos County, NM,Aug-17,14963,13776,1187,7.9
CN3505500000000,35,055,Taos County, NM,Sep-17,14816,13706,1110,7.5
CN3505500000000,35,055,Taos County, NM,Oct-17,14877,13759,1118,7.5
CN3505500000000,35,055,Taos County, NM,Nov-17,15080,13936,1144,7.6
CN3505500000000,35,055,Taos County, NM,Dec-17,15623,14506,1117,7.1
CN3505500000000,35,055,Taos County, NM,Jan-18,15698,14555,1143,7.3
CN3505500000000,35,055,Taos County, NM,Feb-18,15387,14290,1097,7.1
CN3505500000000,35,055,Taos County, NM,Mar-18,15418,14415,1003,6.5
CN3505500000000,35,055,Taos County, NM,Apr-18(p),14793,13795,998,6.7
CN3903900000000,39,039,Defiance County, OH,Mar-17,18663,17706,957,5.1
CN3903900000000,39,039,Defiance County, OH,Apr-17,18560,17672,888,4.8
CN3903900000000,39,039,Defiance County, OH,May-17,18604,17755,849,4.6
CN3903900000000,39,039,Defiance County, OH,Jun-17,18655,17727,928,5.0
CN3903900000000,39,039,Defiance County, OH,Jul-17,18514,17574,940,5.1
CN3903900000000,39,039,Defiance County, OH,Aug-17,18707,17723,984,5.3
CN3903900000000,39,039,Defiance County, OH,Sep-17,18589,17727,862,4.6
CN3903900000000,39,039,Defiance County, OH,Oct-17,18413,17627,786,4.3
CN3903900000000,39,039,Defiance County, OH,Nov-17,18362,17585,777,4.2
CN3903900000000,39,039,Defiance County, OH,Dec-17,18267,17476,791,4.3
CN3903900000000,39,039,Defiance County, OH,Jan-18,17941,17066,875,4.9
CN3903900000000,39,039,Defiance County, OH,Feb-18,18027,17206,821,4.6
CN3903900000000,39,039,Defiance County, OH,Mar-18,18279,17503,776,4.2
CN3903900000000,39,039,Defiance County, OH,Apr-18(p),18190,17452,738,4.1
CN2002900000000,20,029,Cloud County, KS,Mar-17,3930,3741,189,4.8
CN2002900000000,20,029,Cloud County, KS,Apr-17,3872,3718,154,4.0
CN2002900000000,20,029,Cloud County, KS,May-17,3888,3727,161,4.1
CN2002900000000,20,029,Cloud County, KS,Jun-17,3983,3796,187,4.7
CN2002900000000,20,029,Cloud County, KS,Jul-17,3917,3718,199,5.1
CN2002900000000,20,029,Cloud County, KS,Aug-17,3822,3643,179,4.7
CN2002900000000,20,029,Cloud County, KS,Sep-17,3896,3744,152,3.9
CN2002900000000,20,029,Cloud County, KS,Oct-17,3892,3752,140,3.6
CN2002900000000,20,029,Cloud County, KS,Nov-17,3864,3724,140,3.6
CN2002900000000,20,029,Cloud County, KS,Dec-17,3820,3693,127,3.3
CN2002900000000,20,029,Cloud County, KS,Jan-18,3810,3680,130,3.4
CN2002900000000,20,029,Cloud County, KS,Feb-18,3820,3681,139,3.6
CN2002900000000,20,029,Cloud County, KS,Mar-18,3853,3715,138,3.6
CN2002900000000,20,029,Cloud County, KS,Apr-18(p),3781,3649,132,3.5
CN4841900000000,48,419,Shelby County, TX,Mar-17,10901,10304,597,5.5
CN4841900000000,48,419,Shelby County, TX,Apr-17,10862,10323,539,5.0
CN4841900000000,48,419,Shelby County, TX,May-17,10806,10268,538,5.0
CN4841900000000,48,419,Shelby County, TX,Jun-17,10927,10352,575,5.3
CN4841900000000,48,419,Shelby County, TX,Jul-17,10793,10203,590,5.5
CN4841900000000,48,419,Shelby County, TX,Aug-17,10798,10234,564,5.2
CN4841900000000,48,419,Shelby County, TX,Sep-17,10772,10281,491,4.6
CN4841900000000,48,419,Shelby County, TX,Oct-17,10724,10265,459,4.3
CN4841900000000,48,419,Shelby County, TX,Nov-17,10648,10180,468,4.4
CN4841900000000,48,419,Shelby County, TX,Dec-17,10693,10214,479,4.5
CN4841900000000,48,419,Shelby County, TX,Jan-18,10687,10157,530,5.0
CN4841900000000,48,419,Shelby County, TX,Feb-18,10736,10232,504,4.7
CN4841900000000,48,419,Shelby County, TX,Mar-18,10866,10352,514,4.7
CN4841900000000,48,419,Shelby County, TX,Apr-18(p),10694,10236,458,4.3
CN4832900000000,48,329,Midland County, TX,Mar-17,86727,83694,3033,3.5
CN4832900000000,48,329,Midland County, TX,Apr-17,87751,85080,2671,3.0
CN4832900000000,48,329,Midland County, TX,May-17,88211,85553,2658,3.0
CN4832900000000,48,329,Midland County, TX,Jun-17,89069,86266,2803,3.1
CN4832900000000,48,329,Midland County, TX,Jul-17,90773,88016,2757,3.0
CN4832900000000,48,329,Midland County, TX,Aug-17,90744,88062,2682,3.0
CN4832900000000,48,329,Midland County, TX,Sep-17,91754,89369,2385,2.6
CN4832900000000,48,329,Midland County, TX,Oct-17,90633,88487,2146,2.4
CN4832900000000,48,329,Midland County, TX,Nov-17,92072,89848,2224,2.4
CN4832900000000,48,329,Midland County, TX,Dec-17,92092,90011,2081,2.3
CN4832900000000,48,329,Midland County, TX,Jan-18,92870,90604,2266,2.4
CN4832900000000,48,329,Midland County, TX,Feb-18,93620,91308,2312,2.5
CN4832900000000,48,329,Midland County, TX,Mar-18,94525,92214,2311,2.4
CN4832900000000,48,329,Midland County, TX,Apr-18(p),97048,95022,2026,2.1
CN0210000000000,02,100,Haines Borough, AK,Mar-17,928,815,113,12.2
CN0210000000000,02,100,Haines Borough, AK,Apr-17,1043,945,98,9.4
CN0210000000000,02,100,Haines Borough, AK,May-17,1149,1063,86,7.5
CN0210000000000,02,100,Haines Borough, AK,Jun-17,1256,1173,83,6.6
CN0210000000000,02,100,Haines Borough, AK,Jul-17,1409,1331,78,5.5
CN0210000000000,02,100,Haines Borough, AK,Aug-17,1375,1303,72,5.2
CN0210000000000,02,100,Haines Borough, AK,Sep-17,1250,1174,76,6.1
CN0210000000000,02,100,Haines Borough, AK,Oct-17,1013,921,92,9.1
CN0210000000000,02,100,Haines Borough, AK,Nov-17,956,833,123,12.9
CN0210000000000,02,100,Haines Borough, AK,Dec-17,907,788,119,13.1
CN0210000000000,02,100,Haines Borough, AK,Jan-18,920,762,158,17.2
CN0210000000000,02,100,Haines Borough, AK,Feb-18,936,778,158,16.9
CN0210000000000,02,100,Haines Borough, AK,Mar-18,973,826,147,15.1
CN0210000000000,02,100,Haines Borough, AK,Apr-18(p),1066,951,115,10.8
CN1312900000000,13,129,Gordon County, GA,Mar-17,26727,25458,1269,4.7
CN1312900000000,13,129,Gordon County, GA,Apr-17,26557,25400,1157,4.4
CN1312900000000,13,129,Gordon County, GA,May-17,26735,25545,1190,4.5
CN1312900000000,13,129,Gordon County, GA,Jun-17,26658,25366,1292,4.8
CN1312900000000,13,129,Gordon County, GA,Jul-17,26898,25563,1335,5.0
CN1312900000000,13,129,Gordon County, GA,Aug-17,26708,25452,1256,4.7
CN1312900000000,13,129,Gordon County, GA,Sep-17,26960,25832,1128,4.2
CN1312900000000,13,129,Gordon County, GA,Oct-17,26659,25542,1117,4.2
CN1312900000000,13,129,Gordon County, GA,Nov-17,26757,25631,1126,4.2
CN1312900000000,13,129,Gordon County, GA,Dec-17,26799,25653,1146,4.3
CN1312900000000,13,129,Gordon County, GA,Jan-18,27017,25774,1243,4.6
CN1312900000000,13,129,Gordon County, GA,Feb-18,27107,25867,1240,4.6
CN1312900000000,13,129,Gordon County, GA,Mar-18,27118,26024,1094,4.0
CN1312900000000,13,129,Gordon County, GA,Apr-18(p),26823,25864,959,3.6
CN4211700000000,42,117,Tioga County, PA,Mar-17,19434,18062,1372,7.1
CN4211700000000,42,117,Tioga County, PA,Apr-17,19549,18466,1083,5.5
CN4211700000000,42,117,Tioga County, PA,May-17,19724,18629,1095,5.6
CN4211700000000,42,117,Tioga County, PA,Jun-17,19396,18254,1142,5.9
CN4211700000000,42,117,Tioga County, PA,Jul-17,19237,18091,1146,6.0
CN4211700000000,42,117,Tioga County, PA,Aug-17,18934,17815,1119,5.9
CN4211700000000,42,117,Tioga County, PA,Sep-17,19173,18279,894,4.7
CN4211700000000,42,117,Tioga County, PA,Oct-17,18998,18106,892,4.7
CN4211700000000,42,117,Tioga County, PA,Nov-17,18871,17882,989,5.2
CN4211700000000,42,117,Tioga County, PA,Dec-17,18809,17719,1090,5.8
CN4211700000000,42,117,Tioga County, PA,Jan-18,18905,17583,1322,7.0
CN4211700000000,42,117,Tioga County, PA,Feb-18,19047,17743,1304,6.8
CN4211700000000,42,117,Tioga County, PA,Mar-18,18716,17615,1101,5.9
CN4211700000000,42,117,Tioga County, PA,Apr-18(p),18874,17953,921,4.9
CN5110500000000,51,105,Lee County, VA,Mar-17,8385,7890,495,5.9
CN5110500000000,51,105,Lee County, VA,Apr-17,8321,7866,455,5.5
CN5110500000000,51,105,Lee County, VA,May-17,8347,7897,450,5.4
CN5110500000000,51,105,Lee County, VA,Jun-17,8366,7918,448,5.4
CN5110500000000,51,105,Lee County, VA,Jul-17,8217,7764,453,5.5
CN5110500000000,51,105,Lee County, VA,Aug-17,8152,7701,451,5.5
CN5110500000000,51,105,Lee County, VA,Sep-17,8151,7731,420,5.2
CN5110500000000,51,105,Lee County, VA,Oct-17,8132,7732,400,4.9
CN5110500000000,51,105,Lee County, VA,Nov-17,8098,7703,395,4.9
CN5110500000000,51,105,Lee County, VA,Dec-17,8081,7683,398,4.9
CN5110500000000,51,105,Lee County, VA,Jan-18,8087,7665,422,5.2
CN5110500000000,51,105,Lee County, VA,Feb-18,8057,7654,403,5.0
CN5110500000000,51,105,Lee County, VA,Mar-18,8129,7722,407,5.0
CN5110500000000,51,105,Lee County, VA,Apr-18(p),8138,7777,361,4.4
CN7208300000000,72,083,Las Marias Municipio, PR,Mar-17,3102,2397,705,22.7
CN7208300000000,72,083,Las Marias Municipio, PR,Apr-17,2980,2278,702,23.6
CN7208300000000,72,083,Las Marias Municipio, PR,May-17,2928,2327,601,20.5
CN7208300000000,72,083,Las Marias Municipio, PR,Jun-17,2879,2341,538,18.7
CN7208300000000,72,083,Las Marias Municipio, PR,Jul-17,2866,2326,540,18.8
CN7208300000000,72,083,Las Marias Municipio, PR,Aug-17,2905,2294,611,21.0
CN7208300000000,72,083,Las Marias Municipio, PR,Sep-17(y),2842,2311,531,18.7
CN7208300000000,72,083,Las Marias Municipio, PR,Oct-17,2800,2228,572,20.4
CN7208300000000,72,083,Las Marias Municipio, PR,Nov-17,2848,2381,467,16.4
CN7208300000000,72,083,Las Marias Municipio, PR,Dec-17,2918,2446,472,16.2
CN7208300000000,72,083,Las Marias Municipio, PR,Jan-18,2658,2167,491,18.5
CN7208300000000,72,083,Las Marias Municipio, PR,Feb-18,2571,2122,449,17.5
CN7208300000000,72,083,Las Marias Municipio, PR,Mar-18,2680,2241,439,16.4
CN7208300000000,72,083,Las Marias Municipio, PR,Apr-18(p),2534,2145,389,15.4
CN3707900000000,37,079,Greene County, NC,Mar-17,9795,9382,413,4.2
CN3707900000000,37,079,Greene County, NC,Apr-17,9747,9347,400,4.1
CN3707900000000,37,079,Greene County, NC,May-17,9647,9219,428,4.4
CN3707900000000,37,079,Greene County, NC,Jun-17,9462,9011,451,4.8
CN3707900000000,37,079,Greene County, NC,Jul-17,9618,9140,478,5.0
CN3707900000000,37,079,Greene County, NC,Aug-17,9427,8950,477,5.1
CN3707900000000,37,079,Greene County, NC,Sep-17,9643,9233,410,4.3
CN3707900000000,37,079,Greene County, NC,Oct-17,9631,9233,398,4.1
CN3707900000000,37,079,Greene County, NC,Nov-17,9459,9030,429,4.5
CN3707900000000,37,079,Greene County, NC,Dec-17,9548,9143,405,4.2
CN3707900000000,37,079,Greene County, NC,Jan-18,9519,9106,413,4.3
CN3707900000000,37,079,Greene County, NC,Feb-18,9725,9306,419,4.3
CN3707900000000,37,079,Greene County, NC,Mar-18,9665,9265,400,4.1
CN3707900000000,37,079,Greene County, NC,Apr-18(p),9699,9334,365,3.8
CN3009500000000,30,095,Stillwater County, MT,Mar-17,4772,4574,198,4.1
CN3009500000000,30,095,Stillwater County, MT,Apr-17,4841,4671,170,3.5
CN3009500000000,30,095,Stillwater County, MT,May-17,4913,4760,153,3.1
CN3009500000000,30,095,Stillwater County, MT,Jun-17,4865,4679,186,3.8
CN3009500000000,30,095,Stillwater County, MT,Jul-17,4903,4727,176,3.6
CN3009500000000,30,095,Stillwater County, MT,Aug-17,4880,4707,173,3.5
CN3009500000000,30,095,Stillwater County, MT,Sep-17,4824,4661,163,3.4
CN3009500000000,30,095,Stillwater County, MT,Oct-17,4844,4673,171,3.5
CN3009500000000,30,095,Stillwater County, MT,Nov-17,4860,4662,198,4.1
CN3009500000000,30,095,Stillwater County, MT,Dec-17,4808,4611,197,4.1
CN3009500000000,30,095,Stillwater County, MT,Jan-18,4812,4579,233,4.8
CN3009500000000,30,095,Stillwater County, MT,Feb-18,4825,4580,245,5.1
CN3009500000000,30,095,Stillwater County, MT,Mar-18,4798,4576,222,4.6
CN3009500000000,30,095,Stillwater County, MT,Apr-18(p),4809,4633,176,3.7
CN4612900000000,46,129,Walworth County, SD,Mar-17,2199,2070,129,5.9
CN4612900000000,46,129,Walworth County, SD,Apr-17,2214,2097,117,5.3
CN4612900000000,46,129,Walworth County, SD,May-17,2264,2155,109,4.8
CN4612900000000,46,129,Walworth County, SD,Jun-17,2359,2248,111,4.7
CN4612900000000,46,129,Walworth County, SD,Jul-17,2319,2208,111,4.8
CN4612900000000,46,129,Walworth County, SD,Aug-17,2270,2158,112,4.9
CN4612900000000,46,129,Walworth County, SD,Sep-17,2213,2113,100,4.5
CN4612900000000,46,129,Walworth County, SD,Oct-17,2208,2110,98,4.4
CN4612900000000,46,129,Walworth County, SD,Nov-17,2195,2097,98,4.5
CN4612900000000,46,129,Walworth County, SD,Dec-17,2230,2105,125,5.6
CN4612900000000,46,129,Walworth County, SD,Jan-18,2213,2082,131,5.9
CN4612900000000,46,129,Walworth County, SD,Feb-18,2232,2093,139,6.2
CN4612900000000,46,129,Walworth County, SD,Mar-18,2246,2117,129,5.7
CN4612900000000,46,129,Walworth County, SD,Apr-18(p),2251,2122,129,5.7
CN0603900000000,06,039,Madera County, CA,Mar-17,61423,55340,6083,9.9
CN0603900000000,06,039,Madera County, CA,Apr-17,60865,55450,5415,8.9
CN0603900000000,06,039,Madera County, CA,May-17,61535,56794,4741,7.7
CN0603900000000,06,039,Madera County, CA,Jun-17,61497,56636,4861,7.9
CN0603900000000,06,039,Madera County, CA,Jul-17,60917,56049,4868,8.0
CN0603900000000,06,039,Madera County, CA,Aug-17,61396,56917,4479,7.3
CN0603900000000,06,039,Madera County, CA,Sep-17,62410,58599,3811,6.1
CN0603900000000,06,039,Madera County, CA,Oct-17,61071,57263,3808,6.2
CN0603900000000,06,039,Madera County, CA,Nov-17,60081,55945,4136,6.9
CN0603900000000,06,039,Madera County, CA,Dec-17,61258,56678,4580,7.5
CN0603900000000,06,039,Madera County, CA,Jan-18,62623,57438,5185,8.3
CN0603900000000,06,039,Madera County, CA,Feb-18,62762,57553,5209,8.3
CN0603900000000,06,039,Madera County, CA,Mar-18,61169,56155,5014,8.2
CN0603900000000,06,039,Madera County, CA,Apr-18(p),60548,56131,4417,7.3
CN2915300000000,29,153,Ozark County, MO,Mar-17,3574,3390,184,5.1
CN2915300000000,29,153,Ozark County, MO,Apr-17,3667,3485,182,5.0
CN2915300000000,29,153,Ozark County, MO,May-17,3680,3450,230,6.3
CN2915300000000,29,153,Ozark County, MO,Jun-17,3714,3502,212,5.7
CN2915300000000,29,153,Ozark County, MO,Jul-17,3432,3201,231,6.7
CN2915300000000,29,153,Ozark County, MO,Aug-17,3321,3090,231,7.0
CN2915300000000,29,153,Ozark County, MO,Sep-17,3568,3389,179,5.0
CN2915300000000,29,153,Ozark County, MO,Oct-17,3468,3334,134,3.9
CN2915300000000,29,153,Ozark County, MO,Nov-17,3458,3308,150,4.3
CN2915300000000,29,153,Ozark County, MO,Dec-17,3417,3206,211,6.2
CN2915300000000,29,153,Ozark County, MO,Jan-18,3402,3197,205,6.0
CN2915300000000,29,153,Ozark County, MO,Feb-18,3447,3261,186,5.4
CN2915300000000,29,153,Ozark County, MO,Mar-18,3499,3336,163,4.7
CN2915300000000,29,153,Ozark County, MO,Apr-18(p),3578,3397,181,5.1
CN4603900000000,46,039,Deuel County, SD,Mar-17,2136,1995,141,6.6
CN4603900000000,46,039,Deuel County, SD,Apr-17,2223,2108,115,5.2
CN4603900000000,46,039,Deuel County, SD,May-17,2243,2152,91,4.1
CN4603900000000,46,039,Deuel County, SD,Jun-17,2319,2244,75,3.2
CN4603900000000,46,039,Deuel County, SD,Jul-17,2285,2212,73,3.2
CN4603900000000,46,039,Deuel County, SD,Aug-17,2221,2148,73,3.3
CN4603900000000,46,039,Deuel County, SD,Sep-17,2195,2120,75,3.4
CN4603900000000,46,039,Deuel County, SD,Oct-17,2181,2107,74,3.4
CN4603900000000,46,039,Deuel County, SD,Nov-17,2150,2047,103,4.8
CN4603900000000,46,039,Deuel County, SD,Dec-17,2166,2027,139,6.4
CN4603900000000,46,039,Deuel County, SD,Jan-18,2142,1978,164,7.7
CN4603900000000,46,039,Deuel County, SD,Feb-18,2127,1983,144,6.8
CN4603900000000,46,039,Deuel County, SD,Mar-18,2152,2020,132,6.1
CN4603900000000,46,039,Deuel County, SD,Apr-18(p),2158,2047,111,5.1
CN1910300000000,19,103,Johnson County, IA,Mar-17,85447,83205,2242,2.6
CN1910300000000,19,103,Johnson County, IA,Apr-17,85333,83356,1977,2.3
CN1910300000000,19,103,Johnson County, IA,May-17,83957,81973,1984,2.4
CN1910300000000,19,103,Johnson County, IA,Jun-17,84122,81684,2438,2.9
CN1910300000000,19,103,Johnson County, IA,Jul-17,84567,82320,2247,2.7
CN1910300000000,19,103,Johnson County, IA,Aug-17,85199,82846,2353,2.8
CN1910300000000,19,103,Johnson County, IA,Sep-17,85564,83556,2008,2.3
CN1910300000000,19,103,Johnson County, IA,Oct-17,85144,83528,1616,1.9
CN1910300000000,19,103,Johnson County, IA,Nov-17,85214,83535,1679,2.0
CN1910300000000,19,103,Johnson County, IA,Dec-17,83970,82212,1758,2.1
CN1910300000000,19,103,Johnson County, IA,Jan-18,84031,82056,1975,2.4
CN1910300000000,19,103,Johnson County, IA,Feb-18,85473,83488,1985,2.3
CN1910300000000,19,103,Johnson County, IA,Mar-18,85764,83992,1772,2.1
CN1910300000000,19,103,Johnson County, IA,Apr-18(p),85814,84218,1596,1.9
CN1321900000000,13,219,Oconee County, GA,Mar-17,19024,18350,674,3.5
CN1321900000000,13,219,Oconee County, GA,Apr-17,19335,18701,634,3.3
CN1321900000000,13,219,Oconee County, GA,May-17,19181,18539,642,3.3
CN1321900000000,13,219,Oconee County, GA,Jun-17,19406,18651,755,3.9
CN1321900000000,13,219,Oconee County, GA,Jul-17,19277,18533,744,3.9
CN1321900000000,13,219,Oconee County, GA,Aug-17,19173,18450,723,3.8
CN1321900000000,13,219,Oconee County, GA,Sep-17,19516,18841,675,3.5
CN1321900000000,13,219,Oconee County, GA,Oct-17,19480,18822,658,3.4
CN1321900000000,13,219,Oconee County, GA,Nov-17,19508,18889,619,3.2
CN1321900000000,13,219,Oconee County, GA,Dec-17,19235,18621,614,3.2
CN1321900000000,13,219,Oconee County, GA,Jan-18,19464,18846,618,3.2
CN1321900000000,13,219,Oconee County, GA,Feb-18,19829,19180,649,3.3
CN1321900000000,13,219,Oconee County, GA,Mar-18,19788,19193,595,3.0
CN1321900000000,13,219,Oconee County, GA,Apr-18(p),19824,19296,528,2.7
CN1814100000000,18,141,St. Joseph County, IN,Mar-17,134137,129157,4980,3.7
CN1814100000000,18,141,St. Joseph County, IN,Apr-17,134095,130065,4030,3.0
CN1814100000000,18,141,St. Joseph County, IN,May-17,134379,130111,4268,3.2
CN1814100000000,18,141,St. Joseph County, IN,Jun-17,134546,129810,4736,3.5
CN1814100000000,18,141,St. Joseph County, IN,Jul-17,133142,128241,4901,3.7
CN1814100000000,18,141,St. Joseph County, IN,Aug-17,131133,125826,5307,4.0
CN1814100000000,18,141,St. Joseph County, IN,Sep-17,134793,130377,4416,3.3
CN1814100000000,18,141,St. Joseph County, IN,Oct-17,134373,130069,4304,3.2
CN1814100000000,18,141,St. Joseph County, IN,Nov-17,133654,129162,4492,3.4
CN1814100000000,18,141,St. Joseph County, IN,Dec-17,133267,128951,4316,3.2
CN1814100000000,18,141,St. Joseph County, IN,Jan-18,133674,128903,4771,3.6
CN1814100000000,18,141,St. Joseph County, IN,Feb-18,136238,131111,5127,3.8
CN1814100000000,18,141,St. Joseph County, IN,Mar-18,136914,132308,4606,3.4
CN1814100000000,18,141,St. Joseph County, IN,Apr-18(p),137442,133277,4165,3.0
CN3502700000000,35,027,Lincoln County, NM,Mar-17,8418,7935,483,5.7
CN3502700000000,35,027,Lincoln County, NM,Apr-17,8441,8017,424,5.0
CN3502700000000,35,027,Lincoln County, NM,May-17,8656,8240,416,4.8
CN3502700000000,35,027,Lincoln County, NM,Jun-17,9040,8531,509,5.6
CN3502700000000,35,027,Lincoln County, NM,Jul-17,9060,8546,514,5.7
CN3502700000000,35,027,Lincoln County, NM,Aug-17,9078,8612,466,5.1
CN3502700000000,35,027,Lincoln County, NM,Sep-17,8645,8199,446,5.2
CN3502700000000,35,027,Lincoln County, NM,Oct-17,8579,8099,480,5.6
CN3502700000000,35,027,Lincoln County, NM,Nov-17,8519,8034,485,5.7
CN3502700000000,35,027,Lincoln County, NM,Dec-17,8599,8136,463,5.4
CN3502700000000,35,027,Lincoln County, NM,Jan-18,8563,8094,469,5.5
CN3502700000000,35,027,Lincoln County, NM,Feb-18,8427,7991,436,5.2
CN3502700000000,35,027,Lincoln County, NM,Mar-18,8435,8042,393,4.7
CN3502700000000,35,027,Lincoln County, NM,Apr-18(p),8501,8185,316,3.7
CN3714300000000,37,143,Perquimans County, NC,Mar-17,5191,4898,293,5.6
CN3714300000000,37,143,Perquimans County, NC,Apr-17,5183,4916,267,5.2
CN3714300000000,37,143,Perquimans County, NC,May-17,5138,4861,277,5.4
CN3714300000000,37,143,Perquimans County, NC,Jun-17,5074,4787,287,5.7
CN3714300000000,37,143,Perquimans County, NC,Jul-17,5195,4896,299,5.8
CN3714300000000,37,143,Perquimans County, NC,Aug-17,5062,4764,298,5.9
CN3714300000000,37,143,Perquimans County, NC,Sep-17,5120,4865,255,5.0
CN3714300000000,37,143,Perquimans County, NC,Oct-17,5114,4847,267,5.2
CN3714300000000,37,143,Perquimans County, NC,Nov-17,5073,4768,305,6.0
CN3714300000000,37,143,Perquimans County, NC,Dec-17,5077,4780,297,5.8
CN3714300000000,37,143,Perquimans County, NC,Jan-18,5041,4750,291,5.8
CN3714300000000,37,143,Perquimans County, NC,Feb-18,5165,4880,285,5.5
CN3714300000000,37,143,Perquimans County, NC,Mar-18,5133,4863,270,5.3
CN3714300000000,37,143,Perquimans County, NC,Apr-18(p),5149,4917,232,4.5
CN4602500000000,46,025,Clark County, SD,Mar-17,1902,1789,113,5.9
CN4602500000000,46,025,Clark County, SD,Apr-17,1942,1847,95,4.9
CN4602500000000,46,025,Clark County, SD,May-17,1942,1866,76,3.9
CN4602500000000,46,025,Clark County, SD,Jun-17,2014,1933,81,4.0
CN4602500000000,46,025,Clark County, SD,Jul-17,1933,1865,68,3.5
CN4602500000000,46,025,Clark County, SD,Aug-17,1874,1806,68,3.6
CN4602500000000,46,025,Clark County, SD,Sep-17,1865,1799,66,3.5
CN4602500000000,46,025,Clark County, SD,Oct-17,1832,1773,59,3.2
CN4602500000000,46,025,Clark County, SD,Nov-17,1807,1740,67,3.7
CN4602500000000,46,025,Clark County, SD,Dec-17,1884,1778,106,5.6
CN4602500000000,46,025,Clark County, SD,Jan-18,1882,1767,115,6.1
CN4602500000000,46,025,Clark County, SD,Feb-18,1875,1749,126,6.7
CN4602500000000,46,025,Clark County, SD,Mar-18,1888,1780,108,5.7
CN4602500000000,46,025,Clark County, SD,Apr-18(p),1846,1755,91,4.9
CN5116900000000,51,169,Scott County, VA,Mar-17,9451,9033,418,4.4
CN5116900000000,51,169,Scott County, VA,Apr-17,9477,9111,366,3.9
CN5116900000000,51,169,Scott County, VA,May-17,9492,9098,394,4.2
CN5116900000000,51,169,Scott County, VA,Jun-17,9397,8999,398,4.2
CN5116900000000,51,169,Scott County, VA,Jul-17,9406,9012,394,4.2
CN5116900000000,51,169,Scott County, VA,Aug-17,9379,8995,384,4.1
CN5116900000000,51,169,Scott County, VA,Sep-17,9437,9082,355,3.8
CN5116900000000,51,169,Scott County, VA,Oct-17,9360,9020,340,3.6
CN5116900000000,51,169,Scott County, VA,Nov-17,9310,8980,330,3.5
CN5116900000000,51,169,Scott County, VA,Dec-17,9295,8972,323,3.5
CN5116900000000,51,169,Scott County, VA,Jan-18,9312,8934,378,4.1
CN5116900000000,51,169,Scott County, VA,Feb-18,9406,9069,337,3.6
CN5116900000000,51,169,Scott County, VA,Mar-18,9436,9107,329,3.5
CN5116900000000,51,169,Scott County, VA,Apr-18(p),9486,9208,278,2.9
CN4717100000000,47,171,Unicoi County, TN,Mar-17,7088,6689,399,5.6
CN4717100000000,47,171,Unicoi County, TN,Apr-17,7076,6750,326,4.6
CN4717100000000,47,171,Unicoi County, TN,May-17,6970,6642,328,4.7
CN4717100000000,47,171,Unicoi County, TN,Jun-17,6944,6546,398,5.7
CN4717100000000,47,171,Unicoi County, TN,Jul-17,7002,6613,389,5.6
CN4717100000000,47,171,Unicoi County, TN,Aug-17,7036,6653,383,5.4
CN4717100000000,47,171,Unicoi County, TN,Sep-17,7114,6771,343,4.8
CN4717100000000,47,171,Unicoi County, TN,Oct-17,7055,6738,317,4.5
CN4717100000000,47,171,Unicoi County, TN,Nov-17,7010,6707,303,4.3
CN4717100000000,47,171,Unicoi County, TN,Dec-17,7008,6694,314,4.5
CN4717100000000,47,171,Unicoi County, TN,Jan-18,6982,6556,426,6.1
CN4717100000000,47,171,Unicoi County, TN,Feb-18,7080,6697,383,5.4
CN4717100000000,47,171,Unicoi County, TN,Mar-18,7020,6677,343,4.9
CN4717100000000,47,171,Unicoi County, TN,Apr-18(p),7039,6766,273,3.9
CN4507700000000,45,077,Pickens County, SC,Mar-17,56478,54272,2206,3.9
CN4507700000000,45,077,Pickens County, SC,Apr-17,56289,54337,1952,3.5
CN4507700000000,45,077,Pickens County, SC,May-17,56559,54450,2109,3.7
CN4507700000000,45,077,Pickens County, SC,Jun-17,57088,54503,2585,4.5
CN4507700000000,45,077,Pickens County, SC,Jul-17,56911,54368,2543,4.5
CN4507700000000,45,077,Pickens County, SC,Aug-17,56875,54256,2619,4.6
CN4507700000000,45,077,Pickens County, SC,Sep-17,56840,54580,2260,4.0
CN4507700000000,45,077,Pickens County, SC,Oct-17,56834,54652,2182,3.8
CN4507700000000,45,077,Pickens County, SC,Nov-17,56702,54503,2199,3.9
CN4507700000000,45,077,Pickens County, SC,Dec-17,56639,54396,2243,4.0
CN4507700000000,45,077,Pickens County, SC,Jan-18,56959,54189,2770,4.9
CN4507700000000,45,077,Pickens County, SC,Feb-18,57056,54561,2495,4.4
CN4507700000000,45,077,Pickens County, SC,Mar-18,57218,54967,2251,3.9
CN4507700000000,45,077,Pickens County, SC,Apr-18(p),56213,54749,1464,2.6
CN4804900000000,48,049,Brown County, TX,Mar-17,16393,15730,663,4.0
CN4804900000000,48,049,Brown County, TX,Apr-17,16085,15528,557,3.5
CN4804900000000,48,049,Brown County, TX,May-17,16119,15505,614,3.8
CN4804900000000,48,049,Brown County, TX,Jun-17,16218,15534,684,4.2
CN4804900000000,48,049,Brown County, TX,Jul-17,16096,15401,695,4.3
CN4804900000000,48,049,Brown County, TX,Aug-17,16191,15520,671,4.1
CN4804900000000,48,049,Brown County, TX,Sep-17,16314,15737,577,3.5
CN4804900000000,48,049,Brown County, TX,Oct-17,15994,15466,528,3.3
CN4804900000000,48,049,Brown County, TX,Nov-17,16243,15689,554,3.4
CN4804900000000,48,049,Brown County, TX,Dec-17,16228,15692,536,3.3
CN4804900000000,48,049,Brown County, TX,Jan-18,16186,15585,601,3.7
CN4804900000000,48,049,Brown County, TX,Feb-18,16413,15790,623,3.8
CN4804900000000,48,049,Brown County, TX,Mar-18,16623,15974,649,3.9
CN4804900000000,48,049,Brown County, TX,Apr-18(p),16265,15707,558,3.4
CN2203300000000,22,033,East Baton Rouge Parish, LA,Mar-17,232617,222224,10393,4.5
CN2203300000000,22,033,East Baton Rouge Parish, LA,Apr-17,232156,222235,9921,4.3
CN2203300000000,22,033,East Baton Rouge Parish, LA,May-17,230584,220506,10078,4.4
CN2203300000000,22,033,East Baton Rouge Parish, LA,Jun-17,232906,220852,12054,5.2
CN2203300000000,22,033,East Baton Rouge Parish, LA,Jul-17,234031,222452,11579,4.9
CN2203300000000,22,033,East Baton Rouge Parish, LA,Aug-17,233831,222423,11408,4.9
CN2203300000000,22,033,East Baton Rouge Parish, LA,Sep-17,234801,224860,9941,4.2
CN2203300000000,22,033,East Baton Rouge Parish, LA,Oct-17,234025,225429,8596,3.7
CN2203300000000,22,033,East Baton Rouge Parish, LA,Nov-17,235062,226580,8482,3.6
CN2203300000000,22,033,East Baton Rouge Parish, LA,Dec-17,232539,224677,7862,3.4
CN2203300000000,22,033,East Baton Rouge Parish, LA,Jan-18,232562,223702,8860,3.8
CN2203300000000,22,033,East Baton Rouge Parish, LA,Feb-18,235559,227531,8028,3.4
CN2203300000000,22,033,East Baton Rouge Parish, LA,Mar-18,236769,227979,8790,3.7
CN2203300000000,22,033,East Baton Rouge Parish, LA,Apr-18(p),237676,228816,8860,3.7
CN0500500000000,05,005,Baxter County, AR,Mar-17,16403,15754,649,4.0
CN0500500000000,05,005,Baxter County, AR,Apr-17,16414,15825,589,3.6
CN0500500000000,05,005,Baxter County, AR,May-17,16524,15874,650,3.9
CN0500500000000,05,005,Baxter County, AR,Jun-17,16443,15728,715,4.3
CN0500500000000,05,005,Baxter County, AR,Jul-17,16554,15784,770,4.7
CN0500500000000,05,005,Baxter County, AR,Aug-17,16499,15794,705,4.3
CN0500500000000,05,005,Baxter County, AR,Sep-17,16774,16066,708,4.2
CN0500500000000,05,005,Baxter County, AR,Oct-17,16302,15684,618,3.8
CN0500500000000,05,005,Baxter County, AR,Nov-17,16322,15685,637,3.9
CN0500500000000,05,005,Baxter County, AR,Dec-17,16200,15511,689,4.3
CN0500500000000,05,005,Baxter County, AR,Jan-18,16058,15227,831,5.2
CN0500500000000,05,005,Baxter County, AR,Feb-18,16287,15532,755,4.6
CN0500500000000,05,005,Baxter County, AR,Mar-18,16463,15755,708,4.3
CN0500500000000,05,005,Baxter County, AR,Apr-18(p),16440,15838,602,3.7
CN5513900000000,55,139,Winnebago County, WI,Mar-17,93684,90794,2890,3.1
CN5513900000000,55,139,Winnebago County, WI,Apr-17,94042,91488,2554,2.7
CN5513900000000,55,139,Winnebago County, WI,May-17,93695,91002,2693,2.9
CN5513900000000,55,139,Winnebago County, WI,Jun-17,94919,91584,3335,3.5
CN5513900000000,55,139,Winnebago County, WI,Jul-17,96040,92939,3101,3.2
CN5513900000000,55,139,Winnebago County, WI,Aug-17,94774,91770,3004,3.2
CN5513900000000,55,139,Winnebago County, WI,Sep-17,94342,91771,2571,2.7
CN5513900000000,55,139,Winnebago County, WI,Oct-17,94310,91886,2424,2.6
CN5513900000000,55,139,Winnebago County, WI,Nov-17,94057,91643,2414,2.6
CN5513900000000,55,139,Winnebago County, WI,Dec-17,93739,91525,2214,2.4
CN5513900000000,55,139,Winnebago County, WI,Jan-18,93627,91140,2487,2.7
CN5513900000000,55,139,Winnebago County, WI,Feb-18,95206,92556,2650,2.8
CN5513900000000,55,139,Winnebago County, WI,Mar-18,95148,92578,2570,2.7
CN5513900000000,55,139,Winnebago County, WI,Apr-18(p),94603,92377,2226,2.4
CN2001500000000,20,015,Butler County, KS,Mar-17,31796,30588,1208,3.8
CN2001500000000,20,015,Butler County, KS,Apr-17,31847,30698,1149,3.6
CN2001500000000,20,015,Butler County, KS,May-17,31706,30527,1179,3.7
CN2001500000000,20,015,Butler County, KS,Jun-17,32159,30835,1324,4.1
CN2001500000000,20,015,Butler County, KS,Jul-17,32412,30991,1421,4.4
CN2001500000000,20,015,Butler County, KS,Aug-17,31784,30512,1272,4.0
CN2001500000000,20,015,Butler County, KS,Sep-17,31532,30439,1093,3.5
CN2001500000000,20,015,Butler County, KS,Oct-17,31544,30584,960,3.0
CN2001500000000,20,015,Butler County, KS,Nov-17,31605,30555,1050,3.3
CN2001500000000,20,015,Butler County, KS,Dec-17,31534,30507,1027,3.3
CN2001500000000,20,015,Butler County, KS,Jan-18,31570,30445,1125,3.6
CN2001500000000,20,015,Butler County, KS,Feb-18,31595,30370,1225,3.9
CN2001500000000,20,015,Butler County, KS,Mar-18,31461,30318,1143,3.6
CN2001500000000,20,015,Butler County, KS,Apr-18(p),31558,30479,1079,3.4
CN3102700000000,31,027,Cedar County, NE,Mar-17,4363,4268,95,2.2
CN3102700000000,31,027,Cedar County, NE,Apr-17,4529,4431,98,2.2
CN3102700000000,31,027,Cedar County, NE,May-17,4593,4499,94,2.0
CN3102700000000,31,027,Cedar County, NE,Jun-17,4833,4720,113,2.3
CN3102700000000,31,027,Cedar County, NE,Jul-17,4645,4533,112,2.4
CN3102700000000,31,027,Cedar County, NE,Aug-17,4477,4370,107,2.4
CN3102700000000,31,027,Cedar County, NE,Sep-17,4348,4258,90,2.1
CN3102700000000,31,027,Cedar County, NE,Oct-17,4340,4246,94,2.2
CN3102700000000,31,027,Cedar County, NE,Nov-17,4333,4245,88,2.0
CN3102700000000,31,027,Cedar County, NE,Dec-17,4365,4264,101,2.3
CN3102700000000,31,027,Cedar County, NE,Jan-18,4411,4310,101,2.3
CN3102700000000,31,027,Cedar County, NE,Feb-18,4347,4253,94,2.2
CN3102700000000,31,027,Cedar County, NE,Mar-18,4470,4367,103,2.3
CN3102700000000,31,027,Cedar County, NE,Apr-18(p),4461,4348,113,2.5
CN3105700000000,31,057,Dundy County, NE,Mar-17,1161,1134,27,2.3
CN3105700000000,31,057,Dundy County, NE,Apr-17,1208,1180,28,2.3
CN3105700000000,31,057,Dundy County, NE,May-17,1228,1198,30,2.4
CN3105700000000,31,057,Dundy County, NE,Jun-17,1297,1270,27,2.1
CN3105700000000,31,057,Dundy County, NE,Jul-17,1252,1224,28,2.2
CN3105700000000,31,057,Dundy County, NE,Aug-17,1190,1162,28,2.4
CN3105700000000,31,057,Dundy County, NE,Sep-17,1135,1107,28,2.5
CN3105700000000,31,057,Dundy County, NE,Oct-17,1148,1121,27,2.4
CN3105700000000,31,057,Dundy County, NE,Nov-17,1166,1137,29,2.5
CN3105700000000,31,057,Dundy County, NE,Dec-17,1162,1134,28,2.4
CN3105700000000,31,057,Dundy County, NE,Jan-18,1175,1151,24,2.0
CN3105700000000,31,057,Dundy County, NE,Feb-18,1136,1112,24,2.1
CN3105700000000,31,057,Dundy County, NE,Mar-18,1174,1146,28,2.4
CN3105700000000,31,057,Dundy County, NE,Apr-18(p),1183,1157,26,2.2
CN1208600000000,12,086,Miami-Dade County, FL,Mar-17,1361315,1293285,68030,5.0
CN1208600000000,12,086,Miami-Dade County, FL,Apr-17,1396688,1330848,65840,4.7
CN1208600000000,12,086,Miami-Dade County, FL,May-17,1392720,1326874,65846,4.7
CN1208600000000,12,086,Miami-Dade County, FL,Jun-17,1377043,1309129,67914,4.9
CN1208600000000,12,086,Miami-Dade County, FL,Jul-17,1402620,1333671,68949,4.9
CN1208600000000,12,086,Miami-Dade County, FL,Aug-17,1377698,1307808,69890,5.1
CN1208600000000,12,086,Miami-Dade County, FL,Sep-17,1387270,1320188,67082,4.8
CN1208600000000,12,086,Miami-Dade County, FL,Oct-17,1386660,1321335,65325,4.7
CN1208600000000,12,086,Miami-Dade County, FL,Nov-17,1391504,1328909,62595,4.5
CN1208600000000,12,086,Miami-Dade County, FL,Dec-17,1397491,1332250,65241,4.7
CN1208600000000,12,086,Miami-Dade County, FL,Jan-18,1382526,1317168,65358,4.7
CN1208600000000,12,086,Miami-Dade County, FL,Feb-18,1398781,1333875,64906,4.6
CN1208600000000,12,086,Miami-Dade County, FL,Mar-18,1379957,1311485,68472,5.0
CN1208600000000,12,086,Miami-Dade County, FL,Apr-18(p),1401126,1341714,59412,4.2
CN3700100000000,37,001,Alamance County, NC,Mar-17,80114,76673,3441,4.3
CN3700100000000,37,001,Alamance County, NC,Apr-17,79670,76621,3049,3.8
CN3700100000000,37,001,Alamance County, NC,May-17,79661,76414,3247,4.1
CN3700100000000,37,001,Alamance County, NC,Jun-17,79409,75852,3557,4.5
CN3700100000000,37,001,Alamance County, NC,Jul-17,80300,76551,3749,4.7
CN3700100000000,37,001,Alamance County, NC,Aug-17,79405,75666,3739,4.7
CN3700100000000,37,001,Alamance County, NC,Sep-17,80485,77259,3226,4.0
CN3700100000000,37,001,Alamance County, NC,Oct-17,79973,76763,3210,4.0
CN3700100000000,37,001,Alamance County, NC,Nov-17,80004,76647,3357,4.2
CN3700100000000,37,001,Alamance County, NC,Dec-17,79511,76314,3197,4.0
CN3700100000000,37,001,Alamance County, NC,Jan-18,79025,75632,3393,4.3
CN3700100000000,37,001,Alamance County, NC,Feb-18,80053,76651,3402,4.2
CN3700100000000,37,001,Alamance County, NC,Mar-18,80326,77098,3228,4.0
CN3700100000000,37,001,Alamance County, NC,Apr-18(p),79779,76989,2790,3.5
CN4804300000000,48,043,Brewster County, TX,Mar-17,4023,3872,151,3.8
CN4804300000000,48,043,Brewster County, TX,Apr-17,4070,3942,128,3.1
CN4804300000000,48,043,Brewster County, TX,May-17,4055,3922,133,3.3
CN4804300000000,48,043,Brewster County, TX,Jun-17,3961,3820,141,3.6
CN4804300000000,48,043,Brewster County, TX,Jul-17,3856,3715,141,3.7
CN4804300000000,48,043,Brewster County, TX,Aug-17,3911,3768,143,3.7
CN4804300000000,48,043,Brewster County, TX,Sep-17,3874,3755,119,3.1
CN4804300000000,48,043,Brewster County, TX,Oct-17,3806,3695,111,2.9
CN4804300000000,48,043,Brewster County, TX,Nov-17,3855,3734,121,3.1
CN4804300000000,48,043,Brewster County, TX,Dec-17,3838,3715,123,3.2
CN4804300000000,48,043,Brewster County, TX,Jan-18,3783,3632,151,4.0
CN4804300000000,48,043,Brewster County, TX,Feb-18,3865,3718,147,3.8
CN4804300000000,48,043,Brewster County, TX,Mar-18,3971,3826,145,3.7
CN4804300000000,48,043,Brewster County, TX,Apr-18(p),4138,4006,132,3.2
CN1320500000000,13,205,Mitchell County, GA,Mar-17,8472,7933,539,6.4
CN1320500000000,13,205,Mitchell County, GA,Apr-17,8466,7944,522,6.2
CN1320500000000,13,205,Mitchell County, GA,May-17,8537,7992,545,6.4
CN1320500000000,13,205,Mitchell County, GA,Jun-17,8606,8036,570,6.6
CN1320500000000,13,205,Mitchell County, GA,Jul-17,8522,7942,580,6.8
CN1320500000000,13,205,Mitchell County, GA,Aug-17,8512,7928,584,6.9
CN1320500000000,13,205,Mitchell County, GA,Sep-17,8422,7909,513,6.1
CN1320500000000,13,205,Mitchell County, GA,Oct-17,8523,8047,476,5.6
CN1320500000000,13,205,Mitchell County, GA,Nov-17,8539,8073,466,5.5
CN1320500000000,13,205,Mitchell County, GA,Dec-17,8562,8072,490,5.7
CN1320500000000,13,205,Mitchell County, GA,Jan-18,8713,8195,518,5.9
CN1320500000000,13,205,Mitchell County, GA,Feb-18,8516,8012,504,5.9
CN1320500000000,13,205,Mitchell County, GA,Mar-18,8433,7989,444,5.3
CN1320500000000,13,205,Mitchell County, GA,Apr-18(p),8380,7964,416,5.0
CN4801300000000,48,013,Atascosa County, TX,Mar-17,21237,20274,963,4.5
CN4801300000000,48,013,Atascosa County, TX,Apr-17,21192,20334,858,4.0
CN4801300000000,48,013,Atascosa County, TX,May-17,21137,20290,847,4.0
CN4801300000000,48,013,Atascosa County, TX,Jun-17,21234,20313,921,4.3
CN4801300000000,48,013,Atascosa County, TX,Jul-17,21213,20301,912,4.3
CN4801300000000,48,013,Atascosa County, TX,Aug-17,21171,20267,904,4.3
CN4801300000000,48,013,Atascosa County, TX,Sep-17,21289,20478,811,3.8
CN4801300000000,48,013,Atascosa County, TX,Oct-17,21182,20426,756,3.6
CN4801300000000,48,013,Atascosa County, TX,Nov-17,21159,20390,769,3.6
CN4801300000000,48,013,Atascosa County, TX,Dec-17,21214,20477,737,3.5
CN4801300000000,48,013,Atascosa County, TX,Jan-18,21171,20352,819,3.9
CN4801300000000,48,013,Atascosa County, TX,Feb-18,21511,20676,835,3.9
CN4801300000000,48,013,Atascosa County, TX,Mar-18,21620,20779,841,3.9
CN4801300000000,48,013,Atascosa County, TX,Apr-18(p),21550,20784,766,3.6
CN4209100000000,42,091,Montgomery County, PA,Mar-17,447700,430187,17513,3.9
CN4209100000000,42,091,Montgomery County, PA,Apr-17,448510,432592,15918,3.5
CN4209100000000,42,091,Montgomery County, PA,May-17,449663,432004,17659,3.9
CN4209100000000,42,091,Montgomery County, PA,Jun-17,452492,434795,17697,3.9
CN4209100000000,42,091,Montgomery County, PA,Jul-17,455782,436228,19554,4.3
CN4209100000000,42,091,Montgomery County, PA,Aug-17,451123,431873,19250,4.3
CN4209100000000,42,091,Montgomery County, PA,Sep-17,448299,431978,16321,3.6
CN4209100000000,42,091,Montgomery County, PA,Oct-17,446948,431426,15522,3.5
CN4209100000000,42,091,Montgomery County, PA,Nov-17,446748,431127,15621,3.5
CN4209100000000,42,091,Montgomery County, PA,Dec-17,444002,429130,14872,3.3
CN4209100000000,42,091,Montgomery County, PA,Jan-18,443406,425716,17690,4.0
CN4209100000000,42,091,Montgomery County, PA,Feb-18,444159,426264,17895,4.0
CN4209100000000,42,091,Montgomery County, PA,Mar-18,441127,425484,15643,3.5
CN4209100000000,42,091,Montgomery County, PA,Apr-18(p),443369,429333,14036,3.2
CN0611500000000,06,115,Yuba County, CA,Mar-17,28428,25900,2528,8.9
CN0611500000000,06,115,Yuba County, CA,Apr-17,28430,26160,2270,8.0
CN0611500000000,06,115,Yuba County, CA,May-17,28452,26489,1963,6.9
CN0611500000000,06,115,Yuba County, CA,Jun-17,28760,26711,2049,7.1
CN0611500000000,06,115,Yuba County, CA,Jul-17,28616,26505,2111,7.4
CN0611500000000,06,115,Yuba County, CA,Aug-17,28913,26904,2009,6.9
CN0611500000000,06,115,Yuba County, CA,Sep-17,28917,27165,1752,6.1
CN0611500000000,06,115,Yuba County, CA,Oct-17,28522,26823,1699,6.0
CN0611500000000,06,115,Yuba County, CA,Nov-17,28531,26747,1784,6.3
CN0611500000000,06,115,Yuba County, CA,Dec-17,28554,26651,1903,6.7
CN0611500000000,06,115,Yuba County, CA,Jan-18,28671,26505,2166,7.6
CN0611500000000,06,115,Yuba County, CA,Feb-18,28622,26451,2171,7.6
CN0611500000000,06,115,Yuba County, CA,Mar-18,28763,26652,2111,7.3
CN0611500000000,06,115,Yuba County, CA,Apr-18(p),28368,26578,1790,6.3
CN4611500000000,46,115,Spink County, SD,Mar-17,3235,3101,134,4.1
CN4611500000000,46,115,Spink County, SD,Apr-17,3265,3154,111,3.4
CN4611500000000,46,115,Spink County, SD,May-17,3311,3205,106,3.2
CN4611500000000,46,115,Spink County, SD,Jun-17,3403,3297,106,3.1
CN4611500000000,46,115,Spink County, SD,Jul-17,3310,3218,92,2.8
CN4611500000000,46,115,Spink County, SD,Aug-17,3223,3119,104,3.2
CN4611500000000,46,115,Spink County, SD,Sep-17,3165,3074,91,2.9
CN4611500000000,46,115,Spink County, SD,Oct-17,3128,3034,94,3.0
CN4611500000000,46,115,Spink County, SD,Nov-17,3112,3005,107,3.4
CN4611500000000,46,115,Spink County, SD,Dec-17,3198,3068,130,4.1
CN4611500000000,46,115,Spink County, SD,Jan-18,3205,3037,168,5.2
CN4611500000000,46,115,Spink County, SD,Feb-18,3196,3038,158,4.9
CN4611500000000,46,115,Spink County, SD,Mar-18,3259,3105,154,4.7
CN4611500000000,46,115,Spink County, SD,Apr-18(p),3171,3037,134,4.2
CN5510300000000,55,103,Richland County, WI,Mar-17,9252,8916,336,3.6
CN5510300000000,55,103,Richland County, WI,Apr-17,9327,9067,260,2.8
CN5510300000000,55,103,Richland County, WI,May-17,9384,9133,251,2.7
CN5510300000000,55,103,Richland County, WI,Jun-17,9722,9424,298,3.1
CN5510300000000,55,103,Richland County, WI,Jul-17,9500,9229,271,2.9
CN5510300000000,55,103,Richland County, WI,Aug-17,9364,9122,242,2.6
CN5510300000000,55,103,Richland County, WI,Sep-17,9382,9140,242,2.6
CN5510300000000,55,103,Richland County, WI,Oct-17,9442,9206,236,2.5
CN5510300000000,55,103,Richland County, WI,Nov-17,9473,9236,237,2.5
CN5510300000000,55,103,Richland County, WI,Dec-17,9506,9279,227,2.4
CN5510300000000,55,103,Richland County, WI,Jan-18,9440,9151,289,3.1
CN5510300000000,55,103,Richland County, WI,Feb-18,9397,9091,306,3.3
CN5510300000000,55,103,Richland County, WI,Mar-18,9493,9201,292,3.1
CN5510300000000,55,103,Richland County, WI,Apr-18(p),9311,9100,211,2.3
CN3902500000000,39,025,Clermont County, OH,Mar-17,104616,100089,4527,4.3
CN3902500000000,39,025,Clermont County, OH,Apr-17,104581,100553,4028,3.9
CN3902500000000,39,025,Clermont County, OH,May-17,105506,101395,4111,3.9
CN3902500000000,39,025,Clermont County, OH,Jun-17,106924,102002,4922,4.6
CN3902500000000,39,025,Clermont County, OH,Jul-17,107232,102265,4967,4.6
CN3902500000000,39,025,Clermont County, OH,Aug-17,106795,101808,4987,4.7
CN3902500000000,39,025,Clermont County, OH,Sep-17,105884,101502,4382,4.1
CN3902500000000,39,025,Clermont County, OH,Oct-17,105736,101441,4295,4.1
CN3902500000000,39,025,Clermont County, OH,Nov-17,105190,101027,4163,4.0
CN3902500000000,39,025,Clermont County, OH,Dec-17,104897,100647,4250,4.1
CN3902500000000,39,025,Clermont County, OH,Jan-18,103566,98901,4665,4.5
CN3902500000000,39,025,Clermont County, OH,Feb-18,104707,100345,4362,4.2
CN3902500000000,39,025,Clermont County, OH,Mar-18,105844,101736,4108,3.9
CN3902500000000,39,025,Clermont County, OH,Apr-18(p),105551,101670,3881,3.7
CN4206900000000,42,069,Lackawanna County, PA,Mar-17,105878,99960,5918,5.6
CN4206900000000,42,069,Lackawanna County, PA,Apr-17,105811,100812,4999,4.7
CN4206900000000,42,069,Lackawanna County, PA,May-17,106123,100785,5338,5.0
CN4206900000000,42,069,Lackawanna County, PA,Jun-17,106544,100957,5587,5.2
CN4206900000000,42,069,Lackawanna County, PA,Jul-17,107173,101089,6084,5.7
CN4206900000000,42,069,Lackawanna County, PA,Aug-17,106267,100210,6057,5.7
CN4206900000000,42,069,Lackawanna County, PA,Sep-17,106610,101757,4853,4.6
CN4206900000000,42,069,Lackawanna County, PA,Oct-17,106295,101548,4747,4.5
CN4206900000000,42,069,Lackawanna County, PA,Nov-17,107039,102265,4774,4.5
CN4206900000000,42,069,Lackawanna County, PA,Dec-17,106099,101383,4716,4.4
CN4206900000000,42,069,Lackawanna County, PA,Jan-18,106058,100229,5829,5.5
CN4206900000000,42,069,Lackawanna County, PA,Feb-18,105654,99942,5712,5.4
CN4206900000000,42,069,Lackawanna County, PA,Mar-18,104757,99687,5070,4.8
CN4206900000000,42,069,Lackawanna County, PA,Apr-18(p),105106,100680,4426,4.2
CN2203900000000,22,039,Evangeline Parish, LA,Mar-17,12678,11934,744,5.9
CN2203900000000,22,039,Evangeline Parish, LA,Apr-17,12588,11864,724,5.8
CN2203900000000,22,039,Evangeline Parish, LA,May-17,12644,11909,735,5.8
CN2203900000000,22,039,Evangeline Parish, LA,Jun-17,12920,12043,877,6.8
CN2203900000000,22,039,Evangeline Parish, LA,Jul-17,12665,11832,833,6.6
CN2203900000000,22,039,Evangeline Parish, LA,Aug-17,12527,11726,801,6.4
CN2203900000000,22,039,Evangeline Parish, LA,Sep-17,12676,11951,725,5.7
CN2203900000000,22,039,Evangeline Parish, LA,Oct-17,12500,11868,632,5.1
CN2203900000000,22,039,Evangeline Parish, LA,Nov-17,12448,11826,622,5.0
CN2203900000000,22,039,Evangeline Parish, LA,Dec-17,12379,11797,582,4.7
CN2203900000000,22,039,Evangeline Parish, LA,Jan-18,12496,11842,654,5.2
CN2203900000000,22,039,Evangeline Parish, LA,Feb-18,12583,11993,590,4.7
CN2203900000000,22,039,Evangeline Parish, LA,Mar-18,12720,12081,639,5.0
CN2203900000000,22,039,Evangeline Parish, LA,Apr-18(p),12642,12010,632,5.0
CN0507700000000,05,077,Lee County, AR,Mar-17,2992,2850,142,4.7
CN0507700000000,05,077,Lee County, AR,Apr-17,3000,2880,120,4.0
CN0507700000000,05,077,Lee County, AR,May-17,3022,2894,128,4.2
CN0507700000000,05,077,Lee County, AR,Jun-17,3051,2899,152,5.0
CN0507700000000,05,077,Lee County, AR,Jul-17,3083,2918,165,5.4
CN0507700000000,05,077,Lee County, AR,Aug-17,3005,2858,147,4.9
CN0507700000000,05,077,Lee County, AR,Sep-17,2974,2833,141,4.7
CN0507700000000,05,077,Lee County, AR,Oct-17,2918,2795,123,4.2
CN0507700000000,05,077,Lee County, AR,Nov-17,2869,2752,117,4.1
CN0507700000000,05,077,Lee County, AR,Dec-17,2859,2734,125,4.4
CN0507700000000,05,077,Lee County, AR,Jan-18,2793,2618,175,6.3
CN0507700000000,05,077,Lee County, AR,Feb-18,2868,2699,169,5.9
CN0507700000000,05,077,Lee County, AR,Mar-18,2877,2723,154,5.4
CN0507700000000,05,077,Lee County, AR,Apr-18(p),2891,2758,133,4.6
CN4835100000000,48,351,Newton County, TX,Mar-17,5385,4965,420,7.8
CN4835100000000,48,351,Newton County, TX,Apr-17,5355,4957,398,7.4
CN4835100000000,48,351,Newton County, TX,May-17,5327,4932,395,7.4
CN4835100000000,48,351,Newton County, TX,Jun-17,5362,4914,448,8.4
CN4835100000000,48,351,Newton County, TX,Jul-17,5311,4873,438,8.2
CN4835100000000,48,351,Newton County, TX,Aug-17,5239,4821,418,8.0
CN4835100000000,48,351,Newton County, TX,Sep-17,5244,4832,412,7.9
CN4835100000000,48,351,Newton County, TX,Oct-17,5242,4891,351,6.7
CN4835100000000,48,351,Newton County, TX,Nov-17,5258,4883,375,7.1
CN4835100000000,48,351,Newton County, TX,Dec-17,5265,4873,392,7.4
CN4835100000000,48,351,Newton County, TX,Jan-18,5306,4865,441,8.3
CN4835100000000,48,351,Newton County, TX,Feb-18,5331,4937,394,7.4
CN4835100000000,48,351,Newton County, TX,Mar-18,5341,4959,382,7.2
CN4835100000000,48,351,Newton County, TX,Apr-18(p),5298,4934,364,6.9
CN5513300000000,55,133,Waukesha County, WI,Mar-17,225940,219167,6773,3.0
CN5513300000000,55,133,Waukesha County, WI,Apr-17,224641,218703,5938,2.6
CN5513300000000,55,133,Waukesha County, WI,May-17,225353,219213,6140,2.7
CN5513300000000,55,133,Waukesha County, WI,Jun-17,228045,220438,7607,3.3
CN5513300000000,55,133,Waukesha County, WI,Jul-17,230206,222972,7234,3.1
CN5513300000000,55,133,Waukesha County, WI,Aug-17,229577,222482,7095,3.1
CN5513300000000,55,133,Waukesha County, WI,Sep-17,228109,221994,6115,2.7
CN5513300000000,55,133,Waukesha County, WI,Oct-17,226620,220845,5775,2.5
CN5513300000000,55,133,Waukesha County, WI,Nov-17,226164,220423,5741,2.5
CN5513300000000,55,133,Waukesha County, WI,Dec-17,224240,219096,5144,2.3
CN5513300000000,55,133,Waukesha County, WI,Jan-18,224813,218946,5867,2.6
CN5513300000000,55,133,Waukesha County, WI,Feb-18,228475,222225,6250,2.7
CN5513300000000,55,133,Waukesha County, WI,Mar-18,229099,223083,6016,2.6
CN5513300000000,55,133,Waukesha County, WI,Apr-18(p),227651,222599,5052,2.2
CN4708100000000,47,081,Hickman County, TN,Mar-17,10711,10300,411,3.8
CN4708100000000,47,081,Hickman County, TN,Apr-17,10706,10372,334,3.1
CN4708100000000,47,081,Hickman County, TN,May-17,10702,10384,318,3.0
CN4708100000000,47,081,Hickman County, TN,Jun-17,10881,10473,408,3.7
CN4708100000000,47,081,Hickman County, TN,Jul-17,10923,10532,391,3.6
CN4708100000000,47,081,Hickman County, TN,Aug-17,10826,10473,353,3.3
CN4708100000000,47,081,Hickman County, TN,Sep-17,10914,10599,315,2.9
CN4708100000000,47,081,Hickman County, TN,Oct-17,10897,10588,309,2.8
CN4708100000000,47,081,Hickman County, TN,Nov-17,10837,10523,314,2.9
CN4708100000000,47,081,Hickman County, TN,Dec-17,10832,10526,306,2.8
CN4708100000000,47,081,Hickman County, TN,Jan-18,10820,10448,372,3.4
CN4708100000000,47,081,Hickman County, TN,Feb-18,10956,10591,365,3.3
CN4708100000000,47,081,Hickman County, TN,Mar-18,10965,10614,351,3.2
CN4708100000000,47,081,Hickman County, TN,Apr-18(p),11037,10745,292,2.6
CN4813900000000,48,139,Ellis County, TX,Mar-17,86510,83277,3233,3.7
CN4813900000000,48,139,Ellis County, TX,Apr-17,86614,83801,2813,3.2
CN4813900000000,48,139,Ellis County, TX,May-17,86562,83606,2956,3.4
CN4813900000000,48,139,Ellis County, TX,Jun-17,87033,83790,3243,3.7
CN4813900000000,48,139,Ellis County, TX,Jul-17,87551,84321,3230,3.7
CN4813900000000,48,139,Ellis County, TX,Aug-17,87251,84139,3112,3.6
CN4813900000000,48,139,Ellis County, TX,Sep-17,87921,85142,2779,3.2
CN4813900000000,48,139,Ellis County, TX,Oct-17,87539,84966,2573,2.9
CN4813900000000,48,139,Ellis County, TX,Nov-17,88282,85600,2682,3.0
CN4813900000000,48,139,Ellis County, TX,Dec-17,87915,85314,2601,3.0
CN4813900000000,48,139,Ellis County, TX,Jan-18,87924,85024,2900,3.3
CN4813900000000,48,139,Ellis County, TX,Feb-18,89217,86207,3010,3.4
CN4813900000000,48,139,Ellis County, TX,Mar-18,89539,86375,3164,3.5
CN4813900000000,48,139,Ellis County, TX,Apr-18(p),89711,86907,2804,3.1
CN4839300000000,48,393,Roberts County, TX,Mar-17,447,427,20,4.5
CN4839300000000,48,393,Roberts County, TX,Apr-17,441,425,16,3.6
CN4839300000000,48,393,Roberts County, TX,May-17,447,431,16,3.6
CN4839300000000,48,393,Roberts County, TX,Jun-17,454,439,15,3.3
CN4839300000000,48,393,Roberts County, TX,Jul-17,434,418,16,3.7
CN4839300000000,48,393,Roberts County, TX,Aug-17,433,416,17,3.9
CN4839300000000,48,393,Roberts County, TX,Sep-17,431,419,12,2.8
CN4839300000000,48,393,Roberts County, TX,Oct-17,439,426,13,3.0
CN4839300000000,48,393,Roberts County, TX,Nov-17,428,415,13,3.0
CN4839300000000,48,393,Roberts County, TX,Dec-17,426,414,12,2.8
CN4839300000000,48,393,Roberts County, TX,Jan-18,432,420,12,2.8
CN4839300000000,48,393,Roberts County, TX,Feb-18,434,421,13,3.0
CN4839300000000,48,393,Roberts County, TX,Mar-18,449,436,13,2.9
CN4839300000000,48,393,Roberts County, TX,Apr-18(p),437,425,12,2.7
CN3704500000000,37,045,Cleveland County, NC,Mar-17,47636,45418,2218,4.7
CN3704500000000,37,045,Cleveland County, NC,Apr-17,47617,45627,1990,4.2
CN3704500000000,37,045,Cleveland County, NC,May-17,47322,45220,2102,4.4
CN3704500000000,37,045,Cleveland County, NC,Jun-17,47285,45081,2204,4.7
CN3704500000000,37,045,Cleveland County, NC,Jul-17,47439,45076,2363,5.0
CN3704500000000,37,045,Cleveland County, NC,Aug-17,47188,44839,2349,5.0
CN3704500000000,37,045,Cleveland County, NC,Sep-17,47801,45726,2075,4.3
CN3704500000000,37,045,Cleveland County, NC,Oct-17,47877,45729,2148,4.5
CN3704500000000,37,045,Cleveland County, NC,Nov-17,47845,45614,2231,4.7
CN3704500000000,37,045,Cleveland County, NC,Dec-17,47462,45303,2159,4.5
CN3704500000000,37,045,Cleveland County, NC,Jan-18,47803,45473,2330,4.9
CN3704500000000,37,045,Cleveland County, NC,Feb-18,48263,46041,2222,4.6
CN3704500000000,37,045,Cleveland County, NC,Mar-18,48394,46294,2100,4.3
CN3704500000000,37,045,Cleveland County, NC,Apr-18(p),48077,46218,1859,3.9
CN4603300000000,46,033,Custer County, SD,Mar-17,3967,3760,207,5.2
CN4603300000000,46,033,Custer County, SD,Apr-17,4016,3851,165,4.1
CN4603300000000,46,033,Custer County, SD,May-17,4070,3912,158,3.9
CN4603300000000,46,033,Custer County, SD,Jun-17,4179,4035,144,3.4
CN4603300000000,46,033,Custer County, SD,Jul-17,4151,4020,131,3.2
CN4603300000000,46,033,Custer County, SD,Aug-17,4124,3972,152,3.7
CN4603300000000,46,033,Custer County, SD,Sep-17,3993,3844,149,3.7
CN4603300000000,46,033,Custer County, SD,Oct-17,3946,3795,151,3.8
CN4603300000000,46,033,Custer County, SD,Nov-17,3938,3744,194,4.9
CN4603300000000,46,033,Custer County, SD,Dec-17,3959,3760,199,5.0
CN4603300000000,46,033,Custer County, SD,Jan-18,3985,3762,223,5.6
CN4603300000000,46,033,Custer County, SD,Feb-18,4064,3822,242,6.0
CN4603300000000,46,033,Custer County, SD,Mar-18,4098,3869,229,5.6
CN4603300000000,46,033,Custer County, SD,Apr-18(p),4027,3842,185,4.6
CN5603300000000,56,033,Sheridan County, WY,Mar-17,15779,15033,746,4.7
CN5603300000000,56,033,Sheridan County, WY,Apr-17,15783,15184,599,3.8
CN5603300000000,56,033,Sheridan County, WY,May-17,15768,15230,538,3.4
CN5603300000000,56,033,Sheridan County, WY,Jun-17,16255,15667,588,3.6
CN5603300000000,56,033,Sheridan County, WY,Jul-17,16166,15621,545,3.4
CN5603300000000,56,033,Sheridan County, WY,Aug-17,15788,15285,503,3.2
CN5603300000000,56,033,Sheridan County, WY,Sep-17,15601,15081,520,3.3
CN5603300000000,56,033,Sheridan County, WY,Oct-17,15614,15078,536,3.4
CN5603300000000,56,033,Sheridan County, WY,Nov-17,15703,15108,595,3.8
CN5603300000000,56,033,Sheridan County, WY,Dec-17,15530,14889,641,4.1
CN5603300000000,56,033,Sheridan County, WY,Jan-18,15504,14698,806,5.2
CN5603300000000,56,033,Sheridan County, WY,Feb-18,15544,14743,801,5.2
CN5603300000000,56,033,Sheridan County, WY,Mar-18,15745,14972,773,4.9
CN5603300000000,56,033,Sheridan County, WY,Apr-18(p),15507,14883,624,4.0
CN2015100000000,20,151,Pratt County, KS,Mar-17,4984,4818,166,3.3
CN2015100000000,20,151,Pratt County, KS,Apr-17,4963,4801,162,3.3
CN2015100000000,20,151,Pratt County, KS,May-17,4964,4795,169,3.4
CN2015100000000,20,151,Pratt County, KS,Jun-17,5029,4854,175,3.5
CN2015100000000,20,151,Pratt County, KS,Jul-17,4874,4683,191,3.9
CN2015100000000,20,151,Pratt County, KS,Aug-17,4847,4664,183,3.8
CN2015100000000,20,151,Pratt County, KS,Sep-17,4958,4800,158,3.2
CN2015100000000,20,151,Pratt County, KS,Oct-17,4914,4788,126,2.6
CN2015100000000,20,151,Pratt County, KS,Nov-17,4897,4758,139,2.8
CN2015100000000,20,151,Pratt County, KS,Dec-17,4885,4763,122,2.5
CN2015100000000,20,151,Pratt County, KS,Jan-18,4781,4652,129,2.7
CN2015100000000,20,151,Pratt County, KS,Feb-18,4769,4634,135,2.8
CN2015100000000,20,151,Pratt County, KS,Mar-18,4835,4703,132,2.7
CN2015100000000,20,151,Pratt County, KS,Apr-18(p),4776,4644,132,2.8
CN7211100000000,72,111,Penuelas Municipio, PR,Mar-17,6197,5111,1086,17.5
CN7211100000000,72,111,Penuelas Municipio, PR,Apr-17,6194,5048,1146,18.5
CN7211100000000,72,111,Penuelas Municipio, PR,May-17,6052,5019,1033,17.1
CN7211100000000,72,111,Penuelas Municipio, PR,Jun-17,5860,4970,890,15.2
CN7211100000000,72,111,Penuelas Municipio, PR,Jul-17,6169,4959,1210,19.6
CN7211100000000,72,111,Penuelas Municipio, PR,Aug-17,6212,4876,1336,21.5
CN7211100000000,72,111,Penuelas Municipio, PR,Sep-17(y),6006,4924,1082,18.0
CN7211100000000,72,111,Penuelas Municipio, PR,Oct-17,5787,4818,969,16.7
CN7211100000000,72,111,Penuelas Municipio, PR,Nov-17,5936,5060,876,14.8
CN7211100000000,72,111,Penuelas Municipio, PR,Dec-17,5966,5116,850,14.2
CN7211100000000,72,111,Penuelas Municipio, PR,Jan-18,5892,5015,877,14.9
CN7211100000000,72,111,Penuelas Municipio, PR,Feb-18,5850,5007,843,14.4
CN7211100000000,72,111,Penuelas Municipio, PR,Mar-18,5864,5012,852,14.5
CN7211100000000,72,111,Penuelas Municipio, PR,Apr-18(p),5837,5055,782,13.4
CN2906900000000,29,069,Dunklin County, MO,Mar-17,12497,11588,909,7.3
CN2906900000000,29,069,Dunklin County, MO,Apr-17,12768,11940,828,6.5
CN2906900000000,29,069,Dunklin County, MO,May-17,12484,11668,816,6.5
CN2906900000000,29,069,Dunklin County, MO,Jun-17,12574,11685,889,7.1
CN2906900000000,29,069,Dunklin County, MO,Jul-17,11859,10964,895,7.5
CN2906900000000,29,069,Dunklin County, MO,Aug-17,11803,10931,872,7.4
CN2906900000000,29,069,Dunklin County, MO,Sep-17,11848,11199,649,5.5
CN2906900000000,29,069,Dunklin County, MO,Oct-17,11974,11444,530,4.4
CN2906900000000,29,069,Dunklin County, MO,Nov-17,12029,11424,605,5.0
CN2906900000000,29,069,Dunklin County, MO,Dec-17,11875,11200,675,5.7
CN2906900000000,29,069,Dunklin County, MO,Jan-18,12022,11207,815,6.8
CN2906900000000,29,069,Dunklin County, MO,Feb-18,12152,11309,843,6.9
CN2906900000000,29,069,Dunklin County, MO,Mar-18,12059,11291,768,6.4
CN2906900000000,29,069,Dunklin County, MO,Apr-18(p),12228,11525,703,5.7
CN3716300000000,37,163,Sampson County, NC,Mar-17,30550,29124,1426,4.7
CN3716300000000,37,163,Sampson County, NC,Apr-17,30091,28775,1316,4.4
CN3716300000000,37,163,Sampson County, NC,May-17,29480,28139,1341,4.5
CN3716300000000,37,163,Sampson County, NC,Jun-17,28741,27342,1399,4.9
CN3716300000000,37,163,Sampson County, NC,Jul-17,29846,28362,1484,5.0
CN3716300000000,37,163,Sampson County, NC,Aug-17,28922,27423,1499,5.2
CN3716300000000,37,163,Sampson County, NC,Sep-17,29325,28034,1291,4.4
CN3716300000000,37,163,Sampson County, NC,Oct-17,29289,27995,1294,4.4
CN3716300000000,37,163,Sampson County, NC,Nov-17,28660,27278,1382,4.8
CN3716300000000,37,163,Sampson County, NC,Dec-17,28803,27494,1309,4.5
CN3716300000000,37,163,Sampson County, NC,Jan-18,29021,27614,1407,4.8
CN3716300000000,37,163,Sampson County, NC,Feb-18,29909,28502,1407,4.7
CN3716300000000,37,163,Sampson County, NC,Mar-18,29560,28227,1333,4.5
CN3716300000000,37,163,Sampson County, NC,Apr-18(p),29501,28381,1120,3.8
CN3201900000000,32,019,Lyon County, NV,Mar-17,22488,21066,1422,6.3
CN3201900000000,32,019,Lyon County, NV,Apr-17,22287,20965,1322,5.9
CN3201900000000,32,019,Lyon County, NV,May-17,22422,21190,1232,5.5
CN3201900000000,32,019,Lyon County, NV,Jun-17,22707,21403,1304,5.7
CN3201900000000,32,019,Lyon County, NV,Jul-17,21999,20721,1278,5.8
CN3201900000000,32,019,Lyon County, NV,Aug-17,21910,20675,1235,5.6
CN3201900000000,32,019,Lyon County, NV,Sep-17,22019,20801,1218,5.5
CN3201900000000,32,019,Lyon County, NV,Oct-17,21852,20675,1177,5.4
CN3201900000000,32,019,Lyon County, NV,Nov-17,21982,20815,1167,5.3
CN3201900000000,32,019,Lyon County, NV,Dec-17,22013,20790,1223,5.6
CN3201900000000,32,019,Lyon County, NV,Jan-18,21808,20339,1469,6.7
CN3201900000000,32,019,Lyon County, NV,Feb-18,21953,20544,1409,6.4
CN3201900000000,32,019,Lyon County, NV,Mar-18,22265,20837,1428,6.4
CN3201900000000,32,019,Lyon County, NV,Apr-18(p),21851,20548,1303,6.0
CN5100700000000,51,007,Amelia County, VA,Mar-17,6207,5951,256,4.1
CN5100700000000,51,007,Amelia County, VA,Apr-17,6265,6032,233,3.7
CN5100700000000,51,007,Amelia County, VA,May-17,6258,6015,243,3.9
CN5100700000000,51,007,Amelia County, VA,Jun-17,6354,6089,265,4.2
CN5100700000000,51,007,Amelia County, VA,Jul-17,6380,6117,263,4.1
CN5100700000000,51,007,Amelia County, VA,Aug-17,6272,6008,264,4.2
CN5100700000000,51,007,Amelia County, VA,Sep-17,6296,6061,235,3.7
CN5100700000000,51,007,Amelia County, VA,Oct-17,6232,6005,227,3.6
CN5100700000000,51,007,Amelia County, VA,Nov-17,6177,5956,221,3.6
CN5100700000000,51,007,Amelia County, VA,Dec-17,6189,5983,206,3.3
CN5100700000000,51,007,Amelia County, VA,Jan-18,6137,5896,241,3.9
CN5100700000000,51,007,Amelia County, VA,Feb-18,6237,6002,235,3.8
CN5100700000000,51,007,Amelia County, VA,Mar-18,6224,6004,220,3.5
CN5100700000000,51,007,Amelia County, VA,Apr-18(p),6274,6100,174,2.8
CN1811100000000,18,111,Newton County, IN,Mar-17,7000,6610,390,5.6
CN1811100000000,18,111,Newton County, IN,Apr-17,6973,6674,299,4.3
CN1811100000000,18,111,Newton County, IN,May-17,7150,6852,298,4.2
CN1811100000000,18,111,Newton County, IN,Jun-17,7072,6764,308,4.4
CN1811100000000,18,111,Newton County, IN,Jul-17,7011,6696,315,4.5
CN1811100000000,18,111,Newton County, IN,Aug-17,6932,6589,343,4.9
CN1811100000000,18,111,Newton County, IN,Sep-17,6879,6581,298,4.3
CN1811100000000,18,111,Newton County, IN,Oct-17,6913,6632,281,4.1
CN1811100000000,18,111,Newton County, IN,Nov-17,6909,6639,270,3.9
CN1811100000000,18,111,Newton County, IN,Dec-17,6790,6501,289,4.3
CN1811100000000,18,111,Newton County, IN,Jan-18,6737,6384,353,5.2
CN1811100000000,18,111,Newton County, IN,Feb-18,6910,6515,395,5.7
CN1811100000000,18,111,Newton County, IN,Mar-18,6957,6622,335,4.8
CN1811100000000,18,111,Newton County, IN,Apr-18(p),6937,6673,264,3.8
CN5000100000000,50,001,Addison County, VT,Mar-17,20507,19802,705,3.4
CN5000100000000,50,001,Addison County, VT,Apr-17,20504,19926,578,2.8
CN5000100000000,50,001,Addison County, VT,May-17,20857,20364,493,2.4
CN5000100000000,50,001,Addison County, VT,Jun-17,21284,20700,584,2.7
CN5000100000000,50,001,Addison County, VT,Jul-17,21503,20902,601,2.8
CN5000100000000,50,001,Addison County, VT,Aug-17,21372,20770,602,2.8
CN5000100000000,50,001,Addison County, VT,Sep-17,20733,20201,532,2.6
CN5000100000000,50,001,Addison County, VT,Oct-17,20963,20559,404,1.9
CN5000100000000,50,001,Addison County, VT,Nov-17,20902,20414,488,2.3
CN5000100000000,50,001,Addison County, VT,Dec-17,20589,20084,505,2.5
CN5000100000000,50,001,Addison County, VT,Jan-18,20569,19886,683,3.3
CN5000100000000,50,001,Addison County, VT,Feb-18,20678,20029,649,3.1
CN5000100000000,50,001,Addison County, VT,Mar-18,20864,20229,635,3.0
CN5000100000000,50,001,Addison County, VT,Apr-18(p),20768,20226,542,2.6
CN1600900000000,16,009,Benewah County, ID,Mar-17,3989,3593,396,9.9
CN1600900000000,16,009,Benewah County, ID,Apr-17,4026,3640,386,9.6
CN1600900000000,16,009,Benewah County, ID,May-17,4016,3823,193,4.8
CN1600900000000,16,009,Benewah County, ID,Jun-17,4117,3948,169,4.1
CN1600900000000,16,009,Benewah County, ID,Jul-17,4114,3945,169,4.1
CN1600900000000,16,009,Benewah County, ID,Aug-17,4096,3923,173,4.2
CN1600900000000,16,009,Benewah County, ID,Sep-17,3972,3823,149,3.8
CN1600900000000,16,009,Benewah County, ID,Oct-17,3959,3805,154,3.9
CN1600900000000,16,009,Benewah County, ID,Nov-17,3943,3767,176,4.5
CN1600900000000,16,009,Benewah County, ID,Dec-17,3910,3734,176,4.5
CN1600900000000,16,009,Benewah County, ID,Jan-18,3920,3695,225,5.7
CN1600900000000,16,009,Benewah County, ID,Feb-18,3981,3744,237,6.0
CN1600900000000,16,009,Benewah County, ID,Mar-18,4011,3707,304,7.6
CN1600900000000,16,009,Benewah County, ID,Apr-18(p),4079,3767,312,7.6
CN7201900000000,72,019,Barranquitas Municipio, PR,Mar-17,7315,6557,758,10.4
CN7201900000000,72,019,Barranquitas Municipio, PR,Apr-17,7282,6447,835,11.5
CN7201900000000,72,019,Barranquitas Municipio, PR,May-17,7261,6541,720,9.9
CN7201900000000,72,019,Barranquitas Municipio, PR,Jun-17,7264,6531,733,10.1
CN7201900000000,72,019,Barranquitas Municipio, PR,Jul-17,7493,6619,874,11.7
CN7201900000000,72,019,Barranquitas Municipio, PR,Aug-17,7498,6538,960,12.8
CN7201900000000,72,019,Barranquitas Municipio, PR,Sep-17(y),7402,6511,891,12.0
CN7201900000000,72,019,Barranquitas Municipio, PR,Oct-17,7172,6169,1003,14.0
CN7201900000000,72,019,Barranquitas Municipio, PR,Nov-17,7496,6594,902,12.0
CN7201900000000,72,019,Barranquitas Municipio, PR,Dec-17,7486,6618,868,11.6
CN7201900000000,72,019,Barranquitas Municipio, PR,Jan-18,7461,6490,971,13.0
CN7201900000000,72,019,Barranquitas Municipio, PR,Feb-18,7241,6412,829,11.4
CN7201900000000,72,019,Barranquitas Municipio, PR,Mar-18,7207,6440,767,10.6
CN7201900000000,72,019,Barranquitas Municipio, PR,Apr-18(p),7250,6492,758,10.5
CN0219800000000,02,198,Prince of Wales-Hyder Census Area, AK,Mar-17,2778,2398,380,13.7
CN0219800000000,02,198,Prince of Wales-Hyder Census Area, AK,Apr-17,2791,2467,324,11.6
CN0219800000000,02,198,Prince of Wales-Hyder Census Area, AK,May-17,2859,2569,290,10.1
CN0219800000000,02,198,Prince of Wales-Hyder Census Area, AK,Jun-17,3130,2812,318,10.2
CN0219800000000,02,198,Prince of Wales-Hyder Census Area, AK,Jul-17,2967,2693,274,9.2
CN0219800000000,02,198,Prince of Wales-Hyder Census Area, AK,Aug-17,2964,2687,277,9.3
CN0219800000000,02,198,Prince of Wales-Hyder Census Area, AK,Sep-17,2941,2661,280,9.5
CN0219800000000,02,198,Prince of Wales-Hyder Census Area, AK,Oct-17,2677,2389,288,10.8
CN0219800000000,02,198,Prince of Wales-Hyder Census Area, AK,Nov-17,2715,2398,317,11.7
CN0219800000000,02,198,Prince of Wales-Hyder Census Area, AK,Dec-17,2705,2380,325,12.0
CN0219800000000,02,198,Prince of Wales-Hyder Census Area, AK,Jan-18,2739,2338,401,14.6
CN0219800000000,02,198,Prince of Wales-Hyder Census Area, AK,Feb-18,2820,2372,448,15.9
CN0219800000000,02,198,Prince of Wales-Hyder Census Area, AK,Mar-18,2832,2422,410,14.5
CN0219800000000,02,198,Prince of Wales-Hyder Census Area, AK,Apr-18(p),2830,2465,365,12.9
CN2806300000000,28,063,Jefferson County, MS,Mar-17,2164,1826,338,15.6
CN2806300000000,28,063,Jefferson County, MS,Apr-17,2087,1827,260,12.5
CN2806300000000,28,063,Jefferson County, MS,May-17,2094,1806,288,13.8
CN2806300000000,28,063,Jefferson County, MS,Jun-17,2168,1779,389,17.9
CN2806300000000,28,063,Jefferson County, MS,Jul-17,2157,1776,381,17.7
CN2806300000000,28,063,Jefferson County, MS,Aug-17,2073,1737,336,16.2
CN2806300000000,28,063,Jefferson County, MS,Sep-17,2017,1768,249,12.3
CN2806300000000,28,063,Jefferson County, MS,Oct-17,1978,1754,224,11.3
CN2806300000000,28,063,Jefferson County, MS,Nov-17,1981,1758,223,11.3
CN2806300000000,28,063,Jefferson County, MS,Dec-17,2002,1750,252,12.6
CN2806300000000,28,063,Jefferson County, MS,Jan-18,2000,1733,267,13.4
CN2806300000000,28,063,Jefferson County, MS,Feb-18,2023,1744,279,13.8
CN2806300000000,28,063,Jefferson County, MS,Mar-18,1996,1750,246,12.3
CN2806300000000,28,063,Jefferson County, MS,Apr-18(p),1960,1754,206,10.5
CN4705100000000,47,051,Franklin County, TN,Mar-17,20166,19327,839,4.2
CN4705100000000,47,051,Franklin County, TN,Apr-17,20119,19430,689,3.4
CN4705100000000,47,051,Franklin County, TN,May-17,19979,19321,658,3.3
CN4705100000000,47,051,Franklin County, TN,Jun-17,19791,18959,832,4.2
CN4705100000000,47,051,Franklin County, TN,Jul-17,19805,18982,823,4.2
CN4705100000000,47,051,Franklin County, TN,Aug-17,19647,18903,744,3.8
CN4705100000000,47,051,Franklin County, TN,Sep-17,19732,19093,639,3.2
CN4705100000000,47,051,Franklin County, TN,Oct-17,19886,19265,621,3.1
CN4705100000000,47,051,Franklin County, TN,Nov-17,19788,19162,626,3.2
CN4705100000000,47,051,Franklin County, TN,Dec-17,19752,19147,605,3.1
CN4705100000000,47,051,Franklin County, TN,Jan-18,19579,18876,703,3.6
CN4705100000000,47,051,Franklin County, TN,Feb-18,20033,19327,706,3.5
CN4705100000000,47,051,Franklin County, TN,Mar-18,19979,19281,698,3.5
CN4705100000000,47,051,Franklin County, TN,Apr-18(p),19966,19395,571,2.9
CN3806300000000,38,063,Nelson County, ND,Mar-17,1480,1412,68,4.6
CN3806300000000,38,063,Nelson County, ND,Apr-17,1504,1453,51,3.4
CN3806300000000,38,063,Nelson County, ND,May-17,1504,1460,44,2.9
CN3806300000000,38,063,Nelson County, ND,Jun-17,1589,1535,54,3.4
CN3806300000000,38,063,Nelson County, ND,Jul-17,1553,1513,40,2.6
CN3806300000000,38,063,Nelson County, ND,Aug-17,1551,1514,37,2.4
CN3806300000000,38,063,Nelson County, ND,Sep-17,1547,1517,30,1.9
CN3806300000000,38,063,Nelson County, ND,Oct-17,1536,1510,26,1.7
CN3806300000000,38,063,Nelson County, ND,Nov-17,1457,1427,30,2.1
CN3806300000000,38,063,Nelson County, ND,Dec-17,1434,1399,35,2.4
CN3806300000000,38,063,Nelson County, ND,Jan-18,1416,1358,58,4.1
CN3806300000000,38,063,Nelson County, ND,Feb-18,1405,1341,64,4.6
CN3806300000000,38,063,Nelson County, ND,Mar-18,1411,1358,53,3.8
CN3806300000000,38,063,Nelson County, ND,Apr-18(p),1428,1374,54,3.8
CN1907500000000,19,075,Grundy County, IA,Mar-17,6465,6238,227,3.5
CN1907500000000,19,075,Grundy County, IA,Apr-17,6539,6351,188,2.9
CN1907500000000,19,075,Grundy County, IA,May-17,6513,6345,168,2.6
CN1907500000000,19,075,Grundy County, IA,Jun-17,6484,6298,186,2.9
CN1907500000000,19,075,Grundy County, IA,Jul-17,6595,6422,173,2.6
CN1907500000000,19,075,Grundy County, IA,Aug-17,6472,6300,172,2.7
CN1907500000000,19,075,Grundy County, IA,Sep-17,6498,6338,160,2.5
CN1907500000000,19,075,Grundy County, IA,Oct-17,6525,6390,135,2.1
CN1907500000000,19,075,Grundy County, IA,Nov-17,6460,6311,149,2.3
CN1907500000000,19,075,Grundy County, IA,Dec-17,6444,6253,191,3.0
CN1907500000000,19,075,Grundy County, IA,Jan-18,6342,6094,248,3.9
CN1907500000000,19,075,Grundy County, IA,Feb-18,6460,6226,234,3.6
CN1907500000000,19,075,Grundy County, IA,Mar-18,6364,6156,208,3.3
CN1907500000000,19,075,Grundy County, IA,Apr-18(p),6364,6202,162,2.5
CN4850300000000,48,503,Young County, TX,Mar-17,8022,7691,331,4.1
CN4850300000000,48,503,Young County, TX,Apr-17,8127,7835,292,3.6
CN4850300000000,48,503,Young County, TX,May-17,8126,7828,298,3.7
CN4850300000000,48,503,Young County, TX,Jun-17,8238,7916,322,3.9
CN4850300000000,48,503,Young County, TX,Jul-17,8101,7783,318,3.9
CN4850300000000,48,503,Young County, TX,Aug-17,8082,7774,308,3.8
CN4850300000000,48,503,Young County, TX,Sep-17,8122,7845,277,3.4
CN4850300000000,48,503,Young County, TX,Oct-17,8059,7807,252,3.1
CN4850300000000,48,503,Young County, TX,Nov-17,8124,7861,263,3.2
CN4850300000000,48,503,Young County, TX,Dec-17,8033,7781,252,3.1
CN4850300000000,48,503,Young County, TX,Jan-18,7927,7632,295,3.7
CN4850300000000,48,503,Young County, TX,Feb-18,8017,7715,302,3.8
CN4850300000000,48,503,Young County, TX,Mar-18,8095,7788,307,3.8
CN4850300000000,48,503,Young County, TX,Apr-18(p),8101,7842,259,3.2
CN4822300000000,48,223,Hopkins County, TX,Mar-17,17508,16834,674,3.8
CN4822300000000,48,223,Hopkins County, TX,Apr-17,17287,16683,604,3.5
CN4822300000000,48,223,Hopkins County, TX,May-17,17167,16565,602,3.5
CN4822300000000,48,223,Hopkins County, TX,Jun-17,17112,16469,643,3.8
CN4822300000000,48,223,Hopkins County, TX,Jul-17,17012,16367,645,3.8
CN4822300000000,48,223,Hopkins County, TX,Aug-17,16962,16344,618,3.6
CN4822300000000,48,223,Hopkins County, TX,Sep-17,17110,16557,553,3.2
CN4822300000000,48,223,Hopkins County, TX,Oct-17,17067,16561,506,3.0
CN4822300000000,48,223,Hopkins County, TX,Nov-17,17112,16562,550,3.2
CN4822300000000,48,223,Hopkins County, TX,Dec-17,16924,16401,523,3.1
CN4822300000000,48,223,Hopkins County, TX,Jan-18,16941,16353,588,3.5
CN4822300000000,48,223,Hopkins County, TX,Feb-18,17197,16554,643,3.7
CN4822300000000,48,223,Hopkins County, TX,Mar-18,17386,16742,644,3.7
CN4822300000000,48,223,Hopkins County, TX,Apr-18(p),17232,16636,596,3.5
CN0810500000000,08,105,Rio Grande County, CO,Mar-17,5076,4833,243,4.8
CN0810500000000,08,105,Rio Grande County, CO,Apr-17,5287,5080,207,3.9
CN0810500000000,08,105,Rio Grande County, CO,May-17,5435,5246,189,3.5
CN0810500000000,08,105,Rio Grande County, CO,Jun-17,5551,5319,232,4.2
CN0810500000000,08,105,Rio Grande County, CO,Jul-17,5633,5399,234,4.2
CN0810500000000,08,105,Rio Grande County, CO,Aug-17,5564,5305,259,4.7
CN0810500000000,08,105,Rio Grande County, CO,Sep-17,5444,5234,210,3.9
CN0810500000000,08,105,Rio Grande County, CO,Oct-17,5749,5553,196,3.4
CN0810500000000,08,105,Rio Grande County, CO,Nov-17,5653,5432,221,3.9
CN0810500000000,08,105,Rio Grande County, CO,Dec-17,5616,5329,287,5.1
CN0810500000000,08,105,Rio Grande County, CO,Jan-18,5468,5154,314,5.7
CN0810500000000,08,105,Rio Grande County, CO,Feb-18,5315,5015,300,5.6
CN0810500000000,08,105,Rio Grande County, CO,Mar-18,5309,5039,270,5.1
CN0810500000000,08,105,Rio Grande County, CO,Apr-18(p),5454,5239,215,3.9
CN5177000000000,51,770,Roanoke city, VA,Mar-17,49301,47193,2108,4.3
CN5177000000000,51,770,Roanoke city, VA,Apr-17,49016,47158,1858,3.8
CN5177000000000,51,770,Roanoke city, VA,May-17,49133,47183,1950,4.0
CN5177000000000,51,770,Roanoke city, VA,Jun-17,49091,46876,2215,4.5
CN5177000000000,51,770,Roanoke city, VA,Jul-17,49321,47076,2245,4.6
CN5177000000000,51,770,Roanoke city, VA,Aug-17,49169,46764,2405,4.9
CN5177000000000,51,770,Roanoke city, VA,Sep-17,49159,47173,1986,4.0
CN5177000000000,51,770,Roanoke city, VA,Oct-17,48853,47013,1840,3.8
CN5177000000000,51,770,Roanoke city, VA,Nov-17,48611,46809,1802,3.7
CN5177000000000,51,770,Roanoke city, VA,Dec-17,48370,46536,1834,3.8
CN5177000000000,51,770,Roanoke city, VA,Jan-18,48532,46548,1984,4.1
CN5177000000000,51,770,Roanoke city, VA,Feb-18,48958,47114,1844,3.8
CN5177000000000,51,770,Roanoke city, VA,Mar-18,49322,47494,1828,3.7
CN5177000000000,51,770,Roanoke city, VA,Apr-18(p),49252,47695,1557,3.2
CN3005100000000,30,051,Liberty County, MT,Mar-17,963,925,38,3.9
CN3005100000000,30,051,Liberty County, MT,Apr-17,1027,992,35,3.4
CN3005100000000,30,051,Liberty County, MT,May-17,1020,995,25,2.5
CN3005100000000,30,051,Liberty County, MT,Jun-17,979,947,32,3.3
CN3005100000000,30,051,Liberty County, MT,Jul-17,1039,1013,26,2.5
CN3005100000000,30,051,Liberty County, MT,Aug-17,973,948,25,2.6
CN3005100000000,30,051,Liberty County, MT,Sep-17,958,932,26,2.7
CN3005100000000,30,051,Liberty County, MT,Oct-17,973,946,27,2.8
CN3005100000000,30,051,Liberty County, MT,Nov-17,964,940,24,2.5
CN3005100000000,30,051,Liberty County, MT,Dec-17,951,926,25,2.6
CN3005100000000,30,051,Liberty County, MT,Jan-18,958,933,25,2.6
CN3005100000000,30,051,Liberty County, MT,Feb-18,950,926,24,2.5
CN3005100000000,30,051,Liberty County, MT,Mar-18,931,908,23,2.5
CN3005100000000,30,051,Liberty County, MT,Apr-18(p),947,926,21,2.2
CN0100100000000,01,001,Autauga County, AL,Mar-17,26071,24948,1123,4.3
CN0100100000000,01,001,Autauga County, AL,Apr-17,25982,25064,918,3.5
CN0100100000000,01,001,Autauga County, AL,May-17,25929,25036,893,3.4
CN0100100000000,01,001,Autauga County, AL,Jun-17,26128,25015,1113,4.3
CN0100100000000,01,001,Autauga County, AL,Jul-17,25887,24815,1072,4.1
CN0100100000000,01,001,Autauga County, AL,Aug-17,25793,24778,1015,3.9
CN0100100000000,01,001,Autauga County, AL,Sep-17,25793,24958,835,3.2
CN0100100000000,01,001,Autauga County, AL,Oct-17,25945,25101,844,3.3
CN0100100000000,01,001,Autauga County, AL,Nov-17,25871,25085,786,3.0
CN0100100000000,01,001,Autauga County, AL,Dec-17,25733,24952,781,3.0
CN0100100000000,01,001,Autauga County, AL,Jan-18,25544,24598,946,3.7
CN0100100000000,01,001,Autauga County, AL,Feb-18,25854,24861,993,3.8
CN0100100000000,01,001,Autauga County, AL,Mar-18,25879,24963,916,3.5
CN0100100000000,01,001,Autauga County, AL,Apr-18(p),25941,25103,838,3.2
CN2111900000000,21,119,Knott County, KY,Mar-17,4734,4239,495,10.5
CN2111900000000,21,119,Knott County, KY,Apr-17,4645,4249,396,8.5
CN2111900000000,21,119,Knott County, KY,May-17,4637,4251,386,8.3
CN2111900000000,21,119,Knott County, KY,Jun-17,4667,4231,436,9.3
CN2111900000000,21,119,Knott County, KY,Jul-17,4548,4149,399,8.8
CN2111900000000,21,119,Knott County, KY,Aug-17,4486,4145,341,7.6
CN2111900000000,21,119,Knott County, KY,Sep-17,4510,4197,313,6.9
CN2111900000000,21,119,Knott County, KY,Oct-17,4442,4153,289,6.5
CN2111900000000,21,119,Knott County, KY,Nov-17,4437,4156,281,6.3
CN2111900000000,21,119,Knott County, KY,Dec-17,4431,4166,265,6.0
CN2111900000000,21,119,Knott County, KY,Jan-18,4435,4143,292,6.6
CN2111900000000,21,119,Knott County, KY,Feb-18,4513,4172,341,7.6
CN2111900000000,21,119,Knott County, KY,Mar-18,4532,4207,325,7.2
CN2111900000000,21,119,Knott County, KY,Apr-18(p),4501,4220,281,6.2
CN0111100000000,01,111,Randolph County, AL,Mar-17,9322,8881,441,4.7
CN0111100000000,01,111,Randolph County, AL,Apr-17,9268,8906,362,3.9
CN0111100000000,01,111,Randolph County, AL,May-17,9194,8842,352,3.8
CN0111100000000,01,111,Randolph County, AL,Jun-17,9274,8825,449,4.8
CN0111100000000,01,111,Randolph County, AL,Jul-17,9298,8833,465,5.0
CN0111100000000,01,111,Randolph County, AL,Aug-17,9520,9075,445,4.7
CN0111100000000,01,111,Randolph County, AL,Sep-17,9628,9258,370,3.8
CN0111100000000,01,111,Randolph County, AL,Oct-17,9633,9276,357,3.7
CN0111100000000,01,111,Randolph County, AL,Nov-17,9500,9164,336,3.5
CN0111100000000,01,111,Randolph County, AL,Dec-17,9363,9043,320,3.4
CN0111100000000,01,111,Randolph County, AL,Jan-18,9173,8784,389,4.2
CN0111100000000,01,111,Randolph County, AL,Feb-18,9547,9145,402,4.2
CN0111100000000,01,111,Randolph County, AL,Mar-18,9608,9235,373,3.9
CN0111100000000,01,111,Randolph County, AL,Apr-18(p),9634,9295,339,3.5
CN1801900000000,18,019,Clark County, IN,Mar-17,60241,58123,2118,3.5
CN1801900000000,18,019,Clark County, IN,Apr-17,60574,58742,1832,3.0
CN1801900000000,18,019,Clark County, IN,May-17,60577,58593,1984,3.3
CN1801900000000,18,019,Clark County, IN,Jun-17,61804,59658,2146,3.5
CN1801900000000,18,019,Clark County, IN,Jul-17,62269,60047,2222,3.6
CN1801900000000,18,019,Clark County, IN,Aug-17,61224,58841,2383,3.9
CN1801900000000,18,019,Clark County, IN,Sep-17,60993,58957,2036,3.3
CN1801900000000,18,019,Clark County, IN,Oct-17,60552,58688,1864,3.1
CN1801900000000,18,019,Clark County, IN,Nov-17,60607,58741,1866,3.1
CN1801900000000,18,019,Clark County, IN,Dec-17,60516,58674,1842,3.0
CN1801900000000,18,019,Clark County, IN,Jan-18,59859,57839,2020,3.4
CN1801900000000,18,019,Clark County, IN,Feb-18,60640,58508,2132,3.5
CN1801900000000,18,019,Clark County, IN,Mar-18,61212,59284,1928,3.1
CN1801900000000,18,019,Clark County, IN,Apr-18(p),61771,60025,1746,2.8
CN1815500000000,18,155,Switzerland County, IN,Mar-17,4889,4688,201,4.1
CN1815500000000,18,155,Switzerland County, IN,Apr-17,4904,4736,168,3.4
CN1815500000000,18,155,Switzerland County, IN,May-17,4973,4802,171,3.4
CN1815500000000,18,155,Switzerland County, IN,Jun-17,5098,4908,190,3.7
CN1815500000000,18,155,Switzerland County, IN,Jul-17,5087,4887,200,3.9
CN1815500000000,18,155,Switzerland County, IN,Aug-17,5079,4854,225,4.4
CN1815500000000,18,155,Switzerland County, IN,Sep-17,5025,4837,188,3.7
CN1815500000000,18,155,Switzerland County, IN,Oct-17,4948,4768,180,3.6
CN1815500000000,18,155,Switzerland County, IN,Nov-17,4937,4754,183,3.7
CN1815500000000,18,155,Switzerland County, IN,Dec-17,4864,4688,176,3.6
CN1815500000000,18,155,Switzerland County, IN,Jan-18,4786,4593,193,4.0
CN1815500000000,18,155,Switzerland County, IN,Feb-18,4949,4747,202,4.1
CN1815500000000,18,155,Switzerland County, IN,Mar-18,4981,4803,178,3.6
CN1815500000000,18,155,Switzerland County, IN,Apr-18(p),5032,4853,179,3.6
CN2700700000000,27,007,Beltrami County, MN,Mar-17,23628,22165,1463,6.2
CN2700700000000,27,007,Beltrami County, MN,Apr-17,23700,22548,1152,4.9
CN2700700000000,27,007,Beltrami County, MN,May-17,23606,22618,988,4.2
CN2700700000000,27,007,Beltrami County, MN,Jun-17,23749,22643,1106,4.7
CN2700700000000,27,007,Beltrami County, MN,Jul-17,23821,22764,1057,4.4
CN2700700000000,27,007,Beltrami County, MN,Aug-17,23846,22790,1056,4.4
CN2700700000000,27,007,Beltrami County, MN,Sep-17,23619,22790,829,3.5
CN2700700000000,27,007,Beltrami County, MN,Oct-17,23546,22814,732,3.1
CN2700700000000,27,007,Beltrami County, MN,Nov-17,23876,22788,1088,4.6
CN2700700000000,27,007,Beltrami County, MN,Dec-17,23930,22712,1218,5.1
CN2700700000000,27,007,Beltrami County, MN,Jan-18,24075,22582,1493,6.2
CN2700700000000,27,007,Beltrami County, MN,Feb-18,24188,22830,1358,5.6
CN2700700000000,27,007,Beltrami County, MN,Mar-18,24230,22836,1394,5.8
CN2700700000000,27,007,Beltrami County, MN,Apr-18(p),24331,23202,1129,4.6
CN2402100000000,24,021,Frederick County, MD,Mar-17,131351,126596,4755,3.6
CN2402100000000,24,021,Frederick County, MD,Apr-17,130777,126555,4222,3.2
CN2402100000000,24,021,Frederick County, MD,May-17,130746,126232,4514,3.5
CN2402100000000,24,021,Frederick County, MD,Jun-17,132700,127616,5084,3.8
CN2402100000000,24,021,Frederick County, MD,Jul-17,133136,128009,5127,3.9
CN2402100000000,24,021,Frederick County, MD,Aug-17,131030,126305,4725,3.6
CN2402100000000,24,021,Frederick County, MD,Sep-17,131119,126625,4494,3.4
CN2402100000000,24,021,Frederick County, MD,Oct-17,131247,126583,4664,3.6
CN2402100000000,24,021,Frederick County, MD,Nov-17,130743,126152,4591,3.5
CN2402100000000,24,021,Frederick County, MD,Dec-17,130556,126359,4197,3.2
CN2402100000000,24,021,Frederick County, MD,Jan-18,132324,126885,5439,4.1
CN2402100000000,24,021,Frederick County, MD,Feb-18,132397,126838,5559,4.2
CN2402100000000,24,021,Frederick County, MD,Mar-18,132009,126750,5259,4.0
CN2402100000000,24,021,Frederick County, MD,Apr-18(p),131127,126730,4397,3.4
CN3000900000000,30,009,Carbon County, MT,Mar-17,5390,5169,221,4.1
CN3000900000000,30,009,Carbon County, MT,Apr-17,5429,5249,180,3.3
CN3000900000000,30,009,Carbon County, MT,May-17,5474,5297,177,3.2
CN3000900000000,30,009,Carbon County, MT,Jun-17,5448,5254,194,3.6
CN3000900000000,30,009,Carbon County, MT,Jul-17,5479,5297,182,3.3
CN3000900000000,30,009,Carbon County, MT,Aug-17,5449,5270,179,3.3
CN3000900000000,30,009,Carbon County, MT,Sep-17,5407,5219,188,3.5
CN3000900000000,30,009,Carbon County, MT,Oct-17,5381,5200,181,3.4
CN3000900000000,30,009,Carbon County, MT,Nov-17,5389,5186,203,3.8
CN3000900000000,30,009,Carbon County, MT,Dec-17,5337,5140,197,3.7
CN3000900000000,30,009,Carbon County, MT,Jan-18,5338,5078,260,4.9
CN3000900000000,30,009,Carbon County, MT,Feb-18,5364,5102,262,4.9
CN3000900000000,30,009,Carbon County, MT,Mar-18,5377,5118,259,4.8
CN3000900000000,30,009,Carbon County, MT,Apr-18(p),5367,5168,199,3.7
CN4000900000000,40,009,Beckham County, OK,Mar-17,11083,10576,507,4.6
CN4000900000000,40,009,Beckham County, OK,Apr-17,11136,10685,451,4.0
CN4000900000000,40,009,Beckham County, OK,May-17,11233,10764,469,4.2
CN4000900000000,40,009,Beckham County, OK,Jun-17,11380,10924,456,4.0
CN4000900000000,40,009,Beckham County, OK,Jul-17,11345,10931,414,3.6
CN4000900000000,40,009,Beckham County, OK,Aug-17,11619,11215,404,3.5
CN4000900000000,40,009,Beckham County, OK,Sep-17,11684,11288,396,3.4
CN4000900000000,40,009,Beckham County, OK,Oct-17,11633,11247,386,3.3
CN4000900000000,40,009,Beckham County, OK,Nov-17,11581,11217,364,3.1
CN4000900000000,40,009,Beckham County, OK,Dec-17,11425,11060,365,3.2
CN4000900000000,40,009,Beckham County, OK,Jan-18,11359,10965,394,3.5
CN4000900000000,40,009,Beckham County, OK,Feb-18,11348,10978,370,3.3
CN4000900000000,40,009,Beckham County, OK,Mar-18,11276,10925,351,3.1
CN4000900000000,40,009,Beckham County, OK,Apr-18(p),11227,10883,344,3.1
CN3402100000000,34,021,Mercer County, NJ,Mar-17,198140,190145,7995,4.0
CN3402100000000,34,021,Mercer County, NJ,Apr-17,198148,190867,7281,3.7
CN3402100000000,34,021,Mercer County, NJ,May-17,198115,190468,7647,3.9
CN3402100000000,34,021,Mercer County, NJ,Jun-17,200326,192088,8238,4.1
CN3402100000000,34,021,Mercer County, NJ,Jul-17,200975,191492,9483,4.7
CN3402100000000,34,021,Mercer County, NJ,Aug-17,199976,190829,9147,4.6
CN3402100000000,34,021,Mercer County, NJ,Sep-17,198396,190092,8304,4.2
CN3402100000000,34,021,Mercer County, NJ,Oct-17,198765,190944,7821,3.9
CN3402100000000,34,021,Mercer County, NJ,Nov-17,199006,191433,7573,3.8
CN3402100000000,34,021,Mercer County, NJ,Dec-17,198071,190927,7144,3.6
CN3402100000000,34,021,Mercer County, NJ,Jan-18,198422,190097,8325,4.2
CN3402100000000,34,021,Mercer County, NJ,Feb-18,200239,191765,8474,4.2
CN3402100000000,34,021,Mercer County, NJ,Mar-18,198837,190830,8007,4.0
CN3402100000000,34,021,Mercer County, NJ,Apr-18(p),197729,190840,6889,3.5
CN4012700000000,40,127,Pushmataha County, OK,Mar-17,4756,4459,297,6.2
CN4012700000000,40,127,Pushmataha County, OK,Apr-17,4764,4493,271,5.7
CN4012700000000,40,127,Pushmataha County, OK,May-17,4733,4443,290,6.1
CN4012700000000,40,127,Pushmataha County, OK,Jun-17,4621,4317,304,6.6
CN4012700000000,40,127,Pushmataha County, OK,Jul-17,4474,4191,283,6.3
CN4012700000000,40,127,Pushmataha County, OK,Aug-17,4748,4472,276,5.8
CN4012700000000,40,127,Pushmataha County, OK,Sep-17,4714,4445,269,5.7
CN4012700000000,40,127,Pushmataha County, OK,Oct-17,4941,4659,282,5.7
CN4012700000000,40,127,Pushmataha County, OK,Nov-17,4996,4713,283,5.7
CN4012700000000,40,127,Pushmataha County, OK,Dec-17,4913,4608,305,6.2
CN4012700000000,40,127,Pushmataha County, OK,Jan-18,4827,4493,334,6.9
CN4012700000000,40,127,Pushmataha County, OK,Feb-18,4752,4467,285,6.0
CN4012700000000,40,127,Pushmataha County, OK,Mar-18,4705,4427,278,5.9
CN4012700000000,40,127,Pushmataha County, OK,Apr-18(p),4620,4359,261,5.6
CN4709500000000,47,095,Lake County, TN,Mar-17,1891,1771,120,6.3
CN4709500000000,47,095,Lake County, TN,Apr-17,1877,1787,90,4.8
CN4709500000000,47,095,Lake County, TN,May-17,1823,1743,80,4.4
CN4709500000000,47,095,Lake County, TN,Jun-17,1773,1675,98,5.5
CN4709500000000,47,095,Lake County, TN,Jul-17,1773,1677,96,5.4
CN4709500000000,47,095,Lake County, TN,Aug-17,1868,1779,89,4.8
CN4709500000000,47,095,Lake County, TN,Sep-17,1866,1782,84,4.5
CN4709500000000,47,095,Lake County, TN,Oct-17,1850,1778,72,3.9
CN4709500000000,47,095,Lake County, TN,Nov-17,1841,1754,87,4.7
CN4709500000000,47,095,Lake County, TN,Dec-17,1841,1752,89,4.8
CN4709500000000,47,095,Lake County, TN,Jan-18,1848,1729,119,6.4
CN4709500000000,47,095,Lake County, TN,Feb-18,1868,1759,109,5.8
CN4709500000000,47,095,Lake County, TN,Mar-18,1834,1739,95,5.2
CN4709500000000,47,095,Lake County, TN,Apr-18(p),1838,1760,78,4.2
CN5404900000000,54,049,Marion County, WV,Mar-17,25233,23776,1457,5.8
CN5404900000000,54,049,Marion County, WV,Apr-17,25552,24300,1252,4.9
CN5404900000000,54,049,Marion County, WV,May-17,25549,24410,1139,4.5
CN5404900000000,54,049,Marion County, WV,Jun-17,25551,24213,1338,5.2
CN5404900000000,54,049,Marion County, WV,Jul-17,25537,24241,1296,5.1
CN5404900000000,54,049,Marion County, WV,Aug-17,25451,24064,1387,5.4
CN5404900000000,54,049,Marion County, WV,Sep-17,25952,24759,1193,4.6
CN5404900000000,54,049,Marion County, WV,Oct-17,25919,24709,1210,4.7
CN5404900000000,54,049,Marion County, WV,Nov-17,25815,24536,1279,5.0
CN5404900000000,54,049,Marion County, WV,Dec-17,25880,24487,1393,5.4
CN5404900000000,54,049,Marion County, WV,Jan-18,25589,24039,1550,6.1
CN5404900000000,54,049,Marion County, WV,Feb-18,26052,24363,1689,6.5
CN5404900000000,54,049,Marion County, WV,Mar-18,25809,24165,1644,6.4
CN5404900000000,54,049,Marion County, WV,Apr-18(p),26049,24552,1497,5.7
CN2113900000000,21,139,Livingston County, KY,Mar-17,3793,3478,315,8.3
CN2113900000000,21,139,Livingston County, KY,Apr-17,3794,3499,295,7.8
CN2113900000000,21,139,Livingston County, KY,May-17,3778,3481,297,7.9
CN2113900000000,21,139,Livingston County, KY,Jun-17,3815,3518,297,7.8
CN2113900000000,21,139,Livingston County, KY,Jul-17,3790,3505,285,7.5
CN2113900000000,21,139,Livingston County, KY,Aug-17,3756,3491,265,7.1
CN2113900000000,21,139,Livingston County, KY,Sep-17,3735,3503,232,6.2
CN2113900000000,21,139,Livingston County, KY,Oct-17,3700,3490,210,5.7
CN2113900000000,21,139,Livingston County, KY,Nov-17,3713,3497,216,5.8
CN2113900000000,21,139,Livingston County, KY,Dec-17,3733,3482,251,6.7
CN2113900000000,21,139,Livingston County, KY,Jan-18,3717,3436,281,7.6
CN2113900000000,21,139,Livingston County, KY,Feb-18,3744,3436,308,8.2
CN2113900000000,21,139,Livingston County, KY,Mar-18,3764,3476,288,7.7
CN2113900000000,21,139,Livingston County, KY,Apr-18(p),3765,3504,261,6.9
CN3700700000000,37,007,Anson County, NC,Mar-17,10800,10243,557,5.2
CN3700700000000,37,007,Anson County, NC,Apr-17,10636,10106,530,5.0
CN3700700000000,37,007,Anson County, NC,May-17,10614,10066,548,5.2
CN3700700000000,37,007,Anson County, NC,Jun-17,10448,9878,570,5.5
CN3700700000000,37,007,Anson County, NC,Jul-17,10477,9890,587,5.6
CN3700700000000,37,007,Anson County, NC,Aug-17,10468,9881,587,5.6
CN3700700000000,37,007,Anson County, NC,Sep-17,10595,10082,513,4.8
CN3700700000000,37,007,Anson County, NC,Oct-17,10493,9978,515,4.9
CN3700700000000,37,007,Anson County, NC,Nov-17,10403,9868,535,5.1
CN3700700000000,37,007,Anson County, NC,Dec-17,10375,9875,500,4.8
CN3700700000000,37,007,Anson County, NC,Jan-18,10371,9826,545,5.3
CN3700700000000,37,007,Anson County, NC,Feb-18,10669,10127,542,5.1
CN3700700000000,37,007,Anson County, NC,Mar-18,10673,10158,515,4.8
CN3700700000000,37,007,Anson County, NC,Apr-18(p),10585,10149,436,4.1
CN2710100000000,27,101,Murray County, MN,Mar-17,4931,4593,338,6.9
CN2710100000000,27,101,Murray County, MN,Apr-17,4938,4738,200,4.1
CN2710100000000,27,101,Murray County, MN,May-17,4921,4766,155,3.1
CN2710100000000,27,101,Murray County, MN,Jun-17,4921,4771,150,3.0
CN2710100000000,27,101,Murray County, MN,Jul-17,4784,4641,143,3.0
CN2710100000000,27,101,Murray County, MN,Aug-17,4755,4582,173,3.6
CN2710100000000,27,101,Murray County, MN,Sep-17,4774,4620,154,3.2
CN2710100000000,27,101,Murray County, MN,Oct-17,4953,4855,98,2.0
CN2710100000000,27,101,Murray County, MN,Nov-17,4930,4787,143,2.9
CN2710100000000,27,101,Murray County, MN,Dec-17,4982,4752,230,4.6
CN2710100000000,27,101,Murray County, MN,Jan-18,4912,4568,344,7.0
CN2710100000000,27,101,Murray County, MN,Feb-18,4884,4572,312,6.4
CN2710100000000,27,101,Murray County, MN,Mar-18,4931,4632,299,6.1
CN2710100000000,27,101,Murray County, MN,Apr-18(p),5007,4782,225,4.5
CN5106300000000,51,063,Floyd County, VA,Mar-17,8172,7821,351,4.3
CN5106300000000,51,063,Floyd County, VA,Apr-17,8281,8014,267,3.2
CN5106300000000,51,063,Floyd County, VA,May-17,8108,7819,289,3.6
CN5106300000000,51,063,Floyd County, VA,Jun-17,8085,7775,310,3.8
CN5106300000000,51,063,Floyd County, VA,Jul-17,8065,7766,299,3.7
CN5106300000000,51,063,Floyd County, VA,Aug-17,8055,7754,301,3.7
CN5106300000000,51,063,Floyd County, VA,Sep-17,8221,7956,265,3.2
CN5106300000000,51,063,Floyd County, VA,Oct-17,8046,7796,250,3.1
CN5106300000000,51,063,Floyd County, VA,Nov-17,8004,7760,244,3.0
CN5106300000000,51,063,Floyd County, VA,Dec-17,8095,7842,253,3.1
CN5106300000000,51,063,Floyd County, VA,Jan-18,7678,7388,290,3.8
CN5106300000000,51,063,Floyd County, VA,Feb-18,8079,7826,253,3.1
CN5106300000000,51,063,Floyd County, VA,Mar-18,8050,7784,266,3.3
CN5106300000000,51,063,Floyd County, VA,Apr-18(p),8208,7996,212,2.6
CN5504900000000,55,049,Iowa County, WI,Mar-17,13842,13326,516,3.7
CN5504900000000,55,049,Iowa County, WI,Apr-17,13900,13515,385,2.8
CN5504900000000,55,049,Iowa County, WI,May-17,13893,13534,359,2.6
CN5504900000000,55,049,Iowa County, WI,Jun-17,14285,13859,426,3.0
CN5504900000000,55,049,Iowa County, WI,Jul-17,14054,13698,356,2.5
CN5504900000000,55,049,Iowa County, WI,Aug-17,13853,13490,363,2.6
CN5504900000000,55,049,Iowa County, WI,Sep-17,13785,13462,323,2.3
CN5504900000000,55,049,Iowa County, WI,Oct-17,14052,13747,305,2.2
CN5504900000000,55,049,Iowa County, WI,Nov-17,14205,13869,336,2.4
CN5504900000000,55,049,Iowa County, WI,Dec-17,14124,13798,326,2.3
CN5504900000000,55,049,Iowa County, WI,Jan-18,14146,13704,442,3.1
CN5504900000000,55,049,Iowa County, WI,Feb-18,14158,13648,510,3.6
CN5504900000000,55,049,Iowa County, WI,Mar-18,14282,13824,458,3.2
CN5504900000000,55,049,Iowa County, WI,Apr-18(p),14255,13931,324,2.3
CN1901900000000,19,019,Buchanan County, IA,Mar-17,10988,10525,463,4.2
CN1901900000000,19,019,Buchanan County, IA,Apr-17,10988,10649,339,3.1
CN1901900000000,19,019,Buchanan County, IA,May-17,11023,10718,305,2.8
CN1901900000000,19,019,Buchanan County, IA,Jun-17,11260,10934,326,2.9
CN1901900000000,19,019,Buchanan County, IA,Jul-17,11321,11011,310,2.7
CN1901900000000,19,019,Buchanan County, IA,Aug-17,11114,10787,327,2.9
CN1901900000000,19,019,Buchanan County, IA,Sep-17,11001,10714,287,2.6
CN1901900000000,19,019,Buchanan County, IA,Oct-17,10865,10629,236,2.2
CN1901900000000,19,019,Buchanan County, IA,Nov-17,10817,10567,250,2.3
CN1901900000000,19,019,Buchanan County, IA,Dec-17,10917,10596,321,2.9
CN1901900000000,19,019,Buchanan County, IA,Jan-18,10831,10384,447,4.1
CN1901900000000,19,019,Buchanan County, IA,Feb-18,10941,10500,441,4.0
CN1901900000000,19,019,Buchanan County, IA,Mar-18,10840,10458,382,3.5
CN1901900000000,19,019,Buchanan County, IA,Apr-18(p),10900,10599,301,2.8
CN2123700000000,21,237,Wolfe County, KY,Mar-17,2027,1815,212,10.5
CN2123700000000,21,237,Wolfe County, KY,Apr-17,1998,1832,166,8.3
CN2123700000000,21,237,Wolfe County, KY,May-17,2000,1827,173,8.7
CN2123700000000,21,237,Wolfe County, KY,Jun-17,2008,1800,208,10.4
CN2123700000000,21,237,Wolfe County, KY,Jul-17,1960,1771,189,9.6
CN2123700000000,21,237,Wolfe County, KY,Aug-17,1910,1761,149,7.8
CN2123700000000,21,237,Wolfe County, KY,Sep-17,1942,1799,143,7.4
CN2123700000000,21,237,Wolfe County, KY,Oct-17,1938,1805,133,6.9
CN2123700000000,21,237,Wolfe County, KY,Nov-17,1913,1787,126,6.6
CN2123700000000,21,237,Wolfe County, KY,Dec-17,1931,1777,154,8.0
CN2123700000000,21,237,Wolfe County, KY,Jan-18,1932,1771,161,8.3
CN2123700000000,21,237,Wolfe County, KY,Feb-18,1975,1809,166,8.4
CN2123700000000,21,237,Wolfe County, KY,Mar-18,2000,1848,152,7.6
CN2123700000000,21,237,Wolfe County, KY,Apr-18(p),2006,1878,128,6.4
CN2610900000000,26,109,Menominee County, MI,Mar-17,11032,10475,557,5.0
CN2610900000000,26,109,Menominee County, MI,Apr-17,10984,10485,499,4.5
CN2610900000000,26,109,Menominee County, MI,May-17,11035,10552,483,4.4
CN2610900000000,26,109,Menominee County, MI,Jun-17,11291,10762,529,4.7
CN2610900000000,26,109,Menominee County, MI,Jul-17,11238,10584,654,5.8
CN2610900000000,26,109,Menominee County, MI,Aug-17,11118,10521,597,5.4
CN2610900000000,26,109,Menominee County, MI,Sep-17,10999,10472,527,4.8
CN2610900000000,26,109,Menominee County, MI,Oct-17,10832,10365,467,4.3
CN2610900000000,26,109,Menominee County, MI,Nov-17,10825,10339,486,4.5
CN2610900000000,26,109,Menominee County, MI,Dec-17,10837,10271,566,5.2
CN2610900000000,26,109,Menominee County, MI,Jan-18,10788,10174,614,5.7
CN2610900000000,26,109,Menominee County, MI,Feb-18,10860,10250,610,5.6
CN2610900000000,26,109,Menominee County, MI,Mar-18,10885,10338,547,5.0
CN2610900000000,26,109,Menominee County, MI,Apr-18(p),10912,10401,511,4.7
CN2806900000000,28,069,Kemper County, MS,Mar-17,3609,3325,284,7.9
CN2806900000000,28,069,Kemper County, MS,Apr-17,3566,3305,261,7.3
CN2806900000000,28,069,Kemper County, MS,May-17,3564,3266,298,8.4
CN2806900000000,28,069,Kemper County, MS,Jun-17,3608,3268,340,9.4
CN2806900000000,28,069,Kemper County, MS,Jul-17,3563,3224,339,9.5
CN2806900000000,28,069,Kemper County, MS,Aug-17,3463,3208,255,7.4
CN2806900000000,28,069,Kemper County, MS,Sep-17,3465,3216,249,7.2
CN2806900000000,28,069,Kemper County, MS,Oct-17,3375,3134,241,7.1
CN2806900000000,28,069,Kemper County, MS,Nov-17,3368,3129,239,7.1
CN2806900000000,28,069,Kemper County, MS,Dec-17,3407,3174,233,6.8
CN2806900000000,28,069,Kemper County, MS,Jan-18,3394,3164,230,6.8
CN2806900000000,28,069,Kemper County, MS,Feb-18,3435,3205,230,6.7
CN2806900000000,28,069,Kemper County, MS,Mar-18,3454,3217,237,6.9
CN2806900000000,28,069,Kemper County, MS,Apr-18(p),3433,3195,238,6.9
CN2212300000000,22,123,West Carroll Parish, LA,Mar-17,4058,3585,473,11.7
CN2212300000000,22,123,West Carroll Parish, LA,Apr-17,4030,3627,403,10.0
CN2212300000000,22,123,West Carroll Parish, LA,May-17,4056,3700,356,8.8
CN2212300000000,22,123,West Carroll Parish, LA,Jun-17,4219,3859,360,8.5
CN2212300000000,22,123,West Carroll Parish, LA,Jul-17,4078,3725,353,8.7
CN2212300000000,22,123,West Carroll Parish, LA,Aug-17,4001,3634,367,9.2
CN2212300000000,22,123,West Carroll Parish, LA,Sep-17,3941,3616,325,8.2
CN2212300000000,22,123,West Carroll Parish, LA,Oct-17,3877,3582,295,7.6
CN2212300000000,22,123,West Carroll Parish, LA,Nov-17,3878,3583,295,7.6
CN2212300000000,22,123,West Carroll Parish, LA,Dec-17,3923,3577,346,8.8
CN2212300000000,22,123,West Carroll Parish, LA,Jan-18,4008,3591,417,10.4
CN2212300000000,22,123,West Carroll Parish, LA,Feb-18,3999,3607,392,9.8
CN2212300000000,22,123,West Carroll Parish, LA,Mar-18,4030,3652,378,9.4
CN2212300000000,22,123,West Carroll Parish, LA,Apr-18(p),3969,3637,332,8.4
CN1709500000000,17,095,Knox County, IL,Mar-17,22612,21353,1259,5.6
CN1709500000000,17,095,Knox County, IL,Apr-17,22701,21673,1028,4.5
CN1709500000000,17,095,Knox County, IL,May-17,22629,21657,972,4.3
CN1709500000000,17,095,Knox County, IL,Jun-17,22893,21816,1077,4.7
CN1709500000000,17,095,Knox County, IL,Jul-17,22568,21449,1119,5.0
CN1709500000000,17,095,Knox County, IL,Aug-17,22334,21192,1142,5.1
CN1709500000000,17,095,Knox County, IL,Sep-17,22421,21374,1047,4.7
CN1709500000000,17,095,Knox County, IL,Oct-17,22108,21109,999,4.5
CN1709500000000,17,095,Knox County, IL,Nov-17,22082,21101,981,4.4
CN1709500000000,17,095,Knox County, IL,Dec-17,21939,20895,1044,4.8
CN1709500000000,17,095,Knox County, IL,Jan-18,21694,20533,1161,5.4
CN1709500000000,17,095,Knox County, IL,Feb-18,21784,20677,1107,5.1
CN1709500000000,17,095,Knox County, IL,Mar-18,22199,21055,1144,5.2
CN1709500000000,17,095,Knox County, IL,Apr-18(p),22408,21509,899,4.0
CN2608300000000,26,083,Keweenaw County, MI,Mar-17,973,872,101,10.4
CN2608300000000,26,083,Keweenaw County, MI,Apr-17,955,856,99,10.4
CN2608300000000,26,083,Keweenaw County, MI,May-17,893,807,86,9.6
CN2608300000000,26,083,Keweenaw County, MI,Jun-17,903,826,77,8.5
CN2608300000000,26,083,Keweenaw County, MI,Jul-17,898,823,75,8.4
CN2608300000000,26,083,Keweenaw County, MI,Aug-17,892,822,70,7.8
CN2608300000000,26,083,Keweenaw County, MI,Sep-17,944,889,55,5.8
CN2608300000000,26,083,Keweenaw County, MI,Oct-17,953,901,52,5.5
CN2608300000000,26,083,Keweenaw County, MI,Nov-17,976,892,84,8.6
CN2608300000000,26,083,Keweenaw County, MI,Dec-17,973,878,95,9.8
CN2608300000000,26,083,Keweenaw County, MI,Jan-18,933,855,78,8.4
CN2608300000000,26,083,Keweenaw County, MI,Feb-18,966,884,82,8.5
CN2608300000000,26,083,Keweenaw County, MI,Mar-18,954,878,76,8.0
CN2608300000000,26,083,Keweenaw County, MI,Apr-18(p),946,863,83,8.8
CN4901900000000,49,019,Grand County, UT,Mar-17,5810,5482,328,5.6
CN4901900000000,49,019,Grand County, UT,Apr-17,6094,5839,255,4.2
CN4901900000000,49,019,Grand County, UT,May-17,6256,6032,224,3.6
CN4901900000000,49,019,Grand County, UT,Jun-17,6531,6308,223,3.4
CN4901900000000,49,019,Grand County, UT,Jul-17,6541,6332,209,3.2
CN4901900000000,49,019,Grand County, UT,Aug-17,6437,6229,208,3.2
CN4901900000000,49,019,Grand County, UT,Sep-17,6318,6135,183,2.9
CN4901900000000,49,019,Grand County, UT,Oct-17,6077,5888,189,3.1
CN4901900000000,49,019,Grand County, UT,Nov-17,5727,5474,253,4.4
CN4901900000000,49,019,Grand County, UT,Dec-17,5411,4927,484,8.9
CN4901900000000,49,019,Grand County, UT,Jan-18,5301,4627,674,12.7
CN4901900000000,49,019,Grand County, UT,Feb-18,5490,5004,486,8.9
CN4901900000000,49,019,Grand County, UT,Mar-18,5978,5682,296,5.0
CN4901900000000,49,019,Grand County, UT,Apr-18(p),6273,6051,222,3.5
CN3111100000000,31,111,Lincoln County, NE,Mar-17,18528,17948,580,3.1
CN3111100000000,31,111,Lincoln County, NE,Apr-17,18638,18093,545,2.9
CN3111100000000,31,111,Lincoln County, NE,May-17,18693,18178,515,2.8
CN3111100000000,31,111,Lincoln County, NE,Jun-17,18829,18222,607,3.2
CN3111100000000,31,111,Lincoln County, NE,Jul-17,18833,18208,625,3.3
CN3111100000000,31,111,Lincoln County, NE,Aug-17,18664,18124,540,2.9
CN3111100000000,31,111,Lincoln County, NE,Sep-17,18311,17820,491,2.7
CN3111100000000,31,111,Lincoln County, NE,Oct-17,18422,17937,485,2.6
CN3111100000000,31,111,Lincoln County, NE,Nov-17,18362,17874,488,2.7
CN3111100000000,31,111,Lincoln County, NE,Dec-17,18281,17716,565,3.1
CN3111100000000,31,111,Lincoln County, NE,Jan-18,18433,17819,614,3.3
CN3111100000000,31,111,Lincoln County, NE,Feb-18,18565,17971,594,3.2
CN3111100000000,31,111,Lincoln County, NE,Mar-18,18497,17928,569,3.1
CN3111100000000,31,111,Lincoln County, NE,Apr-18(p),18427,17886,541,2.9
CN1603300000000,16,033,Clark County, ID,Mar-17,368,357,11,3.0
CN1603300000000,16,033,Clark County, ID,Apr-17,391,379,12,3.1
CN1603300000000,16,033,Clark County, ID,May-17,402,394,8,2.0
CN1603300000000,16,033,Clark County, ID,Jun-17,410,401,9,2.2
CN1603300000000,16,033,Clark County, ID,Jul-17,421,412,9,2.1
CN1603300000000,16,033,Clark County, ID,Aug-17,432,422,10,2.3
CN1603300000000,16,033,Clark County, ID,Sep-17,436,425,11,2.5
CN1603300000000,16,033,Clark County, ID,Oct-17,447,436,11,2.5
CN1603300000000,16,033,Clark County, ID,Nov-17,403,389,14,3.5
CN1603300000000,16,033,Clark County, ID,Dec-17,393,382,11,2.8
CN1603300000000,16,033,Clark County, ID,Jan-18,375,360,15,4.0
CN1603300000000,16,033,Clark County, ID,Feb-18,376,362,14,3.7
CN1603300000000,16,033,Clark County, ID,Mar-18,377,365,12,3.2
CN1603300000000,16,033,Clark County, ID,Apr-18(p),396,384,12,3.0
CN4705700000000,47,057,Grainger County, TN,Mar-17,9381,8940,441,4.7
CN4705700000000,47,057,Grainger County, TN,Apr-17,9378,9016,362,3.9
CN4705700000000,47,057,Grainger County, TN,May-17,9353,9010,343,3.7
CN4705700000000,47,057,Grainger County, TN,Jun-17,9447,9012,435,4.6
CN4705700000000,47,057,Grainger County, TN,Jul-17,9500,9064,436,4.6
CN4705700000000,47,057,Grainger County, TN,Aug-17,9420,9036,384,4.1
CN4705700000000,47,057,Grainger County, TN,Sep-17,9492,9152,340,3.6
CN4705700000000,47,057,Grainger County, TN,Oct-17,9425,9101,324,3.4
CN4705700000000,47,057,Grainger County, TN,Nov-17,9427,9097,330,3.5
CN4705700000000,47,057,Grainger County, TN,Dec-17,9344,9036,308,3.3
CN4705700000000,47,057,Grainger County, TN,Jan-18,9360,8940,420,4.5
CN4705700000000,47,057,Grainger County, TN,Feb-18,9512,9115,397,4.2
CN4705700000000,47,057,Grainger County, TN,Mar-18,9455,9092,363,3.8
CN4705700000000,47,057,Grainger County, TN,Apr-18(p),9445,9156,289,3.1
CN7201300000000,72,013,Arecibo Municipio, PR,Mar-17,23886,21090,2796,11.7
CN7201300000000,72,013,Arecibo Municipio, PR,Apr-17,23803,20839,2964,12.5
CN7201300000000,72,013,Arecibo Municipio, PR,May-17,23540,20997,2543,10.8
CN7201300000000,72,013,Arecibo Municipio, PR,Jun-17,23214,20932,2282,9.8
CN7201300000000,72,013,Arecibo Municipio, PR,Jul-17,23634,21087,2547,10.8
CN7201300000000,72,013,Arecibo Municipio, PR,Aug-17,23846,20883,2963,12.4
CN7201300000000,72,013,Arecibo Municipio, PR,Sep-17(y),23627,20912,2715,11.5
CN7201300000000,72,013,Arecibo Municipio, PR,Oct-17,23140,20119,3021,13.1
CN7201300000000,72,013,Arecibo Municipio, PR,Nov-17,24069,21290,2779,11.5
CN7201300000000,72,013,Arecibo Municipio, PR,Dec-17,23994,21376,2618,10.9
CN7201300000000,72,013,Arecibo Municipio, PR,Jan-18,23668,20835,2833,12.0
CN7201300000000,72,013,Arecibo Municipio, PR,Feb-18,23416,20766,2650,11.3
CN7201300000000,72,013,Arecibo Municipio, PR,Mar-18,23347,20833,2514,10.8
CN7201300000000,72,013,Arecibo Municipio, PR,Apr-18(p),23517,21058,2459,10.5
CN4817700000000,48,177,Gonzales County, TX,Mar-17,9740,9380,360,3.7
CN4817700000000,48,177,Gonzales County, TX,Apr-17,9515,9207,308,3.2
CN4817700000000,48,177,Gonzales County, TX,May-17,9527,9213,314,3.3
CN4817700000000,48,177,Gonzales County, TX,Jun-17,9455,9111,344,3.6
CN4817700000000,48,177,Gonzales County, TX,Jul-17,9186,8840,346,3.8
CN4817700000000,48,177,Gonzales County, TX,Aug-17,9267,8934,333,3.6
CN4817700000000,48,177,Gonzales County, TX,Sep-17,9170,8871,299,3.3
CN4817700000000,48,177,Gonzales County, TX,Oct-17,9302,9025,277,3.0
CN4817700000000,48,177,Gonzales County, TX,Nov-17,9136,8853,283,3.1
CN4817700000000,48,177,Gonzales County, TX,Dec-17,9167,8901,266,2.9
CN4817700000000,48,177,Gonzales County, TX,Jan-18,9096,8785,311,3.4
CN4817700000000,48,177,Gonzales County, TX,Feb-18,9221,8916,305,3.3
CN4817700000000,48,177,Gonzales County, TX,Mar-18,9481,9160,321,3.4
CN4817700000000,48,177,Gonzales County, TX,Apr-18(p),9289,9007,282,3.0
CN2018500000000,20,185,Stafford County, KS,Mar-17,1991,1922,69,3.5
CN2018500000000,20,185,Stafford County, KS,Apr-17,1951,1887,64,3.3
CN2018500000000,20,185,Stafford County, KS,May-17,1950,1882,68,3.5
CN2018500000000,20,185,Stafford County, KS,Jun-17,2045,1971,74,3.6
CN2018500000000,20,185,Stafford County, KS,Jul-17,1979,1901,78,3.9
CN2018500000000,20,185,Stafford County, KS,Aug-17,1993,1923,70,3.5
CN2018500000000,20,185,Stafford County, KS,Sep-17,2005,1952,53,2.6
CN2018500000000,20,185,Stafford County, KS,Oct-17,2061,2016,45,2.2
CN2018500000000,20,185,Stafford County, KS,Nov-17,2032,1980,52,2.6
CN2018500000000,20,185,Stafford County, KS,Dec-17,2027,1982,45,2.2
CN2018500000000,20,185,Stafford County, KS,Jan-18,1964,1921,43,2.2
CN2018500000000,20,185,Stafford County, KS,Feb-18,1967,1914,53,2.7
CN2018500000000,20,185,Stafford County, KS,Mar-18,1951,1895,56,2.9
CN2018500000000,20,185,Stafford County, KS,Apr-18(p),1822,1770,52,2.9
CN5404300000000,54,043,Lincoln County, WV,Mar-17,7168,6630,538,7.5
CN5404300000000,54,043,Lincoln County, WV,Apr-17,7194,6726,468,6.5
CN5404300000000,54,043,Lincoln County, WV,May-17,7183,6749,434,6.0
CN5404300000000,54,043,Lincoln County, WV,Jun-17,7303,6799,504,6.9
CN5404300000000,54,043,Lincoln County, WV,Jul-17,7243,6768,475,6.6
CN5404300000000,54,043,Lincoln County, WV,Aug-17,7218,6741,477,6.6
CN5404300000000,54,043,Lincoln County, WV,Sep-17,7239,6830,409,5.6
CN5404300000000,54,043,Lincoln County, WV,Oct-17,7247,6810,437,6.0
CN5404300000000,54,043,Lincoln County, WV,Nov-17,7218,6756,462,6.4
CN5404300000000,54,043,Lincoln County, WV,Dec-17,7202,6719,483,6.7
CN5404300000000,54,043,Lincoln County, WV,Jan-18,7180,6593,587,8.2
CN5404300000000,54,043,Lincoln County, WV,Feb-18,7249,6636,613,8.5
CN5404300000000,54,043,Lincoln County, WV,Mar-18,7160,6600,560,7.8
CN5404300000000,54,043,Lincoln County, WV,Apr-18(p),7199,6684,515,7.2
CN5600300000000,56,003,Big Horn County, WY,Mar-17,5155,4904,251,4.9
CN5600300000000,56,003,Big Horn County, WY,Apr-17,5257,5034,223,4.2
CN5600300000000,56,003,Big Horn County, WY,May-17,5388,5167,221,4.1
CN5600300000000,56,003,Big Horn County, WY,Jun-17,5790,5556,234,4.0
CN5600300000000,56,003,Big Horn County, WY,Jul-17,5615,5412,203,3.6
CN5600300000000,56,003,Big Horn County, WY,Aug-17,5588,5392,196,3.5
CN5600300000000,56,003,Big Horn County, WY,Sep-17,5473,5284,189,3.5
CN5600300000000,56,003,Big Horn County, WY,Oct-17,5491,5297,194,3.5
CN5600300000000,56,003,Big Horn County, WY,Nov-17,5456,5252,204,3.7
CN5600300000000,56,003,Big Horn County, WY,Dec-17,5309,5093,216,4.1
CN5600300000000,56,003,Big Horn County, WY,Jan-18,5276,5012,264,5.0
CN5600300000000,56,003,Big Horn County, WY,Feb-18,5238,4975,263,5.0
CN5600300000000,56,003,Big Horn County, WY,Mar-18,5097,4847,250,4.9
CN5600300000000,56,003,Big Horn County, WY,Apr-18(p),5115,4877,238,4.7
CN4829500000000,48,295,Lipscomb County, TX,Mar-17,1660,1601,59,3.6
CN4829500000000,48,295,Lipscomb County, TX,Apr-17,1657,1603,54,3.3
CN4829500000000,48,295,Lipscomb County, TX,May-17,1646,1597,49,3.0
CN4829500000000,48,295,Lipscomb County, TX,Jun-17,1657,1604,53,3.2
CN4829500000000,48,295,Lipscomb County, TX,Jul-17,1634,1580,54,3.3
CN4829500000000,48,295,Lipscomb County, TX,Aug-17,1625,1575,50,3.1
CN4829500000000,48,295,Lipscomb County, TX,Sep-17,1605,1559,46,2.9
CN4829500000000,48,295,Lipscomb County, TX,Oct-17,1630,1585,45,2.8
CN4829500000000,48,295,Lipscomb County, TX,Nov-17,1609,1564,45,2.8
CN4829500000000,48,295,Lipscomb County, TX,Dec-17,1621,1579,42,2.6
CN4829500000000,48,295,Lipscomb County, TX,Jan-18,1633,1583,50,3.1
CN4829500000000,48,295,Lipscomb County, TX,Feb-18,1641,1593,48,2.9
CN4829500000000,48,295,Lipscomb County, TX,Mar-18,1683,1631,52,3.1
CN4829500000000,48,295,Lipscomb County, TX,Apr-18(p),1660,1615,45,2.7
CN2101500000000,21,015,Boone County, KY,Mar-17,68107,65129,2978,4.4
CN2101500000000,21,015,Boone County, KY,Apr-17,68209,65613,2596,3.8
CN2101500000000,21,015,Boone County, KY,May-17,68631,65925,2706,3.9
CN2101500000000,21,015,Boone County, KY,Jun-17,69635,66576,3059,4.4
CN2101500000000,21,015,Boone County, KY,Jul-17,70021,67104,2917,4.2
CN2101500000000,21,015,Boone County, KY,Aug-17,69228,66586,2642,3.8
CN2101500000000,21,015,Boone County, KY,Sep-17,69149,66798,2351,3.4
CN2101500000000,21,015,Boone County, KY,Oct-17,68261,65972,2289,3.4
CN2101500000000,21,015,Boone County, KY,Nov-17,68033,65883,2150,3.2
CN2101500000000,21,015,Boone County, KY,Dec-17,67544,65438,2106,3.1
CN2101500000000,21,015,Boone County, KY,Jan-18,67189,64829,2360,3.5
CN2101500000000,21,015,Boone County, KY,Feb-18,68441,65818,2623,3.8
CN2101500000000,21,015,Boone County, KY,Mar-18,68844,66437,2407,3.5
CN2101500000000,21,015,Boone County, KY,Apr-18(p),68941,66825,2116,3.1
CN1603900000000,16,039,Elmore County, ID,Mar-17,10856,10400,456,4.2
CN1603900000000,16,039,Elmore County, ID,Apr-17,10931,10536,395,3.6
CN1603900000000,16,039,Elmore County, ID,May-17,11186,10840,346,3.1
CN1603900000000,16,039,Elmore County, ID,Jun-17,11522,11126,396,3.4
CN1603900000000,16,039,Elmore County, ID,Jul-17,11490,11085,405,3.5
CN1603900000000,16,039,Elmore County, ID,Aug-17,11507,11126,381,3.3
CN1603900000000,16,039,Elmore County, ID,Sep-17,11366,11017,349,3.1
CN1603900000000,16,039,Elmore County, ID,Oct-17,11092,10778,314,2.8
CN1603900000000,16,039,Elmore County, ID,Nov-17,11155,10774,381,3.4
CN1603900000000,16,039,Elmore County, ID,Dec-17,11024,10649,375,3.4
CN1603900000000,16,039,Elmore County, ID,Jan-18,10906,10406,500,4.6
CN1603900000000,16,039,Elmore County, ID,Feb-18,11129,10694,435,3.9
CN1603900000000,16,039,Elmore County, ID,Mar-18,11194,10795,399,3.6
CN1603900000000,16,039,Elmore County, ID,Apr-18(p),11217,10867,350,3.1
CN3915300000000,39,153,Summit County, OH,Mar-17,272225,257510,14715,5.4
CN3915300000000,39,153,Summit County, OH,Apr-17,273019,260192,12827,4.7
CN3915300000000,39,153,Summit County, OH,May-17,275471,263067,12404,4.5
CN3915300000000,39,153,Summit County, OH,Jun-17,274898,260835,14063,5.1
CN3915300000000,39,153,Summit County, OH,Jul-17,276581,262454,14127,5.1
CN3915300000000,39,153,Summit County, OH,Aug-17,274043,259871,14172,5.2
CN3915300000000,39,153,Summit County, OH,Sep-17,274687,261838,12849,4.7
CN3915300000000,39,153,Summit County, OH,Oct-17,276304,263888,12416,4.5
CN3915300000000,39,153,Summit County, OH,Nov-17,275130,262450,12680,4.6
CN3915300000000,39,153,Summit County, OH,Dec-17,274663,261500,13163,4.8
CN3915300000000,39,153,Summit County, OH,Jan-18,269539,255603,13936,5.2
CN3915300000000,39,153,Summit County, OH,Feb-18,273864,260649,13215,4.8
CN3915300000000,39,153,Summit County, OH,Mar-18,276866,264340,12526,4.5
CN3915300000000,39,153,Summit County, OH,Apr-18(p),274866,263254,11612,4.2
CN2502700000000,25,027,Worcester County, MA,Mar-17,436713,417984,18729,4.3
CN2502700000000,25,027,Worcester County, MA,Apr-17,433893,417368,16525,3.8
CN2502700000000,25,027,Worcester County, MA,May-17,432927,416060,16867,3.9
CN2502700000000,25,027,Worcester County, MA,Jun-17,437132,418773,18359,4.2
CN2502700000000,25,027,Worcester County, MA,Jul-17,435431,416719,18712,4.3
CN2502700000000,25,027,Worcester County, MA,Aug-17,433858,416909,16949,3.9
CN2502700000000,25,027,Worcester County, MA,Sep-17,431821,416156,15665,3.6
CN2502700000000,25,027,Worcester County, MA,Oct-17,431824,418011,13813,3.2
CN2502700000000,25,027,Worcester County, MA,Nov-17,434183,420615,13568,3.1
CN2502700000000,25,027,Worcester County, MA,Dec-17,434143,420376,13767,3.2
CN2502700000000,25,027,Worcester County, MA,Jan-18,436938,418883,18055,4.1
CN2502700000000,25,027,Worcester County, MA,Feb-18,442732,424152,18580,4.2
CN2502700000000,25,027,Worcester County, MA,Mar-18,445187,427351,17836,4.0
CN2502700000000,25,027,Worcester County, MA,Apr-18(p),446684,431078,15606,3.5
CN4814100000000,48,141,El Paso County, TX,Mar-17,354082,336911,17171,4.8
CN4814100000000,48,141,El Paso County, TX,Apr-17,354732,339059,15673,4.4
CN4814100000000,48,141,El Paso County, TX,May-17,353374,337494,15880,4.5
CN4814100000000,48,141,El Paso County, TX,Jun-17,350750,333490,17260,4.9
CN4814100000000,48,141,El Paso County, TX,Jul-17,350691,333777,16914,4.8
CN4814100000000,48,141,El Paso County, TX,Aug-17,350477,333617,16860,4.8
CN4814100000000,48,141,El Paso County, TX,Sep-17,355698,340491,15207,4.3
CN4814100000000,48,141,El Paso County, TX,Oct-17,352667,338373,14294,4.1
CN4814100000000,48,141,El Paso County, TX,Nov-17,355035,340344,14691,4.1
CN4814100000000,48,141,El Paso County, TX,Dec-17,354286,339906,14380,4.1
CN4814100000000,48,141,El Paso County, TX,Jan-18,354942,338768,16174,4.6
CN4814100000000,48,141,El Paso County, TX,Feb-18,360149,343844,16305,4.5
CN4814100000000,48,141,El Paso County, TX,Mar-18,360036,343866,16170,4.5
CN4814100000000,48,141,El Paso County, TX,Apr-18(p),359832,344902,14930,4.1
CN3609100000000,36,091,Saratoga County, NY,Mar-17,118765,113929,4836,4.1
CN3609100000000,36,091,Saratoga County, NY,Apr-17,119072,114601,4471,3.8
CN3609100000000,36,091,Saratoga County, NY,May-17,118377,113895,4482,3.8
CN3609100000000,36,091,Saratoga County, NY,Jun-17,119921,115278,4643,3.9
CN3609100000000,36,091,Saratoga County, NY,Jul-17,119563,114924,4639,3.9
CN3609100000000,36,091,Saratoga County, NY,Aug-17,118564,113964,4600,3.9
CN3609100000000,36,091,Saratoga County, NY,Sep-17,118836,114183,4653,3.9
CN3609100000000,36,091,Saratoga County, NY,Oct-17,118215,113815,4400,3.7
CN3609100000000,36,091,Saratoga County, NY,Nov-17,117835,113227,4608,3.9
CN3609100000000,36,091,Saratoga County, NY,Dec-17,117112,112333,4779,4.1
CN3609100000000,36,091,Saratoga County, NY,Jan-18,118433,112834,5599,4.7
CN3609100000000,36,091,Saratoga County, NY,Feb-18,117767,111840,5927,5.0
CN3609100000000,36,091,Saratoga County, NY,Mar-18,117470,112140,5330,4.5
CN3609100000000,36,091,Saratoga County, NY,Apr-18(p),117455,112810,4645,4.0
CN4845700000000,48,457,Tyler County, TX,Mar-17,7317,6774,543,7.4
CN4845700000000,48,457,Tyler County, TX,Apr-17,7281,6793,488,6.7
CN4845700000000,48,457,Tyler County, TX,May-17,7199,6723,476,6.6
CN4845700000000,48,457,Tyler County, TX,Jun-17,7185,6651,534,7.4
CN4845700000000,48,457,Tyler County, TX,Jul-17,6964,6426,538,7.7
CN4845700000000,48,457,Tyler County, TX,Aug-17,6943,6383,560,8.1
CN4845700000000,48,457,Tyler County, TX,Sep-17,6865,6362,503,7.3
CN4845700000000,48,457,Tyler County, TX,Oct-17,6884,6459,425,6.2
CN4845700000000,48,457,Tyler County, TX,Nov-17,6821,6373,448,6.6
CN4845700000000,48,457,Tyler County, TX,Dec-17,6855,6376,479,7.0
CN4845700000000,48,457,Tyler County, TX,Jan-18,6858,6318,540,7.9
CN4845700000000,48,457,Tyler County, TX,Feb-18,6971,6449,522,7.5
CN4845700000000,48,457,Tyler County, TX,Mar-18,7078,6574,504,7.1
CN4845700000000,48,457,Tyler County, TX,Apr-18(p),7029,6556,473,6.7
CN1330900000000,13,309,Wheeler County, GA,Mar-17,1748,1607,141,8.1
CN1330900000000,13,309,Wheeler County, GA,Apr-17,1752,1606,146,8.3
CN1330900000000,13,309,Wheeler County, GA,May-17,1780,1635,145,8.1
CN1330900000000,13,309,Wheeler County, GA,Jun-17,1773,1622,151,8.5
CN1330900000000,13,309,Wheeler County, GA,Jul-17,1761,1589,172,9.8
CN1330900000000,13,309,Wheeler County, GA,Aug-17,1754,1593,161,9.2
CN1330900000000,13,309,Wheeler County, GA,Sep-17,1751,1590,161,9.2
CN1330900000000,13,309,Wheeler County, GA,Oct-17,1817,1594,223,12.3
CN1330900000000,13,309,Wheeler County, GA,Nov-17,1735,1594,141,8.1
CN1330900000000,13,309,Wheeler County, GA,Dec-17,1752,1606,146,8.3
CN1330900000000,13,309,Wheeler County, GA,Jan-18,1790,1652,138,7.7
CN1330900000000,13,309,Wheeler County, GA,Feb-18,1720,1592,128,7.4
CN1330900000000,13,309,Wheeler County, GA,Mar-18,1714,1590,124,7.2
CN1330900000000,13,309,Wheeler County, GA,Apr-18(p),1700,1593,107,6.3
CN2604100000000,26,041,Delta County, MI,Mar-17,16860,15606,1254,7.4
CN2604100000000,26,041,Delta County, MI,Apr-17,17058,16020,1038,6.1
CN2604100000000,26,041,Delta County, MI,May-17,17138,16162,976,5.7
CN2604100000000,26,041,Delta County, MI,Jun-17,17469,16370,1099,6.3
CN2604100000000,26,041,Delta County, MI,Jul-17,17387,16205,1182,6.8
CN2604100000000,26,041,Delta County, MI,Aug-17,17277,16218,1059,6.1
CN2604100000000,26,041,Delta County, MI,Sep-17,17042,16183,859,5.0
CN2604100000000,26,041,Delta County, MI,Oct-17,16889,16065,824,4.9
CN2604100000000,26,041,Delta County, MI,Nov-17,16774,15849,925,5.5
CN2604100000000,26,041,Delta County, MI,Dec-17,16795,15654,1141,6.8
CN2604100000000,26,041,Delta County, MI,Jan-18,16711,15451,1260,7.5
CN2604100000000,26,041,Delta County, MI,Feb-18,16874,15490,1384,8.2
CN2604100000000,26,041,Delta County, MI,Mar-18,16883,15648,1235,7.3
CN2604100000000,26,041,Delta County, MI,Apr-18(p),17101,16044,1057,6.2
CN2608900000000,26,089,Leelanau County, MI,Mar-17,10370,9703,667,6.4
CN2608900000000,26,089,Leelanau County, MI,Apr-17,10287,9808,479,4.7
CN2608900000000,26,089,Leelanau County, MI,May-17,10551,10119,432,4.1
CN2608900000000,26,089,Leelanau County, MI,Jun-17,11045,10603,442,4.0
CN2608900000000,26,089,Leelanau County, MI,Jul-17,11380,10865,515,4.5
CN2608900000000,26,089,Leelanau County, MI,Aug-17,11096,10614,482,4.3
CN2608900000000,26,089,Leelanau County, MI,Sep-17,10697,10276,421,3.9
CN2608900000000,26,089,Leelanau County, MI,Oct-17,10597,10215,382,3.6
CN2608900000000,26,089,Leelanau County, MI,Nov-17,10521,10087,434,4.1
CN2608900000000,26,089,Leelanau County, MI,Dec-17,10532,10002,530,5.0
CN2608900000000,26,089,Leelanau County, MI,Jan-18,10484,9794,690,6.6
CN2608900000000,26,089,Leelanau County, MI,Feb-18,10616,9857,759,7.1
CN2608900000000,26,089,Leelanau County, MI,Mar-18,10549,9874,675,6.4
CN2608900000000,26,089,Leelanau County, MI,Apr-18(p),10524,9985,539,5.1
CN2703700000000,27,037,Dakota County, MN,Mar-17,237522,229461,8061,3.4
CN2703700000000,27,037,Dakota County, MN,Apr-17,237976,231027,6949,2.9
CN2703700000000,27,037,Dakota County, MN,May-17,238643,231959,6684,2.8
CN2703700000000,27,037,Dakota County, MN,Jun-17,240721,233027,7694,3.2
CN2703700000000,27,037,Dakota County, MN,Jul-17,243173,235710,7463,3.1
CN2703700000000,27,037,Dakota County, MN,Aug-17,242555,234952,7603,3.1
CN2703700000000,27,037,Dakota County, MN,Sep-17,241698,235165,6533,2.7
CN2703700000000,27,037,Dakota County, MN,Oct-17,239116,233688,5428,2.3
CN2703700000000,27,037,Dakota County, MN,Nov-17,239224,233509,5715,2.4
CN2703700000000,27,037,Dakota County, MN,Dec-17,238289,231605,6684,2.8
CN2703700000000,27,037,Dakota County, MN,Jan-18,240933,233134,7799,3.2
CN2703700000000,27,037,Dakota County, MN,Feb-18,242505,234792,7713,3.2
CN2703700000000,27,037,Dakota County, MN,Mar-18,242097,234585,7512,3.1
CN2703700000000,27,037,Dakota County, MN,Apr-18(p),242042,235768,6274,2.6
CN2014300000000,20,143,Ottawa County, KS,Mar-17,3066,2962,104,3.4
CN2014300000000,20,143,Ottawa County, KS,Apr-17,3047,2954,93,3.1
CN2014300000000,20,143,Ottawa County, KS,May-17,3053,2957,96,3.1
CN2014300000000,20,143,Ottawa County, KS,Jun-17,3113,3010,103,3.3
CN2014300000000,20,143,Ottawa County, KS,Jul-17,3073,2965,108,3.5
CN2014300000000,20,143,Ottawa County, KS,Aug-17,3009,2908,101,3.4
CN2014300000000,20,143,Ottawa County, KS,Sep-17,3043,2968,75,2.5
CN2014300000000,20,143,Ottawa County, KS,Oct-17,3069,3004,65,2.1
CN2014300000000,20,143,Ottawa County, KS,Nov-17,3064,2985,79,2.6
CN2014300000000,20,143,Ottawa County, KS,Dec-17,3048,2971,77,2.5
CN2014300000000,20,143,Ottawa County, KS,Jan-18,2999,2920,79,2.6
CN2014300000000,20,143,Ottawa County, KS,Feb-18,2999,2910,89,3.0
CN2014300000000,20,143,Ottawa County, KS,Mar-18,2980,2895,85,2.9
CN2014300000000,20,143,Ottawa County, KS,Apr-18(p),2920,2833,87,3.0
CN1706500000000,17,065,Hamilton County, IL,Mar-17,4406,4188,218,4.9
CN1706500000000,17,065,Hamilton County, IL,Apr-17,4507,4326,181,4.0
CN1706500000000,17,065,Hamilton County, IL,May-17,4508,4320,188,4.2
CN1706500000000,17,065,Hamilton County, IL,Jun-17,4556,4374,182,4.0
CN1706500000000,17,065,Hamilton County, IL,Jul-17,4346,4157,189,4.3
CN1706500000000,17,065,Hamilton County, IL,Aug-17,4288,4089,199,4.6
CN1706500000000,17,065,Hamilton County, IL,Sep-17,4426,4246,180,4.1
CN1706500000000,17,065,Hamilton County, IL,Oct-17,4385,4226,159,3.6
CN1706500000000,17,065,Hamilton County, IL,Nov-17,4407,4251,156,3.5
CN1706500000000,17,065,Hamilton County, IL,Dec-17,4413,4246,167,3.8
CN1706500000000,17,065,Hamilton County, IL,Jan-18,4391,4194,197,4.5
CN1706500000000,17,065,Hamilton County, IL,Feb-18,4401,4210,191,4.3
CN1706500000000,17,065,Hamilton County, IL,Mar-18,4574,4383,191,4.2
CN1706500000000,17,065,Hamilton County, IL,Apr-18(p),4650,4490,160,3.4
CN1309500000000,13,095,Dougherty County, GA,Mar-17,39499,37081,2418,6.1
CN1309500000000,13,095,Dougherty County, GA,Apr-17,38752,36457,2295,5.9
CN1309500000000,13,095,Dougherty County, GA,May-17,38820,36467,2353,6.1
CN1309500000000,13,095,Dougherty County, GA,Jun-17,38840,36288,2552,6.6
CN1309500000000,13,095,Dougherty County, GA,Jul-17,38753,36204,2549,6.6
CN1309500000000,13,095,Dougherty County, GA,Aug-17,38689,36189,2500,6.5
CN1309500000000,13,095,Dougherty County, GA,Sep-17,39001,36731,2270,5.8
CN1309500000000,13,095,Dougherty County, GA,Oct-17,39225,37026,2199,5.6
CN1309500000000,13,095,Dougherty County, GA,Nov-17,39253,37114,2139,5.4
CN1309500000000,13,095,Dougherty County, GA,Dec-17,39294,37198,2096,5.3
CN1309500000000,13,095,Dougherty County, GA,Jan-18,39452,37231,2221,5.6
CN1309500000000,13,095,Dougherty County, GA,Feb-18,39762,37529,2233,5.6
CN1309500000000,13,095,Dougherty County, GA,Mar-18,39445,37387,2058,5.2
CN1309500000000,13,095,Dougherty County, GA,Apr-18(p),39132,37263,1869,4.8
CN7211700000000,72,117,Rincon Municipio, PR,Mar-17,4934,4049,885,17.9
CN7211700000000,72,117,Rincon Municipio, PR,Apr-17,4835,4005,830,17.2
CN7211700000000,72,117,Rincon Municipio, PR,May-17,4608,3986,622,13.5
CN7211700000000,72,117,Rincon Municipio, PR,Jun-17,4459,3950,509,11.4
CN7211700000000,72,117,Rincon Municipio, PR,Jul-17,4456,3935,521,11.7
CN7211700000000,72,117,Rincon Municipio, PR,Aug-17,4481,3893,588,13.1
CN7211700000000,72,117,Rincon Municipio, PR,Sep-17(y),4493,3920,573,12.8
CN7211700000000,72,117,Rincon Municipio, PR,Oct-17,4495,3827,668,14.9
CN7211700000000,72,117,Rincon Municipio, PR,Nov-17,4819,4034,785,16.3
CN7211700000000,72,117,Rincon Municipio, PR,Dec-17,4903,4072,831,16.9
CN7211700000000,72,117,Rincon Municipio, PR,Jan-18,4900,4013,887,18.1
CN7211700000000,72,117,Rincon Municipio, PR,Feb-18,4847,4014,833,17.2
CN7211700000000,72,117,Rincon Municipio, PR,Mar-18,4874,4029,845,17.3
CN7211700000000,72,117,Rincon Municipio, PR,Apr-18(p),4768,4052,716,15.0
CN1600300000000,16,003,Adams County, ID,Mar-17,1722,1553,169,9.8
CN1600300000000,16,003,Adams County, ID,Apr-17,1676,1540,136,8.1
CN1600300000000,16,003,Adams County, ID,May-17,1705,1616,89,5.2
CN1600300000000,16,003,Adams County, ID,Jun-17,1819,1742,77,4.2
CN1600300000000,16,003,Adams County, ID,Jul-17,1844,1771,73,4.0
CN1600300000000,16,003,Adams County, ID,Aug-17,1840,1771,69,3.8
CN1600300000000,16,003,Adams County, ID,Sep-17,1784,1718,66,3.7
CN1600300000000,16,003,Adams County, ID,Oct-17,1749,1677,72,4.1
CN1600300000000,16,003,Adams County, ID,Nov-17,1711,1624,87,5.1
CN1600300000000,16,003,Adams County, ID,Dec-17,1710,1617,93,5.4
CN1600300000000,16,003,Adams County, ID,Jan-18,1723,1618,105,6.1
CN1600300000000,16,003,Adams County, ID,Feb-18,1691,1583,108,6.4
CN1600300000000,16,003,Adams County, ID,Mar-18,1697,1564,133,7.8
CN1600300000000,16,003,Adams County, ID,Apr-18(p),1690,1565,125,7.4
CN0608100000000,06,081,San Mateo County, CA,Mar-17,451939,439369,12570,2.8
CN0608100000000,06,081,San Mateo County, CA,Apr-17,449580,438063,11517,2.6
CN0608100000000,06,081,San Mateo County, CA,May-17,448079,436955,11124,2.5
CN0608100000000,06,081,San Mateo County, CA,Jun-17,450387,437488,12899,2.9
CN0608100000000,06,081,San Mateo County, CA,Jul-17,455915,442106,13809,3.0
CN0608100000000,06,081,San Mateo County, CA,Aug-17,454435,441066,13369,2.9
CN0608100000000,06,081,San Mateo County, CA,Sep-17,456026,444622,11404,2.5
CN0608100000000,06,081,San Mateo County, CA,Oct-17,453649,442567,11082,2.4
CN0608100000000,06,081,San Mateo County, CA,Nov-17,454734,444171,10563,2.3
CN0608100000000,06,081,San Mateo County, CA,Dec-17,454619,444605,10014,2.2
CN0608100000000,06,081,San Mateo County, CA,Jan-18,452926,441844,11082,2.4
CN0608100000000,06,081,San Mateo County, CA,Feb-18,454668,443910,10758,2.4
CN0608100000000,06,081,San Mateo County, CA,Mar-18,452832,442981,9851,2.2
CN0608100000000,06,081,San Mateo County, CA,Apr-18(p),449232,440362,8870,2.0
CN1203900000000,12,039,Gadsden County, FL,Mar-17,18285,17316,969,5.3
CN1203900000000,12,039,Gadsden County, FL,Apr-17,18466,17553,913,4.9
CN1203900000000,12,039,Gadsden County, FL,May-17,18361,17412,949,5.2
CN1203900000000,12,039,Gadsden County, FL,Jun-17,18753,17720,1033,5.5
CN1203900000000,12,039,Gadsden County, FL,Jul-17,18450,17414,1036,5.6
CN1203900000000,12,039,Gadsden County, FL,Aug-17,18207,17170,1037,5.7
CN1203900000000,12,039,Gadsden County, FL,Sep-17,18989,18035,954,5.0
CN1203900000000,12,039,Gadsden County, FL,Oct-17,18945,18046,899,4.7
CN1203900000000,12,039,Gadsden County, FL,Nov-17,18695,17803,892,4.8
CN1203900000000,12,039,Gadsden County, FL,Dec-17,18240,17384,856,4.7
CN1203900000000,12,039,Gadsden County, FL,Jan-18,18401,17420,981,5.3
CN1203900000000,12,039,Gadsden County, FL,Feb-18,18561,17671,890,4.8
CN1203900000000,12,039,Gadsden County, FL,Mar-18,18572,17692,880,4.7
CN1203900000000,12,039,Gadsden County, FL,Apr-18(p),18617,17825,792,4.3
CN0111700000000,01,117,Shelby County, AL,Mar-17,109806,105744,4062,3.7
CN0111700000000,01,117,Shelby County, AL,Apr-17,109515,106191,3324,3.0
CN0111700000000,01,117,Shelby County, AL,May-17,109345,106116,3229,3.0
CN0111700000000,01,117,Shelby County, AL,Jun-17,109940,106041,3899,3.5
CN0111700000000,01,117,Shelby County, AL,Jul-17,109747,106158,3589,3.3
CN0111700000000,01,117,Shelby County, AL,Aug-17,108827,105367,3460,3.2
CN0111700000000,01,117,Shelby County, AL,Sep-17,109014,106127,2887,2.6
CN0111700000000,01,117,Shelby County, AL,Oct-17,109133,106224,2909,2.7
CN0111700000000,01,117,Shelby County, AL,Nov-17,108983,106224,2759,2.5
CN0111700000000,01,117,Shelby County, AL,Dec-17,108788,106121,2667,2.5
CN0111700000000,01,117,Shelby County, AL,Jan-18,108493,105282,3211,3.0
CN0111700000000,01,117,Shelby County, AL,Feb-18,109941,106598,3343,3.0
CN0111700000000,01,117,Shelby County, AL,Mar-18,110271,107158,3113,2.8
CN0111700000000,01,117,Shelby County, AL,Apr-18(p),111544,108670,2874,2.6
CN1801300000000,18,013,Brown County, IN,Mar-17,7529,7254,275,3.7
CN1801300000000,18,013,Brown County, IN,Apr-17,7562,7350,212,2.8
CN1801300000000,18,013,Brown County, IN,May-17,7593,7350,243,3.2
CN1801300000000,18,013,Brown County, IN,Jun-17,7655,7409,246,3.2
CN1801300000000,18,013,Brown County, IN,Jul-17,7639,7381,258,3.4
CN1801300000000,18,013,Brown County, IN,Aug-17,7553,7279,274,3.6
CN1801300000000,18,013,Brown County, IN,Sep-17,7527,7304,223,3.0
CN1801300000000,18,013,Brown County, IN,Oct-17,7515,7302,213,2.8
CN1801300000000,18,013,Brown County, IN,Nov-17,7513,7299,214,2.8
CN1801300000000,18,013,Brown County, IN,Dec-17,7460,7247,213,2.9
CN1801300000000,18,013,Brown County, IN,Jan-18,7527,7237,290,3.9
CN1801300000000,18,013,Brown County, IN,Feb-18,7626,7340,286,3.8
CN1801300000000,18,013,Brown County, IN,Mar-18,7654,7421,233,3.0
CN1801300000000,18,013,Brown County, IN,Apr-18(p),7662,7460,202,2.6
CN4212500000000,42,125,Washington County, PA,Mar-17,106580,100385,6195,5.8
CN4212500000000,42,125,Washington County, PA,Apr-17,106371,101173,5198,4.9
CN4212500000000,42,125,Washington County, PA,May-17,106605,101101,5504,5.2
CN4212500000000,42,125,Washington County, PA,Jun-17,107200,101508,5692,5.3
CN4212500000000,42,125,Washington County, PA,Jul-17,107853,101972,5881,5.5
CN4212500000000,42,125,Washington County, PA,Aug-17,106570,100834,5736,5.4
CN4212500000000,42,125,Washington County, PA,Sep-17,106220,101416,4804,4.5
CN4212500000000,42,125,Washington County, PA,Oct-17,105562,100983,4579,4.3
CN4212500000000,42,125,Washington County, PA,Nov-17,106227,101413,4814,4.5
CN4212500000000,42,125,Washington County, PA,Dec-17,105682,100848,4834,4.6
CN4212500000000,42,125,Washington County, PA,Jan-18,105605,99608,5997,5.7
CN4212500000000,42,125,Washington County, PA,Feb-18,105632,99673,5959,5.6
CN4212500000000,42,125,Washington County, PA,Mar-18,104485,99336,5149,4.9
CN4212500000000,42,125,Washington County, PA,Apr-18(p),104657,100358,4299,4.1
CN1206900000000,12,069,Lake County, FL,Mar-17,149974,143733,6241,4.2
CN1206900000000,12,069,Lake County, FL,Apr-17,149940,144037,5903,3.9
CN1206900000000,12,069,Lake County, FL,May-17,150738,144653,6085,4.0
CN1206900000000,12,069,Lake County, FL,Jun-17,151636,145213,6423,4.2
CN1206900000000,12,069,Lake County, FL,Jul-17,152184,145729,6455,4.2
CN1206900000000,12,069,Lake County, FL,Aug-17,151460,145125,6335,4.2
CN1206900000000,12,069,Lake County, FL,Sep-17,153855,147984,5871,3.8
CN1206900000000,12,069,Lake County, FL,Oct-17,152124,146512,5612,3.7
CN1206900000000,12,069,Lake County, FL,Nov-17,151687,146037,5650,3.7
CN1206900000000,12,069,Lake County, FL,Dec-17,152045,146752,5293,3.5
CN1206900000000,12,069,Lake County, FL,Jan-18,152942,146836,6106,4.0
CN1206900000000,12,069,Lake County, FL,Feb-18,154411,148827,5584,3.6
CN1206900000000,12,069,Lake County, FL,Mar-18,154270,148790,5480,3.6
CN1206900000000,12,069,Lake County, FL,Apr-18(p),153524,148524,5000,3.3
CN2911500000000,29,115,Linn County, MO,Mar-17,5241,4930,311,5.9
CN2911500000000,29,115,Linn County, MO,Apr-17,5232,4989,243,4.6
CN2911500000000,29,115,Linn County, MO,May-17,5227,4970,257,4.9
CN2911500000000,29,115,Linn County, MO,Jun-17,5239,4931,308,5.9
CN2911500000000,29,115,Linn County, MO,Jul-17,5005,4655,350,7.0
CN2911500000000,29,115,Linn County, MO,Aug-17,4954,4609,345,7.0
CN2911500000000,29,115,Linn County, MO,Sep-17,5112,4831,281,5.5
CN2911500000000,29,115,Linn County, MO,Oct-17,5194,4963,231,4.4
CN2911500000000,29,115,Linn County, MO,Nov-17,5186,4904,282,5.4
CN2911500000000,29,115,Linn County, MO,Dec-17,5138,4825,313,6.1
CN2911500000000,29,115,Linn County, MO,Jan-18,5109,4774,335,6.6
CN2911500000000,29,115,Linn County, MO,Feb-18,5155,4827,328,6.4
CN2911500000000,29,115,Linn County, MO,Mar-18,5118,4853,265,5.2
CN2911500000000,29,115,Linn County, MO,Apr-18(p),5125,4918,207,4.0
CN1213300000000,12,133,Washington County, FL,Mar-17,9812,9384,428,4.4
CN1213300000000,12,133,Washington County, FL,Apr-17,9798,9396,402,4.1
CN1213300000000,12,133,Washington County, FL,May-17,9883,9475,408,4.1
CN1213300000000,12,133,Washington County, FL,Jun-17,9853,9406,447,4.5
CN1213300000000,12,133,Washington County, FL,Jul-17,9859,9409,450,4.6
CN1213300000000,12,133,Washington County, FL,Aug-17,9962,9533,429,4.3
CN1213300000000,12,133,Washington County, FL,Sep-17,10096,9684,412,4.1
CN1213300000000,12,133,Washington County, FL,Oct-17,9880,9501,379,3.8
CN1213300000000,12,133,Washington County, FL,Nov-17,9768,9386,382,3.9
CN1213300000000,12,133,Washington County, FL,Dec-17,9729,9356,373,3.8
CN1213300000000,12,133,Washington County, FL,Jan-18,9798,9352,446,4.6
CN1213300000000,12,133,Washington County, FL,Feb-18,9794,9392,402,4.1
CN1213300000000,12,133,Washington County, FL,Mar-18,9825,9451,374,3.8
CN1213300000000,12,133,Washington County, FL,Apr-18(p),9838,9494,344,3.5
CN2204100000000,22,041,Franklin Parish, LA,Mar-17,7271,6700,571,7.9
CN2204100000000,22,041,Franklin Parish, LA,Apr-17,7354,6809,545,7.4
CN2204100000000,22,041,Franklin Parish, LA,May-17,7497,6960,537,7.2
CN2204100000000,22,041,Franklin Parish, LA,Jun-17,7720,7089,631,8.2
CN2204100000000,22,041,Franklin Parish, LA,Jul-17,7481,6893,588,7.9
CN2204100000000,22,041,Franklin Parish, LA,Aug-17,7347,6766,581,7.9
CN2204100000000,22,041,Franklin Parish, LA,Sep-17,7289,6781,508,7.0
CN2204100000000,22,041,Franklin Parish, LA,Oct-17,7094,6663,431,6.1
CN2204100000000,22,041,Franklin Parish, LA,Nov-17,7097,6647,450,6.3
CN2204100000000,22,041,Franklin Parish, LA,Dec-17,7079,6615,464,6.6
CN2204100000000,22,041,Franklin Parish, LA,Jan-18,7184,6672,512,7.1
CN2204100000000,22,041,Franklin Parish, LA,Feb-18,7306,6830,476,6.5
CN2204100000000,22,041,Franklin Parish, LA,Mar-18,7373,6879,494,6.7
CN2204100000000,22,041,Franklin Parish, LA,Apr-18(p),7358,6877,481,6.5
CN1305300000000,13,053,Chattahoochee County, GA,Mar-17,2091,1937,154,7.4
CN1305300000000,13,053,Chattahoochee County, GA,Apr-17,2072,1925,147,7.1
CN1305300000000,13,053,Chattahoochee County, GA,May-17,2083,1931,152,7.3
CN1305300000000,13,053,Chattahoochee County, GA,Jun-17,2077,1929,148,7.1
CN1305300000000,13,053,Chattahoochee County, GA,Jul-17,2087,1929,158,7.6
CN1305300000000,13,053,Chattahoochee County, GA,Aug-17,2074,1918,156,7.5
CN1305300000000,13,053,Chattahoochee County, GA,Sep-17,2079,1942,137,6.6
CN1305300000000,13,053,Chattahoochee County, GA,Oct-17,2090,1949,141,6.7
CN1305300000000,13,053,Chattahoochee County, GA,Nov-17,2093,1958,135,6.5
CN1305300000000,13,053,Chattahoochee County, GA,Dec-17,2104,1962,142,6.7
CN1305300000000,13,053,Chattahoochee County, GA,Jan-18,2111,1962,149,7.1
CN1305300000000,13,053,Chattahoochee County, GA,Feb-18,2099,1961,138,6.6
CN1305300000000,13,053,Chattahoochee County, GA,Mar-18,2101,1973,128,6.1
CN1305300000000,13,053,Chattahoochee County, GA,Apr-18(p),2064,1956,108,5.2
CN1302300000000,13,023,Bleckley County, GA,Mar-17,4602,4296,306,6.6
CN1302300000000,13,023,Bleckley County, GA,Apr-17,4569,4268,301,6.6
CN1302300000000,13,023,Bleckley County, GA,May-17,4550,4265,285,6.3
CN1302300000000,13,023,Bleckley County, GA,Jun-17,4581,4226,355,7.7
CN1302300000000,13,023,Bleckley County, GA,Jul-17,4526,4177,349,7.7
CN1302300000000,13,023,Bleckley County, GA,Aug-17,4515,4207,308,6.8
CN1302300000000,13,023,Bleckley County, GA,Sep-17,4587,4273,314,6.8
CN1302300000000,13,023,Bleckley County, GA,Oct-17,4639,4304,335,7.2
CN1302300000000,13,023,Bleckley County, GA,Nov-17,4610,4336,274,5.9
CN1302300000000,13,023,Bleckley County, GA,Dec-17,4607,4322,285,6.2
CN1302300000000,13,023,Bleckley County, GA,Jan-18,4620,4304,316,6.8
CN1302300000000,13,023,Bleckley County, GA,Feb-18,4685,4389,296,6.3
CN1302300000000,13,023,Bleckley County, GA,Mar-18,4657,4386,271,5.8
CN1302300000000,13,023,Bleckley County, GA,Apr-18(p),4610,4375,235,5.1
CN2809300000000,28,093,Marshall County, MS,Mar-17,14523,13801,722,5.0
CN2809300000000,28,093,Marshall County, MS,Apr-17,14498,13849,649,4.5
CN2809300000000,28,093,Marshall County, MS,May-17,14604,13780,824,5.6
CN2809300000000,28,093,Marshall County, MS,Jun-17,14768,13835,933,6.3
CN2809300000000,28,093,Marshall County, MS,Jul-17,14831,13942,889,6.0
CN2809300000000,28,093,Marshall County, MS,Aug-17,14495,13796,699,4.8
CN2809300000000,28,093,Marshall County, MS,Sep-17,14568,13899,669,4.6
CN2809300000000,28,093,Marshall County, MS,Oct-17,14612,13970,642,4.4
CN2809300000000,28,093,Marshall County, MS,Nov-17,14795,14160,635,4.3
CN2809300000000,28,093,Marshall County, MS,Dec-17,14786,14134,652,4.4
CN2809300000000,28,093,Marshall County, MS,Jan-18,14451,13809,642,4.4
CN2809300000000,28,093,Marshall County, MS,Feb-18,14573,13934,639,4.4
CN2809300000000,28,093,Marshall County, MS,Mar-18,14623,13995,628,4.3
CN2809300000000,28,093,Marshall County, MS,Apr-18(p),14653,14024,629,4.3
CN2616500000000,26,165,Wexford County, MI,Mar-17,14608,13730,878,6.0
CN2616500000000,26,165,Wexford County, MI,Apr-17,14510,13790,720,5.0
CN2616500000000,26,165,Wexford County, MI,May-17,14754,14031,723,4.9
CN2616500000000,26,165,Wexford County, MI,Jun-17,15143,14324,819,5.4
CN2616500000000,26,165,Wexford County, MI,Jul-17,15225,14182,1043,6.9
CN2616500000000,26,165,Wexford County, MI,Aug-17,14972,14085,887,5.9
CN2616500000000,26,165,Wexford County, MI,Sep-17,14725,13999,726,4.9
CN2616500000000,26,165,Wexford County, MI,Oct-17,14622,13938,684,4.7
CN2616500000000,26,165,Wexford County, MI,Nov-17,14653,13943,710,4.8
CN2616500000000,26,165,Wexford County, MI,Dec-17,14736,13905,831,5.6
CN2616500000000,26,165,Wexford County, MI,Jan-18,14696,13737,959,6.5
CN2616500000000,26,165,Wexford County, MI,Feb-18,14877,13884,993,6.7
CN2616500000000,26,165,Wexford County, MI,Mar-18,14822,13947,875,5.9
CN2616500000000,26,165,Wexford County, MI,Apr-18(p),14761,13998,763,5.2
CN2207700000000,22,077,Pointe Coupee Parish, LA,Mar-17,9932,9386,546,5.5
CN2207700000000,22,077,Pointe Coupee Parish, LA,Apr-17,9954,9418,536,5.4
CN2207700000000,22,077,Pointe Coupee Parish, LA,May-17,10010,9473,537,5.4
CN2207700000000,22,077,Pointe Coupee Parish, LA,Jun-17,10205,9563,642,6.3
CN2207700000000,22,077,Pointe Coupee Parish, LA,Jul-17,10159,9546,613,6.0
CN2207700000000,22,077,Pointe Coupee Parish, LA,Aug-17,10041,9422,619,6.2
CN2207700000000,22,077,Pointe Coupee Parish, LA,Sep-17,9960,9415,545,5.5
CN2207700000000,22,077,Pointe Coupee Parish, LA,Oct-17,9905,9422,483,4.9
CN2207700000000,22,077,Pointe Coupee Parish, LA,Nov-17,9921,9463,458,4.6
CN2207700000000,22,077,Pointe Coupee Parish, LA,Dec-17,9844,9402,442,4.5
CN2207700000000,22,077,Pointe Coupee Parish, LA,Jan-18,9928,9421,507,5.1
CN2207700000000,22,077,Pointe Coupee Parish, LA,Feb-18,10028,9570,458,4.6
CN2207700000000,22,077,Pointe Coupee Parish, LA,Mar-18,10109,9627,482,4.8
CN2207700000000,22,077,Pointe Coupee Parish, LA,Apr-18(p),10120,9641,479,4.7
CN4711500000000,47,115,Marion County, TN,Mar-17,12095,11479,616,5.1
CN4711500000000,47,115,Marion County, TN,Apr-17,12038,11539,499,4.1
CN4711500000000,47,115,Marion County, TN,May-17,12036,11561,475,3.9
CN4711500000000,47,115,Marion County, TN,Jun-17,12405,11753,652,5.3
CN4711500000000,47,115,Marion County, TN,Jul-17,12345,11721,624,5.1
CN4711500000000,47,115,Marion County, TN,Aug-17,12146,11567,579,4.8
CN4711500000000,47,115,Marion County, TN,Sep-17,12234,11707,527,4.3
CN4711500000000,47,115,Marion County, TN,Oct-17,12249,11734,515,4.2
CN4711500000000,47,115,Marion County, TN,Nov-17,12224,11733,491,4.0
CN4711500000000,47,115,Marion County, TN,Dec-17,12209,11694,515,4.2
CN4711500000000,47,115,Marion County, TN,Jan-18,12264,11628,636,5.2
CN4711500000000,47,115,Marion County, TN,Feb-18,12402,11784,618,5.0
CN4711500000000,47,115,Marion County, TN,Mar-18,12387,11827,560,4.5
CN4711500000000,47,115,Marion County, TN,Apr-18(p),12504,12021,483,3.9
CN3106500000000,31,065,Furnas County, NE,Mar-17,2625,2569,56,2.1
CN3106500000000,31,065,Furnas County, NE,Apr-17,2699,2642,57,2.1
CN3106500000000,31,065,Furnas County, NE,May-17,2708,2650,58,2.1
CN3106500000000,31,065,Furnas County, NE,Jun-17,2837,2762,75,2.6
CN3106500000000,31,065,Furnas County, NE,Jul-17,2780,2698,82,2.9
CN3106500000000,31,065,Furnas County, NE,Aug-17,2696,2626,70,2.6
CN3106500000000,31,065,Furnas County, NE,Sep-17,2599,2548,51,2.0
CN3106500000000,31,065,Furnas County, NE,Oct-17,2604,2546,58,2.2
CN3106500000000,31,065,Furnas County, NE,Nov-17,2616,2557,59,2.3
CN3106500000000,31,065,Furnas County, NE,Dec-17,2604,2540,64,2.5
CN3106500000000,31,065,Furnas County, NE,Jan-18,2633,2562,71,2.7
CN3106500000000,31,065,Furnas County, NE,Feb-18,2569,2501,68,2.6
CN3106500000000,31,065,Furnas County, NE,Mar-18,2644,2574,70,2.6
CN3106500000000,31,065,Furnas County, NE,Apr-18(p),2651,2583,68,2.6
CN4842700000000,48,427,Starr County, TX,Mar-17,26997,23383,3614,13.4
CN4842700000000,48,427,Starr County, TX,Apr-17,26827,23456,3371,12.6
CN4842700000000,48,427,Starr County, TX,May-17,26300,23417,2883,11.0
CN4842700000000,48,427,Starr County, TX,Jun-17,26236,23119,3117,11.9
CN4842700000000,48,427,Starr County, TX,Jul-17,25567,22665,2902,11.4
CN4842700000000,48,427,Starr County, TX,Aug-17,25154,22409,2745,10.9
CN4842700000000,48,427,Starr County, TX,Sep-17,25125,22700,2425,9.7
CN4842700000000,48,427,Starr County, TX,Oct-17,24977,22801,2176,8.7
CN4842700000000,48,427,Starr County, TX,Nov-17,25273,22895,2378,9.4
CN4842700000000,48,427,Starr County, TX,Dec-17,25703,23103,2600,10.1
CN4842700000000,48,427,Starr County, TX,Jan-18,26399,23188,3211,12.2
CN4842700000000,48,427,Starr County, TX,Feb-18,26456,23437,3019,11.4
CN4842700000000,48,427,Starr County, TX,Mar-18,26497,23640,2857,10.8
CN4842700000000,48,427,Starr County, TX,Apr-18(p),26347,23610,2737,10.4
CN1714100000000,17,141,Ogle County, IL,Mar-17,25645,24167,1478,5.8
CN1714100000000,17,141,Ogle County, IL,Apr-17,25304,24111,1193,4.7
CN1714100000000,17,141,Ogle County, IL,May-17,25228,24117,1111,4.4
CN1714100000000,17,141,Ogle County, IL,Jun-17,25686,24524,1162,4.5
CN1714100000000,17,141,Ogle County, IL,Jul-17,25379,24167,1212,4.8
CN1714100000000,17,141,Ogle County, IL,Aug-17,24994,23809,1185,4.7
CN1714100000000,17,141,Ogle County, IL,Sep-17,24943,23903,1040,4.2
CN1714100000000,17,141,Ogle County, IL,Oct-17,24886,23884,1002,4.0
CN1714100000000,17,141,Ogle County, IL,Nov-17,24979,23925,1054,4.2
CN1714100000000,17,141,Ogle County, IL,Dec-17,24690,23577,1113,4.5
CN1714100000000,17,141,Ogle County, IL,Jan-18,24691,23347,1344,5.4
CN1714100000000,17,141,Ogle County, IL,Feb-18,24953,23720,1233,4.9
CN1714100000000,17,141,Ogle County, IL,Mar-18,25374,24141,1233,4.9
CN1714100000000,17,141,Ogle County, IL,Apr-18(p),25536,24558,978,3.8
CN2011300000000,20,113,McPherson County, KS,Mar-17,16234,15811,423,2.6
CN2011300000000,20,113,McPherson County, KS,Apr-17,16164,15747,417,2.6
CN2011300000000,20,113,McPherson County, KS,May-17,16147,15708,439,2.7
CN2011300000000,20,113,McPherson County, KS,Jun-17,16507,16013,494,3.0
CN2011300000000,20,113,McPherson County, KS,Jul-17,16388,15778,610,3.7
CN2011300000000,20,113,McPherson County, KS,Aug-17,16400,15880,520,3.2
CN2011300000000,20,113,McPherson County, KS,Sep-17,16382,15981,401,2.4
CN2011300000000,20,113,McPherson County, KS,Oct-17,16377,16001,376,2.3
CN2011300000000,20,113,McPherson County, KS,Nov-17,16351,15937,414,2.5
CN2011300000000,20,113,McPherson County, KS,Dec-17,16263,15890,373,2.3
CN2011300000000,20,113,McPherson County, KS,Jan-18,16115,15734,381,2.4
CN2011300000000,20,113,McPherson County, KS,Feb-18,16239,15820,419,2.6
CN2011300000000,20,113,McPherson County, KS,Mar-18,16583,16152,431,2.6
CN2011300000000,20,113,McPherson County, KS,Apr-18(p),16533,16122,411,2.5
CN3912300000000,39,123,Ottawa County, OH,Mar-17,20641,18906,1735,8.4
CN3912300000000,39,123,Ottawa County, OH,Apr-17,20801,19418,1383,6.6
CN3912300000000,39,123,Ottawa County, OH,May-17,21531,20388,1143,5.3
CN3912300000000,39,123,Ottawa County, OH,Jun-17,22655,21434,1221,5.4
CN3912300000000,39,123,Ottawa County, OH,Jul-17,22838,21579,1259,5.5
CN3912300000000,39,123,Ottawa County, OH,Aug-17,22683,21500,1183,5.2
CN3912300000000,39,123,Ottawa County, OH,Sep-17,21921,20827,1094,5.0
CN3912300000000,39,123,Ottawa County, OH,Oct-17,21297,20214,1083,5.1
CN3912300000000,39,123,Ottawa County, OH,Nov-17,20659,19252,1407,6.8
CN3912300000000,39,123,Ottawa County, OH,Dec-17,20466,18850,1616,7.9
CN3912300000000,39,123,Ottawa County, OH,Jan-18,20088,18282,1806,9.0
CN3912300000000,39,123,Ottawa County, OH,Feb-18,20146,18487,1659,8.2
CN3912300000000,39,123,Ottawa County, OH,Mar-18,20451,18971,1480,7.2
CN3912300000000,39,123,Ottawa County, OH,Apr-18(p),20808,19520,1288,6.2
CN3005700000000,30,057,Madison County, MT,Mar-17,4799,4610,189,3.9
CN3005700000000,30,057,Madison County, MT,Apr-17,4698,4540,158,3.4
CN3005700000000,30,057,Madison County, MT,May-17,4001,3857,144,3.6
CN3005700000000,30,057,Madison County, MT,Jun-17,4168,4018,150,3.6
CN3005700000000,30,057,Madison County, MT,Jul-17,4381,4236,145,3.3
CN3005700000000,30,057,Madison County, MT,Aug-17,4243,4103,140,3.3
CN3005700000000,30,057,Madison County, MT,Sep-17,3995,3856,139,3.5
CN3005700000000,30,057,Madison County, MT,Oct-17,3690,3521,169,4.6
CN3005700000000,30,057,Madison County, MT,Nov-17,3754,3558,196,5.2
CN3005700000000,30,057,Madison County, MT,Dec-17,4599,4398,201,4.4
CN3005700000000,30,057,Madison County, MT,Jan-18,4763,4509,254,5.3
CN3005700000000,30,057,Madison County, MT,Feb-18,4754,4528,226,4.8
CN3005700000000,30,057,Madison County, MT,Mar-18,4673,4475,198,4.2
CN3005700000000,30,057,Madison County, MT,Apr-18(p),4469,4328,141,3.2
CN3503500000000,35,035,Otero County, NM,Mar-17,24884,23426,1458,5.9
CN3503500000000,35,035,Otero County, NM,Apr-17,24535,23176,1359,5.5
CN3503500000000,35,035,Otero County, NM,May-17,24597,23149,1448,5.9
CN3503500000000,35,035,Otero County, NM,Jun-17,24787,23036,1751,7.1
CN3503500000000,35,035,Otero County, NM,Jul-17,24702,22973,1729,7.0
CN3503500000000,35,035,Otero County, NM,Aug-17,24518,22935,1583,6.5
CN3503500000000,35,035,Otero County, NM,Sep-17,24566,23070,1496,6.1
CN3503500000000,35,035,Otero County, NM,Oct-17,24753,23264,1489,6.0
CN3503500000000,35,035,Otero County, NM,Nov-17,24888,23462,1426,5.7
CN3503500000000,35,035,Otero County, NM,Dec-17,24913,23573,1340,5.4
CN3503500000000,35,035,Otero County, NM,Jan-18,25116,23745,1371,5.5
CN3503500000000,35,035,Otero County, NM,Feb-18,24797,23509,1288,5.2
CN3503500000000,35,035,Otero County, NM,Mar-18,24577,23406,1171,4.8
CN3503500000000,35,035,Otero County, NM,Apr-18(p),24295,23278,1017,4.2
CN4800500000000,48,005,Angelina County, TX,Mar-17,37051,35004,2047,5.5
CN4800500000000,48,005,Angelina County, TX,Apr-17,36996,35118,1878,5.1
CN4800500000000,48,005,Angelina County, TX,May-17,36727,34894,1833,5.0
CN4800500000000,48,005,Angelina County, TX,Jun-17,36800,34858,1942,5.3
CN4800500000000,48,005,Angelina County, TX,Jul-17,36472,34583,1889,5.2
CN4800500000000,48,005,Angelina County, TX,Aug-17,36371,34504,1867,5.1
CN4800500000000,48,005,Angelina County, TX,Sep-17,36435,34782,1653,4.5
CN4800500000000,48,005,Angelina County, TX,Oct-17,35934,34403,1531,4.3
CN4800500000000,48,005,Angelina County, TX,Nov-17,36137,34559,1578,4.4
CN4800500000000,48,005,Angelina County, TX,Dec-17,36033,34513,1520,4.2
CN4800500000000,48,005,Angelina County, TX,Jan-18,36262,34548,1714,4.7
CN4800500000000,48,005,Angelina County, TX,Feb-18,36537,34849,1688,4.6
CN4800500000000,48,005,Angelina County, TX,Mar-18,36414,34731,1683,4.6
CN4800500000000,48,005,Angelina County, TX,Apr-18(p),36342,34777,1565,4.3
CN4608100000000,46,081,Lawrence County, SD,Mar-17,12807,12348,459,3.6
CN4608100000000,46,081,Lawrence County, SD,Apr-17,12775,12339,436,3.4
CN4608100000000,46,081,Lawrence County, SD,May-17,12934,12508,426,3.3
CN4608100000000,46,081,Lawrence County, SD,Jun-17,13318,12879,439,3.3
CN4608100000000,46,081,Lawrence County, SD,Jul-17,13413,13000,413,3.1
CN4608100000000,46,081,Lawrence County, SD,Aug-17,13400,12964,436,3.3
CN4608100000000,46,081,Lawrence County, SD,Sep-17,13147,12744,403,3.1
CN4608100000000,46,081,Lawrence County, SD,Oct-17,13076,12691,385,2.9
CN4608100000000,46,081,Lawrence County, SD,Nov-17,12934,12521,413,3.2
CN4608100000000,46,081,Lawrence County, SD,Dec-17,12814,12367,447,3.5
CN4608100000000,46,081,Lawrence County, SD,Jan-18,12804,12342,462,3.6
CN4608100000000,46,081,Lawrence County, SD,Feb-18,13014,12546,468,3.6
CN4608100000000,46,081,Lawrence County, SD,Mar-18,13007,12589,418,3.2
CN4608100000000,46,081,Lawrence County, SD,Apr-18(p),13019,12575,444,3.4
CN1317100000000,13,171,Lamar County, GA,Mar-17,8098,7620,478,5.9
CN1317100000000,13,171,Lamar County, GA,Apr-17,8108,7650,458,5.6
CN1317100000000,13,171,Lamar County, GA,May-17,8103,7658,445,5.5
CN1317100000000,13,171,Lamar County, GA,Jun-17,8167,7651,516,6.3
CN1317100000000,13,171,Lamar County, GA,Jul-17,8186,7705,481,5.9
CN1317100000000,13,171,Lamar County, GA,Aug-17,8127,7660,467,5.7
CN1317100000000,13,171,Lamar County, GA,Sep-17,8220,7768,452,5.5
CN1317100000000,13,171,Lamar County, GA,Oct-17,8141,7733,408,5.0
CN1317100000000,13,171,Lamar County, GA,Nov-17,8151,7751,400,4.9
CN1317100000000,13,171,Lamar County, GA,Dec-17,8152,7748,404,5.0
CN1317100000000,13,171,Lamar County, GA,Jan-18,8163,7743,420,5.1
CN1317100000000,13,171,Lamar County, GA,Feb-18,8294,7869,425,5.1
CN1317100000000,13,171,Lamar County, GA,Mar-18,8273,7891,382,4.6
CN1317100000000,13,171,Lamar County, GA,Apr-18(p),8239,7886,353,4.3
CN1330300000000,13,303,Washington County, GA,Mar-17,7493,7032,461,6.2
CN1330300000000,13,303,Washington County, GA,Apr-17,7409,6986,423,5.7
CN1330300000000,13,303,Washington County, GA,May-17,7337,6922,415,5.7
CN1330300000000,13,303,Washington County, GA,Jun-17,7374,6922,452,6.1
CN1330300000000,13,303,Washington County, GA,Jul-17,7371,6910,461,6.3
CN1330300000000,13,303,Washington County, GA,Aug-17,7333,6885,448,6.1
CN1330300000000,13,303,Washington County, GA,Sep-17,7348,6946,402,5.5
CN1330300000000,13,303,Washington County, GA,Oct-17,7332,6923,409,5.6
CN1330300000000,13,303,Washington County, GA,Nov-17,7338,6932,406,5.5
CN1330300000000,13,303,Washington County, GA,Dec-17,7294,6867,427,5.9
CN1330300000000,13,303,Washington County, GA,Jan-18,7413,6942,471,6.4
CN1330300000000,13,303,Washington County, GA,Feb-18,7466,7013,453,6.1
CN1330300000000,13,303,Washington County, GA,Mar-18,7421,7028,393,5.3
CN1330300000000,13,303,Washington County, GA,Apr-18(p),7383,7045,338,4.6
CN2401300000000,24,013,Carroll County, MD,Mar-17,94651,91415,3236,3.4
CN2401300000000,24,013,Carroll County, MD,Apr-17,94701,91874,2827,3.0
CN2401300000000,24,013,Carroll County, MD,May-17,94548,91548,3000,3.2
CN2401300000000,24,013,Carroll County, MD,Jun-17,95606,92188,3418,3.6
CN2401300000000,24,013,Carroll County, MD,Jul-17,96463,92940,3523,3.7
CN2401300000000,24,013,Carroll County, MD,Aug-17,94851,91509,3342,3.5
CN2401300000000,24,013,Carroll County, MD,Sep-17,94905,91913,2992,3.2
CN2401300000000,24,013,Carroll County, MD,Oct-17,95395,92329,3066,3.2
CN2401300000000,24,013,Carroll County, MD,Nov-17,94945,91874,3071,3.2
CN2401300000000,24,013,Carroll County, MD,Dec-17,94464,91716,2748,2.9
CN2401300000000,24,013,Carroll County, MD,Jan-18,95290,91497,3793,4.0
CN2401300000000,24,013,Carroll County, MD,Feb-18,95704,91936,3768,3.9
CN2401300000000,24,013,Carroll County, MD,Mar-18,95993,92426,3567,3.7
CN2401300000000,24,013,Carroll County, MD,Apr-18(p),95396,92462,2934,3.1
CN2006100000000,20,061,Geary County, KS,Mar-17,11661,11052,609,5.2
CN2006100000000,20,061,Geary County, KS,Apr-17,11753,11183,570,4.8
CN2006100000000,20,061,Geary County, KS,May-17,11605,11018,587,5.1
CN2006100000000,20,061,Geary County, KS,Jun-17,11742,11079,663,5.6
CN2006100000000,20,061,Geary County, KS,Jul-17,11314,10664,650,5.7
CN2006100000000,20,061,Geary County, KS,Aug-17,11168,10566,602,5.4
CN2006100000000,20,061,Geary County, KS,Sep-17,11579,11041,538,4.6
CN2006100000000,20,061,Geary County, KS,Oct-17,11597,11107,490,4.2
CN2006100000000,20,061,Geary County, KS,Nov-17,11618,11106,512,4.4
CN2006100000000,20,061,Geary County, KS,Dec-17,11474,10980,494,4.3
CN2006100000000,20,061,Geary County, KS,Jan-18,11241,10720,521,4.6
CN2006100000000,20,061,Geary County, KS,Feb-18,11606,11026,580,5.0
CN2006100000000,20,061,Geary County, KS,Mar-18,11463,10894,569,5.0
CN2006100000000,20,061,Geary County, KS,Apr-18(p),11517,10990,527,4.6
CN3110300000000,31,103,Keya Paha County, NE,Mar-17,595,580,15,2.5
CN3110300000000,31,103,Keya Paha County, NE,Apr-17,633,618,15,2.4
CN3110300000000,31,103,Keya Paha County, NE,May-17,642,626,16,2.5
CN3110300000000,31,103,Keya Paha County, NE,Jun-17,657,643,14,2.1
CN3110300000000,31,103,Keya Paha County, NE,Jul-17,623,607,16,2.6
CN3110300000000,31,103,Keya Paha County, NE,Aug-17,601,585,16,2.7
CN3110300000000,31,103,Keya Paha County, NE,Sep-17,557,543,14,2.5
CN3110300000000,31,103,Keya Paha County, NE,Oct-17,571,558,13,2.3
CN3110300000000,31,103,Keya Paha County, NE,Nov-17,586,573,13,2.2
CN3110300000000,31,103,Keya Paha County, NE,Dec-17,581,569,12,2.1
CN3110300000000,31,103,Keya Paha County, NE,Jan-18,620,610,10,1.6
CN3110300000000,31,103,Keya Paha County, NE,Feb-18,582,572,10,1.7
CN3110300000000,31,103,Keya Paha County, NE,Mar-18,588,575,13,2.2
CN3110300000000,31,103,Keya Paha County, NE,Apr-18(p),622,609,13,2.1
CN0600500000000,06,005,Amador County, CA,Mar-17,14701,13877,824,5.6
CN0600500000000,06,005,Amador County, CA,Apr-17,14746,14011,735,5.0
CN0600500000000,06,005,Amador County, CA,May-17,14821,14160,661,4.5
CN0600500000000,06,005,Amador County, CA,Jun-17,14971,14259,712,4.8
CN0600500000000,06,005,Amador County, CA,Jul-17,14972,14222,750,5.0
CN0600500000000,06,005,Amador County, CA,Aug-17,14957,14234,723,4.8
CN0600500000000,06,005,Amador County, CA,Sep-17,15063,14440,623,4.1
CN0600500000000,06,005,Amador County, CA,Oct-17,14873,14254,619,4.2
CN0600500000000,06,005,Amador County, CA,Nov-17,14709,14093,616,4.2
CN0600500000000,06,005,Amador County, CA,Dec-17,14561,13945,616,4.2
CN0600500000000,06,005,Amador County, CA,Jan-18,14572,13883,689,4.7
CN0600500000000,06,005,Amador County, CA,Feb-18,14601,13922,679,4.7
CN0600500000000,06,005,Amador County, CA,Mar-18,14583,13937,646,4.4
CN0600500000000,06,005,Amador County, CA,Apr-18(p),14527,13965,562,3.9
CN2104100000000,21,041,Carroll County, KY,Mar-17,4935,4664,271,5.5
CN2104100000000,21,041,Carroll County, KY,Apr-17,4954,4734,220,4.4
CN2104100000000,21,041,Carroll County, KY,May-17,4953,4716,237,4.8
CN2104100000000,21,041,Carroll County, KY,Jun-17,4998,4746,252,5.0
CN2104100000000,21,041,Carroll County, KY,Jul-17,4964,4724,240,4.8
CN2104100000000,21,041,Carroll County, KY,Aug-17,4922,4710,212,4.3
CN2104100000000,21,041,Carroll County, KY,Sep-17,4883,4686,197,4.0
CN2104100000000,21,041,Carroll County, KY,Oct-17,4855,4677,178,3.7
CN2104100000000,21,041,Carroll County, KY,Nov-17,4891,4711,180,3.7
CN2104100000000,21,041,Carroll County, KY,Dec-17,4849,4661,188,3.9
CN2104100000000,21,041,Carroll County, KY,Jan-18,4772,4547,225,4.7
CN2104100000000,21,041,Carroll County, KY,Feb-18,4871,4632,239,4.9
CN2104100000000,21,041,Carroll County, KY,Mar-18,4913,4694,219,4.5
CN2104100000000,21,041,Carroll County, KY,Apr-18(p),4963,4758,205,4.1
CN4848300000000,48,483,Wheeler County, TX,Mar-17,2373,2268,105,4.4
CN4848300000000,48,483,Wheeler County, TX,Apr-17,2364,2270,94,4.0
CN4848300000000,48,483,Wheeler County, TX,May-17,2469,2377,92,3.7
CN4848300000000,48,483,Wheeler County, TX,Jun-17,2434,2338,96,3.9
CN4848300000000,48,483,Wheeler County, TX,Jul-17,2357,2260,97,4.1
CN4848300000000,48,483,Wheeler County, TX,Aug-17,2376,2280,96,4.0
CN4848300000000,48,483,Wheeler County, TX,Sep-17,2331,2244,87,3.7
CN4848300000000,48,483,Wheeler County, TX,Oct-17,2333,2253,80,3.4
CN4848300000000,48,483,Wheeler County, TX,Nov-17,2295,2206,89,3.9
CN4848300000000,48,483,Wheeler County, TX,Dec-17,2305,2223,82,3.6
CN4848300000000,48,483,Wheeler County, TX,Jan-18,2228,2131,97,4.4
CN4848300000000,48,483,Wheeler County, TX,Feb-18,2260,2166,94,4.2
CN4848300000000,48,483,Wheeler County, TX,Mar-18,2302,2208,94,4.1
CN4848300000000,48,483,Wheeler County, TX,Apr-18(p),2345,2259,86,3.7
CN2603700000000,26,037,Clinton County, MI,Mar-17,41202,39680,1522,3.7
CN2603700000000,26,037,Clinton County, MI,Apr-17,41168,39933,1235,3.0
CN2603700000000,26,037,Clinton County, MI,May-17,41237,39921,1316,3.2
CN2603700000000,26,037,Clinton County, MI,Jun-17,40335,38734,1601,4.0
CN2603700000000,26,037,Clinton County, MI,Jul-17,40133,38283,1850,4.6
CN2603700000000,26,037,Clinton County, MI,Aug-17,39879,38181,1698,4.3
CN2603700000000,26,037,Clinton County, MI,Sep-17,40812,39354,1458,3.6
CN2603700000000,26,037,Clinton County, MI,Oct-17,40993,39685,1308,3.2
CN2603700000000,26,037,Clinton County, MI,Nov-17,41321,39950,1371,3.3
CN2603700000000,26,037,Clinton County, MI,Dec-17,40940,39487,1453,3.5
CN2603700000000,26,037,Clinton County, MI,Jan-18,41018,39113,1905,4.6
CN2603700000000,26,037,Clinton County, MI,Feb-18,41719,39971,1748,4.2
CN2603700000000,26,037,Clinton County, MI,Mar-18,41582,40043,1539,3.7
CN2603700000000,26,037,Clinton County, MI,Apr-18(p),41665,40319,1346,3.2
CN2208500000000,22,085,Sabine Parish, LA,Mar-17,8724,8225,499,5.7
CN2208500000000,22,085,Sabine Parish, LA,Apr-17,8882,8416,466,5.2
CN2208500000000,22,085,Sabine Parish, LA,May-17,8885,8411,474,5.3
CN2208500000000,22,085,Sabine Parish, LA,Jun-17,9146,8602,544,5.9
CN2208500000000,22,085,Sabine Parish, LA,Jul-17,9125,8600,525,5.8
CN2208500000000,22,085,Sabine Parish, LA,Aug-17,8903,8389,514,5.8
CN2208500000000,22,085,Sabine Parish, LA,Sep-17,8915,8444,471,5.3
CN2208500000000,22,085,Sabine Parish, LA,Oct-17,8616,8207,409,4.7
CN2208500000000,22,085,Sabine Parish, LA,Nov-17,8582,8161,421,4.9
CN2208500000000,22,085,Sabine Parish, LA,Dec-17,8566,8165,401,4.7
CN2208500000000,22,085,Sabine Parish, LA,Jan-18,8675,8233,442,5.1
CN2208500000000,22,085,Sabine Parish, LA,Feb-18,8855,8474,381,4.3
CN2208500000000,22,085,Sabine Parish, LA,Mar-18,8987,8570,417,4.6
CN2208500000000,22,085,Sabine Parish, LA,Apr-18(p),8965,8550,415,4.6
CN0802900000000,08,029,Delta County, CO,Mar-17,13791,13165,626,4.5
CN0802900000000,08,029,Delta County, CO,Apr-17,14133,13604,529,3.7
CN0802900000000,08,029,Delta County, CO,May-17,14328,13848,480,3.4
CN0802900000000,08,029,Delta County, CO,Jun-17,14455,13911,544,3.8
CN0802900000000,08,029,Delta County, CO,Jul-17,14590,14094,496,3.4
CN0802900000000,08,029,Delta County, CO,Aug-17,14570,14073,497,3.4
CN0802900000000,08,029,Delta County, CO,Sep-17,14590,14112,478,3.3
CN0802900000000,08,029,Delta County, CO,Oct-17,15033,14550,483,3.2
CN0802900000000,08,029,Delta County, CO,Nov-17,14726,14198,528,3.6
CN0802900000000,08,029,Delta County, CO,Dec-17,14472,13889,583,4.0
CN0802900000000,08,029,Delta County, CO,Jan-18,14142,13463,679,4.8
CN0802900000000,08,029,Delta County, CO,Feb-18,14143,13464,679,4.8
CN0802900000000,08,029,Delta County, CO,Mar-18,14156,13572,584,4.1
CN0802900000000,08,029,Delta County, CO,Apr-18(p),14477,13989,488,3.4
CN2122900000000,21,229,Washington County, KY,Mar-17,6430,6148,282,4.4
CN2122900000000,21,229,Washington County, KY,Apr-17,6450,6201,249,3.9
CN2122900000000,21,229,Washington County, KY,May-17,6459,6211,248,3.8
CN2122900000000,21,229,Washington County, KY,Jun-17,6481,6191,290,4.5
CN2122900000000,21,229,Washington County, KY,Jul-17,6317,6015,302,4.8
CN2122900000000,21,229,Washington County, KY,Aug-17,6196,5934,262,4.2
CN2122900000000,21,229,Washington County, KY,Sep-17,6328,6099,229,3.6
CN2122900000000,21,229,Washington County, KY,Oct-17,6275,6068,207,3.3
CN2122900000000,21,229,Washington County, KY,Nov-17,6374,6168,206,3.2
CN2122900000000,21,229,Washington County, KY,Dec-17,6344,6131,213,3.4
CN2122900000000,21,229,Washington County, KY,Jan-18,6326,6104,222,3.5
CN2122900000000,21,229,Washington County, KY,Feb-18,6317,6076,241,3.8
CN2122900000000,21,229,Washington County, KY,Mar-18,6365,6139,226,3.6
CN2122900000000,21,229,Washington County, KY,Apr-18(p),6385,6184,201,3.1
CN4009300000000,40,093,Major County, OK,Mar-17,3953,3815,138,3.5
CN4009300000000,40,093,Major County, OK,Apr-17,4000,3874,126,3.2
CN4009300000000,40,093,Major County, OK,May-17,3979,3839,140,3.5
CN4009300000000,40,093,Major County, OK,Jun-17,3963,3820,143,3.6
CN4009300000000,40,093,Major County, OK,Jul-17,4050,3919,131,3.2
CN4009300000000,40,093,Major County, OK,Aug-17,4057,3935,122,3.0
CN4009300000000,40,093,Major County, OK,Sep-17,4021,3901,120,3.0
CN4009300000000,40,093,Major County, OK,Oct-17,4032,3922,110,2.7
CN4009300000000,40,093,Major County, OK,Nov-17,4084,3977,107,2.6
CN4009300000000,40,093,Major County, OK,Dec-17,3993,3895,98,2.5
CN4009300000000,40,093,Major County, OK,Jan-18,3932,3835,97,2.5
CN4009300000000,40,093,Major County, OK,Feb-18,4009,3909,100,2.5
CN4009300000000,40,093,Major County, OK,Mar-18,3989,3886,103,2.6
CN4009300000000,40,093,Major County, OK,Apr-18(p),3919,3823,96,2.4
CN3704900000000,37,049,Craven County, NC,Mar-17,42122,40178,1944,4.6
CN3704900000000,37,049,Craven County, NC,Apr-17,41796,40036,1760,4.2
CN3704900000000,37,049,Craven County, NC,May-17,41875,39991,1884,4.5
CN3704900000000,37,049,Craven County, NC,Jun-17,42226,40231,1995,4.7
CN3704900000000,37,049,Craven County, NC,Jul-17,42408,40304,2104,5.0
CN3704900000000,37,049,Craven County, NC,Aug-17,41864,39754,2110,5.0
CN3704900000000,37,049,Craven County, NC,Sep-17,41949,40045,1904,4.5
CN3704900000000,37,049,Craven County, NC,Oct-17,41531,39676,1855,4.5
CN3704900000000,37,049,Craven County, NC,Nov-17,41648,39660,1988,4.8
CN3704900000000,37,049,Craven County, NC,Dec-17,41279,39361,1918,4.6
CN3704900000000,37,049,Craven County, NC,Jan-18,41374,39371,2003,4.8
CN3704900000000,37,049,Craven County, NC,Feb-18,41694,39741,1953,4.7
CN3704900000000,37,049,Craven County, NC,Mar-18,41901,40003,1898,4.5
CN3704900000000,37,049,Craven County, NC,Apr-18(p),41758,40142,1616,3.9
CN4502500000000,45,025,Chesterfield County, SC,Mar-17,21498,20620,878,4.1
CN4502500000000,45,025,Chesterfield County, SC,Apr-17,21421,20593,828,3.9
CN4502500000000,45,025,Chesterfield County, SC,May-17,21591,20729,862,4.0
CN4502500000000,45,025,Chesterfield County, SC,Jun-17,21815,20781,1034,4.7
CN4502500000000,45,025,Chesterfield County, SC,Jul-17,21751,20730,1021,4.7
CN4502500000000,45,025,Chesterfield County, SC,Aug-17,21667,20598,1069,4.9
CN4502500000000,45,025,Chesterfield County, SC,Sep-17,21661,20689,972,4.5
CN4502500000000,45,025,Chesterfield County, SC,Oct-17,21643,20742,901,4.2
CN4502500000000,45,025,Chesterfield County, SC,Nov-17,21611,20770,841,3.9
CN4502500000000,45,025,Chesterfield County, SC,Dec-17,21818,20940,878,4.0
CN4502500000000,45,025,Chesterfield County, SC,Jan-18,21831,20773,1058,4.8
CN4502500000000,45,025,Chesterfield County, SC,Feb-18,21936,20988,948,4.3
CN4502500000000,45,025,Chesterfield County, SC,Mar-18,21701,20858,843,3.9
CN4502500000000,45,025,Chesterfield County, SC,Apr-18(p),21445,20871,574,2.7
CN5113500000000,51,135,Nottoway County, VA,Mar-17,7040,6752,288,4.1
CN5113500000000,51,135,Nottoway County, VA,Apr-17,7064,6804,260,3.7
CN5113500000000,51,135,Nottoway County, VA,May-17,7052,6791,261,3.7
CN5113500000000,51,135,Nottoway County, VA,Jun-17,7046,6757,289,4.1
CN5113500000000,51,135,Nottoway County, VA,Jul-17,7024,6728,296,4.2
CN5113500000000,51,135,Nottoway County, VA,Aug-17,6944,6656,288,4.1
CN5113500000000,51,135,Nottoway County, VA,Sep-17,6935,6661,274,4.0
CN5113500000000,51,135,Nottoway County, VA,Oct-17,6917,6659,258,3.7
CN5113500000000,51,135,Nottoway County, VA,Nov-17,6920,6677,243,3.5
CN5113500000000,51,135,Nottoway County, VA,Dec-17,6928,6670,258,3.7
CN5113500000000,51,135,Nottoway County, VA,Jan-18,6916,6632,284,4.1
CN5113500000000,51,135,Nottoway County, VA,Feb-18,6939,6675,264,3.8
CN5113500000000,51,135,Nottoway County, VA,Mar-18,7004,6747,257,3.7
CN5113500000000,51,135,Nottoway County, VA,Apr-18(p),7022,6800,222,3.2
CN4714100000000,47,141,Putnam County, TN,Mar-17,34149,32722,1427,4.2
CN4714100000000,47,141,Putnam County, TN,Apr-17,34110,32947,1163,3.4
CN4714100000000,47,141,Putnam County, TN,May-17,33794,32669,1125,3.3
CN4714100000000,47,141,Putnam County, TN,Jun-17,33840,32372,1468,4.3
CN4714100000000,47,141,Putnam County, TN,Jul-17,33682,32308,1374,4.1
CN4714100000000,47,141,Putnam County, TN,Aug-17,33887,32608,1279,3.8
CN4714100000000,47,141,Putnam County, TN,Sep-17,34562,33473,1089,3.2
CN4714100000000,47,141,Putnam County, TN,Oct-17,34415,33359,1056,3.1
CN4714100000000,47,141,Putnam County, TN,Nov-17,34378,33300,1078,3.1
CN4714100000000,47,141,Putnam County, TN,Dec-17,34351,33350,1001,2.9
CN4714100000000,47,141,Putnam County, TN,Jan-18,34047,32803,1244,3.7
CN4714100000000,47,141,Putnam County, TN,Feb-18,34556,33325,1231,3.6
CN4714100000000,47,141,Putnam County, TN,Mar-18,34583,33380,1203,3.5
CN4714100000000,47,141,Putnam County, TN,Apr-18(p),34742,33767,975,2.8
CN4817100000000,48,171,Gillespie County, TX,Mar-17,13163,12796,367,2.8
CN4817100000000,48,171,Gillespie County, TX,Apr-17,13122,12814,308,2.3
CN4817100000000,48,171,Gillespie County, TX,May-17,13181,12847,334,2.5
CN4817100000000,48,171,Gillespie County, TX,Jun-17,13326,12980,346,2.6
CN4817100000000,48,171,Gillespie County, TX,Jul-17,13326,12957,369,2.8
CN4817100000000,48,171,Gillespie County, TX,Aug-17,13354,13007,347,2.6
CN4817100000000,48,171,Gillespie County, TX,Sep-17,13165,12843,322,2.4
CN4817100000000,48,171,Gillespie County, TX,Oct-17,13172,12876,296,2.2
CN4817100000000,48,171,Gillespie County, TX,Nov-17,13270,12960,310,2.3
CN4817100000000,48,171,Gillespie County, TX,Dec-17,13455,13164,291,2.2
CN4817100000000,48,171,Gillespie County, TX,Jan-18,13315,12975,340,2.6
CN4817100000000,48,171,Gillespie County, TX,Feb-18,13510,13162,348,2.6
CN4817100000000,48,171,Gillespie County, TX,Mar-18,13765,13395,370,2.7
CN4817100000000,48,171,Gillespie County, TX,Apr-18(p),13520,13191,329,2.4
CN4606900000000,46,069,Hyde County, SD,Mar-17,684,664,20,2.9
CN4606900000000,46,069,Hyde County, SD,Apr-17,692,675,17,2.5
CN4606900000000,46,069,Hyde County, SD,May-17,704,684,20,2.8
CN4606900000000,46,069,Hyde County, SD,Jun-17,732,713,19,2.6
CN4606900000000,46,069,Hyde County, SD,Jul-17,702,680,22,3.1
CN4606900000000,46,069,Hyde County, SD,Aug-17,686,664,22,3.2
CN4606900000000,46,069,Hyde County, SD,Sep-17,689,664,25,3.6
CN4606900000000,46,069,Hyde County, SD,Oct-17,672,650,22,3.3
CN4606900000000,46,069,Hyde County, SD,Nov-17,670,643,27,4.0
CN4606900000000,46,069,Hyde County, SD,Dec-17,693,665,28,4.0
CN4606900000000,46,069,Hyde County, SD,Jan-18,690,666,24,3.5
CN4606900000000,46,069,Hyde County, SD,Feb-18,688,661,27,3.9
CN4606900000000,46,069,Hyde County, SD,Mar-18,699,674,25,3.6
CN4606900000000,46,069,Hyde County, SD,Apr-18(p),672,649,23,3.4
CN5603700000000,56,037,Sweetwater County, WY,Mar-17,22066,20909,1157,5.2
CN5603700000000,56,037,Sweetwater County, WY,Apr-17,21897,20940,957,4.4
CN5603700000000,56,037,Sweetwater County, WY,May-17,21482,20591,891,4.1
CN5603700000000,56,037,Sweetwater County, WY,Jun-17,21309,20358,951,4.5
CN5603700000000,56,037,Sweetwater County, WY,Jul-17,20973,20055,918,4.4
CN5603700000000,56,037,Sweetwater County, WY,Aug-17,21392,20539,853,4.0
CN5603700000000,56,037,Sweetwater County, WY,Sep-17,21279,20428,851,4.0
CN5603700000000,56,037,Sweetwater County, WY,Oct-17,21447,20589,858,4.0
CN5603700000000,56,037,Sweetwater County, WY,Nov-17,21640,20770,870,4.0
CN5603700000000,56,037,Sweetwater County, WY,Dec-17,21518,20644,874,4.1
CN5603700000000,56,037,Sweetwater County, WY,Jan-18,21195,20217,978,4.6
CN5603700000000,56,037,Sweetwater County, WY,Feb-18,21200,20306,894,4.2
CN5603700000000,56,037,Sweetwater County, WY,Mar-18,21489,20579,910,4.2
CN5603700000000,56,037,Sweetwater County, WY,Apr-18(p),21500,20664,836,3.9
CN3608700000000,36,087,Rockland County, NY,Mar-17,154000,147578,6422,4.2
CN3608700000000,36,087,Rockland County, NY,Apr-17,153873,147770,6103,4.0
CN3608700000000,36,087,Rockland County, NY,May-17,154827,148474,6353,4.1
CN3608700000000,36,087,Rockland County, NY,Jun-17,157618,150653,6965,4.4
CN3608700000000,36,087,Rockland County, NY,Jul-17,159175,151764,7411,4.7
CN3608700000000,36,087,Rockland County, NY,Aug-17,156441,149167,7274,4.6
CN3608700000000,36,087,Rockland County, NY,Sep-17,155101,148087,7014,4.5
CN3608700000000,36,087,Rockland County, NY,Oct-17,153679,146985,6694,4.4
CN3608700000000,36,087,Rockland County, NY,Nov-17,152811,146124,6687,4.4
CN3608700000000,36,087,Rockland County, NY,Dec-17,151726,145375,6351,4.2
CN3608700000000,36,087,Rockland County, NY,Jan-18,152160,144946,7214,4.7
CN3608700000000,36,087,Rockland County, NY,Feb-18,150823,143318,7505,5.0
CN3608700000000,36,087,Rockland County, NY,Mar-18,151183,144348,6835,4.5
CN3608700000000,36,087,Rockland County, NY,Apr-18(p),152356,146090,6266,4.1
CN3905900000000,39,059,Guernsey County, OH,Mar-17,18815,17543,1272,6.8
CN3905900000000,39,059,Guernsey County, OH,Apr-17,18823,17767,1056,5.6
CN3905900000000,39,059,Guernsey County, OH,May-17,19004,18033,971,5.1
CN3905900000000,39,059,Guernsey County, OH,Jun-17,19008,17947,1061,5.6
CN3905900000000,39,059,Guernsey County, OH,Jul-17,19086,18024,1062,5.6
CN3905900000000,39,059,Guernsey County, OH,Aug-17,19255,18204,1051,5.5
CN3905900000000,39,059,Guernsey County, OH,Sep-17,19017,18077,940,4.9
CN3905900000000,39,059,Guernsey County, OH,Oct-17,18849,17864,985,5.2
CN3905900000000,39,059,Guernsey County, OH,Nov-17,18798,17689,1109,5.9
CN3905900000000,39,059,Guernsey County, OH,Dec-17,18673,17469,1204,6.4
CN3905900000000,39,059,Guernsey County, OH,Jan-18,18478,17105,1373,7.4
CN3905900000000,39,059,Guernsey County, OH,Feb-18,18601,17377,1224,6.6
CN3905900000000,39,059,Guernsey County, OH,Mar-18,18792,17698,1094,5.8
CN3905900000000,39,059,Guernsey County, OH,Apr-18(p),18701,17726,975,5.2
CN5507500000000,55,075,Marinette County, WI,Mar-17,19855,18802,1053,5.3
CN5507500000000,55,075,Marinette County, WI,Apr-17,20010,19125,885,4.4
CN5507500000000,55,075,Marinette County, WI,May-17,19978,19202,776,3.9
CN5507500000000,55,075,Marinette County, WI,Jun-17,20498,19560,938,4.6
CN5507500000000,55,075,Marinette County, WI,Jul-17,20222,19315,907,4.5
CN5507500000000,55,075,Marinette County, WI,Aug-17,20105,19206,899,4.5
CN5507500000000,55,075,Marinette County, WI,Sep-17,20090,19326,764,3.8
CN5507500000000,55,075,Marinette County, WI,Oct-17,19999,19296,703,3.5
CN5507500000000,55,075,Marinette County, WI,Nov-17,19993,19261,732,3.7
CN5507500000000,55,075,Marinette County, WI,Dec-17,19869,19105,764,3.8
CN5507500000000,55,075,Marinette County, WI,Jan-18,19790,18940,850,4.3
CN5507500000000,55,075,Marinette County, WI,Feb-18,19860,18916,944,4.8
CN5507500000000,55,075,Marinette County, WI,Mar-18,19933,19009,924,4.6
CN5507500000000,55,075,Marinette County, WI,Apr-18(p),20053,19273,780,3.9
CN1317700000000,13,177,Lee County, GA,Mar-17,15097,14472,625,4.1
CN1317700000000,13,177,Lee County, GA,Apr-17,14850,14234,616,4.1
CN1317700000000,13,177,Lee County, GA,May-17,14867,14241,626,4.2
CN1317700000000,13,177,Lee County, GA,Jun-17,14853,14176,677,4.6
CN1317700000000,13,177,Lee County, GA,Jul-17,14811,14135,676,4.6
CN1317700000000,13,177,Lee County, GA,Aug-17,14788,14128,660,4.5
CN1317700000000,13,177,Lee County, GA,Sep-17,14940,14337,603,4.0
CN1317700000000,13,177,Lee County, GA,Oct-17,15038,14457,581,3.9
CN1317700000000,13,177,Lee County, GA,Nov-17,15068,14489,579,3.8
CN1317700000000,13,177,Lee County, GA,Dec-17,15095,14524,571,3.8
CN1317700000000,13,177,Lee County, GA,Jan-18,15161,14543,618,4.1
CN1317700000000,13,177,Lee County, GA,Feb-18,15247,14642,605,4.0
CN1317700000000,13,177,Lee County, GA,Mar-18,15130,14586,544,3.6
CN1317700000000,13,177,Lee County, GA,Apr-18(p),15032,14544,488,3.2
CN3907100000000,39,071,Highland County, OH,Mar-17,17457,16371,1086,6.2
CN3907100000000,39,071,Highland County, OH,Apr-17,17323,16428,895,5.2
CN3907100000000,39,071,Highland County, OH,May-17,17230,16324,906,5.3
CN3907100000000,39,071,Highland County, OH,Jun-17,17152,16114,1038,6.1
CN3907100000000,39,071,Highland County, OH,Jul-17,17028,15993,1035,6.1
CN3907100000000,39,071,Highland County, OH,Aug-17,17252,16222,1030,6.0
CN3907100000000,39,071,Highland County, OH,Sep-17,17161,16219,942,5.5
CN3907100000000,39,071,Highland County, OH,Oct-17,17123,16205,918,5.4
CN3907100000000,39,071,Highland County, OH,Nov-17,17114,16172,942,5.5
CN3907100000000,39,071,Highland County, OH,Dec-17,16873,15854,1019,6.0
CN3907100000000,39,071,Highland County, OH,Jan-18,16701,15599,1102,6.6
CN3907100000000,39,071,Highland County, OH,Feb-18,17202,16159,1043,6.1
CN3907100000000,39,071,Highland County, OH,Mar-18,17471,16517,954,5.5
CN3907100000000,39,071,Highland County, OH,Apr-18(p),17303,16437,866,5.0
CN2207100000000,22,071,Orleans Parish, LA,Mar-17,178008,169089,8919,5.0
CN2207100000000,22,071,Orleans Parish, LA,Apr-17,179253,170604,8649,4.8
CN2207100000000,22,071,Orleans Parish, LA,May-17,179101,170206,8895,5.0
CN2207100000000,22,071,Orleans Parish, LA,Jun-17,181186,170279,10907,6.0
CN2207100000000,22,071,Orleans Parish, LA,Jul-17,181156,170522,10634,5.9
CN2207100000000,22,071,Orleans Parish, LA,Aug-17,180178,169415,10763,6.0
CN2207100000000,22,071,Orleans Parish, LA,Sep-17,180077,170795,9282,5.2
CN2207100000000,22,071,Orleans Parish, LA,Oct-17,180271,172212,8059,4.5
CN2207100000000,22,071,Orleans Parish, LA,Nov-17,180302,172566,7736,4.3
CN2207100000000,22,071,Orleans Parish, LA,Dec-17,179260,172059,7201,4.0
CN2207100000000,22,071,Orleans Parish, LA,Jan-18,180164,172151,8013,4.4
CN2207100000000,22,071,Orleans Parish, LA,Feb-18,181163,173911,7252,4.0
CN2207100000000,22,071,Orleans Parish, LA,Mar-18,181625,173780,7845,4.3
CN2207100000000,22,071,Orleans Parish, LA,Apr-18(p),182743,174872,7871,4.3
CN0504300000000,05,043,Drew County, AR,Mar-17,7822,7410,412,5.3
CN0504300000000,05,043,Drew County, AR,Apr-17,7889,7518,371,4.7
CN0504300000000,05,043,Drew County, AR,May-17,7944,7544,400,5.0
CN0504300000000,05,043,Drew County, AR,Jun-17,7930,7497,433,5.5
CN0504300000000,05,043,Drew County, AR,Jul-17,7680,7224,456,5.9
CN0504300000000,05,043,Drew County, AR,Aug-17,7576,7162,414,5.5
CN0504300000000,05,043,Drew County, AR,Sep-17,7842,7476,366,4.7
CN0504300000000,05,043,Drew County, AR,Oct-17,8012,7680,332,4.1
CN0504300000000,05,043,Drew County, AR,Nov-17,7968,7620,348,4.4
CN0504300000000,05,043,Drew County, AR,Dec-17,7971,7584,387,4.9
CN0504300000000,05,043,Drew County, AR,Jan-18,7833,7360,473,6.0
CN0504300000000,05,043,Drew County, AR,Feb-18,7907,7441,466,5.9
CN0504300000000,05,043,Drew County, AR,Mar-18,7912,7480,432,5.5
CN0504300000000,05,043,Drew County, AR,Apr-18(p),7917,7562,355,4.5
CN3102300000000,31,023,Butler County, NE,Mar-17,4528,4387,141,3.1
CN3102300000000,31,023,Butler County, NE,Apr-17,4575,4453,122,2.7
CN3102300000000,31,023,Butler County, NE,May-17,4636,4516,120,2.6
CN3102300000000,31,023,Butler County, NE,Jun-17,4741,4598,143,3.0
CN3102300000000,31,023,Butler County, NE,Jul-17,4681,4545,136,2.9
CN3102300000000,31,023,Butler County, NE,Aug-17,4582,4464,118,2.6
CN3102300000000,31,023,Butler County, NE,Sep-17,4422,4317,105,2.4
CN3102300000000,31,023,Butler County, NE,Oct-17,4470,4362,108,2.4
CN3102300000000,31,023,Butler County, NE,Nov-17,4478,4375,103,2.3
CN3102300000000,31,023,Butler County, NE,Dec-17,4452,4341,111,2.5
CN3102300000000,31,023,Butler County, NE,Jan-18,4494,4390,104,2.3
CN3102300000000,31,023,Butler County, NE,Feb-18,4462,4363,99,2.2
CN3102300000000,31,023,Butler County, NE,Mar-18,4494,4386,108,2.4
CN3102300000000,31,023,Butler County, NE,Apr-18(p),4508,4398,110,2.4
CN1203500000000,12,035,Flagler County, FL,Mar-17,46535,44353,2182,4.7
CN1203500000000,12,035,Flagler County, FL,Apr-17,46389,44337,2052,4.4
CN1203500000000,12,035,Flagler County, FL,May-17,46595,44479,2116,4.5
CN1203500000000,12,035,Flagler County, FL,Jun-17,46499,44284,2215,4.8
CN1203500000000,12,035,Flagler County, FL,Jul-17,46677,44410,2267,4.9
CN1203500000000,12,035,Flagler County, FL,Aug-17,46471,44160,2311,5.0
CN1203500000000,12,035,Flagler County, FL,Sep-17,46920,44855,2065,4.4
CN1203500000000,12,035,Flagler County, FL,Oct-17,46523,44558,1965,4.2
CN1203500000000,12,035,Flagler County, FL,Nov-17,46201,44219,1982,4.3
CN1203500000000,12,035,Flagler County, FL,Dec-17,46155,44300,1855,4.0
CN1203500000000,12,035,Flagler County, FL,Jan-18,46457,44319,2138,4.6
CN1203500000000,12,035,Flagler County, FL,Feb-18,47033,45071,1962,4.2
CN1203500000000,12,035,Flagler County, FL,Mar-18,46866,44925,1941,4.1
CN1203500000000,12,035,Flagler County, FL,Apr-18(p),46750,45010,1740,3.7
CN2902100000000,29,021,Buchanan County, MO,Mar-17,46459,44686,1773,3.8
CN2902100000000,29,021,Buchanan County, MO,Apr-17,46240,44634,1606,3.5
CN2902100000000,29,021,Buchanan County, MO,May-17,46283,44618,1665,3.6
CN2902100000000,29,021,Buchanan County, MO,Jun-17,46484,44841,1643,3.5
CN2902100000000,29,021,Buchanan County, MO,Jul-17,46900,45140,1760,3.8
CN2902100000000,29,021,Buchanan County, MO,Aug-17,45787,44054,1733,3.8
CN2902100000000,29,021,Buchanan County, MO,Sep-17,45808,44427,1381,3.0
CN2902100000000,29,021,Buchanan County, MO,Oct-17,45662,44547,1115,2.4
CN2902100000000,29,021,Buchanan County, MO,Nov-17,45748,44478,1270,2.8
CN2902100000000,29,021,Buchanan County, MO,Dec-17,45830,44506,1324,2.9
CN2902100000000,29,021,Buchanan County, MO,Jan-18,45380,43809,1571,3.5
CN2902100000000,29,021,Buchanan County, MO,Feb-18,45905,44338,1567,3.4
CN2902100000000,29,021,Buchanan County, MO,Mar-18,46086,44499,1587,3.4
CN2902100000000,29,021,Buchanan County, MO,Apr-18(p),45992,44598,1394,3.0
CN5168000000000,51,680,Lynchburg city, VA,Mar-17,35874,34082,1792,5.0
CN5168000000000,51,680,Lynchburg city, VA,Apr-17,35796,34195,1601,4.5
CN5168000000000,51,680,Lynchburg city, VA,May-17,35585,33921,1664,4.7
CN5168000000000,51,680,Lynchburg city, VA,Jun-17,35921,33869,2052,5.7
CN5168000000000,51,680,Lynchburg city, VA,Jul-17,36348,34317,2031,5.6
CN5168000000000,51,680,Lynchburg city, VA,Aug-17,36153,34145,2008,5.6
CN5168000000000,51,680,Lynchburg city, VA,Sep-17,36096,34366,1730,4.8
CN5168000000000,51,680,Lynchburg city, VA,Oct-17,35748,34181,1567,4.4
CN5168000000000,51,680,Lynchburg city, VA,Nov-17,35742,34146,1596,4.5
CN5168000000000,51,680,Lynchburg city, VA,Dec-17,35491,34000,1491,4.2
CN5168000000000,51,680,Lynchburg city, VA,Jan-18,35622,33827,1795,5.0
CN5168000000000,51,680,Lynchburg city, VA,Feb-18,36066,34512,1554,4.3
CN5168000000000,51,680,Lynchburg city, VA,Mar-18,36232,34708,1524,4.2
CN5168000000000,51,680,Lynchburg city, VA,Apr-18(p),36312,35013,1299,3.6
CN0801500000000,08,015,Chaffee County, CO,Mar-17,8991,8768,223,2.5
CN0801500000000,08,015,Chaffee County, CO,Apr-17,8971,8772,199,2.2
CN0801500000000,08,015,Chaffee County, CO,May-17,9211,9015,196,2.1
CN0801500000000,08,015,Chaffee County, CO,Jun-17,10131,9915,216,2.1
CN0801500000000,08,015,Chaffee County, CO,Jul-17,10197,9996,201,2.0
CN0801500000000,08,015,Chaffee County, CO,Aug-17,9977,9774,203,2.0
CN0801500000000,08,015,Chaffee County, CO,Sep-17,9400,9187,213,2.3
CN0801500000000,08,015,Chaffee County, CO,Oct-17,9162,8937,225,2.5
CN0801500000000,08,015,Chaffee County, CO,Nov-17,9117,8896,221,2.4
CN0801500000000,08,015,Chaffee County, CO,Dec-17,9163,8938,225,2.5
CN0801500000000,08,015,Chaffee County, CO,Jan-18,9108,8845,263,2.9
CN0801500000000,08,015,Chaffee County, CO,Feb-18,9175,8900,275,3.0
CN0801500000000,08,015,Chaffee County, CO,Mar-18,9374,9141,233,2.5
CN0801500000000,08,015,Chaffee County, CO,Apr-18(p),9372,9164,208,2.2
CN2700300000000,27,003,Anoka County, MN,Mar-17,194280,186620,7660,3.9
CN2700300000000,27,003,Anoka County, MN,Apr-17,194234,187897,6337,3.3
CN2700300000000,27,003,Anoka County, MN,May-17,194605,188669,5936,3.1
CN2700300000000,27,003,Anoka County, MN,Jun-17,196280,189544,6736,3.4
CN2700300000000,27,003,Anoka County, MN,Jul-17,198330,191750,6580,3.3
CN2700300000000,27,003,Anoka County, MN,Aug-17,197751,191114,6637,3.4
CN2700300000000,27,003,Anoka County, MN,Sep-17,196957,191277,5680,2.9
CN2700300000000,27,003,Anoka County, MN,Oct-17,194796,190107,4689,2.4
CN2700300000000,27,003,Anoka County, MN,Nov-17,195064,189946,5118,2.6
CN2700300000000,27,003,Anoka County, MN,Dec-17,194564,188409,6155,3.2
CN2700300000000,27,003,Anoka County, MN,Jan-18,196784,189634,7150,3.6
CN2700300000000,27,003,Anoka County, MN,Feb-18,198074,190964,7110,3.6
CN2700300000000,27,003,Anoka County, MN,Mar-18,197693,190771,6922,3.5
CN2700300000000,27,003,Anoka County, MN,Apr-18(p),197436,191756,5680,2.9
CN2102900000000,21,029,Bullitt County, KY,Mar-17,41064,39122,1942,4.7
CN2102900000000,21,029,Bullitt County, KY,Apr-17,40967,39274,1693,4.1
CN2102900000000,21,029,Bullitt County, KY,May-17,41173,39387,1786,4.3
CN2102900000000,21,029,Bullitt County, KY,Jun-17,41907,39951,1956,4.7
CN2102900000000,21,029,Bullitt County, KY,Jul-17,42348,40255,2093,4.9
CN2102900000000,21,029,Bullitt County, KY,Aug-17,41657,39892,1765,4.2
CN2102900000000,21,029,Bullitt County, KY,Sep-17,41746,40187,1559,3.7
CN2102900000000,21,029,Bullitt County, KY,Oct-17,41175,39751,1424,3.5
CN2102900000000,21,029,Bullitt County, KY,Nov-17,41434,40037,1397,3.4
CN2102900000000,21,029,Bullitt County, KY,Dec-17,41383,40009,1374,3.3
CN2102900000000,21,029,Bullitt County, KY,Jan-18,40847,39308,1539,3.8
CN2102900000000,21,029,Bullitt County, KY,Feb-18,41491,39768,1723,4.2
CN2102900000000,21,029,Bullitt County, KY,Mar-18,41824,40197,1627,3.9
CN2102900000000,21,029,Bullitt County, KY,Apr-18(p),41852,40409,1443,3.4
CN4001700000000,40,017,Canadian County, OK,Mar-17,69453,66907,2546,3.7
CN4001700000000,40,017,Canadian County, OK,Apr-17,69408,67101,2307,3.3
CN4001700000000,40,017,Canadian County, OK,May-17,69397,66792,2605,3.8
CN4001700000000,40,017,Canadian County, OK,Jun-17,70247,67443,2804,4.0
CN4001700000000,40,017,Canadian County, OK,Jul-17,70494,67914,2580,3.7
CN4001700000000,40,017,Canadian County, OK,Aug-17,69874,67347,2527,3.6
CN4001700000000,40,017,Canadian County, OK,Sep-17,70480,68111,2369,3.4
CN4001700000000,40,017,Canadian County, OK,Oct-17,70493,68222,2271,3.2
CN4001700000000,40,017,Canadian County, OK,Nov-17,70593,68376,2217,3.1
CN4001700000000,40,017,Canadian County, OK,Dec-17,70104,67920,2184,3.1
CN4001700000000,40,017,Canadian County, OK,Jan-18,69536,67122,2414,3.5
CN4001700000000,40,017,Canadian County, OK,Feb-18,70705,68367,2338,3.3
CN4001700000000,40,017,Canadian County, OK,Mar-18,71165,68884,2281,3.2
CN4001700000000,40,017,Canadian County, OK,Apr-18(p),70949,68755,2194,3.1
CN5305100000000,53,051,Pend Oreille County, WA,Mar-17,4780,4344,436,9.1
CN5305100000000,53,051,Pend Oreille County, WA,Apr-17,4727,4361,366,7.7
CN5305100000000,53,051,Pend Oreille County, WA,May-17,4713,4386,327,6.9
CN5305100000000,53,051,Pend Oreille County, WA,Jun-17,4719,4412,307,6.5
CN5305100000000,53,051,Pend Oreille County, WA,Jul-17,4679,4365,314,6.7
CN5305100000000,53,051,Pend Oreille County, WA,Aug-17,4647,4348,299,6.4
CN5305100000000,53,051,Pend Oreille County, WA,Sep-17,4688,4402,286,6.1
CN5305100000000,53,051,Pend Oreille County, WA,Oct-17,4737,4449,288,6.1
CN5305100000000,53,051,Pend Oreille County, WA,Nov-17,4788,4476,312,6.5
CN5305100000000,53,051,Pend Oreille County, WA,Dec-17,4776,4396,380,8.0
CN5305100000000,53,051,Pend Oreille County, WA,Jan-18,4702,4265,437,9.3
CN5305100000000,53,051,Pend Oreille County, WA,Feb-18,4736,4276,460,9.7
CN5305100000000,53,051,Pend Oreille County, WA,Mar-18,4712,4302,410,8.7
CN5305100000000,53,051,Pend Oreille County, WA,Apr-18(p),4651,4307,344,7.4
CN0810900000000,08,109,Saguache County, CO,Mar-17,3168,3028,140,4.4
CN0810900000000,08,109,Saguache County, CO,Apr-17,3388,3268,120,3.5
CN0810900000000,08,109,Saguache County, CO,May-17,3417,3302,115,3.4
CN0810900000000,08,109,Saguache County, CO,Jun-17,3448,3297,151,4.4
CN0810900000000,08,109,Saguache County, CO,Jul-17,3445,3294,151,4.4
CN0810900000000,08,109,Saguache County, CO,Aug-17,3456,3246,210,6.1
CN0810900000000,08,109,Saguache County, CO,Sep-17,3445,3279,166,4.8
CN0810900000000,08,109,Saguache County, CO,Oct-17,3592,3466,126,3.5
CN0810900000000,08,109,Saguache County, CO,Nov-17,3544,3397,147,4.1
CN0810900000000,08,109,Saguache County, CO,Dec-17,3481,3320,161,4.6
CN0810900000000,08,109,Saguache County, CO,Jan-18,3414,3240,174,5.1
CN0810900000000,08,109,Saguache County, CO,Feb-18,3323,3177,146,4.4
CN0810900000000,08,109,Saguache County, CO,Mar-18,3298,3178,120,3.6
CN0810900000000,08,109,Saguache County, CO,Apr-18(p),3497,3392,105,3.0
CN3705300000000,37,053,Currituck County, NC,Mar-17,13240,12631,609,4.6
CN3705300000000,37,053,Currituck County, NC,Apr-17,13275,12729,546,4.1
CN3705300000000,37,053,Currituck County, NC,May-17,13247,12691,556,4.2
CN3705300000000,37,053,Currituck County, NC,Jun-17,13422,12861,561,4.2
CN3705300000000,37,053,Currituck County, NC,Jul-17,13613,13032,581,4.3
CN3705300000000,37,053,Currituck County, NC,Aug-17,13330,12752,578,4.3
CN3705300000000,37,053,Currituck County, NC,Sep-17,13395,12896,499,3.7
CN3705300000000,37,053,Currituck County, NC,Oct-17,13211,12706,505,3.8
CN3705300000000,37,053,Currituck County, NC,Nov-17,13216,12647,569,4.3
CN3705300000000,37,053,Currituck County, NC,Dec-17,13100,12523,577,4.4
CN3705300000000,37,053,Currituck County, NC,Jan-18,13146,12460,686,5.2
CN3705300000000,37,053,Currituck County, NC,Feb-18,13324,12644,680,5.1
CN3705300000000,37,053,Currituck County, NC,Mar-18,13268,12702,566,4.3
CN3705300000000,37,053,Currituck County, NC,Apr-18(p),13245,12774,471,3.6
CN3801500000000,38,015,Burleigh County, ND,Mar-17,50827,49306,1521,3.0
CN3801500000000,38,015,Burleigh County, ND,Apr-17,51139,49967,1172,2.3
CN3801500000000,38,015,Burleigh County, ND,May-17,51355,50381,974,1.9
CN3801500000000,38,015,Burleigh County, ND,Jun-17,51791,50528,1263,2.4
CN3801500000000,38,015,Burleigh County, ND,Jul-17,51849,50786,1063,2.1
CN3801500000000,38,015,Burleigh County, ND,Aug-17,51085,49998,1087,2.1
CN3801500000000,38,015,Burleigh County, ND,Sep-17,49721,48747,974,2.0
CN3801500000000,38,015,Burleigh County, ND,Oct-17,49801,48929,872,1.8
CN3801500000000,38,015,Burleigh County, ND,Nov-17,49799,48656,1143,2.3
CN3801500000000,38,015,Burleigh County, ND,Dec-17,49968,48639,1329,2.7
CN3801500000000,38,015,Burleigh County, ND,Jan-18,50366,48624,1742,3.5
CN3801500000000,38,015,Burleigh County, ND,Feb-18,50819,49047,1772,3.5
CN3801500000000,38,015,Burleigh County, ND,Mar-18,50588,48959,1629,3.2
CN3801500000000,38,015,Burleigh County, ND,Apr-18(p),50460,48992,1468,2.9
CN1904500000000,19,045,Clinton County, IA,Mar-17,23258,22185,1073,4.6
CN1904500000000,19,045,Clinton County, IA,Apr-17,23369,22401,968,4.1
CN1904500000000,19,045,Clinton County, IA,May-17,23073,22175,898,3.9
CN1904500000000,19,045,Clinton County, IA,Jun-17,23202,22233,969,4.2
CN1904500000000,19,045,Clinton County, IA,Jul-17,23392,22483,909,3.9
CN1904500000000,19,045,Clinton County, IA,Aug-17,23195,22235,960,4.1
CN1904500000000,19,045,Clinton County, IA,Sep-17,23105,22285,820,3.5
CN1904500000000,19,045,Clinton County, IA,Oct-17,22963,22270,693,3.0
CN1904500000000,19,045,Clinton County, IA,Nov-17,22986,22254,732,3.2
CN1904500000000,19,045,Clinton County, IA,Dec-17,22863,22016,847,3.7
CN1904500000000,19,045,Clinton County, IA,Jan-18,22758,21742,1016,4.5
CN1904500000000,19,045,Clinton County, IA,Feb-18,22811,21850,961,4.2
CN1904500000000,19,045,Clinton County, IA,Mar-18,22745,21955,790,3.5
CN1904500000000,19,045,Clinton County, IA,Apr-18(p),22770,22095,675,3.0
CN1806500000000,18,065,Henry County, IN,Mar-17,22070,21221,849,3.8
CN1806500000000,18,065,Henry County, IN,Apr-17,22136,21443,693,3.1
CN1806500000000,18,065,Henry County, IN,May-17,22289,21533,756,3.4
CN1806500000000,18,065,Henry County, IN,Jun-17,22570,21765,805,3.6
CN1806500000000,18,065,Henry County, IN,Jul-17,22165,21338,827,3.7
CN1806500000000,18,065,Henry County, IN,Aug-17,22257,21343,914,4.1
CN1806500000000,18,065,Henry County, IN,Sep-17,22064,21320,744,3.4
CN1806500000000,18,065,Henry County, IN,Oct-17,22013,21317,696,3.2
CN1806500000000,18,065,Henry County, IN,Nov-17,22014,21313,701,3.2
CN1806500000000,18,065,Henry County, IN,Dec-17,21894,21210,684,3.1
CN1806500000000,18,065,Henry County, IN,Jan-18,21724,20917,807,3.7
CN1806500000000,18,065,Henry County, IN,Feb-18,21920,21043,877,4.0
CN1806500000000,18,065,Henry County, IN,Mar-18,22155,21369,786,3.5
CN1806500000000,18,065,Henry County, IN,Apr-18(p),22244,21565,679,3.1
CN4712900000000,47,129,Morgan County, TN,Mar-17,7845,7427,418,5.3
CN4712900000000,47,129,Morgan County, TN,Apr-17,7852,7480,372,4.7
CN4712900000000,47,129,Morgan County, TN,May-17,7810,7485,325,4.2
CN4712900000000,47,129,Morgan County, TN,Jun-17,7922,7502,420,5.3
CN4712900000000,47,129,Morgan County, TN,Jul-17,7922,7548,374,4.7
CN4712900000000,47,129,Morgan County, TN,Aug-17,7849,7491,358,4.6
CN4712900000000,47,129,Morgan County, TN,Sep-17,7932,7594,338,4.3
CN4712900000000,47,129,Morgan County, TN,Oct-17,7872,7540,332,4.2
CN4712900000000,47,129,Morgan County, TN,Nov-17,7876,7571,305,3.9
CN4712900000000,47,129,Morgan County, TN,Dec-17,7824,7506,318,4.1
CN4712900000000,47,129,Morgan County, TN,Jan-18,7822,7417,405,5.2
CN4712900000000,47,129,Morgan County, TN,Feb-18,7933,7561,372,4.7
CN4712900000000,47,129,Morgan County, TN,Mar-18,7879,7543,336,4.3
CN4712900000000,47,129,Morgan County, TN,Apr-18(p),7885,7581,304,3.9
CN1709900000000,17,099,LaSalle County, IL,Mar-17,56357,52868,3489,6.2
CN1709900000000,17,099,LaSalle County, IL,Apr-17,55692,52933,2759,5.0
CN1709900000000,17,099,LaSalle County, IL,May-17,55610,52913,2697,4.8
CN1709900000000,17,099,LaSalle County, IL,Jun-17,56003,53067,2936,5.2
CN1709900000000,17,099,LaSalle County, IL,Jul-17,56142,53103,3039,5.4
CN1709900000000,17,099,LaSalle County, IL,Aug-17,55580,52635,2945,5.3
CN1709900000000,17,099,LaSalle County, IL,Sep-17,55065,52495,2570,4.7
CN1709900000000,17,099,LaSalle County, IL,Oct-17,54712,52281,2431,4.4
CN1709900000000,17,099,LaSalle County, IL,Nov-17,54729,52147,2582,4.7
CN1709900000000,17,099,LaSalle County, IL,Dec-17,54755,51847,2908,5.3
CN1709900000000,17,099,LaSalle County, IL,Jan-18,55054,51604,3450,6.3
CN1709900000000,17,099,LaSalle County, IL,Feb-18,55497,52418,3079,5.5
CN1709900000000,17,099,LaSalle County, IL,Mar-18,56343,53162,3181,5.6
CN1709900000000,17,099,LaSalle County, IL,Apr-18(p),55877,53338,2539,4.5
CN3118500000000,31,185,York County, NE,Mar-17,7143,6955,188,2.6
CN3118500000000,31,185,York County, NE,Apr-17,7258,7077,181,2.5
CN3118500000000,31,185,York County, NE,May-17,7287,7101,186,2.6
CN3118500000000,31,185,York County, NE,Jun-17,7515,7304,211,2.8
CN3118500000000,31,185,York County, NE,Jul-17,7768,7560,208,2.7
CN3118500000000,31,185,York County, NE,Aug-17,7437,7251,186,2.5
CN3118500000000,31,185,York County, NE,Sep-17,7357,7194,163,2.2
CN3118500000000,31,185,York County, NE,Oct-17,7229,7063,166,2.3
CN3118500000000,31,185,York County, NE,Nov-17,7141,6972,169,2.4
CN3118500000000,31,185,York County, NE,Dec-17,7100,6922,178,2.5
CN3118500000000,31,185,York County, NE,Jan-18,7197,7003,194,2.7
CN3118500000000,31,185,York County, NE,Feb-18,7167,6982,185,2.6
CN3118500000000,31,185,York County, NE,Mar-18,7240,7054,186,2.6
CN3118500000000,31,185,York County, NE,Apr-18(p),7257,7071,186,2.6
CN5409500000000,54,095,Tyler County, WV,Mar-17,3489,3208,281,8.1
CN5409500000000,54,095,Tyler County, WV,Apr-17,3443,3216,227,6.6
CN5409500000000,54,095,Tyler County, WV,May-17,3417,3215,202,5.9
CN5409500000000,54,095,Tyler County, WV,Jun-17,3514,3274,240,6.8
CN5409500000000,54,095,Tyler County, WV,Jul-17,3439,3205,234,6.8
CN5409500000000,54,095,Tyler County, WV,Aug-17,3425,3183,242,7.1
CN5409500000000,54,095,Tyler County, WV,Sep-17,3421,3224,197,5.8
CN5409500000000,54,095,Tyler County, WV,Oct-17,3375,3182,193,5.7
CN5409500000000,54,095,Tyler County, WV,Nov-17,3392,3158,234,6.9
CN5409500000000,54,095,Tyler County, WV,Dec-17,3376,3115,261,7.7
CN5409500000000,54,095,Tyler County, WV,Jan-18,3434,3143,291,8.5
CN5409500000000,54,095,Tyler County, WV,Feb-18,3460,3143,317,9.2
CN5409500000000,54,095,Tyler County, WV,Mar-18,3404,3136,268,7.9
CN5409500000000,54,095,Tyler County, WV,Apr-18(p),3381,3155,226,6.7
CN2123300000000,21,233,Webster County, KY,Mar-17,5955,5597,358,6.0
CN2123300000000,21,233,Webster County, KY,Apr-17,6004,5698,306,5.1
CN2123300000000,21,233,Webster County, KY,May-17,5956,5634,322,5.4
CN2123300000000,21,233,Webster County, KY,Jun-17,5860,5532,328,5.6
CN2123300000000,21,233,Webster County, KY,Jul-17,5724,5401,323,5.6
CN2123300000000,21,233,Webster County, KY,Aug-17,5744,5448,296,5.2
CN2123300000000,21,233,Webster County, KY,Sep-17,5805,5525,280,4.8
CN2123300000000,21,233,Webster County, KY,Oct-17,5797,5553,244,4.2
CN2123300000000,21,233,Webster County, KY,Nov-17,5810,5575,235,4.0
CN2123300000000,21,233,Webster County, KY,Dec-17,5751,5512,239,4.2
CN2123300000000,21,233,Webster County, KY,Jan-18,5726,5469,257,4.5
CN2123300000000,21,233,Webster County, KY,Feb-18,5838,5538,300,5.1
CN2123300000000,21,233,Webster County, KY,Mar-18,5901,5600,301,5.1
CN2123300000000,21,233,Webster County, KY,Apr-18(p),5890,5640,250,4.2
CN1702100000000,17,021,Christian County, IL,Mar-17,14790,13966,824,5.6
CN1702100000000,17,021,Christian County, IL,Apr-17,14927,14234,693,4.6
CN1702100000000,17,021,Christian County, IL,May-17,14836,14175,661,4.5
CN1702100000000,17,021,Christian County, IL,Jun-17,14986,14243,743,5.0
CN1702100000000,17,021,Christian County, IL,Jul-17,14809,14031,778,5.3
CN1702100000000,17,021,Christian County, IL,Aug-17,14786,14011,775,5.2
CN1702100000000,17,021,Christian County, IL,Sep-17,14556,13868,688,4.7
CN1702100000000,17,021,Christian County, IL,Oct-17,14354,13698,656,4.6
CN1702100000000,17,021,Christian County, IL,Nov-17,14379,13712,667,4.6
CN1702100000000,17,021,Christian County, IL,Dec-17,14218,13536,682,4.8
CN1702100000000,17,021,Christian County, IL,Jan-18,14126,13343,783,5.5
CN1702100000000,17,021,Christian County, IL,Feb-18,14227,13512,715,5.0
CN1702100000000,17,021,Christian County, IL,Mar-18,14467,13741,726,5.0
CN1702100000000,17,021,Christian County, IL,Apr-18(p),14591,13998,593,4.1
CN1712900000000,17,129,Menard County, IL,Mar-17,6786,6489,297,4.4
CN1712900000000,17,129,Menard County, IL,Apr-17,6745,6513,232,3.4
CN1712900000000,17,129,Menard County, IL,May-17,6699,6478,221,3.3
CN1712900000000,17,129,Menard County, IL,Jun-17,6798,6558,240,3.5
CN1712900000000,17,129,Menard County, IL,Jul-17,6757,6504,253,3.7
CN1712900000000,17,129,Menard County, IL,Aug-17,6830,6579,251,3.7
CN1712900000000,17,129,Menard County, IL,Sep-17,6673,6436,237,3.6
CN1712900000000,17,129,Menard County, IL,Oct-17,6603,6371,232,3.5
CN1712900000000,17,129,Menard County, IL,Nov-17,6631,6381,250,3.8
CN1712900000000,17,129,Menard County, IL,Dec-17,6593,6326,267,4.0
CN1712900000000,17,129,Menard County, IL,Jan-18,6552,6244,308,4.7
CN1712900000000,17,129,Menard County, IL,Feb-18,6596,6315,281,4.3
CN1712900000000,17,129,Menard County, IL,Mar-18,6685,6412,273,4.1
CN1712900000000,17,129,Menard County, IL,Apr-18(p),6719,6520,199,3.0
CN5604100000000,56,041,Uinta County, WY,Mar-17,9213,8709,504,5.5
CN5604100000000,56,041,Uinta County, WY,Apr-17,9132,8720,412,4.5
CN5604100000000,56,041,Uinta County, WY,May-17,9233,8847,386,4.2
CN5604100000000,56,041,Uinta County, WY,Jun-17,9143,8746,397,4.3
CN5604100000000,56,041,Uinta County, WY,Jul-17,9091,8720,371,4.1
CN5604100000000,56,041,Uinta County, WY,Aug-17,9079,8736,343,3.8
CN5604100000000,56,041,Uinta County, WY,Sep-17,9076,8736,340,3.7
CN5604100000000,56,041,Uinta County, WY,Oct-17,9055,8713,342,3.8
CN5604100000000,56,041,Uinta County, WY,Nov-17,9134,8756,378,4.1
CN5604100000000,56,041,Uinta County, WY,Dec-17,9011,8639,372,4.1
CN5604100000000,56,041,Uinta County, WY,Jan-18,8802,8400,402,4.6
CN5604100000000,56,041,Uinta County, WY,Feb-18,8776,8375,401,4.6
CN5604100000000,56,041,Uinta County, WY,Mar-18,8802,8403,399,4.5
CN5604100000000,56,041,Uinta County, WY,Apr-18(p),8683,8306,377,4.3
CN0608700000000,06,087,Santa Cruz County, CA,Mar-17,143623,132629,10994,7.7
CN0608700000000,06,087,Santa Cruz County, CA,Apr-17,143504,134228,9276,6.5
CN0608700000000,06,087,Santa Cruz County, CA,May-17,144221,136906,7315,5.1
CN0608700000000,06,087,Santa Cruz County, CA,Jun-17,147384,140163,7221,4.9
CN0608700000000,06,087,Santa Cruz County, CA,Jul-17,146666,139276,7390,5.0
CN0608700000000,06,087,Santa Cruz County, CA,Aug-17,144915,138023,6892,4.8
CN0608700000000,06,087,Santa Cruz County, CA,Sep-17,143406,137544,5862,4.1
CN0608700000000,06,087,Santa Cruz County, CA,Oct-17,144841,138996,5845,4.0
CN0608700000000,06,087,Santa Cruz County, CA,Nov-17,143152,136339,6813,4.8
CN0608700000000,06,087,Santa Cruz County, CA,Dec-17,141333,133405,7928,5.6
CN0608700000000,06,087,Santa Cruz County, CA,Jan-18,141179,132341,8838,6.3
CN0608700000000,06,087,Santa Cruz County, CA,Feb-18,143782,134229,9553,6.6
CN0608700000000,06,087,Santa Cruz County, CA,Mar-18,143671,134685,8986,6.3
CN0608700000000,06,087,Santa Cruz County, CA,Apr-18(p),143654,135929,7725,5.4
CN5159500000000,51,595,Emporia city, VA,Mar-17,2271,2139,132,5.8
CN5159500000000,51,595,Emporia city, VA,Apr-17,2321,2204,117,5.0
CN5159500000000,51,595,Emporia city, VA,May-17,2293,2183,110,4.8
CN5159500000000,51,595,Emporia city, VA,Jun-17,2314,2195,119,5.1
CN5159500000000,51,595,Emporia city, VA,Jul-17,2302,2178,124,5.4
CN5159500000000,51,595,Emporia city, VA,Aug-17,2270,2144,126,5.6
CN5159500000000,51,595,Emporia city, VA,Sep-17,2245,2128,117,5.2
CN5159500000000,51,595,Emporia city, VA,Oct-17,2283,2164,119,5.2
CN5159500000000,51,595,Emporia city, VA,Nov-17,2263,2143,120,5.3
CN5159500000000,51,595,Emporia city, VA,Dec-17,2283,2157,126,5.5
CN5159500000000,51,595,Emporia city, VA,Jan-18,2271,2142,129,5.7
CN5159500000000,51,595,Emporia city, VA,Feb-18,2221,2104,117,5.3
CN5159500000000,51,595,Emporia city, VA,Mar-18,2232,2115,117,5.2
CN5159500000000,51,595,Emporia city, VA,Apr-18(p),2236,2143,93,4.2
CN1325700000000,13,257,Stephens County, GA,Mar-17,11041,10468,573,5.2
CN1325700000000,13,257,Stephens County, GA,Apr-17,10995,10471,524,4.8
CN1325700000000,13,257,Stephens County, GA,May-17,11016,10493,523,4.7
CN1325700000000,13,257,Stephens County, GA,Jun-17,11080,10493,587,5.3
CN1325700000000,13,257,Stephens County, GA,Jul-17,11098,10422,676,6.1
CN1325700000000,13,257,Stephens County, GA,Aug-17,10930,10307,623,5.7
CN1325700000000,13,257,Stephens County, GA,Sep-17,11035,10506,529,4.8
CN1325700000000,13,257,Stephens County, GA,Oct-17,11014,10468,546,5.0
CN1325700000000,13,257,Stephens County, GA,Nov-17,11049,10488,561,5.1
CN1325700000000,13,257,Stephens County, GA,Dec-17,11006,10447,559,5.1
CN1325700000000,13,257,Stephens County, GA,Jan-18,11087,10496,591,5.3
CN1325700000000,13,257,Stephens County, GA,Feb-18,11331,10766,565,5.0
CN1325700000000,13,257,Stephens County, GA,Mar-18,11292,10767,525,4.6
CN1325700000000,13,257,Stephens County, GA,Apr-18(p),11279,10795,484,4.3
CN1318500000000,13,185,Lowndes County, GA,Mar-17,52098,49690,2408,4.6
CN1318500000000,13,185,Lowndes County, GA,Apr-17,51874,49634,2240,4.3
CN1318500000000,13,185,Lowndes County, GA,May-17,51854,49562,2292,4.4
CN1318500000000,13,185,Lowndes County, GA,Jun-17,51885,49251,2634,5.1
CN1318500000000,13,185,Lowndes County, GA,Jul-17,51622,49011,2611,5.1
CN1318500000000,13,185,Lowndes County, GA,Aug-17,51463,48900,2563,5.0
CN1318500000000,13,185,Lowndes County, GA,Sep-17,51854,49482,2372,4.6
CN1318500000000,13,185,Lowndes County, GA,Oct-17,51816,49558,2258,4.4
CN1318500000000,13,185,Lowndes County, GA,Nov-17,52202,49973,2229,4.3
CN1318500000000,13,185,Lowndes County, GA,Dec-17,51887,49657,2230,4.3
CN1318500000000,13,185,Lowndes County, GA,Jan-18,52368,49984,2384,4.6
CN1318500000000,13,185,Lowndes County, GA,Feb-18,53050,50690,2360,4.4
CN1318500000000,13,185,Lowndes County, GA,Mar-18,53123,50960,2163,4.1
CN1318500000000,13,185,Lowndes County, GA,Apr-18(p),52986,51040,1946,3.7
CN2918900000000,29,189,St. Louis County, MO,Mar-17,525258,505863,19395,3.7
CN2918900000000,29,189,St. Louis County, MO,Apr-17,526052,508476,17576,3.3
CN2918900000000,29,189,St. Louis County, MO,May-17,528397,510089,18308,3.5
CN2918900000000,29,189,St. Louis County, MO,Jun-17,533863,514841,19022,3.6
CN2918900000000,29,189,St. Louis County, MO,Jul-17,537888,517626,20262,3.8
CN2918900000000,29,189,St. Louis County, MO,Aug-17,531139,510414,20725,3.9
CN2918900000000,29,189,St. Louis County, MO,Sep-17,528612,512125,16487,3.1
CN2918900000000,29,189,St. Louis County, MO,Oct-17,522971,510124,12847,2.5
CN2918900000000,29,189,St. Louis County, MO,Nov-17,524432,509031,15401,2.9
CN2918900000000,29,189,St. Louis County, MO,Dec-17,522272,506239,16033,3.1
CN2918900000000,29,189,St. Louis County, MO,Jan-18,515373,497149,18224,3.5
CN2918900000000,29,189,St. Louis County, MO,Feb-18,523307,504846,18461,3.5
CN2918900000000,29,189,St. Louis County, MO,Mar-18,524397,505904,18493,3.5
CN2918900000000,29,189,St. Louis County, MO,Apr-18(p),526070,509459,16611,3.2
CN7214100000000,72,141,Utuado Municipio, PR,Mar-17,6939,5953,986,14.2
CN7214100000000,72,141,Utuado Municipio, PR,Apr-17,6801,5823,978,14.4
CN7214100000000,72,141,Utuado Municipio, PR,May-17,6762,5935,827,12.2
CN7214100000000,72,141,Utuado Municipio, PR,Jun-17,6707,5926,781,11.6
CN7214100000000,72,141,Utuado Municipio, PR,Jul-17,6916,5959,957,13.8
CN7214100000000,72,141,Utuado Municipio, PR,Aug-17,6970,5907,1063,15.3
CN7214100000000,72,141,Utuado Municipio, PR,Sep-17(y),6781,5838,943,13.9
CN7214100000000,72,141,Utuado Municipio, PR,Oct-17,6562,5640,922,14.1
CN7214100000000,72,141,Utuado Municipio, PR,Nov-17,6930,5985,945,13.6
CN7214100000000,72,141,Utuado Municipio, PR,Dec-17,6918,6028,890,12.9
CN7214100000000,72,141,Utuado Municipio, PR,Jan-18,6851,5915,936,13.7
CN7214100000000,72,141,Utuado Municipio, PR,Feb-18,6698,5835,863,12.9
CN7214100000000,72,141,Utuado Municipio, PR,Mar-18,6704,5878,826,12.3
CN7214100000000,72,141,Utuado Municipio, PR,Apr-18(p),6707,5916,791,11.8
CN2805500000000,28,055,Issaquena County, MS,Mar-17,418,350,68,16.3
CN2805500000000,28,055,Issaquena County, MS,Apr-17,415,370,45,10.8
CN2805500000000,28,055,Issaquena County, MS,May-17,412,364,48,11.7
CN2805500000000,28,055,Issaquena County, MS,Jun-17,404,358,46,11.4
CN2805500000000,28,055,Issaquena County, MS,Jul-17,381,342,39,10.2
CN2805500000000,28,055,Issaquena County, MS,Aug-17,392,360,32,8.2
CN2805500000000,28,055,Issaquena County, MS,Sep-17,392,365,27,6.9
CN2805500000000,28,055,Issaquena County, MS,Oct-17,389,357,32,8.2
CN2805500000000,28,055,Issaquena County, MS,Nov-17,372,340,32,8.6
CN2805500000000,28,055,Issaquena County, MS,Dec-17,373,338,35,9.4
CN2805500000000,28,055,Issaquena County, MS,Jan-18,354,320,34,9.6
CN2805500000000,28,055,Issaquena County, MS,Feb-18,370,329,41,11.1
CN2805500000000,28,055,Issaquena County, MS,Mar-18,392,347,45,11.5
CN2805500000000,28,055,Issaquena County, MS,Apr-18(p),381,349,32,8.4
CN3716900000000,37,169,Stokes County, NC,Mar-17,22087,21147,940,4.3
CN3716900000000,37,169,Stokes County, NC,Apr-17,21961,21121,840,3.8
CN3716900000000,37,169,Stokes County, NC,May-17,21986,21076,910,4.1
CN3716900000000,37,169,Stokes County, NC,Jun-17,22006,21052,954,4.3
CN3716900000000,37,169,Stokes County, NC,Jul-17,22159,21157,1002,4.5
CN3716900000000,37,169,Stokes County, NC,Aug-17,21914,20915,999,4.6
CN3716900000000,37,169,Stokes County, NC,Sep-17,22277,21377,900,4.0
CN3716900000000,37,169,Stokes County, NC,Oct-17,22142,21250,892,4.0
CN3716900000000,37,169,Stokes County, NC,Nov-17,22118,21186,932,4.2
CN3716900000000,37,169,Stokes County, NC,Dec-17,21955,21049,906,4.1
CN3716900000000,37,169,Stokes County, NC,Jan-18,22079,21098,981,4.4
CN3716900000000,37,169,Stokes County, NC,Feb-18,22325,21333,992,4.4
CN3716900000000,37,169,Stokes County, NC,Mar-18,22312,21376,936,4.2
CN3716900000000,37,169,Stokes County, NC,Apr-18(p),22293,21509,784,3.5
CN1309100000000,13,091,Dodge County, GA,Mar-17,7105,6678,427,6.0
CN1309100000000,13,091,Dodge County, GA,Apr-17,7152,6756,396,5.5
CN1309100000000,13,091,Dodge County, GA,May-17,7094,6698,396,5.6
CN1309100000000,13,091,Dodge County, GA,Jun-17,7111,6676,435,6.1
CN1309100000000,13,091,Dodge County, GA,Jul-17,7093,6641,452,6.4
CN1309100000000,13,091,Dodge County, GA,Aug-17,7047,6613,434,6.2
CN1309100000000,13,091,Dodge County, GA,Sep-17,7206,6756,450,6.2
CN1309100000000,13,091,Dodge County, GA,Oct-17,7303,6682,621,8.5
CN1309100000000,13,091,Dodge County, GA,Nov-17,7054,6666,388,5.5
CN1309100000000,13,091,Dodge County, GA,Dec-17,7092,6657,435,6.1
CN1309100000000,13,091,Dodge County, GA,Jan-18,7141,6722,419,5.9
CN1309100000000,13,091,Dodge County, GA,Feb-18,7153,6758,395,5.5
CN1309100000000,13,091,Dodge County, GA,Mar-18,7140,6766,374,5.2
CN1309100000000,13,091,Dodge County, GA,Apr-18(p),7101,6789,312,4.4
CN4000300000000,40,003,Alfalfa County, OK,Mar-17,2942,2865,77,2.6
CN4000300000000,40,003,Alfalfa County, OK,Apr-17,3008,2931,77,2.6
CN4000300000000,40,003,Alfalfa County, OK,May-17,2939,2853,86,2.9
CN4000300000000,40,003,Alfalfa County, OK,Jun-17,2878,2790,88,3.1
CN4000300000000,40,003,Alfalfa County, OK,Jul-17,2777,2696,81,2.9
CN4000300000000,40,003,Alfalfa County, OK,Aug-17,2865,2783,82,2.9
CN4000300000000,40,003,Alfalfa County, OK,Sep-17,2948,2870,78,2.6
CN4000300000000,40,003,Alfalfa County, OK,Oct-17,3041,2970,71,2.3
CN4000300000000,40,003,Alfalfa County, OK,Nov-17,3075,3004,71,2.3
CN4000300000000,40,003,Alfalfa County, OK,Dec-17,2999,2932,67,2.2
CN4000300000000,40,003,Alfalfa County, OK,Jan-18,2918,2850,68,2.3
CN4000300000000,40,003,Alfalfa County, OK,Feb-18,2933,2860,73,2.5
CN4000300000000,40,003,Alfalfa County, OK,Mar-18,2899,2827,72,2.5
CN4000300000000,40,003,Alfalfa County, OK,Apr-18(p),2825,2758,67,2.4
CN0107900000000,01,079,Lawrence County, AL,Mar-17,13694,12947,747,5.5
CN0107900000000,01,079,Lawrence County, AL,Apr-17,13571,12938,633,4.7
CN0107900000000,01,079,Lawrence County, AL,May-17,13602,12986,616,4.5
CN0107900000000,01,079,Lawrence County, AL,Jun-17,13741,13012,729,5.3
CN0107900000000,01,079,Lawrence County, AL,Jul-17,13739,13047,692,5.0
CN0107900000000,01,079,Lawrence County, AL,Aug-17,13634,12984,650,4.8
CN0107900000000,01,079,Lawrence County, AL,Sep-17,13660,13110,550,4.0
CN0107900000000,01,079,Lawrence County, AL,Oct-17,13658,13118,540,4.0
CN0107900000000,01,079,Lawrence County, AL,Nov-17,13609,13110,499,3.7
CN0107900000000,01,079,Lawrence County, AL,Dec-17,13507,12996,511,3.8
CN0107900000000,01,079,Lawrence County, AL,Jan-18,13456,12847,609,4.5
CN0107900000000,01,079,Lawrence County, AL,Feb-18,13636,13000,636,4.7
CN0107900000000,01,079,Lawrence County, AL,Mar-18,13720,13139,581,4.2
CN0107900000000,01,079,Lawrence County, AL,Apr-18(p),13761,13228,533,3.9
CN1903100000000,19,031,Cedar County, IA,Mar-17,10794,10424,370,3.4
CN1903100000000,19,031,Cedar County, IA,Apr-17,10836,10544,292,2.7
CN1903100000000,19,031,Cedar County, IA,May-17,10808,10539,269,2.5
CN1903100000000,19,031,Cedar County, IA,Jun-17,10928,10633,295,2.7
CN1903100000000,19,031,Cedar County, IA,Jul-17,10756,10462,294,2.7
CN1903100000000,19,031,Cedar County, IA,Aug-17,10682,10380,302,2.8
CN1903100000000,19,031,Cedar County, IA,Sep-17,10827,10572,255,2.4
CN1903100000000,19,031,Cedar County, IA,Oct-17,10850,10636,214,2.0
CN1903100000000,19,031,Cedar County, IA,Nov-17,10815,10564,251,2.3
CN1903100000000,19,031,Cedar County, IA,Dec-17,10735,10432,303,2.8
CN1903100000000,19,031,Cedar County, IA,Jan-18,10733,10306,427,4.0
CN1903100000000,19,031,Cedar County, IA,Feb-18,10767,10392,375,3.5
CN1903100000000,19,031,Cedar County, IA,Mar-18,10758,10447,311,2.9
CN1903100000000,19,031,Cedar County, IA,Apr-18(p),10806,10532,274,2.5
CN0512300000000,05,123,St. Francis County, AR,Mar-17,8409,7987,422,5.0
CN0512300000000,05,123,St. Francis County, AR,Apr-17,8387,8024,363,4.3
CN0512300000000,05,123,St. Francis County, AR,May-17,8447,8058,389,4.6
CN0512300000000,05,123,St. Francis County, AR,Jun-17,8638,8168,470,5.4
CN0512300000000,05,123,St. Francis County, AR,Jul-17,8463,7982,481,5.7
CN0512300000000,05,123,St. Francis County, AR,Aug-17,8494,8055,439,5.2
CN0512300000000,05,123,St. Francis County, AR,Sep-17,8392,7986,406,4.8
CN0512300000000,05,123,St. Francis County, AR,Oct-17,8378,8002,376,4.5
CN0512300000000,05,123,St. Francis County, AR,Nov-17,8319,7943,376,4.5
CN0512300000000,05,123,St. Francis County, AR,Dec-17,8286,7881,405,4.9
CN0512300000000,05,123,St. Francis County, AR,Jan-18,8146,7613,533,6.5
CN0512300000000,05,123,St. Francis County, AR,Feb-18,8158,7649,509,6.2
CN0512300000000,05,123,St. Francis County, AR,Mar-18,8172,7714,458,5.6
CN0512300000000,05,123,St. Francis County, AR,Apr-18(p),8149,7764,385,4.7
CN5103300000000,51,033,Caroline County, VA,Mar-17,15082,14420,662,4.4
CN5103300000000,51,033,Caroline County, VA,Apr-17,15088,14486,602,4.0
CN5103300000000,51,033,Caroline County, VA,May-17,15098,14492,606,4.0
CN5103300000000,51,033,Caroline County, VA,Jun-17,15217,14566,651,4.3
CN5103300000000,51,033,Caroline County, VA,Jul-17,15319,14660,659,4.3
CN5103300000000,51,033,Caroline County, VA,Aug-17,15174,14485,689,4.5
CN5103300000000,51,033,Caroline County, VA,Sep-17,15199,14567,632,4.2
CN5103300000000,51,033,Caroline County, VA,Oct-17,15103,14506,597,4.0
CN5103300000000,51,033,Caroline County, VA,Nov-17,14986,14395,591,3.9
CN5103300000000,51,033,Caroline County, VA,Dec-17,15019,14365,654,4.4
CN5103300000000,51,033,Caroline County, VA,Jan-18,14991,14321,670,4.5
CN5103300000000,51,033,Caroline County, VA,Feb-18,15154,14534,620,4.1
CN5103300000000,51,033,Caroline County, VA,Mar-18,15214,14615,599,3.9
CN5103300000000,51,033,Caroline County, VA,Apr-18(p),15234,14708,526,3.5
CN5401900000000,54,019,Fayette County, WV,Mar-17,15533,14418,1115,7.2
CN5401900000000,54,019,Fayette County, WV,Apr-17,15689,14729,960,6.1
CN5401900000000,54,019,Fayette County, WV,May-17,15657,14786,871,5.6
CN5401900000000,54,019,Fayette County, WV,Jun-17,16005,15025,980,6.1
CN5401900000000,54,019,Fayette County, WV,Jul-17,16081,15154,927,5.8
CN5401900000000,54,019,Fayette County, WV,Aug-17,16018,15035,983,6.1
CN5401900000000,54,019,Fayette County, WV,Sep-17,15907,15050,857,5.4
CN5401900000000,54,019,Fayette County, WV,Oct-17,15784,14934,850,5.4
CN5401900000000,54,019,Fayette County, WV,Nov-17,15655,14605,1050,6.7
CN5401900000000,54,019,Fayette County, WV,Dec-17,15575,14502,1073,6.9
CN5401900000000,54,019,Fayette County, WV,Jan-18,15626,14475,1151,7.4
CN5401900000000,54,019,Fayette County, WV,Feb-18,15787,14521,1266,8.0
CN5401900000000,54,019,Fayette County, WV,Mar-18,15628,14406,1222,7.8
CN5401900000000,54,019,Fayette County, WV,Apr-18(p),15759,14673,1086,6.9
CN5400500000000,54,005,Boone County, WV,Mar-17,7625,7122,503,6.6
CN5400500000000,54,005,Boone County, WV,Apr-17,7665,7206,459,6.0
CN5400500000000,54,005,Boone County, WV,May-17,7647,7228,419,5.5
CN5400500000000,54,005,Boone County, WV,Jun-17,7864,7355,509,6.5
CN5400500000000,54,005,Boone County, WV,Jul-17,7806,7322,484,6.2
CN5400500000000,54,005,Boone County, WV,Aug-17,7763,7248,515,6.6
CN5400500000000,54,005,Boone County, WV,Sep-17,7721,7292,429,5.6
CN5400500000000,54,005,Boone County, WV,Oct-17,7664,7232,432,5.6
CN5400500000000,54,005,Boone County, WV,Nov-17,7632,7180,452,5.9
CN5400500000000,54,005,Boone County, WV,Dec-17,7618,7156,462,6.1
CN5400500000000,54,005,Boone County, WV,Jan-18,7635,7157,478,6.3
CN5400500000000,54,005,Boone County, WV,Feb-18,7726,7185,541,7.0
CN5400500000000,54,005,Boone County, WV,Mar-18,7668,7151,517,6.7
CN5400500000000,54,005,Boone County, WV,Apr-18(p),7689,7209,480,6.2
CN5506100000000,55,061,Kewaunee County, WI,Mar-17,11070,10677,393,3.6
CN5506100000000,55,061,Kewaunee County, WI,Apr-17,11180,10882,298,2.7
CN5506100000000,55,061,Kewaunee County, WI,May-17,11262,10951,311,2.8
CN5506100000000,55,061,Kewaunee County, WI,Jun-17,11668,11288,380,3.3
CN5506100000000,55,061,Kewaunee County, WI,Jul-17,11424,11080,344,3.0
CN5506100000000,55,061,Kewaunee County, WI,Aug-17,11304,10965,339,3.0
CN5506100000000,55,061,Kewaunee County, WI,Sep-17,11210,10890,320,2.9
CN5506100000000,55,061,Kewaunee County, WI,Oct-17,11327,11025,302,2.7
CN5506100000000,55,061,Kewaunee County, WI,Nov-17,11390,11100,290,2.5
CN5506100000000,55,061,Kewaunee County, WI,Dec-17,11333,11029,304,2.7
CN5506100000000,55,061,Kewaunee County, WI,Jan-18,11395,11026,369,3.2
CN5506100000000,55,061,Kewaunee County, WI,Feb-18,11332,10913,419,3.7
CN5506100000000,55,061,Kewaunee County, WI,Mar-18,11425,11041,384,3.4
CN5506100000000,55,061,Kewaunee County, WI,Apr-18(p),11461,11160,301,2.6
CN1305700000000,13,057,Cherokee County, GA,Mar-17,129353,124402,4951,3.8
CN1305700000000,13,057,Cherokee County, GA,Apr-17,129427,124784,4643,3.6
CN1305700000000,13,057,Cherokee County, GA,May-17,129693,124969,4724,3.6
CN1305700000000,13,057,Cherokee County, GA,Jun-17,130013,124841,5172,4.0
CN1305700000000,13,057,Cherokee County, GA,Jul-17,130905,125735,5170,3.9
CN1305700000000,13,057,Cherokee County, GA,Aug-17,130134,125051,5083,3.9
CN1305700000000,13,057,Cherokee County, GA,Sep-17,131432,126795,4637,3.5
CN1305700000000,13,057,Cherokee County, GA,Oct-17,130802,126238,4564,3.5
CN1305700000000,13,057,Cherokee County, GA,Nov-17,130990,126612,4378,3.3
CN1305700000000,13,057,Cherokee County, GA,Dec-17,130958,126558,4400,3.4
CN1305700000000,13,057,Cherokee County, GA,Jan-18,130879,126382,4497,3.4
CN1305700000000,13,057,Cherokee County, GA,Feb-18,133172,128490,4682,3.5
CN1305700000000,13,057,Cherokee County, GA,Mar-18,133229,128898,4331,3.3
CN1305700000000,13,057,Cherokee County, GA,Apr-18(p),132531,128675,3856,2.9
CN2910700000000,29,107,Lafayette County, MO,Mar-17,17158,16474,684,4.0
CN2910700000000,29,107,Lafayette County, MO,Apr-17,17348,16771,577,3.3
CN2910700000000,29,107,Lafayette County, MO,May-17,17202,16621,581,3.4
CN2910700000000,29,107,Lafayette County, MO,Jun-17,17399,16721,678,3.9
CN2910700000000,29,107,Lafayette County, MO,Jul-17,17556,16778,778,4.4
CN2910700000000,29,107,Lafayette County, MO,Aug-17,17295,16515,780,4.5
CN2910700000000,29,107,Lafayette County, MO,Sep-17,17099,16581,518,3.0
CN2910700000000,29,107,Lafayette County, MO,Oct-17,17212,16679,533,3.1
CN2910700000000,29,107,Lafayette County, MO,Nov-17,17097,16586,511,3.0
CN2910700000000,29,107,Lafayette County, MO,Dec-17,17002,16436,566,3.3
CN2910700000000,29,107,Lafayette County, MO,Jan-18,17029,16323,706,4.1
CN2910700000000,29,107,Lafayette County, MO,Feb-18,17225,16517,708,4.1
CN2910700000000,29,107,Lafayette County, MO,Mar-18,17186,16537,649,3.8
CN2910700000000,29,107,Lafayette County, MO,Apr-18(p),17267,16689,578,3.3
CN2612100000000,26,121,Muskegon County, MI,Mar-17,77361,73334,4027,5.2
CN2612100000000,26,121,Muskegon County, MI,Apr-17,77351,73884,3467,4.5
CN2612100000000,26,121,Muskegon County, MI,May-17,78454,74666,3788,4.8
CN2612100000000,26,121,Muskegon County, MI,Jun-17,80297,76085,4212,5.2
CN2612100000000,26,121,Muskegon County, MI,Jul-17,80110,74839,5271,6.6
CN2612100000000,26,121,Muskegon County, MI,Aug-17,79371,74558,4813,6.1
CN2612100000000,26,121,Muskegon County, MI,Sep-17,77948,73903,4045,5.2
CN2612100000000,26,121,Muskegon County, MI,Oct-17,77419,73620,3799,4.9
CN2612100000000,26,121,Muskegon County, MI,Nov-17,78018,74151,3867,5.0
CN2612100000000,26,121,Muskegon County, MI,Dec-17,77682,73586,4096,5.3
CN2612100000000,26,121,Muskegon County, MI,Jan-18,77276,72737,4539,5.9
CN2612100000000,26,121,Muskegon County, MI,Feb-18,77846,73119,4727,6.1
CN2612100000000,26,121,Muskegon County, MI,Mar-18,77806,73566,4240,5.4
CN2612100000000,26,121,Muskegon County, MI,Apr-18(p),77476,73802,3674,4.7
CN5109700000000,51,097,King and Queen County, VA,Mar-17,3743,3608,135,3.6
CN5109700000000,51,097,King and Queen County, VA,Apr-17,3763,3647,116,3.1
CN5109700000000,51,097,King and Queen County, VA,May-17,3769,3645,124,3.3
CN5109700000000,51,097,King and Queen County, VA,Jun-17,3839,3702,137,3.6
CN5109700000000,51,097,King and Queen County, VA,Jul-17,3864,3720,144,3.7
CN5109700000000,51,097,King and Queen County, VA,Aug-17,3778,3636,142,3.8
CN5109700000000,51,097,King and Queen County, VA,Sep-17,3758,3630,128,3.4
CN5109700000000,51,097,King and Queen County, VA,Oct-17,3742,3621,121,3.2
CN5109700000000,51,097,King and Queen County, VA,Nov-17,3737,3607,130,3.5
CN5109700000000,51,097,King and Queen County, VA,Dec-17,3760,3629,131,3.5
CN5109700000000,51,097,King and Queen County, VA,Jan-18,3740,3599,141,3.8
CN5109700000000,51,097,King and Queen County, VA,Feb-18,3787,3661,126,3.3
CN5109700000000,51,097,King and Queen County, VA,Mar-18,3800,3670,130,3.4
CN5109700000000,51,097,King and Queen County, VA,Apr-18(p),3827,3718,109,2.8
CN1607700000000,16,077,Power County, ID,Mar-17,3750,3600,150,4.0
CN1607700000000,16,077,Power County, ID,Apr-17,4024,3888,136,3.4
CN1607700000000,16,077,Power County, ID,May-17,3981,3870,111,2.8
CN1607700000000,16,077,Power County, ID,Jun-17,3928,3805,123,3.1
CN1607700000000,16,077,Power County, ID,Jul-17,3889,3770,119,3.1
CN1607700000000,16,077,Power County, ID,Aug-17,3883,3770,113,2.9
CN1607700000000,16,077,Power County, ID,Sep-17,4320,4219,101,2.3
CN1607700000000,16,077,Power County, ID,Oct-17,4654,4560,94,2.0
CN1607700000000,16,077,Power County, ID,Nov-17,3908,3788,120,3.1
CN1607700000000,16,077,Power County, ID,Dec-17,3734,3593,141,3.8
CN1607700000000,16,077,Power County, ID,Jan-18,3665,3486,179,4.9
CN1607700000000,16,077,Power County, ID,Feb-18,3708,3556,152,4.1
CN1607700000000,16,077,Power County, ID,Mar-18,3801,3673,128,3.4
CN1607700000000,16,077,Power County, ID,Apr-18(p),4039,3932,107,2.6
CN2701100000000,27,011,Big Stone County, MN,Mar-17,2584,2430,154,6.0
CN2701100000000,27,011,Big Stone County, MN,Apr-17,2562,2447,115,4.5
CN2701100000000,27,011,Big Stone County, MN,May-17,2565,2482,83,3.2
CN2701100000000,27,011,Big Stone County, MN,Jun-17,2654,2563,91,3.4
CN2701100000000,27,011,Big Stone County, MN,Jul-17,2610,2522,88,3.4
CN2701100000000,27,011,Big Stone County, MN,Aug-17,2534,2446,88,3.5
CN2701100000000,27,011,Big Stone County, MN,Sep-17,2523,2443,80,3.2
CN2701100000000,27,011,Big Stone County, MN,Oct-17,2643,2580,63,2.4
CN2701100000000,27,011,Big Stone County, MN,Nov-17,2630,2539,91,3.5
CN2701100000000,27,011,Big Stone County, MN,Dec-17,2659,2523,136,5.1
CN2701100000000,27,011,Big Stone County, MN,Jan-18,2684,2506,178,6.6
CN2701100000000,27,011,Big Stone County, MN,Feb-18,2660,2501,159,6.0
CN2701100000000,27,011,Big Stone County, MN,Mar-18,2683,2525,158,5.9
CN2701100000000,27,011,Big Stone County, MN,Apr-18(p),2681,2570,111,4.1
CN2114300000000,21,143,Lyon County, KY,Mar-17,3078,2858,220,7.1
CN2114300000000,21,143,Lyon County, KY,Apr-17,3057,2890,167,5.5
CN2114300000000,21,143,Lyon County, KY,May-17,3217,3041,176,5.5
CN2114300000000,21,143,Lyon County, KY,Jun-17,3278,3096,182,5.6
CN2114300000000,21,143,Lyon County, KY,Jul-17,3262,3086,176,5.4
CN2114300000000,21,143,Lyon County, KY,Aug-17,3188,3047,141,4.4
CN2114300000000,21,143,Lyon County, KY,Sep-17,3137,2996,141,4.5
CN2114300000000,21,143,Lyon County, KY,Oct-17,3022,2896,126,4.2
CN2114300000000,21,143,Lyon County, KY,Nov-17,2998,2868,130,4.3
CN2114300000000,21,143,Lyon County, KY,Dec-17,2982,2853,129,4.3
CN2114300000000,21,143,Lyon County, KY,Jan-18,2980,2821,159,5.3
CN2114300000000,21,143,Lyon County, KY,Feb-18,2944,2758,186,6.3
CN2114300000000,21,143,Lyon County, KY,Mar-18,2976,2809,167,5.6
CN2114300000000,21,143,Lyon County, KY,Apr-18(p),3025,2893,132,4.4
CN2814500000000,28,145,Union County, MS,Mar-17,13772,13285,487,3.5
CN2814500000000,28,145,Union County, MS,Apr-17,13764,13320,444,3.2
CN2814500000000,28,145,Union County, MS,May-17,14039,13487,552,3.9
CN2814500000000,28,145,Union County, MS,Jun-17,14183,13574,609,4.3
CN2814500000000,28,145,Union County, MS,Jul-17,14224,13671,553,3.9
CN2814500000000,28,145,Union County, MS,Aug-17,13979,13503,476,3.4
CN2814500000000,28,145,Union County, MS,Sep-17,14056,13588,468,3.3
CN2814500000000,28,145,Union County, MS,Oct-17,14007,13553,454,3.2
CN2814500000000,28,145,Union County, MS,Nov-17,14068,13616,452,3.2
CN2814500000000,28,145,Union County, MS,Dec-17,14105,13666,439,3.1
CN2814500000000,28,145,Union County, MS,Jan-18,14063,13631,432,3.1
CN2814500000000,28,145,Union County, MS,Feb-18,14123,13674,449,3.2
CN2814500000000,28,145,Union County, MS,Mar-18,14102,13669,433,3.1
CN2814500000000,28,145,Union County, MS,Apr-18(p),14211,13760,451,3.2
CN2014700000000,20,147,Phillips County, KS,Mar-17,2777,2694,83,3.0
CN2014700000000,20,147,Phillips County, KS,Apr-17,2780,2704,76,2.7
CN2014700000000,20,147,Phillips County, KS,May-17,2802,2719,83,3.0
CN2014700000000,20,147,Phillips County, KS,Jun-17,2904,2812,92,3.2
CN2014700000000,20,147,Phillips County, KS,Jul-17,2724,2628,96,3.5
CN2014700000000,20,147,Phillips County, KS,Aug-17,2727,2638,89,3.3
CN2014700000000,20,147,Phillips County, KS,Sep-17,2868,2796,72,2.5
CN2014700000000,20,147,Phillips County, KS,Oct-17,2894,2826,68,2.3
CN2014700000000,20,147,Phillips County, KS,Nov-17,2865,2788,77,2.7
CN2014700000000,20,147,Phillips County, KS,Dec-17,2829,2755,74,2.6
CN2014700000000,20,147,Phillips County, KS,Jan-18,2814,2741,73,2.6
CN2014700000000,20,147,Phillips County, KS,Feb-18,2816,2738,78,2.8
CN2014700000000,20,147,Phillips County, KS,Mar-18,2810,2738,72,2.6
CN2014700000000,20,147,Phillips County, KS,Apr-18(p),2711,2641,70,2.6
CN2708900000000,27,089,Marshall County, MN,Mar-17,5699,5126,573,10.1
CN2708900000000,27,089,Marshall County, MN,Apr-17,5588,5105,483,8.6
CN2708900000000,27,089,Marshall County, MN,May-17,5531,5253,278,5.0
CN2708900000000,27,089,Marshall County, MN,Jun-17,5512,5238,274,5.0
CN2708900000000,27,089,Marshall County, MN,Jul-17,5289,5034,255,4.8
CN2708900000000,27,089,Marshall County, MN,Aug-17,5157,4891,266,5.2
CN2708900000000,27,089,Marshall County, MN,Sep-17,5191,4992,199,3.8
CN2708900000000,27,089,Marshall County, MN,Oct-17,5418,5244,174,3.2
CN2708900000000,27,089,Marshall County, MN,Nov-17,5561,5173,388,7.0
CN2708900000000,27,089,Marshall County, MN,Dec-17,5638,5129,509,9.0
CN2708900000000,27,089,Marshall County, MN,Jan-18,5592,4994,598,10.7
CN2708900000000,27,089,Marshall County, MN,Feb-18,5563,5014,549,9.9
CN2708900000000,27,089,Marshall County, MN,Mar-18,5628,5072,556,9.9
CN2708900000000,27,089,Marshall County, MN,Apr-18(p),5510,5122,388,7.0
CN2903500000000,29,035,Carter County, MO,Mar-17,2476,2320,156,6.3
CN2903500000000,29,035,Carter County, MO,Apr-17,2505,2381,124,5.0
CN2903500000000,29,035,Carter County, MO,May-17,2507,2349,158,6.3
CN2903500000000,29,035,Carter County, MO,Jun-17,2523,2360,163,6.5
CN2903500000000,29,035,Carter County, MO,Jul-17,2465,2280,185,7.5
CN2903500000000,29,035,Carter County, MO,Aug-17,2548,2374,174,6.8
CN2903500000000,29,035,Carter County, MO,Sep-17,2505,2390,115,4.6
CN2903500000000,29,035,Carter County, MO,Oct-17,2387,2290,97,4.1
CN2903500000000,29,035,Carter County, MO,Nov-17,2376,2254,122,5.1
CN2903500000000,29,035,Carter County, MO,Dec-17,2383,2251,132,5.5
CN2903500000000,29,035,Carter County, MO,Jan-18,2389,2218,171,7.2
CN2903500000000,29,035,Carter County, MO,Feb-18,2425,2265,160,6.6
CN2903500000000,29,035,Carter County, MO,Mar-18,2443,2294,149,6.1
CN2903500000000,29,035,Carter County, MO,Apr-18(p),2528,2351,177,7.0
CN2909900000000,29,099,Jefferson County, MO,Mar-17,116451,111726,4725,4.1
CN2909900000000,29,099,Jefferson County, MO,Apr-17,116361,112265,4096,3.5
CN2909900000000,29,099,Jefferson County, MO,May-17,116768,112590,4178,3.6
CN2909900000000,29,099,Jefferson County, MO,Jun-17,118024,113769,4255,3.6
CN2909900000000,29,099,Jefferson County, MO,Jul-17,118898,114402,4496,3.8
CN2909900000000,29,099,Jefferson County, MO,Aug-17,117367,112881,4486,3.8
CN2909900000000,29,099,Jefferson County, MO,Sep-17,116907,113260,3647,3.1
CN2909900000000,29,099,Jefferson County, MO,Oct-17,115559,112790,2769,2.4
CN2909900000000,29,099,Jefferson County, MO,Nov-17,115884,112478,3406,2.9
CN2909900000000,29,099,Jefferson County, MO,Dec-17,115613,111940,3673,3.2
CN2909900000000,29,099,Jefferson County, MO,Jan-18,114594,109913,4681,4.1
CN2909900000000,29,099,Jefferson County, MO,Feb-18,116378,111543,4835,4.2
CN2909900000000,29,099,Jefferson County, MO,Mar-18,116315,111809,4506,3.9
CN2909900000000,29,099,Jefferson County, MO,Apr-18(p),116415,112548,3867,3.3
CN2018100000000,20,181,Sherman County, KS,Mar-17,2869,2785,84,2.9
CN2018100000000,20,181,Sherman County, KS,Apr-17,2828,2745,83,2.9
CN2018100000000,20,181,Sherman County, KS,May-17,2837,2752,85,3.0
CN2018100000000,20,181,Sherman County, KS,Jun-17,2932,2841,91,3.1
CN2018100000000,20,181,Sherman County, KS,Jul-17,2980,2884,96,3.2
CN2018100000000,20,181,Sherman County, KS,Aug-17,2946,2855,91,3.1
CN2018100000000,20,181,Sherman County, KS,Sep-17,2898,2821,77,2.7
CN2018100000000,20,181,Sherman County, KS,Oct-17,2894,2823,71,2.5
CN2018100000000,20,181,Sherman County, KS,Nov-17,2852,2778,74,2.6
CN2018100000000,20,181,Sherman County, KS,Dec-17,2830,2759,71,2.5
CN2018100000000,20,181,Sherman County, KS,Jan-18,2778,2700,78,2.8
CN2018100000000,20,181,Sherman County, KS,Feb-18,2778,2696,82,3.0
CN2018100000000,20,181,Sherman County, KS,Mar-18,2849,2764,85,3.0
CN2018100000000,20,181,Sherman County, KS,Apr-18(p),2741,2660,81,3.0
CN5602900000000,56,029,Park County, WY,Mar-17,14606,13796,810,5.5
CN5602900000000,56,029,Park County, WY,Apr-17,14733,14084,649,4.4
CN5602900000000,56,029,Park County, WY,May-17,16016,15428,588,3.7
CN5602900000000,56,029,Park County, WY,Jun-17,17245,16650,595,3.5
CN5602900000000,56,029,Park County, WY,Jul-17,17381,16825,556,3.2
CN5602900000000,56,029,Park County, WY,Aug-17,17170,16653,517,3.0
CN5602900000000,56,029,Park County, WY,Sep-17,16230,15717,513,3.2
CN5602900000000,56,029,Park County, WY,Oct-17,15555,14990,565,3.6
CN5602900000000,56,029,Park County, WY,Nov-17,15135,14460,675,4.5
CN5602900000000,56,029,Park County, WY,Dec-17,14893,14206,687,4.6
CN5602900000000,56,029,Park County, WY,Jan-18,14829,14008,821,5.5
CN5602900000000,56,029,Park County, WY,Feb-18,14827,14036,791,5.3
CN5602900000000,56,029,Park County, WY,Mar-18,14611,13848,763,5.2
CN5602900000000,56,029,Park County, WY,Apr-18(p),14589,13939,650,4.5
CN3915700000000,39,157,Tuscarawas County, OH,Mar-17,44653,42154,2499,5.6
CN3915700000000,39,157,Tuscarawas County, OH,Apr-17,45226,43056,2170,4.8
CN3915700000000,39,157,Tuscarawas County, OH,May-17,46052,44000,2052,4.5
CN3915700000000,39,157,Tuscarawas County, OH,Jun-17,46642,44381,2261,4.8
CN3915700000000,39,157,Tuscarawas County, OH,Jul-17,46825,44597,2228,4.8
CN3915700000000,39,157,Tuscarawas County, OH,Aug-17,46731,44522,2209,4.7
CN3915700000000,39,157,Tuscarawas County, OH,Sep-17,46156,44118,2038,4.4
CN3915700000000,39,157,Tuscarawas County, OH,Oct-17,46055,44072,1983,4.3
CN3915700000000,39,157,Tuscarawas County, OH,Nov-17,45874,43820,2054,4.5
CN3915700000000,39,157,Tuscarawas County, OH,Dec-17,45610,43484,2126,4.7
CN3915700000000,39,157,Tuscarawas County, OH,Jan-18,45003,42547,2456,5.5
CN3915700000000,39,157,Tuscarawas County, OH,Feb-18,45444,43155,2289,5.0
CN3915700000000,39,157,Tuscarawas County, OH,Mar-18,45818,43736,2082,4.5
CN3915700000000,39,157,Tuscarawas County, OH,Apr-18(p),45945,44046,1899,4.1
CN2908100000000,29,081,Harrison County, MO,Mar-17,3932,3757,175,4.5
CN2908100000000,29,081,Harrison County, MO,Apr-17,4057,3924,133,3.3
CN2908100000000,29,081,Harrison County, MO,May-17,3942,3811,131,3.3
CN2908100000000,29,081,Harrison County, MO,Jun-17,3990,3863,127,3.2
CN2908100000000,29,081,Harrison County, MO,Jul-17,3791,3655,136,3.6
CN2908100000000,29,081,Harrison County, MO,Aug-17,3653,3521,132,3.6
CN2908100000000,29,081,Harrison County, MO,Sep-17,3672,3566,106,2.9
CN2908100000000,29,081,Harrison County, MO,Oct-17,3856,3786,70,1.8
CN2908100000000,29,081,Harrison County, MO,Nov-17,3864,3759,105,2.7
CN2908100000000,29,081,Harrison County, MO,Dec-17,3801,3678,123,3.2
CN2908100000000,29,081,Harrison County, MO,Jan-18,3844,3670,174,4.5
CN2908100000000,29,081,Harrison County, MO,Feb-18,3797,3626,171,4.5
CN2908100000000,29,081,Harrison County, MO,Mar-18,3778,3632,146,3.9
CN2908100000000,29,081,Harrison County, MO,Apr-18(p),3846,3722,124,3.2
CN3111700000000,31,117,McPherson County, NE,Mar-17,453,445,8,1.8
CN3111700000000,31,117,McPherson County, NE,Apr-17,451,442,9,2.0
CN3111700000000,31,117,McPherson County, NE,May-17,457,450,7,1.5
CN3111700000000,31,117,McPherson County, NE,Jun-17,461,448,13,2.8
CN3111700000000,31,117,McPherson County, NE,Jul-17,465,451,14,3.0
CN3111700000000,31,117,McPherson County, NE,Aug-17,444,435,9,2.0
CN3111700000000,31,117,McPherson County, NE,Sep-17,426,417,9,2.1
CN3111700000000,31,117,McPherson County, NE,Oct-17,430,422,8,1.9
CN3111700000000,31,117,McPherson County, NE,Nov-17,439,428,11,2.5
CN3111700000000,31,117,McPherson County, NE,Dec-17,441,430,11,2.5
CN3111700000000,31,117,McPherson County, NE,Jan-18,448,436,12,2.7
CN3111700000000,31,117,McPherson County, NE,Feb-18,450,438,12,2.7
CN3111700000000,31,117,McPherson County, NE,Mar-18,447,433,14,3.1
CN3111700000000,31,117,McPherson County, NE,Apr-18(p),448,438,10,2.2
CN2911100000000,29,111,Lewis County, MO,Mar-17,5065,4864,201,4.0
CN2911100000000,29,111,Lewis County, MO,Apr-17,5191,5019,172,3.3
CN2911100000000,29,111,Lewis County, MO,May-17,5147,4963,184,3.6
CN2911100000000,29,111,Lewis County, MO,Jun-17,5163,4965,198,3.8
CN2911100000000,29,111,Lewis County, MO,Jul-17,5018,4837,181,3.6
CN2911100000000,29,111,Lewis County, MO,Aug-17,4945,4752,193,3.9
CN2911100000000,29,111,Lewis County, MO,Sep-17,4982,4835,147,3.0
CN2911100000000,29,111,Lewis County, MO,Oct-17,5052,4945,107,2.1
CN2911100000000,29,111,Lewis County, MO,Nov-17,5045,4906,139,2.8
CN2911100000000,29,111,Lewis County, MO,Dec-17,4995,4849,146,2.9
CN2911100000000,29,111,Lewis County, MO,Jan-18,4957,4775,182,3.7
CN2911100000000,29,111,Lewis County, MO,Feb-18,4993,4825,168,3.4
CN2911100000000,29,111,Lewis County, MO,Mar-18,4991,4819,172,3.4
CN2911100000000,29,111,Lewis County, MO,Apr-18(p),5073,4924,149,2.9
CN2402700000000,24,027,Howard County, MD,Mar-17,181063,175520,5543,3.1
CN2402700000000,24,027,Howard County, MD,Apr-17,181309,176085,5224,2.9
CN2402700000000,24,027,Howard County, MD,May-17,182453,176887,5566,3.1
CN2402700000000,24,027,Howard County, MD,Jun-17,184336,178091,6245,3.4
CN2402700000000,24,027,Howard County, MD,Jul-17,186136,179804,6332,3.4
CN2402700000000,24,027,Howard County, MD,Aug-17,184322,178423,5899,3.2
CN2402700000000,24,027,Howard County, MD,Sep-17,184126,178563,5563,3.0
CN2402700000000,24,027,Howard County, MD,Oct-17,183780,178013,5767,3.1
CN2402700000000,24,027,Howard County, MD,Nov-17,183713,178032,5681,3.1
CN2402700000000,24,027,Howard County, MD,Dec-17,181689,176715,4974,2.7
CN2402700000000,24,027,Howard County, MD,Jan-18,181659,175446,6213,3.4
CN2402700000000,24,027,Howard County, MD,Feb-18,182616,176260,6356,3.5
CN2402700000000,24,027,Howard County, MD,Mar-18,183643,177296,6347,3.5
CN2402700000000,24,027,Howard County, MD,Apr-18(p),182741,177424,5317,2.9
CN3611100000000,36,111,Ulster County, NY,Mar-17,88482,84404,4078,4.6
CN3611100000000,36,111,Ulster County, NY,Apr-17,88602,84738,3864,4.4
CN3611100000000,36,111,Ulster County, NY,May-17,89240,85379,3861,4.3
CN3611100000000,36,111,Ulster County, NY,Jun-17,90982,86925,4057,4.5
CN3611100000000,36,111,Ulster County, NY,Jul-17,90398,86178,4220,4.7
CN3611100000000,36,111,Ulster County, NY,Aug-17,89236,85039,4197,4.7
CN3611100000000,36,111,Ulster County, NY,Sep-17,89247,85313,3934,4.4
CN3611100000000,36,111,Ulster County, NY,Oct-17,89102,85282,3820,4.3
CN3611100000000,36,111,Ulster County, NY,Nov-17,88317,84386,3931,4.5
CN3611100000000,36,111,Ulster County, NY,Dec-17,87559,83639,3920,4.5
CN3611100000000,36,111,Ulster County, NY,Jan-18,87464,82760,4704,5.4
CN3611100000000,36,111,Ulster County, NY,Feb-18,87146,82380,4766,5.5
CN3611100000000,36,111,Ulster County, NY,Mar-18,86944,82720,4224,4.9
CN3611100000000,36,111,Ulster County, NY,Apr-18(p),87664,83959,3705,4.2
CN4810300000000,48,103,Crane County, TX,Mar-17,1621,1522,99,6.1
CN4810300000000,48,103,Crane County, TX,Apr-17,1652,1569,83,5.0
CN4810300000000,48,103,Crane County, TX,May-17,1639,1558,81,4.9
CN4810300000000,48,103,Crane County, TX,Jun-17,1639,1557,82,5.0
CN4810300000000,48,103,Crane County, TX,Jul-17,1565,1481,84,5.4
CN4810300000000,48,103,Crane County, TX,Aug-17,1565,1482,83,5.3
CN4810300000000,48,103,Crane County, TX,Sep-17,1545,1472,73,4.7
CN4810300000000,48,103,Crane County, TX,Oct-17,1536,1470,66,4.3
CN4810300000000,48,103,Crane County, TX,Nov-17,1529,1463,66,4.3
CN4810300000000,48,103,Crane County, TX,Dec-17,1534,1468,66,4.3
CN4810300000000,48,103,Crane County, TX,Jan-18,1552,1478,74,4.8
CN4810300000000,48,103,Crane County, TX,Feb-18,1586,1508,78,4.9
CN4810300000000,48,103,Crane County, TX,Mar-18,1592,1513,79,5.0
CN4810300000000,48,103,Crane County, TX,Apr-18(p),1600,1529,71,4.4
CN4825700000000,48,257,Kaufman County, TX,Mar-17,58956,56722,2234,3.8
CN4825700000000,48,257,Kaufman County, TX,Apr-17,59054,57103,1951,3.3
CN4825700000000,48,257,Kaufman County, TX,May-17,58964,56955,2009,3.4
CN4825700000000,48,257,Kaufman County, TX,Jun-17,59333,57061,2272,3.8
CN4825700000000,48,257,Kaufman County, TX,Jul-17,59757,57508,2249,3.8
CN4825700000000,48,257,Kaufman County, TX,Aug-17,59601,57372,2229,3.7
CN4825700000000,48,257,Kaufman County, TX,Sep-17,60047,58099,1948,3.2
CN4825700000000,48,257,Kaufman County, TX,Oct-17,59768,57937,1831,3.1
CN4825700000000,48,257,Kaufman County, TX,Nov-17,60267,58365,1902,3.2
CN4825700000000,48,257,Kaufman County, TX,Dec-17,59924,58100,1824,3.0
CN4825700000000,48,257,Kaufman County, TX,Jan-18,59981,57903,2078,3.5
CN4825700000000,48,257,Kaufman County, TX,Feb-18,60914,58735,2179,3.6
CN4825700000000,48,257,Kaufman County, TX,Mar-18,61012,58773,2239,3.7
CN4825700000000,48,257,Kaufman County, TX,Apr-18(p),61158,59164,1994,3.3
CN4818500000000,48,185,Grimes County, TX,Mar-17,10980,10332,648,5.9
CN4818500000000,48,185,Grimes County, TX,Apr-17,10915,10343,572,5.2
CN4818500000000,48,185,Grimes County, TX,May-17,10907,10349,558,5.1
CN4818500000000,48,185,Grimes County, TX,Jun-17,10773,10169,604,5.6
CN4818500000000,48,185,Grimes County, TX,Jul-17,10741,10142,599,5.6
CN4818500000000,48,185,Grimes County, TX,Aug-17,10771,10178,593,5.5
CN4818500000000,48,185,Grimes County, TX,Sep-17,10890,10395,495,4.5
CN4818500000000,48,185,Grimes County, TX,Oct-17,10972,10509,463,4.2
CN4818500000000,48,185,Grimes County, TX,Nov-17,10908,10440,468,4.3
CN4818500000000,48,185,Grimes County, TX,Dec-17,10769,10318,451,4.2
CN4818500000000,48,185,Grimes County, TX,Jan-18,10638,10135,503,4.7
CN4818500000000,48,185,Grimes County, TX,Feb-18,10824,10336,488,4.5
CN4818500000000,48,185,Grimes County, TX,Mar-18,10954,10446,508,4.6
CN4818500000000,48,185,Grimes County, TX,Apr-18(p),10834,10392,442,4.1
CN0106500000000,01,065,Hale County, AL,Mar-17,5985,5581,404,6.8
CN0106500000000,01,065,Hale County, AL,Apr-17,5898,5570,328,5.6
CN0106500000000,01,065,Hale County, AL,May-17,5839,5528,311,5.3
CN0106500000000,01,065,Hale County, AL,Jun-17,5912,5529,383,6.5
CN0106500000000,01,065,Hale County, AL,Jul-17,6091,5688,403,6.6
CN0106500000000,01,065,Hale County, AL,Aug-17,6096,5746,350,5.7
CN0106500000000,01,065,Hale County, AL,Sep-17,6242,5952,290,4.6
CN0106500000000,01,065,Hale County, AL,Oct-17,6171,5891,280,4.5
CN0106500000000,01,065,Hale County, AL,Nov-17,6063,5780,283,4.7
CN0106500000000,01,065,Hale County, AL,Dec-17,5879,5606,273,4.6
CN0106500000000,01,065,Hale County, AL,Jan-18,5870,5555,315,5.4
CN0106500000000,01,065,Hale County, AL,Feb-18,6014,5682,332,5.5
CN0106500000000,01,065,Hale County, AL,Mar-18,5992,5704,288,4.8
CN0106500000000,01,065,Hale County, AL,Apr-18(p),6006,5744,262,4.4
CN5000700000000,50,007,Chittenden County, VT,Mar-17,94993,92638,2355,2.5
CN5000700000000,50,007,Chittenden County, VT,Apr-17,95391,93398,1993,2.1
CN5000700000000,50,007,Chittenden County, VT,May-17,95333,93307,2026,2.1
CN5000700000000,50,007,Chittenden County, VT,Jun-17,96635,94133,2502,2.6
CN5000700000000,50,007,Chittenden County, VT,Jul-17,97287,94786,2501,2.6
CN5000700000000,50,007,Chittenden County, VT,Aug-17,96544,94145,2399,2.5
CN5000700000000,50,007,Chittenden County, VT,Sep-17,96106,93781,2325,2.4
CN5000700000000,50,007,Chittenden County, VT,Oct-17,96135,94317,1818,1.9
CN5000700000000,50,007,Chittenden County, VT,Nov-17,95875,93881,1994,2.1
CN5000700000000,50,007,Chittenden County, VT,Dec-17,94563,92845,1718,1.8
CN5000700000000,50,007,Chittenden County, VT,Jan-18,94207,92064,2143,2.3
CN5000700000000,50,007,Chittenden County, VT,Feb-18,95573,93602,1971,2.1
CN5000700000000,50,007,Chittenden County, VT,Mar-18,96315,94252,2063,2.1
CN5000700000000,50,007,Chittenden County, VT,Apr-18(p),96984,95075,1909,2.0
CN1700900000000,17,009,Brown County, IL,Mar-17,2874,2791,83,2.9
CN1700900000000,17,009,Brown County, IL,Apr-17,2896,2823,73,2.5
CN1700900000000,17,009,Brown County, IL,May-17,2887,2819,68,2.4
CN1700900000000,17,009,Brown County, IL,Jun-17,2890,2812,78,2.7
CN1700900000000,17,009,Brown County, IL,Jul-17,2880,2803,77,2.7
CN1700900000000,17,009,Brown County, IL,Aug-17,2880,2796,84,2.9
CN1700900000000,17,009,Brown County, IL,Sep-17,2859,2778,81,2.8
CN1700900000000,17,009,Brown County, IL,Oct-17,2783,2707,76,2.7
CN1700900000000,17,009,Brown County, IL,Nov-17,2788,2710,78,2.8
CN1700900000000,17,009,Brown County, IL,Dec-17,2751,2676,75,2.7
CN1700900000000,17,009,Brown County, IL,Jan-18,2705,2626,79,2.9
CN1700900000000,17,009,Brown County, IL,Feb-18,2743,2681,62,2.3
CN1700900000000,17,009,Brown County, IL,Mar-18,2846,2770,76,2.7
CN1700900000000,17,009,Brown County, IL,Apr-18(p),2858,2796,62,2.2
CN5303900000000,53,039,Klickitat County, WA,Mar-17,9692,9030,662,6.8
CN5303900000000,53,039,Klickitat County, WA,Apr-17,9713,9136,577,5.9
CN5303900000000,53,039,Klickitat County, WA,May-17,9859,9269,590,6.0
CN5303900000000,53,039,Klickitat County, WA,Jun-17,10707,10146,561,5.2
CN5303900000000,53,039,Klickitat County, WA,Jul-17,10763,10230,533,5.0
CN5303900000000,53,039,Klickitat County, WA,Aug-17,10427,9892,535,5.1
CN5303900000000,53,039,Klickitat County, WA,Sep-17,10273,9804,469,4.6
CN5303900000000,53,039,Klickitat County, WA,Oct-17,10376,9914,462,4.5
CN5303900000000,53,039,Klickitat County, WA,Nov-17,10044,9517,527,5.2
CN5303900000000,53,039,Klickitat County, WA,Dec-17,9842,9222,620,6.3
CN5303900000000,53,039,Klickitat County, WA,Jan-18,9678,8998,680,7.0
CN5303900000000,53,039,Klickitat County, WA,Feb-18,9811,9095,716,7.3
CN5303900000000,53,039,Klickitat County, WA,Mar-18,9739,9075,664,6.8
CN5303900000000,53,039,Klickitat County, WA,Apr-18(p),9843,9251,592,6.0
CN4202700000000,42,027,Centre County, PA,Mar-17,80462,77481,2981,3.7
CN4202700000000,42,027,Centre County, PA,Apr-17,80969,78342,2627,3.2
CN4202700000000,42,027,Centre County, PA,May-17,75724,72677,3047,4.0
CN4202700000000,42,027,Centre County, PA,Jun-17,76403,73419,2984,3.9
CN4202700000000,42,027,Centre County, PA,Jul-17,77764,74471,3293,4.2
CN4202700000000,42,027,Centre County, PA,Aug-17,77858,74803,3055,3.9
CN4202700000000,42,027,Centre County, PA,Sep-17,79305,76703,2602,3.3
CN4202700000000,42,027,Centre County, PA,Oct-17,79565,77090,2475,3.1
CN4202700000000,42,027,Centre County, PA,Nov-17,80253,77682,2571,3.2
CN4202700000000,42,027,Centre County, PA,Dec-17,79021,76466,2555,3.2
CN4202700000000,42,027,Centre County, PA,Jan-18,76885,73876,3009,3.9
CN4202700000000,42,027,Centre County, PA,Feb-18,79256,76153,3103,3.9
CN4202700000000,42,027,Centre County, PA,Mar-18,78580,76087,2493,3.2
CN4202700000000,42,027,Centre County, PA,Apr-18(p),79219,76903,2316,2.9
CN0112500000000,01,125,Tuscaloosa County, AL,Mar-17,99803,95130,4673,4.7
CN0112500000000,01,125,Tuscaloosa County, AL,Apr-17,99371,95632,3739,3.8
CN0112500000000,01,125,Tuscaloosa County, AL,May-17,98471,94721,3750,3.8
CN0112500000000,01,125,Tuscaloosa County, AL,Jun-17,98732,93920,4812,4.9
CN0112500000000,01,125,Tuscaloosa County, AL,Jul-17,98724,94057,4667,4.7
CN0112500000000,01,125,Tuscaloosa County, AL,Aug-17,98653,94644,4009,4.1
CN0112500000000,01,125,Tuscaloosa County, AL,Sep-17,99552,96262,3290,3.3
CN0112500000000,01,125,Tuscaloosa County, AL,Oct-17,99611,96369,3242,3.3
CN0112500000000,01,125,Tuscaloosa County, AL,Nov-17,99565,96386,3179,3.2
CN0112500000000,01,125,Tuscaloosa County, AL,Dec-17,99208,96150,3058,3.1
CN0112500000000,01,125,Tuscaloosa County, AL,Jan-18,99043,95302,3741,3.8
CN0112500000000,01,125,Tuscaloosa County, AL,Feb-18,100316,96497,3819,3.8
CN0112500000000,01,125,Tuscaloosa County, AL,Mar-18,101083,97520,3563,3.5
CN0112500000000,01,125,Tuscaloosa County, AL,Apr-18(p),101327,98153,3174,3.1
CN2200300000000,22,003,Allen Parish, LA,Mar-17,8956,8500,456,5.1
CN2200300000000,22,003,Allen Parish, LA,Apr-17,9018,8586,432,4.8
CN2200300000000,22,003,Allen Parish, LA,May-17,9075,8627,448,4.9
CN2200300000000,22,003,Allen Parish, LA,Jun-17,9230,8682,548,5.9
CN2200300000000,22,003,Allen Parish, LA,Jul-17,8963,8435,528,5.9
CN2200300000000,22,003,Allen Parish, LA,Aug-17,8938,8426,512,5.7
CN2200300000000,22,003,Allen Parish, LA,Sep-17,9047,8583,464,5.1
CN2200300000000,22,003,Allen Parish, LA,Oct-17,9120,8705,415,4.6
CN2200300000000,22,003,Allen Parish, LA,Nov-17,9099,8671,428,4.7
CN2200300000000,22,003,Allen Parish, LA,Dec-17,8985,8546,439,4.9
CN2200300000000,22,003,Allen Parish, LA,Jan-18,9186,8687,499,5.4
CN2200300000000,22,003,Allen Parish, LA,Feb-18,9117,8693,424,4.7
CN2200300000000,22,003,Allen Parish, LA,Mar-18,9129,8678,451,4.9
CN2200300000000,22,003,Allen Parish, LA,Apr-18(p),9195,8729,466,5.1
CN1604700000000,16,047,Gooding County, ID,Mar-17,7905,7674,231,2.9
CN1604700000000,16,047,Gooding County, ID,Apr-17,8008,7827,181,2.3
CN1604700000000,16,047,Gooding County, ID,May-17,8099,7930,169,2.1
CN1604700000000,16,047,Gooding County, ID,Jun-17,8129,7948,181,2.2
CN1604700000000,16,047,Gooding County, ID,Jul-17,8112,7938,174,2.1
CN1604700000000,16,047,Gooding County, ID,Aug-17,8109,7946,163,2.0
CN1604700000000,16,047,Gooding County, ID,Sep-17,8114,7955,159,2.0
CN1604700000000,16,047,Gooding County, ID,Oct-17,8134,7965,169,2.1
CN1604700000000,16,047,Gooding County, ID,Nov-17,8160,7970,190,2.3
CN1604700000000,16,047,Gooding County, ID,Dec-17,8094,7905,189,2.3
CN1604700000000,16,047,Gooding County, ID,Jan-18,7977,7697,280,3.5
CN1604700000000,16,047,Gooding County, ID,Feb-18,8011,7778,233,2.9
CN1604700000000,16,047,Gooding County, ID,Mar-18,8096,7875,221,2.7
CN1604700000000,16,047,Gooding County, ID,Apr-18(p),8144,7953,191,2.3
CN3916100000000,39,161,Van Wert County, OH,Mar-17,14492,13919,573,4.0
CN3916100000000,39,161,Van Wert County, OH,Apr-17,14458,13942,516,3.6
CN3916100000000,39,161,Van Wert County, OH,May-17,14503,13974,529,3.6
CN3916100000000,39,161,Van Wert County, OH,Jun-17,14640,14045,595,4.1
CN3916100000000,39,161,Van Wert County, OH,Jul-17,14617,13956,661,4.5
CN3916100000000,39,161,Van Wert County, OH,Aug-17,14663,14085,578,3.9
CN3916100000000,39,161,Van Wert County, OH,Sep-17,14440,13913,527,3.6
CN3916100000000,39,161,Van Wert County, OH,Oct-17,14416,13902,514,3.6
CN3916100000000,39,161,Van Wert County, OH,Nov-17,14323,13821,502,3.5
CN3916100000000,39,161,Van Wert County, OH,Dec-17,14239,13706,533,3.7
CN3916100000000,39,161,Van Wert County, OH,Jan-18,14005,13468,537,3.8
CN3916100000000,39,161,Van Wert County, OH,Feb-18,14505,13998,507,3.5
CN3916100000000,39,161,Van Wert County, OH,Mar-18,14743,14281,462,3.1
CN3916100000000,39,161,Van Wert County, OH,Apr-18(p),14689,14235,454,3.1
CN2716500000000,27,165,Watonwan County, MN,Mar-17,6586,6206,380,5.8
CN2716500000000,27,165,Watonwan County, MN,Apr-17,6635,6343,292,4.4
CN2716500000000,27,165,Watonwan County, MN,May-17,6546,6317,229,3.5
CN2716500000000,27,165,Watonwan County, MN,Jun-17,6557,6305,252,3.8
CN2716500000000,27,165,Watonwan County, MN,Jul-17,6436,6184,252,3.9
CN2716500000000,27,165,Watonwan County, MN,Aug-17,6333,6032,301,4.8
CN2716500000000,27,165,Watonwan County, MN,Sep-17,6262,6007,255,4.1
CN2716500000000,27,165,Watonwan County, MN,Oct-17,6460,6270,190,2.9
CN2716500000000,27,165,Watonwan County, MN,Nov-17,6415,6194,221,3.4
CN2716500000000,27,165,Watonwan County, MN,Dec-17,6409,6152,257,4.0
CN2716500000000,27,165,Watonwan County, MN,Jan-18,6440,6083,357,5.5
CN2716500000000,27,165,Watonwan County, MN,Feb-18,6402,6072,330,5.2
CN2716500000000,27,165,Watonwan County, MN,Mar-18,6458,6131,327,5.1
CN2716500000000,27,165,Watonwan County, MN,Apr-18(p),6434,6188,246,3.8
CN2709300000000,27,093,Meeker County, MN,Mar-17,13344,12599,745,5.6
CN2709300000000,27,093,Meeker County, MN,Apr-17,13420,12860,560,4.2
CN2709300000000,27,093,Meeker County, MN,May-17,13303,12881,422,3.2
CN2709300000000,27,093,Meeker County, MN,Jun-17,13449,12953,496,3.7
CN2709300000000,27,093,Meeker County, MN,Jul-17,13352,12889,463,3.5
CN2709300000000,27,093,Meeker County, MN,Aug-17,13267,12790,477,3.6
CN2709300000000,27,093,Meeker County, MN,Sep-17,13058,12679,379,2.9
CN2709300000000,27,093,Meeker County, MN,Oct-17,13225,12906,319,2.4
CN2709300000000,27,093,Meeker County, MN,Nov-17,13239,12826,413,3.1
CN2709300000000,27,093,Meeker County, MN,Dec-17,13330,12753,577,4.3
CN2709300000000,27,093,Meeker County, MN,Jan-18,13429,12710,719,5.4
CN2709300000000,27,093,Meeker County, MN,Feb-18,13466,12759,707,5.3
CN2709300000000,27,093,Meeker County, MN,Mar-18,13492,12796,696,5.2
CN2709300000000,27,093,Meeker County, MN,Apr-18(p),13563,12972,591,4.4
CN2111300000000,21,113,Jessamine County, KY,Mar-17,26079,24953,1126,4.3
CN2111300000000,21,113,Jessamine County, KY,Apr-17,26189,25181,1008,3.8
CN2111300000000,21,113,Jessamine County, KY,May-17,26104,25083,1021,3.9
CN2111300000000,21,113,Jessamine County, KY,Jun-17,26356,25176,1180,4.5
CN2111300000000,21,113,Jessamine County, KY,Jul-17,26125,25020,1105,4.2
CN2111300000000,21,113,Jessamine County, KY,Aug-17,25845,24883,962,3.7
CN2111300000000,21,113,Jessamine County, KY,Sep-17,26023,25182,841,3.2
CN2111300000000,21,113,Jessamine County, KY,Oct-17,26016,25216,800,3.1
CN2111300000000,21,113,Jessamine County, KY,Nov-17,26100,25321,779,3.0
CN2111300000000,21,113,Jessamine County, KY,Dec-17,26083,25307,776,3.0
CN2111300000000,21,113,Jessamine County, KY,Jan-18,25932,25053,879,3.4
CN2111300000000,21,113,Jessamine County, KY,Feb-18,26064,25035,1029,3.9
CN2111300000000,21,113,Jessamine County, KY,Mar-18,26266,25264,1002,3.8
CN2111300000000,21,113,Jessamine County, KY,Apr-18(p),26493,25605,888,3.4
CN5410300000000,54,103,Wetzel County, WV,Mar-17,7078,6494,584,8.3
CN5410300000000,54,103,Wetzel County, WV,Apr-17,7041,6551,490,7.0
CN5410300000000,54,103,Wetzel County, WV,May-17,6969,6548,421,6.0
CN5410300000000,54,103,Wetzel County, WV,Jun-17,7184,6705,479,6.7
CN5410300000000,54,103,Wetzel County, WV,Jul-17,7101,6627,474,6.7
CN5410300000000,54,103,Wetzel County, WV,Aug-17,7066,6571,495,7.0
CN5410300000000,54,103,Wetzel County, WV,Sep-17,7051,6649,402,5.7
CN5410300000000,54,103,Wetzel County, WV,Oct-17,6961,6557,404,5.8
CN5410300000000,54,103,Wetzel County, WV,Nov-17,7004,6550,454,6.5
CN5410300000000,54,103,Wetzel County, WV,Dec-17,7029,6480,549,7.8
CN5410300000000,54,103,Wetzel County, WV,Jan-18,7134,6466,668,9.4
CN5410300000000,54,103,Wetzel County, WV,Feb-18,7155,6475,680,9.5
CN5410300000000,54,103,Wetzel County, WV,Mar-18,7071,6489,582,8.2
CN5410300000000,54,103,Wetzel County, WV,Apr-18(p),7054,6536,518,7.3
CN1805700000000,18,057,Hamilton County, IN,Mar-17,174015,169234,4781,2.7
CN1805700000000,18,057,Hamilton County, IN,Apr-17,175340,171404,3936,2.2
CN1805700000000,18,057,Hamilton County, IN,May-17,175938,171489,4449,2.5
CN1805700000000,18,057,Hamilton County, IN,Jun-17,178449,173425,5024,2.8
CN1805700000000,18,057,Hamilton County, IN,Jul-17,178776,173603,5173,2.9
CN1805700000000,18,057,Hamilton County, IN,Aug-17,177296,171591,5705,3.2
CN1805700000000,18,057,Hamilton County, IN,Sep-17,176281,171653,4628,2.6
CN1805700000000,18,057,Hamilton County, IN,Oct-17,175087,170729,4358,2.5
CN1805700000000,18,057,Hamilton County, IN,Nov-17,175233,170781,4452,2.5
CN1805700000000,18,057,Hamilton County, IN,Dec-17,173773,169673,4100,2.4
CN1805700000000,18,057,Hamilton County, IN,Jan-18,173808,169240,4568,2.6
CN1805700000000,18,057,Hamilton County, IN,Feb-18,175971,171182,4789,2.7
CN1805700000000,18,057,Hamilton County, IN,Mar-18,177900,173513,4387,2.5
CN1805700000000,18,057,Hamilton County, IN,Apr-18(p),178720,174647,4073,2.3
CN4701300000000,47,013,Campbell County, TN,Mar-17,14872,13957,915,6.2
CN4701300000000,47,013,Campbell County, TN,Apr-17,14790,14074,716,4.8
CN4701300000000,47,013,Campbell County, TN,May-17,14774,14110,664,4.5
CN4701300000000,47,013,Campbell County, TN,Jun-17,14898,14111,787,5.3
CN4701300000000,47,013,Campbell County, TN,Jul-17,14948,14183,765,5.1
CN4701300000000,47,013,Campbell County, TN,Aug-17,14760,14054,706,4.8
CN4701300000000,47,013,Campbell County, TN,Sep-17,14890,14246,644,4.3
CN4701300000000,47,013,Campbell County, TN,Oct-17,14790,14184,606,4.1
CN4701300000000,47,013,Campbell County, TN,Nov-17,14794,14189,605,4.1
CN4701300000000,47,013,Campbell County, TN,Dec-17,14694,14089,605,4.1
CN4701300000000,47,013,Campbell County, TN,Jan-18,14712,13960,752,5.1
CN4701300000000,47,013,Campbell County, TN,Feb-18,14974,14217,757,5.1
CN4701300000000,47,013,Campbell County, TN,Mar-18,14924,14214,710,4.8
CN4701300000000,47,013,Campbell County, TN,Apr-18(p),14886,14296,590,4.0
CN1306100000000,13,061,Clay County, GA,Mar-17,871,787,84,9.6
CN1306100000000,13,061,Clay County, GA,Apr-17,860,789,71,8.3
CN1306100000000,13,061,Clay County, GA,May-17,899,822,77,8.6
CN1306100000000,13,061,Clay County, GA,Jun-17,895,813,82,9.2
CN1306100000000,13,061,Clay County, GA,Jul-17,876,792,84,9.6
CN1306100000000,13,061,Clay County, GA,Aug-17,870,790,80,9.2
CN1306100000000,13,061,Clay County, GA,Sep-17,868,797,71,8.2
CN1306100000000,13,061,Clay County, GA,Oct-17,878,811,67,7.6
CN1306100000000,13,061,Clay County, GA,Nov-17,868,800,68,7.8
CN1306100000000,13,061,Clay County, GA,Dec-17,869,803,66,7.6
CN1306100000000,13,061,Clay County, GA,Jan-18,881,808,73,8.3
CN1306100000000,13,061,Clay County, GA,Feb-18,837,759,78,9.3
CN1306100000000,13,061,Clay County, GA,Mar-18,827,762,65,7.9
CN1306100000000,13,061,Clay County, GA,Apr-18(p),826,768,58,7.0
CN2119500000000,21,195,Pike County, KY,Mar-17,20688,18739,1949,9.4
CN2119500000000,21,195,Pike County, KY,Apr-17,20606,18940,1666,8.1
CN2119500000000,21,195,Pike County, KY,May-17,20488,18790,1698,8.3
CN2119500000000,21,195,Pike County, KY,Jun-17,20564,18729,1835,8.9
CN2119500000000,21,195,Pike County, KY,Jul-17,21064,19405,1659,7.9
CN2119500000000,21,195,Pike County, KY,Aug-17,20472,18991,1481,7.2
CN2119500000000,21,195,Pike County, KY,Sep-17,20490,19157,1333,6.5
CN2119500000000,21,195,Pike County, KY,Oct-17,20104,18895,1209,6.0
CN2119500000000,21,195,Pike County, KY,Nov-17,20112,18955,1157,5.8
CN2119500000000,21,195,Pike County, KY,Dec-17,19891,18787,1104,5.6
CN2119500000000,21,195,Pike County, KY,Jan-18,19733,18547,1186,6.0
CN2119500000000,21,195,Pike County, KY,Feb-18,20165,18879,1286,6.4
CN2119500000000,21,195,Pike County, KY,Mar-18,20250,19002,1248,6.2
CN2119500000000,21,195,Pike County, KY,Apr-18(p),20101,19022,1079,5.4
CN4805700000000,48,057,Calhoun County, TX,Mar-17,10497,9863,634,6.0
CN4805700000000,48,057,Calhoun County, TX,Apr-17,10593,10009,584,5.5
CN4805700000000,48,057,Calhoun County, TX,May-17,10491,9945,546,5.2
CN4805700000000,48,057,Calhoun County, TX,Jun-17,10536,9936,600,5.7
CN4805700000000,48,057,Calhoun County, TX,Jul-17,10483,9902,581,5.5
CN4805700000000,48,057,Calhoun County, TX,Aug-17,10393,9799,594,5.7
CN4805700000000,48,057,Calhoun County, TX,Sep-17,10570,9919,651,6.2
CN4805700000000,48,057,Calhoun County, TX,Oct-17,10303,9727,576,5.6
CN4805700000000,48,057,Calhoun County, TX,Nov-17,10244,9660,584,5.7
CN4805700000000,48,057,Calhoun County, TX,Dec-17,10178,9634,544,5.3
CN4805700000000,48,057,Calhoun County, TX,Jan-18,9944,9342,602,6.1
CN4805700000000,48,057,Calhoun County, TX,Feb-18,10142,9594,548,5.4
CN4805700000000,48,057,Calhoun County, TX,Mar-18,10162,9632,530,5.2
CN4805700000000,48,057,Calhoun County, TX,Apr-18(p),10679,10198,481,4.5
CN4842300000000,48,423,Smith County, TX,Mar-17,105248,100724,4524,4.3
CN4842300000000,48,423,Smith County, TX,Apr-17,105647,101599,4048,3.8
CN4842300000000,48,423,Smith County, TX,May-17,106531,102430,4101,3.8
CN4842300000000,48,423,Smith County, TX,Jun-17,105966,101580,4386,4.1
CN4842300000000,48,423,Smith County, TX,Jul-17,106068,101701,4367,4.1
CN4842300000000,48,423,Smith County, TX,Aug-17,105567,101281,4286,4.1
CN4842300000000,48,423,Smith County, TX,Sep-17,106876,102829,4047,3.8
CN4842300000000,48,423,Smith County, TX,Oct-17,106561,102120,4441,4.2
CN4842300000000,48,423,Smith County, TX,Nov-17,106398,102573,3825,3.6
CN4842300000000,48,423,Smith County, TX,Dec-17,106787,103079,3708,3.5
CN4842300000000,48,423,Smith County, TX,Jan-18,106388,102298,4090,3.8
CN4842300000000,48,423,Smith County, TX,Feb-18,107749,103686,4063,3.8
CN4842300000000,48,423,Smith County, TX,Mar-18,107846,103806,4040,3.7
CN4842300000000,48,423,Smith County, TX,Apr-18(p),108175,104452,3723,3.4
CN4211100000000,42,111,Somerset County, PA,Mar-17,33914,31467,2447,7.2
CN4211100000000,42,111,Somerset County, PA,Apr-17,33258,31394,1864,5.6
CN4211100000000,42,111,Somerset County, PA,May-17,33516,31684,1832,5.5
CN4211100000000,42,111,Somerset County, PA,Jun-17,33962,31974,1988,5.9
CN4211100000000,42,111,Somerset County, PA,Jul-17,34073,32081,1992,5.8
CN4211100000000,42,111,Somerset County, PA,Aug-17,33554,31552,2002,6.0
CN4211100000000,42,111,Somerset County, PA,Sep-17,33062,31547,1515,4.6
CN4211100000000,42,111,Somerset County, PA,Oct-17,32813,31308,1505,4.6
CN4211100000000,42,111,Somerset County, PA,Nov-17,32756,31058,1698,5.2
CN4211100000000,42,111,Somerset County, PA,Dec-17,33144,31101,2043,6.2
CN4211100000000,42,111,Somerset County, PA,Jan-18,33728,31272,2456,7.3
CN4211100000000,42,111,Somerset County, PA,Feb-18,33594,31202,2392,7.1
CN4211100000000,42,111,Somerset County, PA,Mar-18,32797,30762,2035,6.2
CN4211100000000,42,111,Somerset County, PA,Apr-18(p),32108,30499,1609,5.0
CN3401700000000,34,017,Hudson County, NJ,Mar-17,363920,348698,15222,4.2
CN3401700000000,34,017,Hudson County, NJ,Apr-17,363041,348586,14455,4.0
CN3401700000000,34,017,Hudson County, NJ,May-17,362725,347234,15491,4.3
CN3401700000000,34,017,Hudson County, NJ,Jun-17,365294,348644,16650,4.6
CN3401700000000,34,017,Hudson County, NJ,Jul-17,365206,347327,17879,4.9
CN3401700000000,34,017,Hudson County, NJ,Aug-17,361774,344441,17333,4.8
CN3401700000000,34,017,Hudson County, NJ,Sep-17,360793,344079,16714,4.6
CN3401700000000,34,017,Hudson County, NJ,Oct-17,361521,345993,15528,4.3
CN3401700000000,34,017,Hudson County, NJ,Nov-17,362070,347207,14863,4.1
CN3401700000000,34,017,Hudson County, NJ,Dec-17,360956,347014,13942,3.9
CN3401700000000,34,017,Hudson County, NJ,Jan-18,357597,342200,15397,4.3
CN3401700000000,34,017,Hudson County, NJ,Feb-18,360959,345234,15725,4.4
CN3401700000000,34,017,Hudson County, NJ,Mar-18,358490,343024,15466,4.3
CN3401700000000,34,017,Hudson County, NJ,Apr-18(p),355352,341562,13790,3.9
CN5119500000000,51,195,Wise County, VA,Mar-17,13310,12372,938,7.0
CN5119500000000,51,195,Wise County, VA,Apr-17,13257,12408,849,6.4
CN5119500000000,51,195,Wise County, VA,May-17,13097,12251,846,6.5
CN5119500000000,51,195,Wise County, VA,Jun-17,13156,12257,899,6.8
CN5119500000000,51,195,Wise County, VA,Jul-17,12893,11975,918,7.1
CN5119500000000,51,195,Wise County, VA,Aug-17,12844,11960,884,6.9
CN5119500000000,51,195,Wise County, VA,Sep-17,12668,11846,822,6.5
CN5119500000000,51,195,Wise County, VA,Oct-17,12875,12112,763,5.9
CN5119500000000,51,195,Wise County, VA,Nov-17,12782,12041,741,5.8
CN5119500000000,51,195,Wise County, VA,Dec-17,12732,11945,787,6.2
CN5119500000000,51,195,Wise County, VA,Jan-18,12604,11782,822,6.5
CN5119500000000,51,195,Wise County, VA,Feb-18,12450,11691,759,6.1
CN5119500000000,51,195,Wise County, VA,Mar-18,12548,11768,780,6.2
CN5119500000000,51,195,Wise County, VA,Apr-18(p),12509,11865,644,5.1
CN1324900000000,13,249,Schley County, GA,Mar-17,2154,2034,120,5.6
CN1324900000000,13,249,Schley County, GA,Apr-17,2120,2008,112,5.3
CN1324900000000,13,249,Schley County, GA,May-17,2128,2010,118,5.5
CN1324900000000,13,249,Schley County, GA,Jun-17,2134,2009,125,5.9
CN1324900000000,13,249,Schley County, GA,Jul-17,2119,1989,130,6.1
CN1324900000000,13,249,Schley County, GA,Aug-17,2102,1980,122,5.8
CN1324900000000,13,249,Schley County, GA,Sep-17,2125,2012,113,5.3
CN1324900000000,13,249,Schley County, GA,Oct-17,2124,2015,109,5.1
CN1324900000000,13,249,Schley County, GA,Nov-17,2112,2010,102,4.8
CN1324900000000,13,249,Schley County, GA,Dec-17,2108,1997,111,5.3
CN1324900000000,13,249,Schley County, GA,Jan-18,2129,2016,113,5.3
CN1324900000000,13,249,Schley County, GA,Feb-18,2168,2053,115,5.3
CN1324900000000,13,249,Schley County, GA,Mar-18,2158,2051,107,5.0
CN1324900000000,13,249,Schley County, GA,Apr-18(p),2151,2056,95,4.4
CN3713900000000,37,139,Pasquotank County, NC,Mar-17,17569,16580,989,5.6
CN3713900000000,37,139,Pasquotank County, NC,Apr-17,17618,16736,882,5.0
CN3713900000000,37,139,Pasquotank County, NC,May-17,17616,16706,910,5.2
CN3713900000000,37,139,Pasquotank County, NC,Jun-17,17498,16543,955,5.5
CN3713900000000,37,139,Pasquotank County, NC,Jul-17,17617,16628,989,5.6
CN3713900000000,37,139,Pasquotank County, NC,Aug-17,17328,16347,981,5.7
CN3713900000000,37,139,Pasquotank County, NC,Sep-17,17573,16703,870,5.0
CN3713900000000,37,139,Pasquotank County, NC,Oct-17,17509,16615,894,5.1
CN3713900000000,37,139,Pasquotank County, NC,Nov-17,17466,16484,982,5.6
CN3713900000000,37,139,Pasquotank County, NC,Dec-17,17398,16437,961,5.5
CN3713900000000,37,139,Pasquotank County, NC,Jan-18,17404,16336,1068,6.1
CN3713900000000,37,139,Pasquotank County, NC,Feb-18,17591,16590,1001,5.7
CN3713900000000,37,139,Pasquotank County, NC,Mar-18,17581,16679,902,5.1
CN3713900000000,37,139,Pasquotank County, NC,Apr-18(p),17600,16837,763,4.3
CN4826100000000,48,261,Kenedy County, TX,Mar-17,251,240,11,4.4
CN4826100000000,48,261,Kenedy County, TX,Apr-17,257,247,10,3.9
CN4826100000000,48,261,Kenedy County, TX,May-17,256,249,7,2.7
CN4826100000000,48,261,Kenedy County, TX,Jun-17,249,242,7,2.8
CN4826100000000,48,261,Kenedy County, TX,Jul-17,239,231,8,3.3
CN4826100000000,48,261,Kenedy County, TX,Aug-17,243,236,7,2.9
CN4826100000000,48,261,Kenedy County, TX,Sep-17,238,231,7,2.9
CN4826100000000,48,261,Kenedy County, TX,Oct-17,259,253,6,2.3
CN4826100000000,48,261,Kenedy County, TX,Nov-17,250,244,6,2.4
CN4826100000000,48,261,Kenedy County, TX,Dec-17,250,244,6,2.4
CN4826100000000,48,261,Kenedy County, TX,Jan-18,261,254,7,2.7
CN4826100000000,48,261,Kenedy County, TX,Feb-18,268,259,9,3.4
CN4826100000000,48,261,Kenedy County, TX,Mar-18,283,273,10,3.5
CN4826100000000,48,261,Kenedy County, TX,Apr-18(p),270,264,6,2.2
CN3006500000000,30,065,Musselshell County, MT,Mar-17,2251,2135,116,5.2
CN3006500000000,30,065,Musselshell County, MT,Apr-17,2288,2201,87,3.8
CN3006500000000,30,065,Musselshell County, MT,May-17,2322,2242,80,3.4
CN3006500000000,30,065,Musselshell County, MT,Jun-17,2336,2229,107,4.6
CN3006500000000,30,065,Musselshell County, MT,Jul-17,2337,2248,89,3.8
CN3006500000000,30,065,Musselshell County, MT,Aug-17,2292,2206,86,3.8
CN3006500000000,30,065,Musselshell County, MT,Sep-17,2300,2216,84,3.7
CN3006500000000,30,065,Musselshell County, MT,Oct-17,2304,2207,97,4.2
CN3006500000000,30,065,Musselshell County, MT,Nov-17,2315,2196,119,5.1
CN3006500000000,30,065,Musselshell County, MT,Dec-17,2297,2181,116,5.1
CN3006500000000,30,065,Musselshell County, MT,Jan-18,2312,2170,142,6.1
CN3006500000000,30,065,Musselshell County, MT,Feb-18,2309,2172,137,5.9
CN3006500000000,30,065,Musselshell County, MT,Mar-18,2281,2159,122,5.3
CN3006500000000,30,065,Musselshell County, MT,Apr-18(p),2285,2180,105,4.6
CN1703900000000,17,039,De Witt County, IL,Mar-17,7783,7397,386,5.0
CN1703900000000,17,039,De Witt County, IL,Apr-17,7904,7582,322,4.1
CN1703900000000,17,039,De Witt County, IL,May-17,7776,7471,305,3.9
CN1703900000000,17,039,De Witt County, IL,Jun-17,7675,7352,323,4.2
CN1703900000000,17,039,De Witt County, IL,Jul-17,7724,7387,337,4.4
CN1703900000000,17,039,De Witt County, IL,Aug-17,7685,7333,352,4.6
CN1703900000000,17,039,De Witt County, IL,Sep-17,7750,7445,305,3.9
CN1703900000000,17,039,De Witt County, IL,Oct-17,7761,7467,294,3.8
CN1703900000000,17,039,De Witt County, IL,Nov-17,7748,7428,320,4.1
CN1703900000000,17,039,De Witt County, IL,Dec-17,7626,7283,343,4.5
CN1703900000000,17,039,De Witt County, IL,Jan-18,7557,7173,384,5.1
CN1703900000000,17,039,De Witt County, IL,Feb-18,7728,7392,336,4.3
CN1703900000000,17,039,De Witt County, IL,Mar-18,7858,7496,362,4.6
CN1703900000000,17,039,De Witt County, IL,Apr-18(p),7912,7619,293,3.7
CN3602700000000,36,027,Dutchess County, NY,Mar-17,144027,138010,6017,4.2
CN3602700000000,36,027,Dutchess County, NY,Apr-17,144428,138593,5835,4.0
CN3602700000000,36,027,Dutchess County, NY,May-17,144594,138630,5964,4.1
CN3602700000000,36,027,Dutchess County, NY,Jun-17,146664,140189,6475,4.4
CN3602700000000,36,027,Dutchess County, NY,Jul-17,148064,141513,6551,4.4
CN3602700000000,36,027,Dutchess County, NY,Aug-17,145909,139522,6387,4.4
CN3602700000000,36,027,Dutchess County, NY,Sep-17,144907,138478,6429,4.4
CN3602700000000,36,027,Dutchess County, NY,Oct-17,144862,138779,6083,4.2
CN3602700000000,36,027,Dutchess County, NY,Nov-17,144384,138299,6085,4.2
CN3602700000000,36,027,Dutchess County, NY,Dec-17,143281,137462,5819,4.1
CN3602700000000,36,027,Dutchess County, NY,Jan-18,143534,136716,6818,4.8
CN3602700000000,36,027,Dutchess County, NY,Feb-18,143406,136282,7124,5.0
CN3602700000000,36,027,Dutchess County, NY,Mar-18,142868,136479,6389,4.5
CN3602700000000,36,027,Dutchess County, NY,Apr-18(p),143452,137621,5831,4.1
CN7205700000000,72,057,Guayama Municipio, PR,Mar-17,12021,10174,1847,15.4
CN7205700000000,72,057,Guayama Municipio, PR,Apr-17,11882,10003,1879,15.8
CN7205700000000,72,057,Guayama Municipio, PR,May-17,11692,9957,1735,14.8
CN7205700000000,72,057,Guayama Municipio, PR,Jun-17,11347,9781,1566,13.8
CN7205700000000,72,057,Guayama Municipio, PR,Jul-17,11870,9850,2020,17.0
CN7205700000000,72,057,Guayama Municipio, PR,Aug-17,12050,9721,2329,19.3
CN7205700000000,72,057,Guayama Municipio, PR,Sep-17(y),11738,9819,1919,16.3
CN7205700000000,72,057,Guayama Municipio, PR,Oct-17,11230,9499,1731,15.4
CN7205700000000,72,057,Guayama Municipio, PR,Nov-17,11776,9990,1786,15.2
CN7205700000000,72,057,Guayama Municipio, PR,Dec-17,11840,10094,1746,14.7
CN7205700000000,72,057,Guayama Municipio, PR,Jan-18,11711,9921,1790,15.3
CN7205700000000,72,057,Guayama Municipio, PR,Feb-18,11516,9937,1579,13.7
CN7205700000000,72,057,Guayama Municipio, PR,Mar-18,11516,9976,1540,13.4
CN7205700000000,72,057,Guayama Municipio, PR,Apr-18(p),11502,10063,1439,12.5
CN2211900000000,22,119,Webster Parish, LA,Mar-17,14906,13825,1081,7.3
CN2211900000000,22,119,Webster Parish, LA,Apr-17,14845,13819,1026,6.9
CN2211900000000,22,119,Webster Parish, LA,May-17,14772,13721,1051,7.1
CN2211900000000,22,119,Webster Parish, LA,Jun-17,15072,13883,1189,7.9
CN2211900000000,22,119,Webster Parish, LA,Jul-17,15070,13984,1086,7.2
CN2211900000000,22,119,Webster Parish, LA,Aug-17,14936,13853,1083,7.3
CN2211900000000,22,119,Webster Parish, LA,Sep-17,14899,13946,953,6.4
CN2211900000000,22,119,Webster Parish, LA,Oct-17,14797,13945,852,5.8
CN2211900000000,22,119,Webster Parish, LA,Nov-17,14754,13944,810,5.5
CN2211900000000,22,119,Webster Parish, LA,Dec-17,14680,13917,763,5.2
CN2211900000000,22,119,Webster Parish, LA,Jan-18,14759,13930,829,5.6
CN2211900000000,22,119,Webster Parish, LA,Feb-18,14932,14156,776,5.2
CN2211900000000,22,119,Webster Parish, LA,Mar-18,14944,14087,857,5.7
CN2211900000000,22,119,Webster Parish, LA,Apr-18(p),14890,14062,828,5.6
CN5306900000000,53,069,Wahkiakum County, WA,Mar-17,1317,1204,113,8.6
CN5306900000000,53,069,Wahkiakum County, WA,Apr-17,1277,1188,89,7.0
CN5306900000000,53,069,Wahkiakum County, WA,May-17,1302,1214,88,6.8
CN5306900000000,53,069,Wahkiakum County, WA,Jun-17,1312,1226,86,6.6
CN5306900000000,53,069,Wahkiakum County, WA,Jul-17,1311,1221,90,6.9
CN5306900000000,53,069,Wahkiakum County, WA,Aug-17,1305,1221,84,6.4
CN5306900000000,53,069,Wahkiakum County, WA,Sep-17,1304,1220,84,6.4
CN5306900000000,53,069,Wahkiakum County, WA,Oct-17,1326,1242,84,6.3
CN5306900000000,53,069,Wahkiakum County, WA,Nov-17,1317,1236,81,6.2
CN5306900000000,53,069,Wahkiakum County, WA,Dec-17,1300,1214,86,6.6
CN5306900000000,53,069,Wahkiakum County, WA,Jan-18,1297,1201,96,7.4
CN5306900000000,53,069,Wahkiakum County, WA,Feb-18,1299,1199,100,7.7
CN5306900000000,53,069,Wahkiakum County, WA,Mar-18,1302,1212,90,6.9
CN5306900000000,53,069,Wahkiakum County, WA,Apr-18(p),1299,1207,92,7.1
CN1705100000000,17,051,Fayette County, IL,Mar-17,9549,8975,574,6.0
CN1705100000000,17,051,Fayette County, IL,Apr-17,9700,9231,469,4.8
CN1705100000000,17,051,Fayette County, IL,May-17,9705,9250,455,4.7
CN1705100000000,17,051,Fayette County, IL,Jun-17,9829,9335,494,5.0
CN1705100000000,17,051,Fayette County, IL,Jul-17,9608,9098,510,5.3
CN1705100000000,17,051,Fayette County, IL,Aug-17,9629,9137,492,5.1
CN1705100000000,17,051,Fayette County, IL,Sep-17,9563,9122,441,4.6
CN1705100000000,17,051,Fayette County, IL,Oct-17,9504,9080,424,4.5
CN1705100000000,17,051,Fayette County, IL,Nov-17,9452,9001,451,4.8
CN1705100000000,17,051,Fayette County, IL,Dec-17,9398,8921,477,5.1
CN1705100000000,17,051,Fayette County, IL,Jan-18,9434,8855,579,6.1
CN1705100000000,17,051,Fayette County, IL,Feb-18,9420,8913,507,5.4
CN1705100000000,17,051,Fayette County, IL,Mar-18,9598,9107,491,5.1
CN1705100000000,17,051,Fayette County, IL,Apr-18(p),9768,9368,400,4.1
CN0807500000000,08,075,Logan County, CO,Mar-17,10898,10641,257,2.4
CN0807500000000,08,075,Logan County, CO,Apr-17,11104,10866,238,2.1
CN0807500000000,08,075,Logan County, CO,May-17,11246,11011,235,2.1
CN0807500000000,08,075,Logan County, CO,Jun-17,11223,10922,301,2.7
CN0807500000000,08,075,Logan County, CO,Jul-17,11267,10985,282,2.5
CN0807500000000,08,075,Logan County, CO,Aug-17,11241,10982,259,2.3
CN0807500000000,08,075,Logan County, CO,Sep-17,11255,11021,234,2.1
CN0807500000000,08,075,Logan County, CO,Oct-17,11608,11360,248,2.1
CN0807500000000,08,075,Logan County, CO,Nov-17,11516,11267,249,2.2
CN0807500000000,08,075,Logan County, CO,Dec-17,11328,11069,259,2.3
CN0807500000000,08,075,Logan County, CO,Jan-18,11160,10844,316,2.8
CN0807500000000,08,075,Logan County, CO,Feb-18,11118,10807,311,2.8
CN0807500000000,08,075,Logan County, CO,Mar-18,11143,10854,289,2.6
CN0807500000000,08,075,Logan County, CO,Apr-18(p),11270,11023,247,2.2
CN2706300000000,27,063,Jackson County, MN,Mar-17,5854,5604,250,4.3
CN2706300000000,27,063,Jackson County, MN,Apr-17,5795,5608,187,3.2
CN2706300000000,27,063,Jackson County, MN,May-17,5843,5661,182,3.1
CN2706300000000,27,063,Jackson County, MN,Jun-17,5848,5656,192,3.3
CN2706300000000,27,063,Jackson County, MN,Jul-17,5742,5552,190,3.3
CN2706300000000,27,063,Jackson County, MN,Aug-17,5714,5436,278,4.9
CN2706300000000,27,063,Jackson County, MN,Sep-17,5618,5386,232,4.1
CN2706300000000,27,063,Jackson County, MN,Oct-17,5759,5610,149,2.6
CN2706300000000,27,063,Jackson County, MN,Nov-17,5677,5537,140,2.5
CN2706300000000,27,063,Jackson County, MN,Dec-17,5692,5511,181,3.2
CN2706300000000,27,063,Jackson County, MN,Jan-18,5707,5477,230,4.0
CN2706300000000,27,063,Jackson County, MN,Feb-18,5687,5475,212,3.7
CN2706300000000,27,063,Jackson County, MN,Mar-18,5679,5471,208,3.7
CN2706300000000,27,063,Jackson County, MN,Apr-18(p),5657,5497,160,2.8
CN1701300000000,17,013,Calhoun County, IL,Mar-17,2357,2220,137,5.8
CN1701300000000,17,013,Calhoun County, IL,Apr-17,2371,2253,118,5.0
CN1701300000000,17,013,Calhoun County, IL,May-17,2351,2246,105,4.5
CN1701300000000,17,013,Calhoun County, IL,Jun-17,2376,2268,108,4.5
CN1701300000000,17,013,Calhoun County, IL,Jul-17,2363,2246,117,5.0
CN1701300000000,17,013,Calhoun County, IL,Aug-17,2356,2228,128,5.4
CN1701300000000,17,013,Calhoun County, IL,Sep-17,2336,2228,108,4.6
CN1701300000000,17,013,Calhoun County, IL,Oct-17,2342,2229,113,4.8
CN1701300000000,17,013,Calhoun County, IL,Nov-17,2345,2225,120,5.1
CN1701300000000,17,013,Calhoun County, IL,Dec-17,2322,2196,126,5.4
CN1701300000000,17,013,Calhoun County, IL,Jan-18,2316,2186,130,5.6
CN1701300000000,17,013,Calhoun County, IL,Feb-18,2336,2215,121,5.2
CN1701300000000,17,013,Calhoun County, IL,Mar-18,2382,2261,121,5.1
CN1701300000000,17,013,Calhoun County, IL,Apr-18(p),2388,2289,99,4.1
CN0511500000000,05,115,Pope County, AR,Mar-17,29310,28160,1150,3.9
CN0511500000000,05,115,Pope County, AR,Apr-17,29431,28431,1000,3.4
CN0511500000000,05,115,Pope County, AR,May-17,29607,28455,1152,3.9
CN0511500000000,05,115,Pope County, AR,Jun-17,29860,28456,1404,4.7
CN0511500000000,05,115,Pope County, AR,Jul-17,28991,27353,1638,5.7
CN0511500000000,05,115,Pope County, AR,Aug-17,28839,27362,1477,5.1
CN0511500000000,05,115,Pope County, AR,Sep-17,29291,27998,1293,4.4
CN0511500000000,05,115,Pope County, AR,Oct-17,29850,28748,1102,3.7
CN0511500000000,05,115,Pope County, AR,Nov-17,29710,28559,1151,3.9
CN0511500000000,05,115,Pope County, AR,Dec-17,29453,28180,1273,4.3
CN0511500000000,05,115,Pope County, AR,Jan-18,28926,27378,1548,5.4
CN0511500000000,05,115,Pope County, AR,Feb-18,28806,27362,1444,5.0
CN0511500000000,05,115,Pope County, AR,Mar-18,28930,27705,1225,4.2
CN0511500000000,05,115,Pope County, AR,Apr-18(p),28899,27859,1040,3.6
CN4821900000000,48,219,Hockley County, TX,Mar-17,11323,10874,449,4.0
CN4821900000000,48,219,Hockley County, TX,Apr-17,11375,10986,389,3.4
CN4821900000000,48,219,Hockley County, TX,May-17,11376,10969,407,3.6
CN4821900000000,48,219,Hockley County, TX,Jun-17,11341,10876,465,4.1
CN4821900000000,48,219,Hockley County, TX,Jul-17,11215,10755,460,4.1
CN4821900000000,48,219,Hockley County, TX,Aug-17,11218,10761,457,4.1
CN4821900000000,48,219,Hockley County, TX,Sep-17,11292,10897,395,3.5
CN4821900000000,48,219,Hockley County, TX,Oct-17,11372,11000,372,3.3
CN4821900000000,48,219,Hockley County, TX,Nov-17,11293,10925,368,3.3
CN4821900000000,48,219,Hockley County, TX,Dec-17,11284,10945,339,3.0
CN4821900000000,48,219,Hockley County, TX,Jan-18,11305,10939,366,3.2
CN4821900000000,48,219,Hockley County, TX,Feb-18,11417,11033,384,3.4
CN4821900000000,48,219,Hockley County, TX,Mar-18,11509,11092,417,3.6
CN4821900000000,48,219,Hockley County, TX,Apr-18(p),11692,11340,352,3.0
CN5304300000000,53,043,Lincoln County, WA,Mar-17,4909,4633,276,5.6
CN5304300000000,53,043,Lincoln County, WA,Apr-17,4905,4684,221,4.5
CN5304300000000,53,043,Lincoln County, WA,May-17,4982,4759,223,4.5
CN5304300000000,53,043,Lincoln County, WA,Jun-17,5100,4880,220,4.3
CN5304300000000,53,043,Lincoln County, WA,Jul-17,5127,4905,222,4.3
CN5304300000000,53,043,Lincoln County, WA,Aug-17,5137,4923,214,4.2
CN5304300000000,53,043,Lincoln County, WA,Sep-17,5038,4829,209,4.1
CN5304300000000,53,043,Lincoln County, WA,Oct-17,4957,4746,211,4.3
CN5304300000000,53,043,Lincoln County, WA,Nov-17,4918,4686,232,4.7
CN5304300000000,53,043,Lincoln County, WA,Dec-17,4831,4556,275,5.7
CN5304300000000,53,043,Lincoln County, WA,Jan-18,4769,4475,294,6.2
CN5304300000000,53,043,Lincoln County, WA,Feb-18,4818,4502,316,6.6
CN5304300000000,53,043,Lincoln County, WA,Mar-18,5043,4743,300,5.9
CN5304300000000,53,043,Lincoln County, WA,Apr-18(p),4967,4712,255,5.1
CN1304900000000,13,049,Charlton County, GA,Mar-17,4847,4603,244,5.0
CN1304900000000,13,049,Charlton County, GA,Apr-17,4829,4600,229,4.7
CN1304900000000,13,049,Charlton County, GA,May-17,4835,4611,224,4.6
CN1304900000000,13,049,Charlton County, GA,Jun-17,4836,4580,256,5.3
CN1304900000000,13,049,Charlton County, GA,Jul-17,4834,4574,260,5.4
CN1304900000000,13,049,Charlton County, GA,Aug-17,4820,4549,271,5.6
CN1304900000000,13,049,Charlton County, GA,Sep-17,4836,4601,235,4.9
CN1304900000000,13,049,Charlton County, GA,Oct-17,4837,4609,228,4.7
CN1304900000000,13,049,Charlton County, GA,Nov-17,4850,4627,223,4.6
CN1304900000000,13,049,Charlton County, GA,Dec-17,4885,4647,238,4.9
CN1304900000000,13,049,Charlton County, GA,Jan-18,4922,4667,255,5.2
CN1304900000000,13,049,Charlton County, GA,Feb-18,4890,4652,238,4.9
CN1304900000000,13,049,Charlton County, GA,Mar-18,4897,4673,224,4.6
CN1304900000000,13,049,Charlton County, GA,Apr-18(p),4874,4682,192,3.9
CN1326100000000,13,261,Sumter County, GA,Mar-17,13108,12180,928,7.1
CN1326100000000,13,261,Sumter County, GA,Apr-17,12877,12003,874,6.8
CN1326100000000,13,261,Sumter County, GA,May-17,12897,12026,871,6.8
CN1326100000000,13,261,Sumter County, GA,Jun-17,12953,12030,923,7.1
CN1326100000000,13,261,Sumter County, GA,Jul-17,12859,11894,965,7.5
CN1326100000000,13,261,Sumter County, GA,Aug-17,12765,11856,909,7.1
CN1326100000000,13,261,Sumter County, GA,Sep-17,12864,12023,841,6.5
CN1326100000000,13,261,Sumter County, GA,Oct-17,12899,12070,829,6.4
CN1326100000000,13,261,Sumter County, GA,Nov-17,12830,12048,782,6.1
CN1326100000000,13,261,Sumter County, GA,Dec-17,12787,11981,806,6.3
CN1326100000000,13,261,Sumter County, GA,Jan-18,12984,12091,893,6.9
CN1326100000000,13,261,Sumter County, GA,Feb-18,13113,12274,839,6.4
CN1326100000000,13,261,Sumter County, GA,Mar-18,13058,12266,792,6.1
CN1326100000000,13,261,Sumter County, GA,Apr-18(p),12969,12276,693,5.3
CN2920500000000,29,205,Shelby County, MO,Mar-17,3078,2963,115,3.7
CN2920500000000,29,205,Shelby County, MO,Apr-17,3185,3090,95,3.0
CN2920500000000,29,205,Shelby County, MO,May-17,3119,3024,95,3.0
CN2920500000000,29,205,Shelby County, MO,Jun-17,3113,3004,109,3.5
CN2920500000000,29,205,Shelby County, MO,Jul-17,3020,2898,122,4.0
CN2920500000000,29,205,Shelby County, MO,Aug-17,2985,2860,125,4.2
CN2920500000000,29,205,Shelby County, MO,Sep-17,2949,2858,91,3.1
CN2920500000000,29,205,Shelby County, MO,Oct-17,3026,2967,59,1.9
CN2920500000000,29,205,Shelby County, MO,Nov-17,3015,2939,76,2.5
CN2920500000000,29,205,Shelby County, MO,Dec-17,2974,2874,100,3.4
CN2920500000000,29,205,Shelby County, MO,Jan-18,3010,2877,133,4.4
CN2920500000000,29,205,Shelby County, MO,Feb-18,3051,2906,145,4.8
CN2920500000000,29,205,Shelby County, MO,Mar-18,3030,2908,122,4.0
CN2920500000000,29,205,Shelby County, MO,Apr-18(p),3073,2983,90,2.9
CN5408700000000,54,087,Roane County, WV,Mar-17,5205,4661,544,10.5
CN5408700000000,54,087,Roane County, WV,Apr-17,5146,4694,452,8.8
CN5408700000000,54,087,Roane County, WV,May-17,5060,4701,359,7.1
CN5408700000000,54,087,Roane County, WV,Jun-17,5183,4787,396,7.6
CN5408700000000,54,087,Roane County, WV,Jul-17,5103,4713,390,7.6
CN5408700000000,54,087,Roane County, WV,Aug-17,5084,4689,395,7.8
CN5408700000000,54,087,Roane County, WV,Sep-17,5043,4721,322,6.4
CN5408700000000,54,087,Roane County, WV,Oct-17,5051,4701,350,6.9
CN5408700000000,54,087,Roane County, WV,Nov-17,5040,4636,404,8.0
CN5408700000000,54,087,Roane County, WV,Dec-17,5073,4610,463,9.1
CN5408700000000,54,087,Roane County, WV,Jan-18,5130,4591,539,10.5
CN5408700000000,54,087,Roane County, WV,Feb-18,5197,4627,570,11.0
CN5408700000000,54,087,Roane County, WV,Mar-18,5084,4610,474,9.3
CN5408700000000,54,087,Roane County, WV,Apr-18(p),5077,4671,406,8.0
CN3001300000000,30,013,Cascade County, MT,Mar-17,37958,36421,1537,4.0
CN3001300000000,30,013,Cascade County, MT,Apr-17,37919,36640,1279,3.4
CN3001300000000,30,013,Cascade County, MT,May-17,37844,36655,1189,3.1
CN3001300000000,30,013,Cascade County, MT,Jun-17,38286,36804,1482,3.9
CN3001300000000,30,013,Cascade County, MT,Jul-17,37406,36049,1357,3.6
CN3001300000000,30,013,Cascade County, MT,Aug-17,37523,36183,1340,3.6
CN3001300000000,30,013,Cascade County, MT,Sep-17,37944,36623,1321,3.5
CN3001300000000,30,013,Cascade County, MT,Oct-17,37958,36622,1336,3.5
CN3001300000000,30,013,Cascade County, MT,Nov-17,38249,36767,1482,3.9
CN3001300000000,30,013,Cascade County, MT,Dec-17,38075,36584,1491,3.9
CN3001300000000,30,013,Cascade County, MT,Jan-18,37809,35991,1818,4.8
CN3001300000000,30,013,Cascade County, MT,Feb-18,37797,35975,1822,4.8
CN3001300000000,30,013,Cascade County, MT,Mar-18,37795,36098,1697,4.5
CN3001300000000,30,013,Cascade County, MT,Apr-18(p),37624,36387,1237,3.3
CN4902300000000,49,023,Juab County, UT,Mar-17,5432,5224,208,3.8
CN4902300000000,49,023,Juab County, UT,Apr-17,5429,5245,184,3.4
CN4902300000000,49,023,Juab County, UT,May-17,5366,5209,157,2.9
CN4902300000000,49,023,Juab County, UT,Jun-17,5436,5251,185,3.4
CN4902300000000,49,023,Juab County, UT,Jul-17,5413,5231,182,3.4
CN4902300000000,49,023,Juab County, UT,Aug-17,5455,5271,184,3.4
CN4902300000000,49,023,Juab County, UT,Sep-17,5516,5355,161,2.9
CN4902300000000,49,023,Juab County, UT,Oct-17,5539,5389,150,2.7
CN4902300000000,49,023,Juab County, UT,Nov-17,5582,5423,159,2.8
CN4902300000000,49,023,Juab County, UT,Dec-17,5589,5417,172,3.1
CN4902300000000,49,023,Juab County, UT,Jan-18,5580,5376,204,3.7
CN4902300000000,49,023,Juab County, UT,Feb-18,5621,5411,210,3.7
CN4902300000000,49,023,Juab County, UT,Mar-18,5629,5437,192,3.4
CN4902300000000,49,023,Juab County, UT,Apr-18(p),5590,5439,151,2.7
CN3810500000000,38,105,Williams County, ND,Mar-17,21811,21070,741,3.4
CN3810500000000,38,105,Williams County, ND,Apr-17,22245,21608,637,2.9
CN3810500000000,38,105,Williams County, ND,May-17,22709,22190,519,2.3
CN3810500000000,38,105,Williams County, ND,Jun-17,23561,22961,600,2.5
CN3810500000000,38,105,Williams County, ND,Jul-17,24332,23857,475,2.0
CN3810500000000,38,105,Williams County, ND,Aug-17,24293,23783,510,2.1
CN3810500000000,38,105,Williams County, ND,Sep-17,23815,23384,431,1.8
CN3810500000000,38,105,Williams County, ND,Oct-17,23474,23040,434,1.8
CN3810500000000,38,105,Williams County, ND,Nov-17,23354,22875,479,2.1
CN3810500000000,38,105,Williams County, ND,Dec-17,23178,22694,484,2.1
CN3810500000000,38,105,Williams County, ND,Jan-18,23102,22517,585,2.5
CN3810500000000,38,105,Williams County, ND,Feb-18,23001,22413,588,2.6
CN3810500000000,38,105,Williams County, ND,Mar-18,22583,22014,569,2.5
CN3810500000000,38,105,Williams County, ND,Apr-18(p),22297,21790,507,2.3
CN1911700000000,19,117,Lucas County, IA,Mar-17,4345,4216,129,3.0
CN1911700000000,19,117,Lucas County, IA,Apr-17,4363,4240,123,2.8
CN1911700000000,19,117,Lucas County, IA,May-17,4366,4241,125,2.9
CN1911700000000,19,117,Lucas County, IA,Jun-17,4449,4307,142,3.2
CN1911700000000,19,117,Lucas County, IA,Jul-17,4451,4325,126,2.8
CN1911700000000,19,117,Lucas County, IA,Aug-17,4375,4249,126,2.9
CN1911700000000,19,117,Lucas County, IA,Sep-17,4325,4211,114,2.6
CN1911700000000,19,117,Lucas County, IA,Oct-17,4319,4222,97,2.2
CN1911700000000,19,117,Lucas County, IA,Nov-17,4306,4219,87,2.0
CN1911700000000,19,117,Lucas County, IA,Dec-17,4301,4194,107,2.5
CN1911700000000,19,117,Lucas County, IA,Jan-18,4330,4196,134,3.1
CN1911700000000,19,117,Lucas County, IA,Feb-18,4353,4227,126,2.9
CN1911700000000,19,117,Lucas County, IA,Mar-18,4266,4156,110,2.6
CN1911700000000,19,117,Lucas County, IA,Apr-18(p),4247,4153,94,2.2
CN5105900000000,51,059,Fairfax County, VA,Mar-17,628518,608854,19664,3.1
CN5105900000000,51,059,Fairfax County, VA,Apr-17,627758,610064,17694,2.8
CN5105900000000,51,059,Fairfax County, VA,May-17,631641,612448,19193,3.0
CN5105900000000,51,059,Fairfax County, VA,Jun-17,635549,615375,20174,3.2
CN5105900000000,51,059,Fairfax County, VA,Jul-17,638979,618720,20259,3.2
CN5105900000000,51,059,Fairfax County, VA,Aug-17,629882,609581,20301,3.2
CN5105900000000,51,059,Fairfax County, VA,Sep-17,630556,611695,18861,3.0
CN5105900000000,51,059,Fairfax County, VA,Oct-17,629373,611611,17762,2.8
CN5105900000000,51,059,Fairfax County, VA,Nov-17,630189,612496,17693,2.8
CN5105900000000,51,059,Fairfax County, VA,Dec-17,627927,611294,16633,2.6
CN5105900000000,51,059,Fairfax County, VA,Jan-18,632827,614530,18297,2.9
CN5105900000000,51,059,Fairfax County, VA,Feb-18,637974,621536,16438,2.6
CN5105900000000,51,059,Fairfax County, VA,Mar-18,640739,623692,17047,2.7
CN5105900000000,51,059,Fairfax County, VA,Apr-18(p),638964,624441,14523,2.3
CN3914900000000,39,149,Shelby County, OH,Mar-17,24051,23036,1015,4.2
CN3914900000000,39,149,Shelby County, OH,Apr-17,24012,23113,899,3.7
CN3914900000000,39,149,Shelby County, OH,May-17,24086,23179,907,3.8
CN3914900000000,39,149,Shelby County, OH,Jun-17,24484,23450,1034,4.2
CN3914900000000,39,149,Shelby County, OH,Jul-17,24598,23421,1177,4.8
CN3914900000000,39,149,Shelby County, OH,Aug-17,24576,23546,1030,4.2
CN3914900000000,39,149,Shelby County, OH,Sep-17,24213,23296,917,3.8
CN3914900000000,39,149,Shelby County, OH,Oct-17,24225,23335,890,3.7
CN3914900000000,39,149,Shelby County, OH,Nov-17,24165,23265,900,3.7
CN3914900000000,39,149,Shelby County, OH,Dec-17,23987,23075,912,3.8
CN3914900000000,39,149,Shelby County, OH,Jan-18,23590,22641,949,4.0
CN3914900000000,39,149,Shelby County, OH,Feb-18,23816,22893,923,3.9
CN3914900000000,39,149,Shelby County, OH,Mar-18,24102,23255,847,3.5
CN3914900000000,39,149,Shelby County, OH,Apr-18(p),23994,23203,791,3.3
CN2105900000000,21,059,Daviess County, KY,Mar-17,47538,45247,2291,4.8
CN2105900000000,21,059,Daviess County, KY,Apr-17,47455,45403,2052,4.3
CN2105900000000,21,059,Daviess County, KY,May-17,47581,45458,2123,4.5
CN2105900000000,21,059,Daviess County, KY,Jun-17,48007,45608,2399,5.0
CN2105900000000,21,059,Daviess County, KY,Jul-17,48039,45776,2263,4.7
CN2105900000000,21,059,Daviess County, KY,Aug-17,47376,45344,2032,4.3
CN2105900000000,21,059,Daviess County, KY,Sep-17,47403,45599,1804,3.8
CN2105900000000,21,059,Daviess County, KY,Oct-17,46839,45091,1748,3.7
CN2105900000000,21,059,Daviess County, KY,Nov-17,47083,45352,1731,3.7
CN2105900000000,21,059,Daviess County, KY,Dec-17,47064,45342,1722,3.7
CN2105900000000,21,059,Daviess County, KY,Jan-18,47361,45433,1928,4.1
CN2105900000000,21,059,Daviess County, KY,Feb-18,47798,45657,2141,4.5
CN2105900000000,21,059,Daviess County, KY,Mar-18,47973,45992,1981,4.1
CN2105900000000,21,059,Daviess County, KY,Apr-18(p),47865,46102,1763,3.7
CN3103100000000,31,031,Cherry County, NE,Mar-17,3300,3227,73,2.2
CN3103100000000,31,031,Cherry County, NE,Apr-17,3391,3319,72,2.1
CN3103100000000,31,031,Cherry County, NE,May-17,3498,3427,71,2.0
CN3103100000000,31,031,Cherry County, NE,Jun-17,3730,3646,84,2.3
CN3103100000000,31,031,Cherry County, NE,Jul-17,3612,3521,91,2.5
CN3103100000000,31,031,Cherry County, NE,Aug-17,3489,3405,84,2.4
CN3103100000000,31,031,Cherry County, NE,Sep-17,3300,3222,78,2.4
CN3103100000000,31,031,Cherry County, NE,Oct-17,3282,3205,77,2.3
CN3103100000000,31,031,Cherry County, NE,Nov-17,3285,3215,70,2.1
CN3103100000000,31,031,Cherry County, NE,Dec-17,3291,3213,78,2.4
CN3103100000000,31,031,Cherry County, NE,Jan-18,3354,3278,76,2.3
CN3103100000000,31,031,Cherry County, NE,Feb-18,3256,3179,77,2.4
CN3103100000000,31,031,Cherry County, NE,Mar-18,3363,3283,80,2.4
CN3103100000000,31,031,Cherry County, NE,Apr-18(p),3375,3297,78,2.3
CN2013900000000,20,139,Osage County, KS,Mar-17,7965,7629,336,4.2
CN2013900000000,20,139,Osage County, KS,Apr-17,7850,7558,292,3.7
CN2013900000000,20,139,Osage County, KS,May-17,7860,7566,294,3.7
CN2013900000000,20,139,Osage County, KS,Jun-17,8022,7694,328,4.1
CN2013900000000,20,139,Osage County, KS,Jul-17,8175,7829,346,4.2
CN2013900000000,20,139,Osage County, KS,Aug-17,8039,7705,334,4.2
CN2013900000000,20,139,Osage County, KS,Sep-17,7921,7653,268,3.4
CN2013900000000,20,139,Osage County, KS,Oct-17,7892,7644,248,3.1
CN2013900000000,20,139,Osage County, KS,Nov-17,7914,7655,259,3.3
CN2013900000000,20,139,Osage County, KS,Dec-17,7868,7602,266,3.4
CN2013900000000,20,139,Osage County, KS,Jan-18,7925,7576,349,4.4
CN2013900000000,20,139,Osage County, KS,Feb-18,7935,7587,348,4.4
CN2013900000000,20,139,Osage County, KS,Mar-18,7906,7607,299,3.8
CN2013900000000,20,139,Osage County, KS,Apr-18(p),7826,7544,282,3.6
CN3708300000000,37,083,Halifax County, NC,Mar-17,20875,19395,1480,7.1
CN3708300000000,37,083,Halifax County, NC,Apr-17,20852,19395,1457,7.0
CN3708300000000,37,083,Halifax County, NC,May-17,20732,19268,1464,7.1
CN3708300000000,37,083,Halifax County, NC,Jun-17,20668,19145,1523,7.4
CN3708300000000,37,083,Halifax County, NC,Jul-17,20693,19106,1587,7.7
CN3708300000000,37,083,Halifax County, NC,Aug-17,20287,18713,1574,7.8
CN3708300000000,37,083,Halifax County, NC,Sep-17,20669,19232,1437,7.0
CN3708300000000,37,083,Halifax County, NC,Oct-17,20653,19219,1434,6.9
CN3708300000000,37,083,Halifax County, NC,Nov-17,20555,19079,1476,7.2
CN3708300000000,37,083,Halifax County, NC,Dec-17,20458,19041,1417,6.9
CN3708300000000,37,083,Halifax County, NC,Jan-18,20495,18947,1548,7.6
CN3708300000000,37,083,Halifax County, NC,Feb-18,20551,19072,1479,7.2
CN3708300000000,37,083,Halifax County, NC,Mar-18,20565,19195,1370,6.7
CN3708300000000,37,083,Halifax County, NC,Apr-18(p),20547,19312,1235,6.0
CN1204300000000,12,043,Glades County, FL,Mar-17,5201,4946,255,4.9
CN1204300000000,12,043,Glades County, FL,Apr-17,5289,5049,240,4.5
CN1204300000000,12,043,Glades County, FL,May-17,5262,5023,239,4.5
CN1204300000000,12,043,Glades County, FL,Jun-17,5102,4825,277,5.4
CN1204300000000,12,043,Glades County, FL,Jul-17,4997,4708,289,5.8
CN1204300000000,12,043,Glades County, FL,Aug-17,5007,4714,293,5.9
CN1204300000000,12,043,Glades County, FL,Sep-17,4824,4560,264,5.5
CN1204300000000,12,043,Glades County, FL,Oct-17,4800,4568,232,4.8
CN1204300000000,12,043,Glades County, FL,Nov-17,4791,4557,234,4.9
CN1204300000000,12,043,Glades County, FL,Dec-17,4897,4677,220,4.5
CN1204300000000,12,043,Glades County, FL,Jan-18,5079,4846,233,4.6
CN1204300000000,12,043,Glades County, FL,Feb-18,5088,4867,221,4.3
CN1204300000000,12,043,Glades County, FL,Mar-18,5063,4852,211,4.2
CN1204300000000,12,043,Glades County, FL,Apr-18(p),5101,4910,191,3.7
CN1809500000000,18,095,Madison County, IN,Mar-17,58629,56091,2538,4.3
CN1809500000000,18,095,Madison County, IN,Apr-17,58781,56774,2007,3.4
CN1809500000000,18,095,Madison County, IN,May-17,59114,57032,2082,3.5
CN1809500000000,18,095,Madison County, IN,Jun-17,59794,57535,2259,3.8
CN1809500000000,18,095,Madison County, IN,Jul-17,59809,57488,2321,3.9
CN1809500000000,18,095,Madison County, IN,Aug-17,59296,56827,2469,4.2
CN1809500000000,18,095,Madison County, IN,Sep-17,58892,56758,2134,3.6
CN1809500000000,18,095,Madison County, IN,Oct-17,58531,56514,2017,3.4
CN1809500000000,18,095,Madison County, IN,Nov-17,58645,56629,2016,3.4
CN1809500000000,18,095,Madison County, IN,Dec-17,58165,56189,1976,3.4
CN1809500000000,18,095,Madison County, IN,Jan-18,58384,55961,2423,4.2
CN1809500000000,18,095,Madison County, IN,Feb-18,59225,56658,2567,4.3
CN1809500000000,18,095,Madison County, IN,Mar-18,59746,57454,2292,3.8
CN1809500000000,18,095,Madison County, IN,Apr-18(p),59814,57770,2044,3.4
CN4801900000000,48,019,Bandera County, TX,Mar-17,9635,9282,353,3.7
CN4801900000000,48,019,Bandera County, TX,Apr-17,9614,9306,308,3.2
CN4801900000000,48,019,Bandera County, TX,May-17,9614,9289,325,3.4
CN4801900000000,48,019,Bandera County, TX,Jun-17,9666,9307,359,3.7
CN4801900000000,48,019,Bandera County, TX,Jul-17,9661,9292,369,3.8
CN4801900000000,48,019,Bandera County, TX,Aug-17,9642,9275,367,3.8
CN4801900000000,48,019,Bandera County, TX,Sep-17,9708,9366,342,3.5
CN4801900000000,48,019,Bandera County, TX,Oct-17,9660,9348,312,3.2
CN4801900000000,48,019,Bandera County, TX,Nov-17,9661,9338,323,3.3
CN4801900000000,48,019,Bandera County, TX,Dec-17,9692,9393,299,3.1
CN4801900000000,48,019,Bandera County, TX,Jan-18,9682,9340,342,3.5
CN4801900000000,48,019,Bandera County, TX,Feb-18,9839,9479,360,3.7
CN4801900000000,48,019,Bandera County, TX,Mar-18,9900,9535,365,3.7
CN4801900000000,48,019,Bandera County, TX,Apr-18(p),9855,9538,317,3.2
CN2017700000000,20,177,Shawnee County, KS,Mar-17,90809,87458,3351,3.7
CN2017700000000,20,177,Shawnee County, KS,Apr-17,90260,87095,3165,3.5
CN2017700000000,20,177,Shawnee County, KS,May-17,90568,87308,3260,3.6
CN2017700000000,20,177,Shawnee County, KS,Jun-17,92000,88409,3591,3.9
CN2017700000000,20,177,Shawnee County, KS,Jul-17,93431,89573,3858,4.1
CN2017700000000,20,177,Shawnee County, KS,Aug-17,91434,87771,3663,4.0
CN2017700000000,20,177,Shawnee County, KS,Sep-17,89973,86976,2997,3.3
CN2017700000000,20,177,Shawnee County, KS,Oct-17,89556,86808,2748,3.1
CN2017700000000,20,177,Shawnee County, KS,Nov-17,90360,87490,2870,3.2
CN2017700000000,20,177,Shawnee County, KS,Dec-17,89597,86827,2770,3.1
CN2017700000000,20,177,Shawnee County, KS,Jan-18,90055,86834,3221,3.6
CN2017700000000,20,177,Shawnee County, KS,Feb-18,90313,86919,3394,3.8
CN2017700000000,20,177,Shawnee County, KS,Mar-18,90107,86973,3134,3.5
CN2017700000000,20,177,Shawnee County, KS,Apr-18(p),90221,87261,2960,3.3
CN1308700000000,13,087,Decatur County, GA,Mar-17,11607,10957,650,5.6
CN1308700000000,13,087,Decatur County, GA,Apr-17,11494,10878,616,5.4
CN1308700000000,13,087,Decatur County, GA,May-17,11658,11038,620,5.3
CN1308700000000,13,087,Decatur County, GA,Jun-17,11781,11090,691,5.9
CN1308700000000,13,087,Decatur County, GA,Jul-17,11687,10971,716,6.1
CN1308700000000,13,087,Decatur County, GA,Aug-17,11583,10895,688,5.9
CN1308700000000,13,087,Decatur County, GA,Sep-17,11615,10992,623,5.4
CN1308700000000,13,087,Decatur County, GA,Oct-17,11653,11066,587,5.0
CN1308700000000,13,087,Decatur County, GA,Nov-17,11700,11124,576,4.9
CN1308700000000,13,087,Decatur County, GA,Dec-17,11829,11201,628,5.3
CN1308700000000,13,087,Decatur County, GA,Jan-18,11927,11258,669,5.6
CN1308700000000,13,087,Decatur County, GA,Feb-18,11733,11090,643,5.5
CN1308700000000,13,087,Decatur County, GA,Mar-18,11706,11116,590,5.0
CN1308700000000,13,087,Decatur County, GA,Apr-18(p),11625,11103,522,4.5
CN4823100000000,48,231,Hunt County, TX,Mar-17,41272,39489,1783,4.3
CN4823100000000,48,231,Hunt County, TX,Apr-17,41245,39724,1521,3.7
CN4823100000000,48,231,Hunt County, TX,May-17,41186,39640,1546,3.8
CN4823100000000,48,231,Hunt County, TX,Jun-17,41462,39718,1744,4.2
CN4823100000000,48,231,Hunt County, TX,Jul-17,41662,39919,1743,4.2
CN4823100000000,48,231,Hunt County, TX,Aug-17,41542,39851,1691,4.1
CN4823100000000,48,231,Hunt County, TX,Sep-17,41826,40299,1527,3.7
CN4823100000000,48,231,Hunt County, TX,Oct-17,41680,40246,1434,3.4
CN4823100000000,48,231,Hunt County, TX,Nov-17,41987,40526,1461,3.5
CN4823100000000,48,231,Hunt County, TX,Dec-17,41826,40411,1415,3.4
CN4823100000000,48,231,Hunt County, TX,Jan-18,41864,40263,1601,3.8
CN4823100000000,48,231,Hunt County, TX,Feb-18,42459,40828,1631,3.8
CN4823100000000,48,231,Hunt County, TX,Mar-18,42639,40955,1684,3.9
CN4823100000000,48,231,Hunt County, TX,Apr-18(p),42706,41179,1527,3.6
CN0811300000000,08,113,San Miguel County, CO,Mar-17,5808,5703,105,1.8
CN0811300000000,08,113,San Miguel County, CO,Apr-17,5105,4873,232,4.5
CN0811300000000,08,113,San Miguel County, CO,May-17,4421,4163,258,5.8
CN0811300000000,08,113,San Miguel County, CO,Jun-17,5405,5283,122,2.3
CN0811300000000,08,113,San Miguel County, CO,Jul-17,5578,5478,100,1.8
CN0811300000000,08,113,San Miguel County, CO,Aug-17,5560,5461,99,1.8
CN0811300000000,08,113,San Miguel County, CO,Sep-17,5469,5370,99,1.8
CN0811300000000,08,113,San Miguel County, CO,Oct-17,5123,4991,132,2.6
CN0811300000000,08,113,San Miguel County, CO,Nov-17,4774,4486,288,6.0
CN0811300000000,08,113,San Miguel County, CO,Dec-17,5942,5770,172,2.9
CN0811300000000,08,113,San Miguel County, CO,Jan-18,5965,5847,118,2.0
CN0811300000000,08,113,San Miguel County, CO,Feb-18,6068,5939,129,2.1
CN0811300000000,08,113,San Miguel County, CO,Mar-18,6039,5929,110,1.8
CN0811300000000,08,113,San Miguel County, CO,Apr-18(p),5224,5081,143,2.7
CN2604500000000,26,045,Eaton County, MI,Mar-17,57755,55462,2293,4.0
CN2604500000000,26,045,Eaton County, MI,Apr-17,57789,55902,1887,3.3
CN2604500000000,26,045,Eaton County, MI,May-17,58104,55987,2117,3.6
CN2604500000000,26,045,Eaton County, MI,Jun-17,57090,54349,2741,4.8
CN2604500000000,26,045,Eaton County, MI,Jul-17,56628,53520,3108,5.5
CN2604500000000,26,045,Eaton County, MI,Aug-17,56321,53578,2743,4.9
CN2604500000000,26,045,Eaton County, MI,Sep-17,57477,55169,2308,4.0
CN2604500000000,26,045,Eaton County, MI,Oct-17,57603,55510,2093,3.6
CN2604500000000,26,045,Eaton County, MI,Nov-17,58183,56081,2102,3.6
CN2604500000000,26,045,Eaton County, MI,Dec-17,57509,55305,2204,3.8
CN2604500000000,26,045,Eaton County, MI,Jan-18,57793,54753,3040,5.3
CN2604500000000,26,045,Eaton County, MI,Feb-18,58410,55858,2552,4.4
CN2604500000000,26,045,Eaton County, MI,Mar-18,58238,56022,2216,3.8
CN2604500000000,26,045,Eaton County, MI,Apr-18(p),58529,56500,2029,3.5
CN4507100000000,45,071,Newberry County, SC,Mar-17,18297,17627,670,3.7
CN4507100000000,45,071,Newberry County, SC,Apr-17,18307,17705,602,3.3
CN4507100000000,45,071,Newberry County, SC,May-17,18367,17721,646,3.5
CN4507100000000,45,071,Newberry County, SC,Jun-17,18649,17878,771,4.1
CN4507100000000,45,071,Newberry County, SC,Jul-17,18750,17936,814,4.3
CN4507100000000,45,071,Newberry County, SC,Aug-17,18633,17657,976,5.2
CN4507100000000,45,071,Newberry County, SC,Sep-17,18496,17645,851,4.6
CN4507100000000,45,071,Newberry County, SC,Oct-17,18486,17652,834,4.5
CN4507100000000,45,071,Newberry County, SC,Nov-17,18434,17679,755,4.1
CN4507100000000,45,071,Newberry County, SC,Dec-17,18668,17906,762,4.1
CN4507100000000,45,071,Newberry County, SC,Jan-18,18707,17815,892,4.8
CN4507100000000,45,071,Newberry County, SC,Feb-18,18740,17933,807,4.3
CN4507100000000,45,071,Newberry County, SC,Mar-18,18424,17733,691,3.8
CN4507100000000,45,071,Newberry County, SC,Apr-18(p),18257,17795,462,2.5
CN4503300000000,45,033,Dillon County, SC,Mar-17,12326,11677,649,5.3
CN4503300000000,45,033,Dillon County, SC,Apr-17,12361,11734,627,5.1
CN4503300000000,45,033,Dillon County, SC,May-17,12347,11711,636,5.2
CN4503300000000,45,033,Dillon County, SC,Jun-17,12775,12015,760,5.9
CN4503300000000,45,033,Dillon County, SC,Jul-17,12761,12034,727,5.7
CN4503300000000,45,033,Dillon County, SC,Aug-17,12684,11896,788,6.2
CN4503300000000,45,033,Dillon County, SC,Sep-17,12596,11902,694,5.5
CN4503300000000,45,033,Dillon County, SC,Oct-17,12605,11902,703,5.6
CN4503300000000,45,033,Dillon County, SC,Nov-17,12665,11940,725,5.7
CN4503300000000,45,033,Dillon County, SC,Dec-17,12814,12101,713,5.6
CN4503300000000,45,033,Dillon County, SC,Jan-18,12881,12041,840,6.5
CN4503300000000,45,033,Dillon County, SC,Feb-18,12917,12120,797,6.2
CN4503300000000,45,033,Dillon County, SC,Mar-18,12670,11984,686,5.4
CN4503300000000,45,033,Dillon County, SC,Apr-18(p),12514,12015,499,4.0
CN1200500000000,12,005,Bay County, FL,Mar-17,88268,84556,3712,4.2
CN1200500000000,12,005,Bay County, FL,Apr-17,88078,84625,3453,3.9
CN1200500000000,12,005,Bay County, FL,May-17,89129,85584,3545,4.0
CN1200500000000,12,005,Bay County, FL,Jun-17,91421,87694,3727,4.1
CN1200500000000,12,005,Bay County, FL,Jul-17,91264,87554,3710,4.1
CN1200500000000,12,005,Bay County, FL,Aug-17,90828,87175,3653,4.0
CN1200500000000,12,005,Bay County, FL,Sep-17,91224,87919,3305,3.6
CN1200500000000,12,005,Bay County, FL,Oct-17,89840,86680,3160,3.5
CN1200500000000,12,005,Bay County, FL,Nov-17,88113,84805,3308,3.8
CN1200500000000,12,005,Bay County, FL,Dec-17,87007,83684,3323,3.8
CN1200500000000,12,005,Bay County, FL,Jan-18,87508,83593,3915,4.5
CN1200500000000,12,005,Bay County, FL,Feb-18,88227,84711,3516,4.0
CN1200500000000,12,005,Bay County, FL,Mar-18,89843,86537,3306,3.7
CN1200500000000,12,005,Bay County, FL,Apr-18(p),90277,87337,2940,3.3
CN5510900000000,55,109,St. Croix County, WI,Mar-17,50229,48383,1846,3.7
CN5510900000000,55,109,St. Croix County, WI,Apr-17,50154,48708,1446,2.9
CN5510900000000,55,109,St. Croix County, WI,May-17,50358,48972,1386,2.8
CN5510900000000,55,109,St. Croix County, WI,Jun-17,51104,49458,1646,3.2
CN5510900000000,55,109,St. Croix County, WI,Jul-17,51310,49828,1482,2.9
CN5510900000000,55,109,St. Croix County, WI,Aug-17,50971,49503,1468,2.9
CN5510900000000,55,109,St. Croix County, WI,Sep-17,50985,49649,1336,2.6
CN5510900000000,55,109,St. Croix County, WI,Oct-17,50881,49618,1263,2.5
CN5510900000000,55,109,St. Croix County, WI,Nov-17,50723,49366,1357,2.7
CN5510900000000,55,109,St. Croix County, WI,Dec-17,50483,49081,1402,2.8
CN5510900000000,55,109,St. Croix County, WI,Jan-18,50664,49016,1648,3.3
CN5510900000000,55,109,St. Croix County, WI,Feb-18,51167,49294,1873,3.7
CN5510900000000,55,109,St. Croix County, WI,Mar-18,51084,49390,1694,3.3
CN5510900000000,55,109,St. Croix County, WI,Apr-18(p),50885,49473,1412,2.8
CN3502100000000,35,021,Harding County, NM,Mar-17,276,261,15,5.4
CN3502100000000,35,021,Harding County, NM,Apr-17,266,251,15,5.6
CN3502100000000,35,021,Harding County, NM,May-17,265,249,16,6.0
CN3502100000000,35,021,Harding County, NM,Jun-17,271,253,18,6.6
CN3502100000000,35,021,Harding County, NM,Jul-17,270,250,20,7.4
CN3502100000000,35,021,Harding County, NM,Aug-17,280,261,19,6.8
CN3502100000000,35,021,Harding County, NM,Sep-17,277,258,19,6.9
CN3502100000000,35,021,Harding County, NM,Oct-17,288,267,21,7.3
CN3502100000000,35,021,Harding County, NM,Nov-17,283,264,19,6.7
CN3502100000000,35,021,Harding County, NM,Dec-17,281,264,17,6.0
CN3502100000000,35,021,Harding County, NM,Jan-18,277,261,16,5.8
CN3502100000000,35,021,Harding County, NM,Feb-18,270,256,14,5.2
CN3502100000000,35,021,Harding County, NM,Mar-18,273,259,14,5.1
CN3502100000000,35,021,Harding County, NM,Apr-18(p),268,254,14,5.2
CN3800700000000,38,007,Billings County, ND,Mar-17,369,348,21,5.7
CN3800700000000,38,007,Billings County, ND,Apr-17,380,366,14,3.7
CN3800700000000,38,007,Billings County, ND,May-17,416,405,11,2.6
CN3800700000000,38,007,Billings County, ND,Jun-17,557,544,13,2.3
CN3800700000000,38,007,Billings County, ND,Jul-17,577,567,10,1.7
CN3800700000000,38,007,Billings County, ND,Aug-17,577,565,12,2.1
CN3800700000000,38,007,Billings County, ND,Sep-17,520,510,10,1.9
CN3800700000000,38,007,Billings County, ND,Oct-17,414,406,8,1.9
CN3800700000000,38,007,Billings County, ND,Nov-17,372,364,8,2.2
CN3800700000000,38,007,Billings County, ND,Dec-17,360,350,10,2.8
CN3800700000000,38,007,Billings County, ND,Jan-18,348,334,14,4.0
CN3800700000000,38,007,Billings County, ND,Feb-18,343,326,17,5.0
CN3800700000000,38,007,Billings County, ND,Mar-18,347,332,15,4.3
CN3800700000000,38,007,Billings County, ND,Apr-18(p),358,345,13,3.6
CN0609500000000,06,095,Solano County, CA,Mar-17,208984,198054,10930,5.2
CN0609500000000,06,095,Solano County, CA,Apr-17,208523,198626,9897,4.7
CN0609500000000,06,095,Solano County, CA,May-17,208029,198894,9135,4.4
CN0609500000000,06,095,Solano County, CA,Jun-17,209683,199666,10017,4.8
CN0609500000000,06,095,Solano County, CA,Jul-17,210052,199426,10626,5.1
CN0609500000000,06,095,Solano County, CA,Aug-17,210090,199830,10260,4.9
CN0609500000000,06,095,Solano County, CA,Sep-17,210823,201965,8858,4.2
CN0609500000000,06,095,Solano County, CA,Oct-17,209692,200949,8743,4.2
CN0609500000000,06,095,Solano County, CA,Nov-17,210175,201474,8701,4.1
CN0609500000000,06,095,Solano County, CA,Dec-17,208826,200238,8588,4.1
CN0609500000000,06,095,Solano County, CA,Jan-18,208373,198987,9386,4.5
CN0609500000000,06,095,Solano County, CA,Feb-18,209239,200118,9121,4.4
CN0609500000000,06,095,Solano County, CA,Mar-18,208161,199743,8418,4.0
CN0609500000000,06,095,Solano County, CA,Apr-18(p),207114,199607,7507,3.6
CN1713700000000,17,137,Morgan County, IL,Mar-17,16693,15959,734,4.4
CN1713700000000,17,137,Morgan County, IL,Apr-17,16628,16028,600,3.6
CN1713700000000,17,137,Morgan County, IL,May-17,16506,15904,602,3.6
CN1713700000000,17,137,Morgan County, IL,Jun-17,16419,15733,686,4.2
CN1713700000000,17,137,Morgan County, IL,Jul-17,16298,15569,729,4.5
CN1713700000000,17,137,Morgan County, IL,Aug-17,16213,15494,719,4.4
CN1713700000000,17,137,Morgan County, IL,Sep-17,16340,15696,644,3.9
CN1713700000000,17,137,Morgan County, IL,Oct-17,16314,15688,626,3.8
CN1713700000000,17,137,Morgan County, IL,Nov-17,16377,15732,645,3.9
CN1713700000000,17,137,Morgan County, IL,Dec-17,16211,15570,641,4.0
CN1713700000000,17,137,Morgan County, IL,Jan-18,16032,15299,733,4.6
CN1713700000000,17,137,Morgan County, IL,Feb-18,16052,15406,646,4.0
CN1713700000000,17,137,Morgan County, IL,Mar-18,16428,15755,673,4.1
CN1713700000000,17,137,Morgan County, IL,Apr-18(p),16478,15916,562,3.4
CN1802700000000,18,027,Daviess County, IN,Mar-17,15947,15493,454,2.8
CN1802700000000,18,027,Daviess County, IN,Apr-17,15850,15510,340,2.1
CN1802700000000,18,027,Daviess County, IN,May-17,16212,15834,378,2.3
CN1802700000000,18,027,Daviess County, IN,Jun-17,16274,15829,445,2.7
CN1802700000000,18,027,Daviess County, IN,Jul-17,15963,15499,464,2.9
CN1802700000000,18,027,Daviess County, IN,Aug-17,15849,15333,516,3.3
CN1802700000000,18,027,Daviess County, IN,Sep-17,15704,15304,400,2.5
CN1802700000000,18,027,Daviess County, IN,Oct-17,15637,15245,392,2.5
CN1802700000000,18,027,Daviess County, IN,Nov-17,15706,15293,413,2.6
CN1802700000000,18,027,Daviess County, IN,Dec-17,15668,15282,386,2.5
CN1802700000000,18,027,Daviess County, IN,Jan-18,15498,15060,438,2.8
CN1802700000000,18,027,Daviess County, IN,Feb-18,15762,15287,475,3.0
CN1802700000000,18,027,Daviess County, IN,Mar-18,15952,15546,406,2.5
CN1802700000000,18,027,Daviess County, IN,Apr-18(p),15940,15582,358,2.2
CN4808700000000,48,087,Collingsworth County, TX,Mar-17,1197,1157,40,3.3
CN4808700000000,48,087,Collingsworth County, TX,Apr-17,1176,1140,36,3.1
CN4808700000000,48,087,Collingsworth County, TX,May-17,1191,1150,41,3.4
CN4808700000000,48,087,Collingsworth County, TX,Jun-17,1190,1145,45,3.8
CN4808700000000,48,087,Collingsworth County, TX,Jul-17,1148,1103,45,3.9
CN4808700000000,48,087,Collingsworth County, TX,Aug-17,1162,1116,46,4.0
CN4808700000000,48,087,Collingsworth County, TX,Sep-17,1125,1083,42,3.7
CN4808700000000,48,087,Collingsworth County, TX,Oct-17,1174,1134,40,3.4
CN4808700000000,48,087,Collingsworth County, TX,Nov-17,1133,1090,43,3.8
CN4808700000000,48,087,Collingsworth County, TX,Dec-17,1137,1097,40,3.5
CN4808700000000,48,087,Collingsworth County, TX,Jan-18,1132,1087,45,4.0
CN4808700000000,48,087,Collingsworth County, TX,Feb-18,1147,1108,39,3.4
CN4808700000000,48,087,Collingsworth County, TX,Mar-18,1193,1155,38,3.2
CN4808700000000,48,087,Collingsworth County, TX,Apr-18(p),1153,1118,35,3.0
CN5107100000000,51,071,Giles County, VA,Mar-17,8122,7628,494,6.1
CN5107100000000,51,071,Giles County, VA,Apr-17,8058,7716,342,4.2
CN5107100000000,51,071,Giles County, VA,May-17,7897,7554,343,4.3
CN5107100000000,51,071,Giles County, VA,Jun-17,7762,7413,349,4.5
CN5107100000000,51,071,Giles County, VA,Jul-17,7782,7422,360,4.6
CN5107100000000,51,071,Giles County, VA,Aug-17,7864,7495,369,4.7
CN5107100000000,51,071,Giles County, VA,Sep-17,8000,7664,336,4.2
CN5107100000000,51,071,Giles County, VA,Oct-17,7885,7563,322,4.1
CN5107100000000,51,071,Giles County, VA,Nov-17,7840,7534,306,3.9
CN5107100000000,51,071,Giles County, VA,Dec-17,7830,7534,296,3.8
CN5107100000000,51,071,Giles County, VA,Jan-18,7534,7207,327,4.3
CN5107100000000,51,071,Giles County, VA,Feb-18,7929,7619,310,3.9
CN5107100000000,51,071,Giles County, VA,Mar-18,7950,7636,314,3.9
CN5107100000000,51,071,Giles County, VA,Apr-18(p),7993,7740,253,3.2
CN4106900000000,41,069,Wheeler County, OR,Mar-17,729,697,32,4.4
CN4106900000000,41,069,Wheeler County, OR,Apr-17,731,700,31,4.2
CN4106900000000,41,069,Wheeler County, OR,May-17,727,697,30,4.1
CN4106900000000,41,069,Wheeler County, OR,Jun-17,753,725,28,3.7
CN4106900000000,41,069,Wheeler County, OR,Jul-17,742,712,30,4.0
CN4106900000000,41,069,Wheeler County, OR,Aug-17,766,737,29,3.8
CN4106900000000,41,069,Wheeler County, OR,Sep-17,772,747,25,3.2
CN4106900000000,41,069,Wheeler County, OR,Oct-17,767,740,27,3.5
CN4106900000000,41,069,Wheeler County, OR,Nov-17,761,735,26,3.4
CN4106900000000,41,069,Wheeler County, OR,Dec-17,731,709,22,3.0
CN4106900000000,41,069,Wheeler County, OR,Jan-18,713,691,22,3.1
CN4106900000000,41,069,Wheeler County, OR,Feb-18,723,700,23,3.2
CN4106900000000,41,069,Wheeler County, OR,Mar-18,690,668,22,3.2
CN4106900000000,41,069,Wheeler County, OR,Apr-18(p),700,677,23,3.3
CN3906300000000,39,063,Hancock County, OH,Mar-17,41713,40213,1500,3.6
CN3906300000000,39,063,Hancock County, OH,Apr-17,41722,40401,1321,3.2
CN3906300000000,39,063,Hancock County, OH,May-17,41833,40460,1373,3.3
CN3906300000000,39,063,Hancock County, OH,Jun-17,42063,40460,1603,3.8
CN3906300000000,39,063,Hancock County, OH,Jul-17,42162,40474,1688,4.0
CN3906300000000,39,063,Hancock County, OH,Aug-17,42115,40516,1599,3.8
CN3906300000000,39,063,Hancock County, OH,Sep-17,42086,40668,1418,3.4
CN3906300000000,39,063,Hancock County, OH,Oct-17,42053,40709,1344,3.2
CN3906300000000,39,063,Hancock County, OH,Nov-17,41940,40591,1349,3.2
CN3906300000000,39,063,Hancock County, OH,Dec-17,41698,40299,1399,3.4
CN3906300000000,39,063,Hancock County, OH,Jan-18,40949,39520,1429,3.5
CN3906300000000,39,063,Hancock County, OH,Feb-18,41739,40364,1375,3.3
CN3906300000000,39,063,Hancock County, OH,Mar-18,42088,40823,1265,3.0
CN3906300000000,39,063,Hancock County, OH,Apr-18(p),42015,40795,1220,2.9
CN5502300000000,55,023,Crawford County, WI,Mar-17,7887,7439,448,5.7
CN5502300000000,55,023,Crawford County, WI,Apr-17,7903,7569,334,4.2
CN5502300000000,55,023,Crawford County, WI,May-17,7916,7649,267,3.4
CN5502300000000,55,023,Crawford County, WI,Jun-17,8237,7924,313,3.8
CN5502300000000,55,023,Crawford County, WI,Jul-17,8030,7735,295,3.7
CN5502300000000,55,023,Crawford County, WI,Aug-17,7944,7639,305,3.8
CN5502300000000,55,023,Crawford County, WI,Sep-17,7925,7669,256,3.2
CN5502300000000,55,023,Crawford County, WI,Oct-17,8051,7827,224,2.8
CN5502300000000,55,023,Crawford County, WI,Nov-17,8124,7858,266,3.3
CN5502300000000,55,023,Crawford County, WI,Dec-17,8138,7848,290,3.6
CN5502300000000,55,023,Crawford County, WI,Jan-18,8031,7678,353,4.4
CN5502300000000,55,023,Crawford County, WI,Feb-18,7868,7459,409,5.2
CN5502300000000,55,023,Crawford County, WI,Mar-18,7890,7531,359,4.6
CN5502300000000,55,023,Crawford County, WI,Apr-18(p),7856,7535,321,4.1
CN1312500000000,13,125,Glascock County, GA,Mar-17,1293,1232,61,4.7
CN1312500000000,13,125,Glascock County, GA,Apr-17,1305,1241,64,4.9
CN1312500000000,13,125,Glascock County, GA,May-17,1297,1233,64,4.9
CN1312500000000,13,125,Glascock County, GA,Jun-17,1301,1231,70,5.4
CN1312500000000,13,125,Glascock County, GA,Jul-17,1287,1216,71,5.5
CN1312500000000,13,125,Glascock County, GA,Aug-17,1293,1230,63,4.9
CN1312500000000,13,125,Glascock County, GA,Sep-17,1306,1241,65,5.0
CN1312500000000,13,125,Glascock County, GA,Oct-17,1312,1248,64,4.9
CN1312500000000,13,125,Glascock County, GA,Nov-17,1316,1252,64,4.9
CN1312500000000,13,125,Glascock County, GA,Dec-17,1318,1260,58,4.4
CN1312500000000,13,125,Glascock County, GA,Jan-18,1338,1276,62,4.6
CN1312500000000,13,125,Glascock County, GA,Feb-18,1307,1246,61,4.7
CN1312500000000,13,125,Glascock County, GA,Mar-18,1314,1256,58,4.4
CN1312500000000,13,125,Glascock County, GA,Apr-18(p),1312,1259,53,4.0
CN0900300000000,09,003,Hartford County, CT,Mar-17,483181,458365,24816,5.1
CN0900300000000,09,003,Hartford County, CT,Apr-17,482111,458391,23720,4.9
CN0900300000000,09,003,Hartford County, CT,May-17,483315,460165,23150,4.8
CN0900300000000,09,003,Hartford County, CT,Jun-17,484864,460949,23915,4.9
CN0900300000000,09,003,Hartford County, CT,Jul-17,486735,461664,25071,5.2
CN0900300000000,09,003,Hartford County, CT,Aug-17,479853,455874,23979,5.0
CN0900300000000,09,003,Hartford County, CT,Sep-17,478575,457237,21338,4.5
CN0900300000000,09,003,Hartford County, CT,Oct-17,479800,459160,20640,4.3
CN0900300000000,09,003,Hartford County, CT,Nov-17,478981,458506,20475,4.3
CN0900300000000,09,003,Hartford County, CT,Dec-17,477830,458094,19736,4.1
CN0900300000000,09,003,Hartford County, CT,Jan-18,477370,451926,25444,5.3
CN0900300000000,09,003,Hartford County, CT,Feb-18,478429,453561,24868,5.2
CN0900300000000,09,003,Hartford County, CT,Mar-18,478810,456234,22576,4.7
CN0900300000000,09,003,Hartford County, CT,Apr-18(p),475688,453821,21867,4.6
CN0216400000000,02,164,Lake and Peninsula Borough, AK,Mar-17,623,537,86,13.8
CN0216400000000,02,164,Lake and Peninsula Borough, AK,Apr-17,635,550,85,13.4
CN0216400000000,02,164,Lake and Peninsula Borough, AK,May-17,741,661,80,10.8
CN0216400000000,02,164,Lake and Peninsula Borough, AK,Jun-17,829,743,86,10.4
CN0216400000000,02,164,Lake and Peninsula Borough, AK,Jul-17,1040,951,89,8.6
CN0216400000000,02,164,Lake and Peninsula Borough, AK,Aug-17,868,783,85,9.8
CN0216400000000,02,164,Lake and Peninsula Borough, AK,Sep-17,813,737,76,9.3
CN0216400000000,02,164,Lake and Peninsula Borough, AK,Oct-17,688,602,86,12.5
CN0216400000000,02,164,Lake and Peninsula Borough, AK,Nov-17,648,554,94,14.5
CN0216400000000,02,164,Lake and Peninsula Borough, AK,Dec-17,605,516,89,14.7
CN0216400000000,02,164,Lake and Peninsula Borough, AK,Jan-18,619,514,105,17.0
CN0216400000000,02,164,Lake and Peninsula Borough, AK,Feb-18,617,515,102,16.5
CN0216400000000,02,164,Lake and Peninsula Borough, AK,Mar-18,643,544,99,15.4
CN0216400000000,02,164,Lake and Peninsula Borough, AK,Apr-18(p),661,570,91,13.8
CN2110500000000,21,105,Hickman County, KY,Mar-17,1981,1821,160,8.1
CN2110500000000,21,105,Hickman County, KY,Apr-17,2021,1878,143,7.1
CN2110500000000,21,105,Hickman County, KY,May-17,2004,1856,148,7.4
CN2110500000000,21,105,Hickman County, KY,Jun-17,2003,1855,148,7.4
CN2110500000000,21,105,Hickman County, KY,Jul-17,1786,1643,143,8.0
CN2110500000000,21,105,Hickman County, KY,Aug-17,1768,1637,131,7.4
CN2110500000000,21,105,Hickman County, KY,Sep-17,1871,1752,119,6.4
CN2110500000000,21,105,Hickman County, KY,Oct-17,1928,1811,117,6.1
CN2110500000000,21,105,Hickman County, KY,Nov-17,1925,1816,109,5.7
CN2110500000000,21,105,Hickman County, KY,Dec-17,1892,1781,111,5.9
CN2110500000000,21,105,Hickman County, KY,Jan-18,1866,1745,121,6.5
CN2110500000000,21,105,Hickman County, KY,Feb-18,1751,1618,133,7.6
CN2110500000000,21,105,Hickman County, KY,Mar-18,1752,1636,116,6.6
CN2110500000000,21,105,Hickman County, KY,Apr-18(p),1764,1665,99,5.6
CN4100900000000,41,009,Columbia County, OR,Mar-17,24000,22744,1256,5.2
CN4100900000000,41,009,Columbia County, OR,Apr-17,24077,22920,1157,4.8
CN4100900000000,41,009,Columbia County, OR,May-17,24025,22918,1107,4.6
CN4100900000000,41,009,Columbia County, OR,Jun-17,24173,22904,1269,5.2
CN4100900000000,41,009,Columbia County, OR,Jul-17,24458,23075,1383,5.7
CN4100900000000,41,009,Columbia County, OR,Aug-17,24506,23075,1431,5.8
CN4100900000000,41,009,Columbia County, OR,Sep-17,24484,23226,1258,5.1
CN4100900000000,41,009,Columbia County, OR,Oct-17,24465,23221,1244,5.1
CN4100900000000,41,009,Columbia County, OR,Nov-17,24494,23264,1230,5.0
CN4100900000000,41,009,Columbia County, OR,Dec-17,24383,23238,1145,4.7
CN4100900000000,41,009,Columbia County, OR,Jan-18,24455,23209,1246,5.1
CN4100900000000,41,009,Columbia County, OR,Feb-18,24587,23279,1308,5.3
CN4100900000000,41,009,Columbia County, OR,Mar-18,24484,23186,1298,5.3
CN4100900000000,41,009,Columbia County, OR,Apr-18(p),24207,23071,1136,4.7
CN2600700000000,26,007,Alpena County, MI,Mar-17,13758,12837,921,6.7
CN2600700000000,26,007,Alpena County, MI,Apr-17,13640,12916,724,5.3
CN2600700000000,26,007,Alpena County, MI,May-17,13835,13144,691,5.0
CN2600700000000,26,007,Alpena County, MI,Jun-17,13551,12782,769,5.7
CN2600700000000,26,007,Alpena County, MI,Jul-17,13377,12517,860,6.4
CN2600700000000,26,007,Alpena County, MI,Aug-17,13269,12455,814,6.1
CN2600700000000,26,007,Alpena County, MI,Sep-17,13489,12834,655,4.9
CN2600700000000,26,007,Alpena County, MI,Oct-17,13469,12863,606,4.5
CN2600700000000,26,007,Alpena County, MI,Nov-17,13540,12848,692,5.1
CN2600700000000,26,007,Alpena County, MI,Dec-17,13482,12663,819,6.1
CN2600700000000,26,007,Alpena County, MI,Jan-18,13561,12631,930,6.9
CN2600700000000,26,007,Alpena County, MI,Feb-18,13813,12795,1018,7.4
CN2600700000000,26,007,Alpena County, MI,Mar-18,13790,12865,925,6.7
CN2600700000000,26,007,Alpena County, MI,Apr-18(p),13716,12952,764,5.6
CN7210300000000,72,103,Naguabo Municipio, PR,Mar-17,8080,7169,911,11.3
CN7210300000000,72,103,Naguabo Municipio, PR,Apr-17,8025,7098,927,11.6
CN7210300000000,72,103,Naguabo Municipio, PR,May-17,7903,7083,820,10.4
CN7210300000000,72,103,Naguabo Municipio, PR,Jun-17,7786,7057,729,9.4
CN7210300000000,72,103,Naguabo Municipio, PR,Jul-17,7871,7034,837,10.6
CN7210300000000,72,103,Naguabo Municipio, PR,Aug-17,7867,6938,929,11.8
CN7210300000000,72,103,Naguabo Municipio, PR,Sep-17(y),7882,7006,876,11.1
CN7210300000000,72,103,Naguabo Municipio, PR,Oct-17,7692,6699,993,12.9
CN7210300000000,72,103,Naguabo Municipio, PR,Nov-17,8071,7130,941,11.7
CN7210300000000,72,103,Naguabo Municipio, PR,Dec-17,8086,7193,893,11.0
CN7210300000000,72,103,Naguabo Municipio, PR,Jan-18,8042,7048,994,12.4
CN7210300000000,72,103,Naguabo Municipio, PR,Feb-18,7951,7032,919,11.6
CN7210300000000,72,103,Naguabo Municipio, PR,Mar-18,7963,7043,920,11.6
CN7210300000000,72,103,Naguabo Municipio, PR,Apr-18(p),8019,7114,905,11.3
CN4843100000000,48,431,Sterling County, TX,Mar-17,661,630,31,4.7
CN4843100000000,48,431,Sterling County, TX,Apr-17,638,616,22,3.4
CN4843100000000,48,431,Sterling County, TX,May-17,641,620,21,3.3
CN4843100000000,48,431,Sterling County, TX,Jun-17,633,612,21,3.3
CN4843100000000,48,431,Sterling County, TX,Jul-17,582,562,20,3.4
CN4843100000000,48,431,Sterling County, TX,Aug-17,600,580,20,3.3
CN4843100000000,48,431,Sterling County, TX,Sep-17,571,554,17,3.0
CN4843100000000,48,431,Sterling County, TX,Oct-17,598,581,17,2.8
CN4843100000000,48,431,Sterling County, TX,Nov-17,575,555,20,3.5
CN4843100000000,48,431,Sterling County, TX,Dec-17,575,558,17,3.0
CN4843100000000,48,431,Sterling County, TX,Jan-18,548,528,20,3.6
CN4843100000000,48,431,Sterling County, TX,Feb-18,565,543,22,3.9
CN4843100000000,48,431,Sterling County, TX,Mar-18,610,590,20,3.3
CN4843100000000,48,431,Sterling County, TX,Apr-18(p),577,558,19,3.3
CN2907300000000,29,073,Gasconade County, MO,Mar-17,7636,7337,299,3.9
CN2907300000000,29,073,Gasconade County, MO,Apr-17,7749,7481,268,3.5
CN2907300000000,29,073,Gasconade County, MO,May-17,7672,7397,275,3.6
CN2907300000000,29,073,Gasconade County, MO,Jun-17,7832,7548,284,3.6
CN2907300000000,29,073,Gasconade County, MO,Jul-17,7553,7269,284,3.8
CN2907300000000,29,073,Gasconade County, MO,Aug-17,7670,7355,315,4.1
CN2907300000000,29,073,Gasconade County, MO,Sep-17,7689,7456,233,3.0
CN2907300000000,29,073,Gasconade County, MO,Oct-17,7796,7500,296,3.8
CN2907300000000,29,073,Gasconade County, MO,Nov-17,7708,7411,297,3.9
CN2907300000000,29,073,Gasconade County, MO,Dec-17,7563,7301,262,3.5
CN2907300000000,29,073,Gasconade County, MO,Jan-18,7512,7191,321,4.3
CN2907300000000,29,073,Gasconade County, MO,Feb-18,7687,7359,328,4.3
CN2907300000000,29,073,Gasconade County, MO,Mar-18,7648,7374,274,3.6
CN2907300000000,29,073,Gasconade County, MO,Apr-18(p),7728,7496,232,3.0
CN4838500000000,48,385,Real County, TX,Mar-17,1065,1005,60,5.6
CN4838500000000,48,385,Real County, TX,Apr-17,984,926,58,5.9
CN4838500000000,48,385,Real County, TX,May-17,992,936,56,5.6
CN4838500000000,48,385,Real County, TX,Jun-17,1148,1085,63,5.5
CN4838500000000,48,385,Real County, TX,Jul-17,1163,1093,70,6.0
CN4838500000000,48,385,Real County, TX,Aug-17,1126,1063,63,5.6
CN4838500000000,48,385,Real County, TX,Sep-17,1006,951,55,5.5
CN4838500000000,48,385,Real County, TX,Oct-17,1020,968,52,5.1
CN4838500000000,48,385,Real County, TX,Nov-17,1018,959,59,5.8
CN4838500000000,48,385,Real County, TX,Dec-17,1019,968,51,5.0
CN4838500000000,48,385,Real County, TX,Jan-18,1005,950,55,5.5
CN4838500000000,48,385,Real County, TX,Feb-18,1046,991,55,5.3
CN4838500000000,48,385,Real County, TX,Mar-18,1075,1019,56,5.2
CN4838500000000,48,385,Real County, TX,Apr-18(p),991,933,58,5.9
CN3115500000000,31,155,Saunders County, NE,Mar-17,10804,10493,311,2.9
CN3115500000000,31,155,Saunders County, NE,Apr-17,10838,10561,277,2.6
CN3115500000000,31,155,Saunders County, NE,May-17,10903,10605,298,2.7
CN3115500000000,31,155,Saunders County, NE,Jun-17,11022,10699,323,2.9
CN3115500000000,31,155,Saunders County, NE,Jul-17,11076,10742,334,3.0
CN3115500000000,31,155,Saunders County, NE,Aug-17,10905,10603,302,2.8
CN3115500000000,31,155,Saunders County, NE,Sep-17,10746,10482,264,2.5
CN3115500000000,31,155,Saunders County, NE,Oct-17,10814,10553,261,2.4
CN3115500000000,31,155,Saunders County, NE,Nov-17,10854,10593,261,2.4
CN3115500000000,31,155,Saunders County, NE,Dec-17,10822,10541,281,2.6
CN3115500000000,31,155,Saunders County, NE,Jan-18,10816,10495,321,3.0
CN3115500000000,31,155,Saunders County, NE,Feb-18,10857,10545,312,2.9
CN3115500000000,31,155,Saunders County, NE,Mar-18,10954,10635,319,2.9
CN3115500000000,31,155,Saunders County, NE,Apr-18(p),10996,10691,305,2.8
CN0506900000000,05,069,Jefferson County, AR,Mar-17,27953,26540,1413,5.1
CN0506900000000,05,069,Jefferson County, AR,Apr-17,28042,26780,1262,4.5
CN0506900000000,05,069,Jefferson County, AR,May-17,28074,26709,1365,4.9
CN0506900000000,05,069,Jefferson County, AR,Jun-17,28279,26688,1591,5.6
CN0506900000000,05,069,Jefferson County, AR,Jul-17,28549,26857,1692,5.9
CN0506900000000,05,069,Jefferson County, AR,Aug-17,28152,26620,1532,5.4
CN0506900000000,05,069,Jefferson County, AR,Sep-17,28252,26870,1382,4.9
CN0506900000000,05,069,Jefferson County, AR,Oct-17,28131,26866,1265,4.5
CN0506900000000,05,069,Jefferson County, AR,Nov-17,27987,26694,1293,4.6
CN0506900000000,05,069,Jefferson County, AR,Dec-17,27752,26335,1417,5.1
CN0506900000000,05,069,Jefferson County, AR,Jan-18,27257,25636,1621,5.9
CN0506900000000,05,069,Jefferson County, AR,Feb-18,27776,26166,1610,5.8
CN0506900000000,05,069,Jefferson County, AR,Mar-18,27859,26317,1542,5.5
CN0506900000000,05,069,Jefferson County, AR,Apr-18(p),27681,26341,1340,4.8
CN4607700000000,46,077,Kingsbury County, SD,Mar-17,2671,2571,100,3.7
CN4607700000000,46,077,Kingsbury County, SD,Apr-17,2723,2631,92,3.4
CN4607700000000,46,077,Kingsbury County, SD,May-17,2781,2691,90,3.2
CN4607700000000,46,077,Kingsbury County, SD,Jun-17,2871,2791,80,2.8
CN4607700000000,46,077,Kingsbury County, SD,Jul-17,2811,2729,82,2.9
CN4607700000000,46,077,Kingsbury County, SD,Aug-17,2737,2655,82,3.0
CN4607700000000,46,077,Kingsbury County, SD,Sep-17,2708,2631,77,2.8
CN4607700000000,46,077,Kingsbury County, SD,Oct-17,2711,2639,72,2.7
CN4607700000000,46,077,Kingsbury County, SD,Nov-17,2687,2609,78,2.9
CN4607700000000,46,077,Kingsbury County, SD,Dec-17,2710,2627,83,3.1
CN4607700000000,46,077,Kingsbury County, SD,Jan-18,2685,2577,108,4.0
CN4607700000000,46,077,Kingsbury County, SD,Feb-18,2634,2531,103,3.9
CN4607700000000,46,077,Kingsbury County, SD,Mar-18,2658,2560,98,3.7
CN4607700000000,46,077,Kingsbury County, SD,Apr-18(p),2645,2551,94,3.6
CN4013100000000,40,131,Rogers County, OK,Mar-17,44776,42760,2016,4.5
CN4013100000000,40,131,Rogers County, OK,Apr-17,44607,42726,1881,4.2
CN4013100000000,40,131,Rogers County, OK,May-17,44782,42702,2080,4.6
CN4013100000000,40,131,Rogers County, OK,Jun-17,45560,43316,2244,4.9
CN4013100000000,40,131,Rogers County, OK,Jul-17,45602,43521,2081,4.6
CN4013100000000,40,131,Rogers County, OK,Aug-17,44919,42908,2011,4.5
CN4013100000000,40,131,Rogers County, OK,Sep-17,45110,43247,1863,4.1
CN4013100000000,40,131,Rogers County, OK,Oct-17,45361,43554,1807,4.0
CN4013100000000,40,131,Rogers County, OK,Nov-17,45574,43824,1750,3.8
CN4013100000000,40,131,Rogers County, OK,Dec-17,45418,43666,1752,3.9
CN4013100000000,40,131,Rogers County, OK,Jan-18,45076,43169,1907,4.2
CN4013100000000,40,131,Rogers County, OK,Feb-18,45206,43467,1739,3.8
CN4013100000000,40,131,Rogers County, OK,Mar-18,45473,43782,1691,3.7
CN4013100000000,40,131,Rogers County, OK,Apr-18(p),45597,43919,1678,3.7
CN4102100000000,41,021,Gilliam County, OR,Mar-17,849,811,38,4.5
CN4102100000000,41,021,Gilliam County, OR,Apr-17,843,805,38,4.5
CN4102100000000,41,021,Gilliam County, OR,May-17,854,823,31,3.6
CN4102100000000,41,021,Gilliam County, OR,Jun-17,898,861,37,4.1
CN4102100000000,41,021,Gilliam County, OR,Jul-17,909,871,38,4.2
CN4102100000000,41,021,Gilliam County, OR,Aug-17,913,871,42,4.6
CN4102100000000,41,021,Gilliam County, OR,Sep-17,873,837,36,4.1
CN4102100000000,41,021,Gilliam County, OR,Oct-17,850,818,32,3.8
CN4102100000000,41,021,Gilliam County, OR,Nov-17,857,823,34,4.0
CN4102100000000,41,021,Gilliam County, OR,Dec-17,843,809,34,4.0
CN4102100000000,41,021,Gilliam County, OR,Jan-18,860,829,31,3.6
CN4102100000000,41,021,Gilliam County, OR,Feb-18,858,826,32,3.7
CN4102100000000,41,021,Gilliam County, OR,Mar-18,858,825,33,3.8
CN4102100000000,41,021,Gilliam County, OR,Apr-18(p),848,821,27,3.2
CN1212900000000,12,129,Wakulla County, FL,Mar-17,14630,14120,510,3.5
CN1212900000000,12,129,Wakulla County, FL,Apr-17,14747,14262,485,3.3
CN1212900000000,12,129,Wakulla County, FL,May-17,14621,14130,491,3.4
CN1212900000000,12,129,Wakulla County, FL,Jun-17,14477,13925,552,3.8
CN1212900000000,12,129,Wakulla County, FL,Jul-17,14584,14029,555,3.8
CN1212900000000,12,129,Wakulla County, FL,Aug-17,14374,13841,533,3.7
CN1212900000000,12,129,Wakulla County, FL,Sep-17,15022,14533,489,3.3
CN1212900000000,12,129,Wakulla County, FL,Oct-17,14753,14284,469,3.2
CN1212900000000,12,129,Wakulla County, FL,Nov-17,14683,14193,490,3.3
CN1212900000000,12,129,Wakulla County, FL,Dec-17,14573,14124,449,3.1
CN1212900000000,12,129,Wakulla County, FL,Jan-18,14809,14271,538,3.6
CN1212900000000,12,129,Wakulla County, FL,Feb-18,15000,14505,495,3.3
CN1212900000000,12,129,Wakulla County, FL,Mar-18,14965,14476,489,3.3
CN1212900000000,12,129,Wakulla County, FL,Apr-18(p),14948,14521,427,2.9
CN5165000000000,51,650,Hampton city, VA,Mar-17,64668,61319,3349,5.2
CN5165000000000,51,650,Hampton city, VA,Apr-17,64879,61782,3097,4.8
CN5165000000000,51,650,Hampton city, VA,May-17,64861,61754,3107,4.8
CN5165000000000,51,650,Hampton city, VA,Jun-17,65440,62142,3298,5.0
CN5165000000000,51,650,Hampton city, VA,Jul-17,66074,62680,3394,5.1
CN5165000000000,51,650,Hampton city, VA,Aug-17,65601,62057,3544,5.4
CN5165000000000,51,650,Hampton city, VA,Sep-17,65107,61902,3205,4.9
CN5165000000000,51,650,Hampton city, VA,Oct-17,64424,61460,2964,4.6
CN5165000000000,51,650,Hampton city, VA,Nov-17,63958,60994,2964,4.6
CN5165000000000,51,650,Hampton city, VA,Dec-17,63609,60617,2992,4.7
CN5165000000000,51,650,Hampton city, VA,Jan-18,63509,60390,3119,4.9
CN5165000000000,51,650,Hampton city, VA,Feb-18,64270,61345,2925,4.6
CN5165000000000,51,650,Hampton city, VA,Mar-18,64696,61806,2890,4.5
CN5165000000000,51,650,Hampton city, VA,Apr-18(p),64627,62141,2486,3.8
CN1810300000000,18,103,Miami County, IN,Mar-17,15933,15295,638,4.0
CN1810300000000,18,103,Miami County, IN,Apr-17,15882,15374,508,3.2
CN1810300000000,18,103,Miami County, IN,May-17,16108,15569,539,3.3
CN1810300000000,18,103,Miami County, IN,Jun-17,16289,15487,802,4.9
CN1810300000000,18,103,Miami County, IN,Jul-17,15754,15133,621,3.9
CN1810300000000,18,103,Miami County, IN,Aug-17,15733,15083,650,4.1
CN1810300000000,18,103,Miami County, IN,Sep-17,15651,15106,545,3.5
CN1810300000000,18,103,Miami County, IN,Oct-17,15467,14933,534,3.5
CN1810300000000,18,103,Miami County, IN,Nov-17,15630,15085,545,3.5
CN1810300000000,18,103,Miami County, IN,Dec-17,15467,14951,516,3.3
CN1810300000000,18,103,Miami County, IN,Jan-18,15313,14705,608,4.0
CN1810300000000,18,103,Miami County, IN,Feb-18,15572,14942,630,4.0
CN1810300000000,18,103,Miami County, IN,Mar-18,15774,15191,583,3.7
CN1810300000000,18,103,Miami County, IN,Apr-18(p),15867,15291,576,3.6
CN4206500000000,42,065,Jefferson County, PA,Mar-17,20651,19306,1345,6.5
CN4206500000000,42,065,Jefferson County, PA,Apr-17,20597,19561,1036,5.0
CN4206500000000,42,065,Jefferson County, PA,May-17,20764,19696,1068,5.1
CN4206500000000,42,065,Jefferson County, PA,Jun-17,20983,19809,1174,5.6
CN4206500000000,42,065,Jefferson County, PA,Jul-17,21001,19843,1158,5.5
CN4206500000000,42,065,Jefferson County, PA,Aug-17,20712,19558,1154,5.6
CN4206500000000,42,065,Jefferson County, PA,Sep-17,20426,19507,919,4.5
CN4206500000000,42,065,Jefferson County, PA,Oct-17,20202,19291,911,4.5
CN4206500000000,42,065,Jefferson County, PA,Nov-17,20132,19144,988,4.9
CN4206500000000,42,065,Jefferson County, PA,Dec-17,20147,19076,1071,5.3
CN4206500000000,42,065,Jefferson County, PA,Jan-18,20326,19013,1313,6.5
CN4206500000000,42,065,Jefferson County, PA,Feb-18,20248,19014,1234,6.1
CN4206500000000,42,065,Jefferson County, PA,Mar-18,20013,18959,1054,5.3
CN4206500000000,42,065,Jefferson County, PA,Apr-18(p),19997,19152,845,4.2
CN4203500000000,42,035,Clinton County, PA,Mar-17,18580,17273,1307,7.0
CN4203500000000,42,035,Clinton County, PA,Apr-17,18575,17557,1018,5.5
CN4203500000000,42,035,Clinton County, PA,May-17,18387,17348,1039,5.7
CN4203500000000,42,035,Clinton County, PA,Jun-17,18350,17243,1107,6.0
CN4203500000000,42,035,Clinton County, PA,Jul-17,18389,17217,1172,6.4
CN4203500000000,42,035,Clinton County, PA,Aug-17,18139,17001,1138,6.3
CN4203500000000,42,035,Clinton County, PA,Sep-17,18318,17378,940,5.1
CN4203500000000,42,035,Clinton County, PA,Oct-17,18129,17213,916,5.1
CN4203500000000,42,035,Clinton County, PA,Nov-17,18135,17133,1002,5.5
CN4203500000000,42,035,Clinton County, PA,Dec-17,18109,16979,1130,6.2
CN4203500000000,42,035,Clinton County, PA,Jan-18,18149,16769,1380,7.6
CN4203500000000,42,035,Clinton County, PA,Feb-18,18444,17178,1266,6.9
CN4203500000000,42,035,Clinton County, PA,Mar-18,18169,17051,1118,6.2
CN4203500000000,42,035,Clinton County, PA,Apr-18(p),18101,17230,871,4.8
CN0102700000000,01,027,Clay County, AL,Mar-17,5731,5457,274,4.8
CN0102700000000,01,027,Clay County, AL,Apr-17,5716,5495,221,3.9
CN0102700000000,01,027,Clay County, AL,May-17,5694,5473,221,3.9
CN0102700000000,01,027,Clay County, AL,Jun-17,5692,5422,270,4.7
CN0102700000000,01,027,Clay County, AL,Jul-17,5707,5439,268,4.7
CN0102700000000,01,027,Clay County, AL,Aug-17,5756,5493,263,4.6
CN0102700000000,01,027,Clay County, AL,Sep-17,5837,5622,215,3.7
CN0102700000000,01,027,Clay County, AL,Oct-17,5810,5591,219,3.8
CN0102700000000,01,027,Clay County, AL,Nov-17,5714,5515,199,3.5
CN0102700000000,01,027,Clay County, AL,Dec-17,5648,5450,198,3.5
CN0102700000000,01,027,Clay County, AL,Jan-18,5617,5384,233,4.1
CN0102700000000,01,027,Clay County, AL,Feb-18,5788,5553,235,4.1
CN0102700000000,01,027,Clay County, AL,Mar-18,5835,5582,253,4.3
CN0102700000000,01,027,Clay County, AL,Apr-18(p),5827,5625,202,3.5
CN1914700000000,19,147,Palo Alto County, IA,Mar-17,4782,4636,146,3.1
CN1914700000000,19,147,Palo Alto County, IA,Apr-17,4928,4796,132,2.7
CN1914700000000,19,147,Palo Alto County, IA,May-17,4925,4799,126,2.6
CN1914700000000,19,147,Palo Alto County, IA,Jun-17,5041,4904,137,2.7
CN1914700000000,19,147,Palo Alto County, IA,Jul-17,5033,4900,133,2.6
CN1914700000000,19,147,Palo Alto County, IA,Aug-17,4908,4772,136,2.8
CN1914700000000,19,147,Palo Alto County, IA,Sep-17,4923,4808,115,2.3
CN1914700000000,19,147,Palo Alto County, IA,Oct-17,4970,4873,97,2.0
CN1914700000000,19,147,Palo Alto County, IA,Nov-17,4910,4801,109,2.2
CN1914700000000,19,147,Palo Alto County, IA,Dec-17,4867,4740,127,2.6
CN1914700000000,19,147,Palo Alto County, IA,Jan-18,4835,4683,152,3.1
CN1914700000000,19,147,Palo Alto County, IA,Feb-18,4854,4709,145,3.0
CN1914700000000,19,147,Palo Alto County, IA,Mar-18,4823,4696,127,2.6
CN1914700000000,19,147,Palo Alto County, IA,Apr-18(p),4859,4742,117,2.4
CN3809700000000,38,097,Traill County, ND,Mar-17,4598,4462,136,3.0
CN3809700000000,38,097,Traill County, ND,Apr-17,4667,4560,107,2.3
CN3809700000000,38,097,Traill County, ND,May-17,4669,4585,84,1.8
CN3809700000000,38,097,Traill County, ND,Jun-17,4713,4566,147,3.1
CN3809700000000,38,097,Traill County, ND,Jul-17,4671,4550,121,2.6
CN3809700000000,38,097,Traill County, ND,Aug-17,4662,4559,103,2.2
CN3809700000000,38,097,Traill County, ND,Sep-17,4703,4623,80,1.7
CN3809700000000,38,097,Traill County, ND,Oct-17,4719,4639,80,1.7
CN3809700000000,38,097,Traill County, ND,Nov-17,4656,4559,97,2.1
CN3809700000000,38,097,Traill County, ND,Dec-17,4664,4555,109,2.3
CN3809700000000,38,097,Traill County, ND,Jan-18,4592,4439,153,3.3
CN3809700000000,38,097,Traill County, ND,Feb-18,4604,4456,148,3.2
CN3809700000000,38,097,Traill County, ND,Mar-18,4629,4490,139,3.0
CN3809700000000,38,097,Traill County, ND,Apr-18(p),4648,4530,118,2.5
CN2801700000000,28,017,Chickasaw County, MS,Mar-17,7064,6701,363,5.1
CN2801700000000,28,017,Chickasaw County, MS,Apr-17,7075,6758,317,4.5
CN2801700000000,28,017,Chickasaw County, MS,May-17,7099,6708,391,5.5
CN2801700000000,28,017,Chickasaw County, MS,Jun-17,7214,6765,449,6.2
CN2801700000000,28,017,Chickasaw County, MS,Jul-17,7225,6766,459,6.4
CN2801700000000,28,017,Chickasaw County, MS,Aug-17,7041,6683,358,5.1
CN2801700000000,28,017,Chickasaw County, MS,Sep-17,7127,6777,350,4.9
CN2801700000000,28,017,Chickasaw County, MS,Oct-17,7015,6680,335,4.8
CN2801700000000,28,017,Chickasaw County, MS,Nov-17,6970,6651,319,4.6
CN2801700000000,28,017,Chickasaw County, MS,Dec-17,6988,6673,315,4.5
CN2801700000000,28,017,Chickasaw County, MS,Jan-18,6917,6597,320,4.6
CN2801700000000,28,017,Chickasaw County, MS,Feb-18,6989,6681,308,4.4
CN2801700000000,28,017,Chickasaw County, MS,Mar-18,7031,6739,292,4.2
CN2801700000000,28,017,Chickasaw County, MS,Apr-18(p),7080,6768,312,4.4
CN2712700000000,27,127,Redwood County, MN,Mar-17,7777,7366,411,5.3
CN2712700000000,27,127,Redwood County, MN,Apr-17,7758,7469,289,3.7
CN2712700000000,27,127,Redwood County, MN,May-17,7732,7473,259,3.3
CN2712700000000,27,127,Redwood County, MN,Jun-17,7871,7573,298,3.8
CN2712700000000,27,127,Redwood County, MN,Jul-17,7771,7476,295,3.8
CN2712700000000,27,127,Redwood County, MN,Aug-17,7477,7158,319,4.3
CN2712700000000,27,127,Redwood County, MN,Sep-17,7419,7175,244,3.3
CN2712700000000,27,127,Redwood County, MN,Oct-17,7705,7495,210,2.7
CN2712700000000,27,127,Redwood County, MN,Nov-17,7638,7400,238,3.1
CN2712700000000,27,127,Redwood County, MN,Dec-17,7678,7350,328,4.3
CN2712700000000,27,127,Redwood County, MN,Jan-18,7435,7003,432,5.8
CN2712700000000,27,127,Redwood County, MN,Feb-18,7476,7045,431,5.8
CN2712700000000,27,127,Redwood County, MN,Mar-18,7507,7115,392,5.2
CN2712700000000,27,127,Redwood County, MN,Apr-18(p),7535,7213,322,4.3
CN2919700000000,29,197,Schuyler County, MO,Mar-17,1882,1778,104,5.5
CN2919700000000,29,197,Schuyler County, MO,Apr-17,1965,1881,84,4.3
CN2919700000000,29,197,Schuyler County, MO,May-17,1880,1804,76,4.0
CN2919700000000,29,197,Schuyler County, MO,Jun-17,1891,1795,96,5.1
CN2919700000000,29,197,Schuyler County, MO,Jul-17,1847,1749,98,5.3
CN2919700000000,29,197,Schuyler County, MO,Aug-17,1860,1747,113,6.1
CN2919700000000,29,197,Schuyler County, MO,Sep-17,1880,1795,85,4.5
CN2919700000000,29,197,Schuyler County, MO,Oct-17,1864,1802,62,3.3
CN2919700000000,29,197,Schuyler County, MO,Nov-17,1855,1791,64,3.5
CN2919700000000,29,197,Schuyler County, MO,Dec-17,1824,1743,81,4.4
CN2919700000000,29,197,Schuyler County, MO,Jan-18,1863,1746,117,6.3
CN2919700000000,29,197,Schuyler County, MO,Feb-18,1940,1829,111,5.7
CN2919700000000,29,197,Schuyler County, MO,Mar-18,1930,1825,105,5.4
CN2919700000000,29,197,Schuyler County, MO,Apr-18(p),1964,1881,83,4.2
CN5001500000000,50,015,Lamoille County, VT,Mar-17,14074,13366,708,5.0
CN5001500000000,50,015,Lamoille County, VT,Apr-17,13803,13125,678,4.9
CN5001500000000,50,015,Lamoille County, VT,May-17,13847,13320,527,3.8
CN5001500000000,50,015,Lamoille County, VT,Jun-17,14283,13776,507,3.5
CN5001500000000,50,015,Lamoille County, VT,Jul-17,14423,13931,492,3.4
CN5001500000000,50,015,Lamoille County, VT,Aug-17,14346,13896,450,3.1
CN5001500000000,50,015,Lamoille County, VT,Sep-17,14171,13685,486,3.4
CN5001500000000,50,015,Lamoille County, VT,Oct-17,14101,13675,426,3.0
CN5001500000000,50,015,Lamoille County, VT,Nov-17,13913,13393,520,3.7
CN5001500000000,50,015,Lamoille County, VT,Dec-17,14018,13512,506,3.6
CN5001500000000,50,015,Lamoille County, VT,Jan-18,14231,13569,662,4.7
CN5001500000000,50,015,Lamoille County, VT,Feb-18,14336,13725,611,4.3
CN5001500000000,50,015,Lamoille County, VT,Mar-18,14365,13738,627,4.4
CN5001500000000,50,015,Lamoille County, VT,Apr-18(p),14241,13600,641,4.5
CN2005300000000,20,053,Ellsworth County, KS,Mar-17,2683,2596,87,3.2
CN2005300000000,20,053,Ellsworth County, KS,Apr-17,2678,2595,83,3.1
CN2005300000000,20,053,Ellsworth County, KS,May-17,2735,2650,85,3.1
CN2005300000000,20,053,Ellsworth County, KS,Jun-17,2769,2677,92,3.3
CN2005300000000,20,053,Ellsworth County, KS,Jul-17,2715,2617,98,3.6
CN2005300000000,20,053,Ellsworth County, KS,Aug-17,2754,2662,92,3.3
CN2005300000000,20,053,Ellsworth County, KS,Sep-17,2694,2620,74,2.7
CN2005300000000,20,053,Ellsworth County, KS,Oct-17,2698,2634,64,2.4
CN2005300000000,20,053,Ellsworth County, KS,Nov-17,2674,2605,69,2.6
CN2005300000000,20,053,Ellsworth County, KS,Dec-17,2670,2605,65,2.4
CN2005300000000,20,053,Ellsworth County, KS,Jan-18,2515,2443,72,2.9
CN2005300000000,20,053,Ellsworth County, KS,Feb-18,2502,2429,73,2.9
CN2005300000000,20,053,Ellsworth County, KS,Mar-18,2505,2433,72,2.9
CN2005300000000,20,053,Ellsworth County, KS,Apr-18(p),2427,2356,71,2.9
CN3101900000000,31,019,Buffalo County, NE,Mar-17,27110,26513,597,2.2
CN3101900000000,31,019,Buffalo County, NE,Apr-17,27322,26705,617,2.3
CN3101900000000,31,019,Buffalo County, NE,May-17,27197,26531,666,2.4
CN3101900000000,31,019,Buffalo County, NE,Jun-17,27093,26319,774,2.9
CN3101900000000,31,019,Buffalo County, NE,Jul-17,27049,26289,760,2.8
CN3101900000000,31,019,Buffalo County, NE,Aug-17,26704,26007,697,2.6
CN3101900000000,31,019,Buffalo County, NE,Sep-17,26897,26297,600,2.2
CN3101900000000,31,019,Buffalo County, NE,Oct-17,27137,26564,573,2.1
CN3101900000000,31,019,Buffalo County, NE,Nov-17,27053,26506,547,2.0
CN3101900000000,31,019,Buffalo County, NE,Dec-17,26997,26385,612,2.3
CN3101900000000,31,019,Buffalo County, NE,Jan-18,27044,26418,626,2.3
CN3101900000000,31,019,Buffalo County, NE,Feb-18,27409,26793,616,2.2
CN3101900000000,31,019,Buffalo County, NE,Mar-18,27431,26787,644,2.3
CN3101900000000,31,019,Buffalo County, NE,Apr-18(p),27439,26786,653,2.4
CN7202700000000,72,027,Camuy Municipio, PR,Mar-17,9507,8399,1108,11.7
CN7202700000000,72,027,Camuy Municipio, PR,Apr-17,9472,8302,1170,12.4
CN7202700000000,72,027,Camuy Municipio, PR,May-17,9386,8378,1008,10.7
CN7202700000000,72,027,Camuy Municipio, PR,Jun-17,9307,8365,942,10.1
CN7202700000000,72,027,Camuy Municipio, PR,Jul-17,9463,8448,1015,10.7
CN7202700000000,72,027,Camuy Municipio, PR,Aug-17,9519,8369,1150,12.1
CN7202700000000,72,027,Camuy Municipio, PR,Sep-17(y),9460,8358,1102,11.6
CN7202700000000,72,027,Camuy Municipio, PR,Oct-17,9215,8030,1185,12.9
CN7202700000000,72,027,Camuy Municipio, PR,Nov-17,9597,8530,1067,11.1
CN7202700000000,72,027,Camuy Municipio, PR,Dec-17,9583,8564,1019,10.6
CN7202700000000,72,027,Camuy Municipio, PR,Jan-18,9444,8328,1116,11.8
CN7202700000000,72,027,Camuy Municipio, PR,Feb-18,9321,8278,1043,11.2
CN7202700000000,72,027,Camuy Municipio, PR,Mar-18,9294,8305,989,10.6
CN7202700000000,72,027,Camuy Municipio, PR,Apr-18(p),9355,8403,952,10.2
CN2815300000000,28,153,Wayne County, MS,Mar-17,7634,7132,502,6.6
CN2815300000000,28,153,Wayne County, MS,Apr-17,7634,7194,440,5.8
CN2815300000000,28,153,Wayne County, MS,May-17,7585,7089,496,6.5
CN2815300000000,28,153,Wayne County, MS,Jun-17,7638,7062,576,7.5
CN2815300000000,28,153,Wayne County, MS,Jul-17,7559,7022,537,7.1
CN2815300000000,28,153,Wayne County, MS,Aug-17,7464,7017,447,6.0
CN2815300000000,28,153,Wayne County, MS,Sep-17,7533,7122,411,5.5
CN2815300000000,28,153,Wayne County, MS,Oct-17,7386,7010,376,5.1
CN2815300000000,28,153,Wayne County, MS,Nov-17,7313,6940,373,5.1
CN2815300000000,28,153,Wayne County, MS,Dec-17,7344,6962,382,5.2
CN2815300000000,28,153,Wayne County, MS,Jan-18,7295,6908,387,5.3
CN2815300000000,28,153,Wayne County, MS,Feb-18,7392,7014,378,5.1
CN2815300000000,28,153,Wayne County, MS,Mar-18,7482,7132,350,4.7
CN2815300000000,28,153,Wayne County, MS,Apr-18(p),7508,7138,370,4.9
CN3301100000000,33,011,Hillsborough County, NH,Mar-17,231986,224611,7375,3.2
CN3301100000000,33,011,Hillsborough County, NH,Apr-17,231427,225005,6422,2.8
CN3301100000000,33,011,Hillsborough County, NH,May-17,230869,224643,6226,2.7
CN3301100000000,33,011,Hillsborough County, NH,Jun-17,233841,227277,6564,2.8
CN3301100000000,33,011,Hillsborough County, NH,Jul-17,232423,225887,6536,2.8
CN3301100000000,33,011,Hillsborough County, NH,Aug-17,230615,224069,6546,2.8
CN3301100000000,33,011,Hillsborough County, NH,Sep-17,228975,222899,6076,2.7
CN3301100000000,33,011,Hillsborough County, NH,Oct-17,229800,224079,5721,2.5
CN3301100000000,33,011,Hillsborough County, NH,Nov-17,231043,225177,5866,2.5
CN3301100000000,33,011,Hillsborough County, NH,Dec-17,229457,223921,5536,2.4
CN3301100000000,33,011,Hillsborough County, NH,Jan-18,231307,223857,7450,3.2
CN3301100000000,33,011,Hillsborough County, NH,Feb-18,231801,224500,7301,3.1
CN3301100000000,33,011,Hillsborough County, NH,Mar-18,233512,226379,7133,3.1
CN3301100000000,33,011,Hillsborough County, NH,Apr-18(p),233903,227265,6638,2.8
CN4835500000000,48,355,Nueces County, TX,Mar-17,170091,160666,9425,5.5
CN4835500000000,48,355,Nueces County, TX,Apr-17,169276,160429,8847,5.2
CN4835500000000,48,355,Nueces County, TX,May-17,168612,160097,8515,5.1
CN4835500000000,48,355,Nueces County, TX,Jun-17,168734,159610,9124,5.4
CN4835500000000,48,355,Nueces County, TX,Jul-17,167746,158689,9057,5.4
CN4835500000000,48,355,Nueces County, TX,Aug-17,166512,157293,9219,5.5
CN4835500000000,48,355,Nueces County, TX,Sep-17,166328,157461,8867,5.3
CN4835500000000,48,355,Nueces County, TX,Oct-17,164930,156757,8173,5.0
CN4835500000000,48,355,Nueces County, TX,Nov-17,166034,157782,8252,5.0
CN4835500000000,48,355,Nueces County, TX,Dec-17,165532,157585,7947,4.8
CN4835500000000,48,355,Nueces County, TX,Jan-18,165162,156350,8812,5.3
CN4835500000000,48,355,Nueces County, TX,Feb-18,167812,159233,8579,5.1
CN4835500000000,48,355,Nueces County, TX,Mar-18,168512,159881,8631,5.1
CN4835500000000,48,355,Nueces County, TX,Apr-18(p),167751,159717,8034,4.8
CN1608500000000,16,085,Valley County, ID,Mar-17,4972,4664,308,6.2
CN1608500000000,16,085,Valley County, ID,Apr-17,4732,4451,281,5.9
CN1608500000000,16,085,Valley County, ID,May-17,4837,4634,203,4.2
CN1608500000000,16,085,Valley County, ID,Jun-17,5430,5250,180,3.3
CN1608500000000,16,085,Valley County, ID,Jul-17,5720,5545,175,3.1
CN1608500000000,16,085,Valley County, ID,Aug-17,5617,5445,172,3.1
CN1608500000000,16,085,Valley County, ID,Sep-17,5236,5072,164,3.1
CN1608500000000,16,085,Valley County, ID,Oct-17,4976,4811,165,3.3
CN1608500000000,16,085,Valley County, ID,Nov-17,4805,4590,215,4.5
CN1608500000000,16,085,Valley County, ID,Dec-17,5003,4759,244,4.9
CN1608500000000,16,085,Valley County, ID,Jan-18,5197,4899,298,5.7
CN1608500000000,16,085,Valley County, ID,Feb-18,5109,4842,267,5.2
CN1608500000000,16,085,Valley County, ID,Mar-18,4983,4728,255,5.1
CN1608500000000,16,085,Valley County, ID,Apr-18(p),4806,4588,218,4.5
CN3717700000000,37,177,Tyrrell County, NC,Mar-17,1443,1317,126,8.7
CN3717700000000,37,177,Tyrrell County, NC,Apr-17,1540,1424,116,7.5
CN3717700000000,37,177,Tyrrell County, NC,May-17,1571,1460,111,7.1
CN3717700000000,37,177,Tyrrell County, NC,Jun-17,1682,1582,100,5.9
CN3717700000000,37,177,Tyrrell County, NC,Jul-17,1808,1709,99,5.5
CN3717700000000,37,177,Tyrrell County, NC,Aug-17,1714,1615,99,5.8
CN3717700000000,37,177,Tyrrell County, NC,Sep-17,1601,1515,86,5.4
CN3717700000000,37,177,Tyrrell County, NC,Oct-17,1521,1430,91,6.0
CN3717700000000,37,177,Tyrrell County, NC,Nov-17,1414,1302,112,7.9
CN3717700000000,37,177,Tyrrell County, NC,Dec-17,1380,1255,125,9.1
CN3717700000000,37,177,Tyrrell County, NC,Jan-18,1332,1191,141,10.6
CN3717700000000,37,177,Tyrrell County, NC,Feb-18,1352,1220,132,9.8
CN3717700000000,37,177,Tyrrell County, NC,Mar-18,1374,1254,120,8.7
CN3717700000000,37,177,Tyrrell County, NC,Apr-18(p),1470,1377,93,6.3
CN3806700000000,38,067,Pembina County, ND,Mar-17,3544,3353,191,5.4
CN3806700000000,38,067,Pembina County, ND,Apr-17,3568,3414,154,4.3
CN3806700000000,38,067,Pembina County, ND,May-17,3573,3463,110,3.1
CN3806700000000,38,067,Pembina County, ND,Jun-17,3743,3565,178,4.8
CN3806700000000,38,067,Pembina County, ND,Jul-17,3690,3549,141,3.8
CN3806700000000,38,067,Pembina County, ND,Aug-17,3752,3597,155,4.1
CN3806700000000,38,067,Pembina County, ND,Sep-17,3668,3574,94,2.6
CN3806700000000,38,067,Pembina County, ND,Oct-17,3551,3468,83,2.3
CN3806700000000,38,067,Pembina County, ND,Nov-17,3468,3357,111,3.2
CN3806700000000,38,067,Pembina County, ND,Dec-17,3402,3261,141,4.1
CN3806700000000,38,067,Pembina County, ND,Jan-18,3393,3194,199,5.9
CN3806700000000,38,067,Pembina County, ND,Feb-18,3361,3163,198,5.9
CN3806700000000,38,067,Pembina County, ND,Mar-18,3376,3211,165,4.9
CN3806700000000,38,067,Pembina County, ND,Apr-18(p),3386,3241,145,4.3
CN4010100000000,40,101,Muskogee County, OK,Mar-17,29570,28106,1464,5.0
CN4010100000000,40,101,Muskogee County, OK,Apr-17,29365,28009,1356,4.6
CN4010100000000,40,101,Muskogee County, OK,May-17,29398,27861,1537,5.2
CN4010100000000,40,101,Muskogee County, OK,Jun-17,29821,28166,1655,5.5
CN4010100000000,40,101,Muskogee County, OK,Jul-17,29676,28118,1558,5.3
CN4010100000000,40,101,Muskogee County, OK,Aug-17,29506,27949,1557,5.3
CN4010100000000,40,101,Muskogee County, OK,Sep-17,29753,28245,1508,5.1
CN4010100000000,40,101,Muskogee County, OK,Oct-17,29465,27944,1521,5.2
CN4010100000000,40,101,Muskogee County, OK,Nov-17,29409,27976,1433,4.9
CN4010100000000,40,101,Muskogee County, OK,Dec-17,29254,27797,1457,5.0
CN4010100000000,40,101,Muskogee County, OK,Jan-18,29232,27639,1593,5.4
CN4010100000000,40,101,Muskogee County, OK,Feb-18,29454,28026,1428,4.8
CN4010100000000,40,101,Muskogee County, OK,Mar-18,29669,28319,1350,4.6
CN4010100000000,40,101,Muskogee County, OK,Apr-18(p),29571,28269,1302,4.4
CN0503900000000,05,039,Dallas County, AR,Mar-17,2833,2717,116,4.1
CN0503900000000,05,039,Dallas County, AR,Apr-17,2862,2750,112,3.9
CN0503900000000,05,039,Dallas County, AR,May-17,2883,2762,121,4.2
CN0503900000000,05,039,Dallas County, AR,Jun-17,2958,2811,147,5.0
CN0503900000000,05,039,Dallas County, AR,Jul-17,2873,2712,161,5.6
CN0503900000000,05,039,Dallas County, AR,Aug-17,2822,2681,141,5.0
CN0503900000000,05,039,Dallas County, AR,Sep-17,2815,2685,130,4.6
CN0503900000000,05,039,Dallas County, AR,Oct-17,2957,2841,116,3.9
CN0503900000000,05,039,Dallas County, AR,Nov-17,2943,2831,112,3.8
CN0503900000000,05,039,Dallas County, AR,Dec-17,2920,2806,114,3.9
CN0503900000000,05,039,Dallas County, AR,Jan-18,2924,2780,144,4.9
CN0503900000000,05,039,Dallas County, AR,Feb-18,2861,2718,143,5.0
CN0503900000000,05,039,Dallas County, AR,Mar-18,2870,2733,137,4.8
CN0503900000000,05,039,Dallas County, AR,Apr-18(p),2870,2744,126,4.4
CN4704300000000,47,043,Dickson County, TN,Mar-17,25467,24533,934,3.7
CN4704300000000,47,043,Dickson County, TN,Apr-17,25429,24685,744,2.9
CN4704300000000,47,043,Dickson County, TN,May-17,25468,24752,716,2.8
CN4704300000000,47,043,Dickson County, TN,Jun-17,25937,25003,934,3.6
CN4704300000000,47,043,Dickson County, TN,Jul-17,26030,25147,883,3.4
CN4704300000000,47,043,Dickson County, TN,Aug-17,25729,24894,835,3.2
CN4704300000000,47,043,Dickson County, TN,Sep-17,25985,25214,771,3.0
CN4704300000000,47,043,Dickson County, TN,Oct-17,25896,25178,718,2.8
CN4704300000000,47,043,Dickson County, TN,Nov-17,25839,25095,744,2.9
CN4704300000000,47,043,Dickson County, TN,Dec-17,25794,25068,726,2.8
CN4704300000000,47,043,Dickson County, TN,Jan-18,25765,24881,884,3.4
CN4704300000000,47,043,Dickson County, TN,Feb-18,26044,25207,837,3.2
CN4704300000000,47,043,Dickson County, TN,Mar-18,26069,25284,785,3.0
CN4704300000000,47,043,Dickson County, TN,Apr-18(p),26197,25563,634,2.4
CN0603500000000,06,035,Lassen County, CA,Mar-17,9875,9171,704,7.1
CN0603500000000,06,035,Lassen County, CA,Apr-17,9964,9346,618,6.2
CN0603500000000,06,035,Lassen County, CA,May-17,10016,9510,506,5.1
CN0603500000000,06,035,Lassen County, CA,Jun-17,9992,9464,528,5.3
CN0603500000000,06,035,Lassen County, CA,Jul-17,10004,9468,536,5.4
CN0603500000000,06,035,Lassen County, CA,Aug-17,9974,9463,511,5.1
CN0603500000000,06,035,Lassen County, CA,Sep-17,10171,9729,442,4.3
CN0603500000000,06,035,Lassen County, CA,Oct-17,10675,10242,433,4.1
CN0603500000000,06,035,Lassen County, CA,Nov-17,9826,9368,458,4.7
CN0603500000000,06,035,Lassen County, CA,Dec-17,9753,9259,494,5.1
CN0603500000000,06,035,Lassen County, CA,Jan-18,9886,9314,572,5.8
CN0603500000000,06,035,Lassen County, CA,Feb-18,9859,9238,621,6.3
CN0603500000000,06,035,Lassen County, CA,Mar-18,9791,9213,578,5.9
CN0603500000000,06,035,Lassen County, CA,Apr-18(p),9812,9322,490,5.0
CN1817900000000,18,179,Wells County, IN,Mar-17,14094,13670,424,3.0
CN1817900000000,18,179,Wells County, IN,Apr-17,14113,13791,322,2.3
CN1817900000000,18,179,Wells County, IN,May-17,14404,14054,350,2.4
CN1817900000000,18,179,Wells County, IN,Jun-17,14426,14014,412,2.9
CN1817900000000,18,179,Wells County, IN,Jul-17,14320,13891,429,3.0
CN1817900000000,18,179,Wells County, IN,Aug-17,14193,13709,484,3.4
CN1817900000000,18,179,Wells County, IN,Sep-17,14132,13719,413,2.9
CN1817900000000,18,179,Wells County, IN,Oct-17,14106,13733,373,2.6
CN1817900000000,18,179,Wells County, IN,Nov-17,14187,13794,393,2.8
CN1817900000000,18,179,Wells County, IN,Dec-17,14020,13645,375,2.7
CN1817900000000,18,179,Wells County, IN,Jan-18,13945,13483,462,3.3
CN1817900000000,18,179,Wells County, IN,Feb-18,14248,13776,472,3.3
CN1817900000000,18,179,Wells County, IN,Mar-18,14320,13915,405,2.8
CN1817900000000,18,179,Wells County, IN,Apr-18(p),14355,14010,345,2.4
CN3609300000000,36,093,Schenectady County, NY,Mar-17,76487,73088,3399,4.4
CN3609300000000,36,093,Schenectady County, NY,Apr-17,76747,73554,3193,4.2
CN3609300000000,36,093,Schenectady County, NY,May-17,76500,73184,3316,4.3
CN3609300000000,36,093,Schenectady County, NY,Jun-17,77554,74040,3514,4.5
CN3609300000000,36,093,Schenectady County, NY,Jul-17,77455,73857,3598,4.6
CN3609300000000,36,093,Schenectady County, NY,Aug-17,76771,73294,3477,4.5
CN3609300000000,36,093,Schenectady County, NY,Sep-17,76828,73356,3472,4.5
CN3609300000000,36,093,Schenectady County, NY,Oct-17,76427,73085,3342,4.4
CN3609300000000,36,093,Schenectady County, NY,Nov-17,75948,72556,3392,4.5
CN3609300000000,36,093,Schenectady County, NY,Dec-17,75479,72071,3408,4.5
CN3609300000000,36,093,Schenectady County, NY,Jan-18,76238,72311,3927,5.2
CN3609300000000,36,093,Schenectady County, NY,Feb-18,75798,71693,4105,5.4
CN3609300000000,36,093,Schenectady County, NY,Mar-18,75739,71974,3765,5.0
CN3609300000000,36,093,Schenectady County, NY,Apr-18(p),75737,72357,3380,4.5
CN4805300000000,48,053,Burnet County, TX,Mar-17,22019,21279,740,3.4
CN4805300000000,48,053,Burnet County, TX,Apr-17,22200,21558,642,2.9
CN4805300000000,48,053,Burnet County, TX,May-17,22382,21695,687,3.1
CN4805300000000,48,053,Burnet County, TX,Jun-17,22569,21838,731,3.2
CN4805300000000,48,053,Burnet County, TX,Jul-17,22404,21636,768,3.4
CN4805300000000,48,053,Burnet County, TX,Aug-17,22278,21540,738,3.3
CN4805300000000,48,053,Burnet County, TX,Sep-17,22197,21531,666,3.0
CN4805300000000,48,053,Burnet County, TX,Oct-17,22024,21420,604,2.7
CN4805300000000,48,053,Burnet County, TX,Nov-17,22104,21476,628,2.8
CN4805300000000,48,053,Burnet County, TX,Dec-17,22038,21446,592,2.7
CN4805300000000,48,053,Burnet County, TX,Jan-18,22094,21419,675,3.1
CN4805300000000,48,053,Burnet County, TX,Feb-18,22421,21733,688,3.1
CN4805300000000,48,053,Burnet County, TX,Mar-18,22609,21892,717,3.2
CN4805300000000,48,053,Burnet County, TX,Apr-18(p),22657,22026,631,2.8
CN4704100000000,47,041,DeKalb County, TN,Mar-17,7581,7180,401,5.3
CN4704100000000,47,041,DeKalb County, TN,Apr-17,7684,7341,343,4.5
CN4704100000000,47,041,DeKalb County, TN,May-17,7748,7423,325,4.2
CN4704100000000,47,041,DeKalb County, TN,Jun-17,7795,7394,401,5.1
CN4704100000000,47,041,DeKalb County, TN,Jul-17,7789,7405,384,4.9
CN4704100000000,47,041,DeKalb County, TN,Aug-17,7881,7528,353,4.5
CN4704100000000,47,041,DeKalb County, TN,Sep-17,7830,7513,317,4.0
CN4704100000000,47,041,DeKalb County, TN,Oct-17,7727,7429,298,3.9
CN4704100000000,47,041,DeKalb County, TN,Nov-17,7696,7397,299,3.9
CN4704100000000,47,041,DeKalb County, TN,Dec-17,7688,7389,299,3.9
CN4704100000000,47,041,DeKalb County, TN,Jan-18,7715,7352,363,4.7
CN4704100000000,47,041,DeKalb County, TN,Feb-18,7784,7427,357,4.6
CN4704100000000,47,041,DeKalb County, TN,Mar-18,7745,7415,330,4.3
CN4704100000000,47,041,DeKalb County, TN,Apr-18(p),7806,7537,269,3.4
CN4833300000000,48,333,Mills County, TX,Mar-17,1949,1876,73,3.7
CN4833300000000,48,333,Mills County, TX,Apr-17,1904,1843,61,3.2
CN4833300000000,48,333,Mills County, TX,May-17,1924,1860,64,3.3
CN4833300000000,48,333,Mills County, TX,Jun-17,1927,1856,71,3.7
CN4833300000000,48,333,Mills County, TX,Jul-17,1913,1839,74,3.9
CN4833300000000,48,333,Mills County, TX,Aug-17,1919,1849,70,3.6
CN4833300000000,48,333,Mills County, TX,Sep-17,1903,1840,63,3.3
CN4833300000000,48,333,Mills County, TX,Oct-17,1938,1882,56,2.9
CN4833300000000,48,333,Mills County, TX,Nov-17,1923,1864,59,3.1
CN4833300000000,48,333,Mills County, TX,Dec-17,1914,1862,52,2.7
CN4833300000000,48,333,Mills County, TX,Jan-18,1873,1810,63,3.4
CN4833300000000,48,333,Mills County, TX,Feb-18,1906,1838,68,3.6
CN4833300000000,48,333,Mills County, TX,Mar-18,1967,1894,73,3.7
CN4833300000000,48,333,Mills County, TX,Apr-18(p),1924,1861,63,3.3
CN0805300000000,08,053,Hinsdale County, CO,Mar-17,414,405,9,2.2
CN0805300000000,08,053,Hinsdale County, CO,Apr-17,415,405,10,2.4
CN0805300000000,08,053,Hinsdale County, CO,May-17,435,425,10,2.3
CN0805300000000,08,053,Hinsdale County, CO,Jun-17,567,558,9,1.6
CN0805300000000,08,053,Hinsdale County, CO,Jul-17,603,594,9,1.5
CN0805300000000,08,053,Hinsdale County, CO,Aug-17,604,595,9,1.5
CN0805300000000,08,053,Hinsdale County, CO,Sep-17,561,549,12,2.1
CN0805300000000,08,053,Hinsdale County, CO,Oct-17,515,501,14,2.7
CN0805300000000,08,053,Hinsdale County, CO,Nov-17,485,471,14,2.9
CN0805300000000,08,053,Hinsdale County, CO,Dec-17,480,466,14,2.9
CN0805300000000,08,053,Hinsdale County, CO,Jan-18,459,446,13,2.8
CN0805300000000,08,053,Hinsdale County, CO,Feb-18,470,457,13,2.8
CN0805300000000,08,053,Hinsdale County, CO,Mar-18,466,455,11,2.4
CN0805300000000,08,053,Hinsdale County, CO,Apr-18(p),470,460,10,2.1
CN1000500000000,10,005,Sussex County, DE,Mar-17,99670,94494,5176,5.2
CN1000500000000,10,005,Sussex County, DE,Apr-17,101015,96285,4730,4.7
CN1000500000000,10,005,Sussex County, DE,May-17,103171,98942,4229,4.1
CN1000500000000,10,005,Sussex County, DE,Jun-17,109198,104608,4590,4.2
CN1000500000000,10,005,Sussex County, DE,Jul-17,109886,105453,4433,4.0
CN1000500000000,10,005,Sussex County, DE,Aug-17,109371,105112,4259,3.9
CN1000500000000,10,005,Sussex County, DE,Sep-17,104484,100175,4309,4.1
CN1000500000000,10,005,Sussex County, DE,Oct-17,102047,97773,4274,4.2
CN1000500000000,10,005,Sussex County, DE,Nov-17,100371,95975,4396,4.4
CN1000500000000,10,005,Sussex County, DE,Dec-17,100070,95353,4717,4.7
CN1000500000000,10,005,Sussex County, DE,Jan-18,99624,94159,5465,5.5
CN1000500000000,10,005,Sussex County, DE,Feb-18,99475,94472,5003,5.0
CN1000500000000,10,005,Sussex County, DE,Mar-18,101180,96620,4560,4.5
CN1000500000000,10,005,Sussex County, DE,Apr-18(p),102144,98180,3964,3.9
CN1900100000000,19,001,Adair County, IA,Mar-17,4055,3924,131,3.2
CN1900100000000,19,001,Adair County, IA,Apr-17,4142,4029,113,2.7
CN1900100000000,19,001,Adair County, IA,May-17,4143,4037,106,2.6
CN1900100000000,19,001,Adair County, IA,Jun-17,4217,4109,108,2.6
CN1900100000000,19,001,Adair County, IA,Jul-17,4272,4171,101,2.4
CN1900100000000,19,001,Adair County, IA,Aug-17,4194,4089,105,2.5
CN1900100000000,19,001,Adair County, IA,Sep-17,4156,4052,104,2.5
CN1900100000000,19,001,Adair County, IA,Oct-17,4190,4107,83,2.0
CN1900100000000,19,001,Adair County, IA,Nov-17,4136,4051,85,2.1
CN1900100000000,19,001,Adair County, IA,Dec-17,4116,4005,111,2.7
CN1900100000000,19,001,Adair County, IA,Jan-18,4042,3895,147,3.6
CN1900100000000,19,001,Adair County, IA,Feb-18,4091,3935,156,3.8
CN1900100000000,19,001,Adair County, IA,Mar-18,4027,3908,119,3.0
CN1900100000000,19,001,Adair County, IA,Apr-18(p),4025,3924,101,2.5
CN4838300000000,48,383,Reagan County, TX,Mar-17,1791,1709,82,4.6
CN4838300000000,48,383,Reagan County, TX,Apr-17,1786,1711,75,4.2
CN4838300000000,48,383,Reagan County, TX,May-17,1790,1721,69,3.9
CN4838300000000,48,383,Reagan County, TX,Jun-17,1808,1738,70,3.9
CN4838300000000,48,383,Reagan County, TX,Jul-17,1772,1704,68,3.8
CN4838300000000,48,383,Reagan County, TX,Aug-17,1815,1751,64,3.5
CN4838300000000,48,383,Reagan County, TX,Sep-17,1785,1727,58,3.2
CN4838300000000,48,383,Reagan County, TX,Oct-17,1760,1708,52,3.0
CN4838300000000,48,383,Reagan County, TX,Nov-17,1749,1695,54,3.1
CN4838300000000,48,383,Reagan County, TX,Dec-17,1743,1692,51,2.9
CN4838300000000,48,383,Reagan County, TX,Jan-18,1811,1753,58,3.2
CN4838300000000,48,383,Reagan County, TX,Feb-18,1821,1768,53,2.9
CN4838300000000,48,383,Reagan County, TX,Mar-18,1847,1795,52,2.8
CN4838300000000,48,383,Reagan County, TX,Apr-18(p),1893,1845,48,2.5
CN4844500000000,48,445,Terry County, TX,Mar-17,5395,5109,286,5.3
CN4844500000000,48,445,Terry County, TX,Apr-17,5434,5171,263,4.8
CN4844500000000,48,445,Terry County, TX,May-17,5443,5183,260,4.8
CN4844500000000,48,445,Terry County, TX,Jun-17,5372,5076,296,5.5
CN4844500000000,48,445,Terry County, TX,Jul-17,5178,4891,287,5.5
CN4844500000000,48,445,Terry County, TX,Aug-17,5231,4941,290,5.5
CN4844500000000,48,445,Terry County, TX,Sep-17,5135,4885,250,4.9
CN4844500000000,48,445,Terry County, TX,Oct-17,5162,4936,226,4.4
CN4844500000000,48,445,Terry County, TX,Nov-17,5120,4900,220,4.3
CN4844500000000,48,445,Terry County, TX,Dec-17,5126,4906,220,4.3
CN4844500000000,48,445,Terry County, TX,Jan-18,5020,4766,254,5.1
CN4844500000000,48,445,Terry County, TX,Feb-18,5104,4851,253,5.0
CN4844500000000,48,445,Terry County, TX,Mar-18,5258,5017,241,4.6
CN4844500000000,48,445,Terry County, TX,Apr-18(p),5230,5013,217,4.1
CN1911300000000,19,113,Linn County, IA,Mar-17,118464,114206,4258,3.6
CN1911300000000,19,113,Linn County, IA,Apr-17,117953,114054,3899,3.3
CN1911300000000,19,113,Linn County, IA,May-17,117216,113428,3788,3.2
CN1911300000000,19,113,Linn County, IA,Jun-17,120063,115902,4161,3.5
CN1911300000000,19,113,Linn County, IA,Jul-17,119442,115510,3932,3.3
CN1911300000000,19,113,Linn County, IA,Aug-17,118383,114288,4095,3.5
CN1911300000000,19,113,Linn County, IA,Sep-17,118130,114449,3681,3.1
CN1911300000000,19,113,Linn County, IA,Oct-17,117617,114528,3089,2.6
CN1911300000000,19,113,Linn County, IA,Nov-17,117909,114557,3352,2.8
CN1911300000000,19,113,Linn County, IA,Dec-17,117657,113874,3783,3.2
CN1911300000000,19,113,Linn County, IA,Jan-18,118008,113486,4522,3.8
CN1911300000000,19,113,Linn County, IA,Feb-18,118833,114482,4351,3.7
CN1911300000000,19,113,Linn County, IA,Mar-18,118811,115008,3803,3.2
CN1911300000000,19,113,Linn County, IA,Apr-18(p),119160,115887,3273,2.7
CN3604900000000,36,049,Lewis County, NY,Mar-17,11875,10855,1020,8.6
CN3604900000000,36,049,Lewis County, NY,Apr-17,11746,10917,829,7.1
CN3604900000000,36,049,Lewis County, NY,May-17,11532,10819,713,6.2
CN3604900000000,36,049,Lewis County, NY,Jun-17,12024,11369,655,5.4
CN3604900000000,36,049,Lewis County, NY,Jul-17,11808,11144,664,5.6
CN3604900000000,36,049,Lewis County, NY,Aug-17,11567,10940,627,5.4
CN3604900000000,36,049,Lewis County, NY,Sep-17,11477,10852,625,5.4
CN3604900000000,36,049,Lewis County, NY,Oct-17,11432,10825,607,5.3
CN3604900000000,36,049,Lewis County, NY,Nov-17,11585,10905,680,5.9
CN3604900000000,36,049,Lewis County, NY,Dec-17,11703,10893,810,6.9
CN3604900000000,36,049,Lewis County, NY,Jan-18,12138,11063,1075,8.9
CN3604900000000,36,049,Lewis County, NY,Feb-18,12045,10952,1093,9.1
CN3604900000000,36,049,Lewis County, NY,Mar-18,11624,10640,984,8.5
CN3604900000000,36,049,Lewis County, NY,Apr-18(p),11517,10693,824,7.2
CN3911300000000,39,113,Montgomery County, OH,Mar-17,250690,238315,12375,4.9
CN3911300000000,39,113,Montgomery County, OH,Apr-17,250556,239380,11176,4.5
CN3911300000000,39,113,Montgomery County, OH,May-17,251620,240235,11385,4.5
CN3911300000000,39,113,Montgomery County, OH,Jun-17,254212,241167,13045,5.1
CN3911300000000,39,113,Montgomery County, OH,Jul-17,257825,244703,13122,5.1
CN3911300000000,39,113,Montgomery County, OH,Aug-17,255443,242450,12993,5.1
CN3911300000000,39,113,Montgomery County, OH,Sep-17,253430,241689,11741,4.6
CN3911300000000,39,113,Montgomery County, OH,Oct-17,255317,243965,11352,4.4
CN3911300000000,39,113,Montgomery County, OH,Nov-17,256424,245023,11401,4.4
CN3911300000000,39,113,Montgomery County, OH,Dec-17,257208,245791,11417,4.4
CN3911300000000,39,113,Montgomery County, OH,Jan-18,250942,239092,11850,4.7
CN3911300000000,39,113,Montgomery County, OH,Feb-18,256074,244822,11252,4.4
CN3911300000000,39,113,Montgomery County, OH,Mar-18,257587,247203,10384,4.0
CN3911300000000,39,113,Montgomery County, OH,Apr-18(p),256890,246854,10036,3.9
CN2212700000000,22,127,Winn Parish, LA,Mar-17,5031,4689,342,6.8
CN2212700000000,22,127,Winn Parish, LA,Apr-17,5117,4798,319,6.2
CN2212700000000,22,127,Winn Parish, LA,May-17,5151,4820,331,6.4
CN2212700000000,22,127,Winn Parish, LA,Jun-17,5272,4910,362,6.9
CN2212700000000,22,127,Winn Parish, LA,Jul-17,5264,4905,359,6.8
CN2212700000000,22,127,Winn Parish, LA,Aug-17,5064,4717,347,6.9
CN2212700000000,22,127,Winn Parish, LA,Sep-17,4979,4674,305,6.1
CN2212700000000,22,127,Winn Parish, LA,Oct-17,4949,4682,267,5.4
CN2212700000000,22,127,Winn Parish, LA,Nov-17,4921,4659,262,5.3
CN2212700000000,22,127,Winn Parish, LA,Dec-17,4930,4664,266,5.4
CN2212700000000,22,127,Winn Parish, LA,Jan-18,5011,4721,290,5.8
CN2212700000000,22,127,Winn Parish, LA,Feb-18,4964,4699,265,5.3
CN2212700000000,22,127,Winn Parish, LA,Mar-18,5010,4728,282,5.6
CN2212700000000,22,127,Winn Parish, LA,Apr-18(p),4982,4702,280,5.6
CN4010300000000,40,103,Noble County, OK,Mar-17,5818,5623,195,3.4
CN4010300000000,40,103,Noble County, OK,Apr-17,5788,5610,178,3.1
CN4010300000000,40,103,Noble County, OK,May-17,5836,5645,191,3.3
CN4010300000000,40,103,Noble County, OK,Jun-17,5807,5586,221,3.8
CN4010300000000,40,103,Noble County, OK,Jul-17,5696,5503,193,3.4
CN4010300000000,40,103,Noble County, OK,Aug-17,5689,5501,188,3.3
CN4010300000000,40,103,Noble County, OK,Sep-17,5729,5539,190,3.3
CN4010300000000,40,103,Noble County, OK,Oct-17,5803,5626,177,3.1
CN4010300000000,40,103,Noble County, OK,Nov-17,5817,5639,178,3.1
CN4010300000000,40,103,Noble County, OK,Dec-17,5752,5577,175,3.0
CN4010300000000,40,103,Noble County, OK,Jan-18,5748,5556,192,3.3
CN4010300000000,40,103,Noble County, OK,Feb-18,5706,5525,181,3.2
CN4010300000000,40,103,Noble County, OK,Mar-18,5732,5547,185,3.2
CN4010300000000,40,103,Noble County, OK,Apr-18(p),5692,5519,173,3.0
CN0504500000000,05,045,Faulkner County, AR,Mar-17,60759,58779,1980,3.3
CN0504500000000,05,045,Faulkner County, AR,Apr-17,60952,59178,1774,2.9
CN0504500000000,05,045,Faulkner County, AR,May-17,61284,59256,2028,3.3
CN0504500000000,05,045,Faulkner County, AR,Jun-17,62000,59815,2185,3.5
CN0504500000000,05,045,Faulkner County, AR,Jul-17,62960,60650,2310,3.7
CN0504500000000,05,045,Faulkner County, AR,Aug-17,61958,59875,2083,3.4
CN0504500000000,05,045,Faulkner County, AR,Sep-17,61686,59723,1963,3.2
CN0504500000000,05,045,Faulkner County, AR,Oct-17,61320,59549,1771,2.9
CN0504500000000,05,045,Faulkner County, AR,Nov-17,61192,59367,1825,3.0
CN0504500000000,05,045,Faulkner County, AR,Dec-17,60759,58805,1954,3.2
CN0504500000000,05,045,Faulkner County, AR,Jan-18,60066,57758,2308,3.8
CN0504500000000,05,045,Faulkner County, AR,Feb-18,60781,58443,2338,3.8
CN0504500000000,05,045,Faulkner County, AR,Mar-18,61130,59024,2106,3.4
CN0504500000000,05,045,Faulkner County, AR,Apr-18(p),60758,58909,1849,3.0
CN2302100000000,23,021,Piscataquis County, ME,Mar-17,7480,7126,354,4.7
CN2302100000000,23,021,Piscataquis County, ME,Apr-17,7447,7090,357,4.8
CN2302100000000,23,021,Piscataquis County, ME,May-17,7509,7160,349,4.6
CN2302100000000,23,021,Piscataquis County, ME,Jun-17,7668,7370,298,3.9
CN2302100000000,23,021,Piscataquis County, ME,Jul-17,7743,7461,282,3.6
CN2302100000000,23,021,Piscataquis County, ME,Aug-17,7674,7408,266,3.5
CN2302100000000,23,021,Piscataquis County, ME,Sep-17,7559,7321,238,3.1
CN2302100000000,23,021,Piscataquis County, ME,Oct-17,7558,7322,236,3.1
CN2302100000000,23,021,Piscataquis County, ME,Nov-17,7475,7195,280,3.7
CN2302100000000,23,021,Piscataquis County, ME,Dec-17,7462,7217,245,3.3
CN2302100000000,23,021,Piscataquis County, ME,Jan-18,7490,7174,316,4.2
CN2302100000000,23,021,Piscataquis County, ME,Feb-18,7545,7244,301,4.0
CN2302100000000,23,021,Piscataquis County, ME,Mar-18,7571,7269,302,4.0
CN2302100000000,23,021,Piscataquis County, ME,Apr-18(p),7523,7223,300,4.0
CN0509500000000,05,095,Monroe County, AR,Mar-17,2825,2704,121,4.3
CN0509500000000,05,095,Monroe County, AR,Apr-17,2888,2788,100,3.5
CN0509500000000,05,095,Monroe County, AR,May-17,2879,2779,100,3.5
CN0509500000000,05,095,Monroe County, AR,Jun-17,2937,2817,120,4.1
CN0509500000000,05,095,Monroe County, AR,Jul-17,2807,2676,131,4.7
CN0509500000000,05,095,Monroe County, AR,Aug-17,2802,2683,119,4.2
CN0509500000000,05,095,Monroe County, AR,Sep-17,2786,2670,116,4.2
CN0509500000000,05,095,Monroe County, AR,Oct-17,2808,2704,104,3.7
CN0509500000000,05,095,Monroe County, AR,Nov-17,2749,2637,112,4.1
CN0509500000000,05,095,Monroe County, AR,Dec-17,2749,2631,118,4.3
CN0509500000000,05,095,Monroe County, AR,Jan-18,2727,2581,146,5.4
CN0509500000000,05,095,Monroe County, AR,Feb-18,2722,2588,134,4.9
CN0509500000000,05,095,Monroe County, AR,Mar-18,2727,2608,119,4.4
CN0509500000000,05,095,Monroe County, AR,Apr-18(p),2769,2661,108,3.9
CN0605700000000,06,057,Nevada County, CA,Mar-17,48772,46594,2178,4.5
CN0605700000000,06,057,Nevada County, CA,Apr-17,48265,46294,1971,4.1
CN0605700000000,06,057,Nevada County, CA,May-17,47849,46037,1812,3.8
CN0605700000000,06,057,Nevada County, CA,Jun-17,48918,46911,2007,4.1
CN0605700000000,06,057,Nevada County, CA,Jul-17,48641,46520,2121,4.4
CN0605700000000,06,057,Nevada County, CA,Aug-17,49466,47385,2081,4.2
CN0605700000000,06,057,Nevada County, CA,Sep-17,49024,47213,1811,3.7
CN0605700000000,06,057,Nevada County, CA,Oct-17,48444,46693,1751,3.6
CN0605700000000,06,057,Nevada County, CA,Nov-17,48245,46520,1725,3.6
CN0605700000000,06,057,Nevada County, CA,Dec-17,48609,46892,1717,3.5
CN0605700000000,06,057,Nevada County, CA,Jan-18,49135,47259,1876,3.8
CN0605700000000,06,057,Nevada County, CA,Feb-18,49057,47180,1877,3.8
CN0605700000000,06,057,Nevada County, CA,Mar-18,48704,46909,1795,3.7
CN0605700000000,06,057,Nevada County, CA,Apr-18(p),48110,46545,1565,3.3
CN4822700000000,48,227,Howard County, TX,Mar-17,13292,12656,636,4.8
CN4822700000000,48,227,Howard County, TX,Apr-17,13226,12648,578,4.4
CN4822700000000,48,227,Howard County, TX,May-17,13220,12654,566,4.3
CN4822700000000,48,227,Howard County, TX,Jun-17,13198,12603,595,4.5
CN4822700000000,48,227,Howard County, TX,Jul-17,13324,12736,588,4.4
CN4822700000000,48,227,Howard County, TX,Aug-17,13231,12661,570,4.3
CN4822700000000,48,227,Howard County, TX,Sep-17,13232,12730,502,3.8
CN4822700000000,48,227,Howard County, TX,Oct-17,13065,12606,459,3.5
CN4822700000000,48,227,Howard County, TX,Nov-17,13119,12652,467,3.6
CN4822700000000,48,227,Howard County, TX,Dec-17,13079,12646,433,3.3
CN4822700000000,48,227,Howard County, TX,Jan-18,13286,12799,487,3.7
CN4822700000000,48,227,Howard County, TX,Feb-18,13398,12905,493,3.7
CN4822700000000,48,227,Howard County, TX,Mar-18,13493,12954,539,4.0
CN4822700000000,48,227,Howard County, TX,Apr-18(p),13384,12943,441,3.3
CN0901500000000,09,015,Windham County, CT,Mar-17,64503,60854,3649,5.7
CN0901500000000,09,015,Windham County, CT,Apr-17,63933,60876,3057,4.8
CN0901500000000,09,015,Windham County, CT,May-17,64320,61281,3039,4.7
CN0901500000000,09,015,Windham County, CT,Jun-17,64896,61481,3415,5.3
CN0901500000000,09,015,Windham County, CT,Jul-17,65173,61774,3399,5.2
CN0901500000000,09,015,Windham County, CT,Aug-17,64351,61134,3217,5.0
CN0901500000000,09,015,Windham County, CT,Sep-17,63555,60727,2828,4.4
CN0901500000000,09,015,Windham County, CT,Oct-17,63807,61079,2728,4.3
CN0901500000000,09,015,Windham County, CT,Nov-17,63678,60970,2708,4.3
CN0901500000000,09,015,Windham County, CT,Dec-17,63739,61018,2721,4.3
CN0901500000000,09,015,Windham County, CT,Jan-18,63770,59965,3805,6.0
CN0901500000000,09,015,Windham County, CT,Feb-18,63780,60165,3615,5.7
CN0901500000000,09,015,Windham County, CT,Mar-18,63836,60432,3404,5.3
CN0901500000000,09,015,Windham County, CT,Apr-18(p),63233,60419,2814,4.5
CN2605700000000,26,057,Gratiot County, MI,Mar-17,18255,17195,1060,5.8
CN2605700000000,26,057,Gratiot County, MI,Apr-17,18189,17309,880,4.8
CN2605700000000,26,057,Gratiot County, MI,May-17,18033,17186,847,4.7
CN2605700000000,26,057,Gratiot County, MI,Jun-17,18031,17036,995,5.5
CN2605700000000,26,057,Gratiot County, MI,Jul-17,17866,16579,1287,7.2
CN2605700000000,26,057,Gratiot County, MI,Aug-17,17723,16685,1038,5.9
CN2605700000000,26,057,Gratiot County, MI,Sep-17,17867,16979,888,5.0
CN2605700000000,26,057,Gratiot County, MI,Oct-17,18168,17294,874,4.8
CN2605700000000,26,057,Gratiot County, MI,Nov-17,18061,17255,806,4.5
CN2605700000000,26,057,Gratiot County, MI,Dec-17,18083,17178,905,5.0
CN2605700000000,26,057,Gratiot County, MI,Jan-18,18243,16948,1295,7.1
CN2605700000000,26,057,Gratiot County, MI,Feb-18,18293,17150,1143,6.2
CN2605700000000,26,057,Gratiot County, MI,Mar-18,18204,17182,1022,5.6
CN2605700000000,26,057,Gratiot County, MI,Apr-18(p),18219,17260,959,5.3
CN2706900000000,27,069,Kittson County, MN,Mar-17,2417,2301,116,4.8
CN2706900000000,27,069,Kittson County, MN,Apr-17,2414,2318,96,4.0
CN2706900000000,27,069,Kittson County, MN,May-17,2410,2343,67,2.8
CN2706900000000,27,069,Kittson County, MN,Jun-17,2414,2319,95,3.9
CN2706900000000,27,069,Kittson County, MN,Jul-17,2365,2277,88,3.7
CN2706900000000,27,069,Kittson County, MN,Aug-17,2309,2233,76,3.3
CN2706900000000,27,069,Kittson County, MN,Sep-17,2282,2223,59,2.6
CN2706900000000,27,069,Kittson County, MN,Oct-17,2386,2341,45,1.9
CN2706900000000,27,069,Kittson County, MN,Nov-17,2375,2301,74,3.1
CN2706900000000,27,069,Kittson County, MN,Dec-17,2374,2276,98,4.1
CN2706900000000,27,069,Kittson County, MN,Jan-18,2343,2232,111,4.7
CN2706900000000,27,069,Kittson County, MN,Feb-18,2343,2243,100,4.3
CN2706900000000,27,069,Kittson County, MN,Mar-18,2361,2260,101,4.3
CN2706900000000,27,069,Kittson County, MN,Apr-18(p),2375,2292,83,3.5
CN3202900000000,32,029,Storey County, NV,Mar-17,1927,1821,106,5.5
CN3202900000000,32,029,Storey County, NV,Apr-17,1950,1845,105,5.4
CN3202900000000,32,029,Storey County, NV,May-17,1971,1869,102,5.2
CN3202900000000,32,029,Storey County, NV,Jun-17,1964,1872,92,4.7
CN3202900000000,32,029,Storey County, NV,Jul-17,1975,1883,92,4.7
CN3202900000000,32,029,Storey County, NV,Aug-17,1980,1890,90,4.5
CN3202900000000,32,029,Storey County, NV,Sep-17,1999,1912,87,4.4
CN3202900000000,32,029,Storey County, NV,Oct-17,2000,1916,84,4.2
CN3202900000000,32,029,Storey County, NV,Nov-17,2001,1913,88,4.4
CN3202900000000,32,029,Storey County, NV,Dec-17,2005,1911,94,4.7
CN3202900000000,32,029,Storey County, NV,Jan-18,1990,1878,112,5.6
CN3202900000000,32,029,Storey County, NV,Feb-18,2019,1910,109,5.4
CN3202900000000,32,029,Storey County, NV,Mar-18,2005,1912,93,4.6
CN3202900000000,32,029,Storey County, NV,Apr-18(p),2030,1930,100,4.9
CN3916300000000,39,163,Vinton County, OH,Mar-17,5556,5079,477,8.6
CN3916300000000,39,163,Vinton County, OH,Apr-17,5463,5108,355,6.5
CN3916300000000,39,163,Vinton County, OH,May-17,5429,5126,303,5.6
CN3916300000000,39,163,Vinton County, OH,Jun-17,5494,5147,347,6.3
CN3916300000000,39,163,Vinton County, OH,Jul-17,5467,5116,351,6.4
CN3916300000000,39,163,Vinton County, OH,Aug-17,5529,5177,352,6.4
CN3916300000000,39,163,Vinton County, OH,Sep-17,5479,5167,312,5.7
CN3916300000000,39,163,Vinton County, OH,Oct-17,5437,5151,286,5.3
CN3916300000000,39,163,Vinton County, OH,Nov-17,5426,5106,320,5.9
CN3916300000000,39,163,Vinton County, OH,Dec-17,5378,5022,356,6.6
CN3916300000000,39,163,Vinton County, OH,Jan-18,5345,4896,449,8.4
CN3916300000000,39,163,Vinton County, OH,Feb-18,5465,5046,419,7.7
CN3916300000000,39,163,Vinton County, OH,Mar-18,5545,5176,369,6.7
CN3916300000000,39,163,Vinton County, OH,Apr-18(p),5480,5154,326,5.9
CN4901500000000,49,015,Emery County, UT,Mar-17,4180,3926,254,6.1
CN4901500000000,49,015,Emery County, UT,Apr-17,4219,4005,214,5.1
CN4901500000000,49,015,Emery County, UT,May-17,4284,4079,205,4.8
CN4901500000000,49,015,Emery County, UT,Jun-17,4412,4171,241,5.5
CN4901500000000,49,015,Emery County, UT,Jul-17,4351,4129,222,5.1
CN4901500000000,49,015,Emery County, UT,Aug-17,4298,4085,213,5.0
CN4901500000000,49,015,Emery County, UT,Sep-17,4258,4083,175,4.1
CN4901500000000,49,015,Emery County, UT,Oct-17,4269,4094,175,4.1
CN4901500000000,49,015,Emery County, UT,Nov-17,4225,4061,164,3.9
CN4901500000000,49,015,Emery County, UT,Dec-17,4278,4088,190,4.4
CN4901500000000,49,015,Emery County, UT,Jan-18,4293,4040,253,5.9
CN4901500000000,49,015,Emery County, UT,Feb-18,4227,3947,280,6.6
CN4901500000000,49,015,Emery County, UT,Mar-18,4218,3975,243,5.8
CN4901500000000,49,015,Emery County, UT,Apr-18(p),4210,4009,201,4.8
CN3101700000000,31,017,Brown County, NE,Mar-17,1386,1328,58,4.2
CN3101700000000,31,017,Brown County, NE,Apr-17,1415,1373,42,3.0
CN3101700000000,31,017,Brown County, NE,May-17,1444,1401,43,3.0
CN3101700000000,31,017,Brown County, NE,Jun-17,1488,1443,45,3.0
CN3101700000000,31,017,Brown County, NE,Jul-17,1456,1412,44,3.0
CN3101700000000,31,017,Brown County, NE,Aug-17,1414,1372,42,3.0
CN3101700000000,31,017,Brown County, NE,Sep-17,1331,1297,34,2.6
CN3101700000000,31,017,Brown County, NE,Oct-17,1340,1305,35,2.6
CN3101700000000,31,017,Brown County, NE,Nov-17,1339,1308,31,2.3
CN3101700000000,31,017,Brown County, NE,Dec-17,1337,1295,42,3.1
CN3101700000000,31,017,Brown County, NE,Jan-18,1376,1329,47,3.4
CN3101700000000,31,017,Brown County, NE,Feb-18,1338,1290,48,3.6
CN3101700000000,31,017,Brown County, NE,Mar-18,1367,1315,52,3.8
CN3101700000000,31,017,Brown County, NE,Apr-18(p),1368,1315,53,3.9
CN3112300000000,31,123,Morrill County, NE,Mar-17,2590,2509,81,3.1
CN3112300000000,31,123,Morrill County, NE,Apr-17,2627,2551,76,2.9
CN3112300000000,31,123,Morrill County, NE,May-17,2658,2584,74,2.8
CN3112300000000,31,123,Morrill County, NE,Jun-17,2737,2659,78,2.8
CN3112300000000,31,123,Morrill County, NE,Jul-17,2685,2605,80,3.0
CN3112300000000,31,123,Morrill County, NE,Aug-17,2622,2548,74,2.8
CN3112300000000,31,123,Morrill County, NE,Sep-17,2540,2474,66,2.6
CN3112300000000,31,123,Morrill County, NE,Oct-17,2565,2502,63,2.5
CN3112300000000,31,123,Morrill County, NE,Nov-17,2588,2518,70,2.7
CN3112300000000,31,123,Morrill County, NE,Dec-17,2569,2498,71,2.8
CN3112300000000,31,123,Morrill County, NE,Jan-18,2613,2544,69,2.6
CN3112300000000,31,123,Morrill County, NE,Feb-18,2578,2511,67,2.6
CN3112300000000,31,123,Morrill County, NE,Mar-18,2606,2533,73,2.8
CN3112300000000,31,123,Morrill County, NE,Apr-18(p),2617,2547,70,2.7
CN4800300000000,48,003,Andrews County, TX,Mar-17,8918,8614,304,3.4
CN4800300000000,48,003,Andrews County, TX,Apr-17,8904,8631,273,3.1
CN4800300000000,48,003,Andrews County, TX,May-17,9020,8757,263,2.9
CN4800300000000,48,003,Andrews County, TX,Jun-17,9042,8752,290,3.2
CN4800300000000,48,003,Andrews County, TX,Jul-17,9121,8845,276,3.0
CN4800300000000,48,003,Andrews County, TX,Aug-17,9104,8838,266,2.9
CN4800300000000,48,003,Andrews County, TX,Sep-17,9162,8915,247,2.7
CN4800300000000,48,003,Andrews County, TX,Oct-17,9081,8855,226,2.5
CN4800300000000,48,003,Andrews County, TX,Nov-17,9107,8874,233,2.6
CN4800300000000,48,003,Andrews County, TX,Dec-17,9052,8839,213,2.4
CN4800300000000,48,003,Andrews County, TX,Jan-18,9150,8906,244,2.7
CN4800300000000,48,003,Andrews County, TX,Feb-18,9210,8966,244,2.6
CN4800300000000,48,003,Andrews County, TX,Mar-18,9219,8971,248,2.7
CN4800300000000,48,003,Andrews County, TX,Apr-18(p),9220,8999,221,2.4
CN4706900000000,47,069,Hardeman County, TN,Mar-17,9247,8726,521,5.6
CN4706900000000,47,069,Hardeman County, TN,Apr-17,9126,8715,411,4.5
CN4706900000000,47,069,Hardeman County, TN,May-17,9159,8754,405,4.4
CN4706900000000,47,069,Hardeman County, TN,Jun-17,9282,8812,470,5.1
CN4706900000000,47,069,Hardeman County, TN,Jul-17,9289,8842,447,4.8
CN4706900000000,47,069,Hardeman County, TN,Aug-17,9272,8830,442,4.8
CN4706900000000,47,069,Hardeman County, TN,Sep-17,9325,8886,439,4.7
CN4706900000000,47,069,Hardeman County, TN,Oct-17,9296,8855,441,4.7
CN4706900000000,47,069,Hardeman County, TN,Nov-17,9274,8811,463,5.0
CN4706900000000,47,069,Hardeman County, TN,Dec-17,9279,8818,461,5.0
CN4706900000000,47,069,Hardeman County, TN,Jan-18,9249,8737,512,5.5
CN4706900000000,47,069,Hardeman County, TN,Feb-18,9326,8843,483,5.2
CN4706900000000,47,069,Hardeman County, TN,Mar-18,9249,8788,461,5.0
CN4706900000000,47,069,Hardeman County, TN,Apr-18(p),9233,8851,382,4.1
CN0111500000000,01,115,St. Clair County, AL,Mar-17,39123,37357,1766,4.5
CN0111500000000,01,115,St. Clair County, AL,Apr-17,38965,37508,1457,3.7
CN0111500000000,01,115,St. Clair County, AL,May-17,38897,37482,1415,3.6
CN0111500000000,01,115,St. Clair County, AL,Jun-17,39154,37483,1671,4.3
CN0111500000000,01,115,St. Clair County, AL,Jul-17,39132,37561,1571,4.0
CN0111500000000,01,115,St. Clair County, AL,Aug-17,38815,37304,1511,3.9
CN0111500000000,01,115,St. Clair County, AL,Sep-17,38902,37611,1291,3.3
CN0111500000000,01,115,St. Clair County, AL,Oct-17,38914,37613,1301,3.3
CN0111500000000,01,115,St. Clair County, AL,Nov-17,38771,37557,1214,3.1
CN0111500000000,01,115,St. Clair County, AL,Dec-17,38649,37458,1191,3.1
CN0111500000000,01,115,St. Clair County, AL,Jan-18,38576,37156,1420,3.7
CN0111500000000,01,115,St. Clair County, AL,Feb-18,39140,37656,1484,3.8
CN0111500000000,01,115,St. Clair County, AL,Mar-18,39226,37859,1367,3.5
CN0111500000000,01,115,St. Clair County, AL,Apr-18(p),39615,38382,1233,3.1
CN1815100000000,18,151,Steuben County, IN,Mar-17,19846,19200,646,3.3
CN1815100000000,18,151,Steuben County, IN,Apr-17,19799,19306,493,2.5
CN1815100000000,18,151,Steuben County, IN,May-17,19939,19430,509,2.6
CN1815100000000,18,151,Steuben County, IN,Jun-17,20459,19880,579,2.8
CN1815100000000,18,151,Steuben County, IN,Jul-17,20378,19791,587,2.9
CN1815100000000,18,151,Steuben County, IN,Aug-17,19889,19255,634,3.2
CN1815100000000,18,151,Steuben County, IN,Sep-17,19976,19462,514,2.6
CN1815100000000,18,151,Steuben County, IN,Oct-17,19874,19398,476,2.4
CN1815100000000,18,151,Steuben County, IN,Nov-17,19786,19295,491,2.5
CN1815100000000,18,151,Steuben County, IN,Dec-17,19470,19021,449,2.3
CN1815100000000,18,151,Steuben County, IN,Jan-18,19270,18713,557,2.9
CN1815100000000,18,151,Steuben County, IN,Feb-18,19537,18992,545,2.8
CN1815100000000,18,151,Steuben County, IN,Mar-18,19609,19121,488,2.5
CN1815100000000,18,151,Steuben County, IN,Apr-18(p),19868,19425,443,2.2
CN1319700000000,13,197,Marion County, GA,Mar-17,3437,3216,221,6.4
CN1319700000000,13,197,Marion County, GA,Apr-17,3419,3209,210,6.1
CN1319700000000,13,197,Marion County, GA,May-17,3407,3212,195,5.7
CN1319700000000,13,197,Marion County, GA,Jun-17,3403,3204,199,5.8
CN1319700000000,13,197,Marion County, GA,Jul-17,3411,3211,200,5.9
CN1319700000000,13,197,Marion County, GA,Aug-17,3391,3184,207,6.1
CN1319700000000,13,197,Marion County, GA,Sep-17,3415,3232,183,5.4
CN1319700000000,13,197,Marion County, GA,Oct-17,3421,3234,187,5.5
CN1319700000000,13,197,Marion County, GA,Nov-17,3417,3241,176,5.2
CN1319700000000,13,197,Marion County, GA,Dec-17,3424,3248,176,5.1
CN1319700000000,13,197,Marion County, GA,Jan-18,3444,3253,191,5.5
CN1319700000000,13,197,Marion County, GA,Feb-18,3446,3262,184,5.3
CN1319700000000,13,197,Marion County, GA,Mar-18,3460,3278,182,5.3
CN1319700000000,13,197,Marion County, GA,Apr-18(p),3434,3266,168,4.9
CN5106700000000,51,067,Franklin County, VA,Mar-17,26272,25200,1072,4.1
CN5106700000000,51,067,Franklin County, VA,Apr-17,26295,25344,951,3.6
CN5106700000000,51,067,Franklin County, VA,May-17,26331,25301,1030,3.9
CN5106700000000,51,067,Franklin County, VA,Jun-17,26369,25288,1081,4.1
CN5106700000000,51,067,Franklin County, VA,Jul-17,26451,25357,1094,4.1
CN5106700000000,51,067,Franklin County, VA,Aug-17,26170,25068,1102,4.2
CN5106700000000,51,067,Franklin County, VA,Sep-17,26352,25339,1013,3.8
CN5106700000000,51,067,Franklin County, VA,Oct-17,26112,25155,957,3.7
CN5106700000000,51,067,Franklin County, VA,Nov-17,25996,25047,949,3.7
CN5106700000000,51,067,Franklin County, VA,Dec-17,25923,25037,886,3.4
CN5106700000000,51,067,Franklin County, VA,Jan-18,25813,24821,992,3.8
CN5106700000000,51,067,Franklin County, VA,Feb-18,26081,25184,897,3.4
CN5106700000000,51,067,Franklin County, VA,Mar-18,26201,25292,909,3.5
CN5106700000000,51,067,Franklin County, VA,Apr-18(p),26340,25570,770,2.9
CN5117300000000,51,173,Smyth County, VA,Mar-17,13227,12442,785,5.9
CN5117300000000,51,173,Smyth County, VA,Apr-17,13127,12427,700,5.3
CN5117300000000,51,173,Smyth County, VA,May-17,13173,12483,690,5.2
CN5117300000000,51,173,Smyth County, VA,Jun-17,13168,12445,723,5.5
CN5117300000000,51,173,Smyth County, VA,Jul-17,13369,12605,764,5.7
CN5117300000000,51,173,Smyth County, VA,Aug-17,13147,12441,706,5.4
CN5117300000000,51,173,Smyth County, VA,Sep-17,13121,12455,666,5.1
CN5117300000000,51,173,Smyth County, VA,Oct-17,12893,12290,603,4.7
CN5117300000000,51,173,Smyth County, VA,Nov-17,12841,12261,580,4.5
CN5117300000000,51,173,Smyth County, VA,Dec-17,12831,12253,578,4.5
CN5117300000000,51,173,Smyth County, VA,Jan-18,12826,12183,643,5.0
CN5117300000000,51,173,Smyth County, VA,Feb-18,12848,12251,597,4.6
CN5117300000000,51,173,Smyth County, VA,Mar-18,12913,12304,609,4.7
CN5117300000000,51,173,Smyth County, VA,Apr-18(p),12915,12397,518,4.0
CN1301300000000,13,013,Barrow County, GA,Mar-17,38697,37063,1634,4.2
CN1301300000000,13,013,Barrow County, GA,Apr-17,38664,37132,1532,4.0
CN1301300000000,13,013,Barrow County, GA,May-17,38767,37215,1552,4.0
CN1301300000000,13,013,Barrow County, GA,Jun-17,38889,37190,1699,4.4
CN1301300000000,13,013,Barrow County, GA,Jul-17,39103,37431,1672,4.3
CN1301300000000,13,013,Barrow County, GA,Aug-17,38900,37259,1641,4.2
CN1301300000000,13,013,Barrow County, GA,Sep-17,39226,37749,1477,3.8
CN1301300000000,13,013,Barrow County, GA,Oct-17,39081,37618,1463,3.7
CN1301300000000,13,013,Barrow County, GA,Nov-17,39170,37758,1412,3.6
CN1301300000000,13,013,Barrow County, GA,Dec-17,39136,37744,1392,3.6
CN1301300000000,13,013,Barrow County, GA,Jan-18,39149,37675,1474,3.8
CN1301300000000,13,013,Barrow County, GA,Feb-18,39747,38263,1484,3.7
CN1301300000000,13,013,Barrow County, GA,Mar-18,39752,38400,1352,3.4
CN1301300000000,13,013,Barrow County, GA,Apr-18(p),39529,38278,1251,3.2
CN1812900000000,18,129,Posey County, IN,Mar-17,13287,12875,412,3.1
CN1812900000000,18,129,Posey County, IN,Apr-17,13271,12916,355,2.7
CN1812900000000,18,129,Posey County, IN,May-17,13413,13033,380,2.8
CN1812900000000,18,129,Posey County, IN,Jun-17,13519,13110,409,3.0
CN1812900000000,18,129,Posey County, IN,Jul-17,13595,13180,415,3.1
CN1812900000000,18,129,Posey County, IN,Aug-17,13413,12956,457,3.4
CN1812900000000,18,129,Posey County, IN,Sep-17,13447,13082,365,2.7
CN1812900000000,18,129,Posey County, IN,Oct-17,13486,13121,365,2.7
CN1812900000000,18,129,Posey County, IN,Nov-17,13509,13163,346,2.6
CN1812900000000,18,129,Posey County, IN,Dec-17,13338,13015,323,2.4
CN1812900000000,18,129,Posey County, IN,Jan-18,13191,12792,399,3.0
CN1812900000000,18,129,Posey County, IN,Feb-18,13405,13011,394,2.9
CN1812900000000,18,129,Posey County, IN,Mar-18,13585,13224,361,2.7
CN1812900000000,18,129,Posey County, IN,Apr-18(p),13650,13298,352,2.6
CN5301300000000,53,013,Columbia County, WA,Mar-17,1730,1620,110,6.4
CN5301300000000,53,013,Columbia County, WA,Apr-17,1736,1644,92,5.3
CN5301300000000,53,013,Columbia County, WA,May-17,1744,1653,91,5.2
CN5301300000000,53,013,Columbia County, WA,Jun-17,1774,1691,83,4.7
CN5301300000000,53,013,Columbia County, WA,Jul-17,1784,1701,83,4.7
CN5301300000000,53,013,Columbia County, WA,Aug-17,1802,1712,90,5.0
CN5301300000000,53,013,Columbia County, WA,Sep-17,1804,1716,88,4.9
CN5301300000000,53,013,Columbia County, WA,Oct-17,1803,1718,85,4.7
CN5301300000000,53,013,Columbia County, WA,Nov-17,1802,1710,92,5.1
CN5301300000000,53,013,Columbia County, WA,Dec-17,1780,1677,103,5.8
CN5301300000000,53,013,Columbia County, WA,Jan-18,1743,1630,113,6.5
CN5301300000000,53,013,Columbia County, WA,Feb-18,1787,1656,131,7.3
CN5301300000000,53,013,Columbia County, WA,Mar-18,1797,1682,115,6.4
CN5301300000000,53,013,Columbia County, WA,Apr-18(p),1782,1684,98,5.5
CN3117300000000,31,173,Thurston County, NE,Mar-17,2945,2796,149,5.1
CN3117300000000,31,173,Thurston County, NE,Apr-17,3018,2879,139,4.6
CN3117300000000,31,173,Thurston County, NE,May-17,3015,2868,147,4.9
CN3117300000000,31,173,Thurston County, NE,Jun-17,3099,2935,164,5.3
CN3117300000000,31,173,Thurston County, NE,Jul-17,3060,2889,171,5.6
CN3117300000000,31,173,Thurston County, NE,Aug-17,3018,2877,141,4.7
CN3117300000000,31,173,Thurston County, NE,Sep-17,2950,2799,151,5.1
CN3117300000000,31,173,Thurston County, NE,Oct-17,2957,2828,129,4.4
CN3117300000000,31,173,Thurston County, NE,Nov-17,2966,2817,149,5.0
CN3117300000000,31,173,Thurston County, NE,Dec-17,2936,2802,134,4.6
CN3117300000000,31,173,Thurston County, NE,Jan-18,2957,2820,137,4.6
CN3117300000000,31,173,Thurston County, NE,Feb-18,2938,2820,118,4.0
CN3117300000000,31,173,Thurston County, NE,Mar-18,2927,2808,119,4.1
CN3117300000000,31,173,Thurston County, NE,Apr-18(p),2930,2809,121,4.1
CN3503700000000,35,037,Quay County, NM,Mar-17,3226,3024,202,6.3
CN3503700000000,35,037,Quay County, NM,Apr-17,3221,3044,177,5.5
CN3503700000000,35,037,Quay County, NM,May-17,3253,3071,182,5.6
CN3503700000000,35,037,Quay County, NM,Jun-17,3225,2989,236,7.3
CN3503700000000,35,037,Quay County, NM,Jul-17,3262,3024,238,7.3
CN3503700000000,35,037,Quay County, NM,Aug-17,3234,3012,222,6.9
CN3503700000000,35,037,Quay County, NM,Sep-17,3206,3015,191,6.0
CN3503700000000,35,037,Quay County, NM,Oct-17,3162,2977,185,5.9
CN3503700000000,35,037,Quay County, NM,Nov-17,3160,2986,174,5.5
CN3503700000000,35,037,Quay County, NM,Dec-17,3154,2993,161,5.1
CN3503700000000,35,037,Quay County, NM,Jan-18,3159,2997,162,5.1
CN3503700000000,35,037,Quay County, NM,Feb-18,3240,3091,149,4.6
CN3503700000000,35,037,Quay County, NM,Mar-18,3240,3097,143,4.4
CN3503700000000,35,037,Quay County, NM,Apr-18(p),3223,3096,127,3.9
CN3610500000000,36,105,Sullivan County, NY,Mar-17,33750,31972,1778,5.3
CN3610500000000,36,105,Sullivan County, NY,Apr-17,33791,32157,1634,4.8
CN3610500000000,36,105,Sullivan County, NY,May-17,34121,32587,1534,4.5
CN3610500000000,36,105,Sullivan County, NY,Jun-17,35584,33987,1597,4.5
CN3610500000000,36,105,Sullivan County, NY,Jul-17,37043,35422,1621,4.4
CN3610500000000,36,105,Sullivan County, NY,Aug-17,36865,35228,1637,4.4
CN3610500000000,36,105,Sullivan County, NY,Sep-17,34925,33279,1646,4.7
CN3610500000000,36,105,Sullivan County, NY,Oct-17,33941,32344,1597,4.7
CN3610500000000,36,105,Sullivan County, NY,Nov-17,34180,32442,1738,5.1
CN3610500000000,36,105,Sullivan County, NY,Dec-17,33606,31793,1813,5.4
CN3610500000000,36,105,Sullivan County, NY,Jan-18,34182,32130,2052,6.0
CN3610500000000,36,105,Sullivan County, NY,Feb-18,34809,32773,2036,5.8
CN3610500000000,36,105,Sullivan County, NY,Mar-18,34668,32835,1833,5.3
CN3610500000000,36,105,Sullivan County, NY,Apr-18(p),34991,33360,1631,4.7
CN3005500000000,30,055,McCone County, MT,Mar-17,1009,987,22,2.2
CN3005500000000,30,055,McCone County, MT,Apr-17,1040,1020,20,1.9
CN3005500000000,30,055,McCone County, MT,May-17,1072,1053,19,1.8
CN3005500000000,30,055,McCone County, MT,Jun-17,1034,1012,22,2.1
CN3005500000000,30,055,McCone County, MT,Jul-17,1076,1053,23,2.1
CN3005500000000,30,055,McCone County, MT,Aug-17,1011,989,22,2.2
CN3005500000000,30,055,McCone County, MT,Sep-17,992,970,22,2.2
CN3005500000000,30,055,McCone County, MT,Oct-17,995,973,22,2.2
CN3005500000000,30,055,McCone County, MT,Nov-17,984,963,21,2.1
CN3005500000000,30,055,McCone County, MT,Dec-17,972,950,22,2.3
CN3005500000000,30,055,McCone County, MT,Jan-18,994,972,22,2.2
CN3005500000000,30,055,McCone County, MT,Feb-18,984,965,19,1.9
CN3005500000000,30,055,McCone County, MT,Mar-18,958,940,18,1.9
CN3005500000000,30,055,McCone County, MT,Apr-18(p),952,936,16,1.7
CN1810100000000,18,101,Martin County, IN,Mar-17,5083,4914,169,3.3
CN1810100000000,18,101,Martin County, IN,Apr-17,5095,4960,135,2.6
CN1810100000000,18,101,Martin County, IN,May-17,5227,5086,141,2.7
CN1810100000000,18,101,Martin County, IN,Jun-17,5286,5131,155,2.9
CN1810100000000,18,101,Martin County, IN,Jul-17,5259,5102,157,3.0
CN1810100000000,18,101,Martin County, IN,Aug-17,5166,4999,167,3.2
CN1810100000000,18,101,Martin County, IN,Sep-17,5047,4909,138,2.7
CN1810100000000,18,101,Martin County, IN,Oct-17,5056,4923,133,2.6
CN1810100000000,18,101,Martin County, IN,Nov-17,5074,4943,131,2.6
CN1810100000000,18,101,Martin County, IN,Dec-17,5026,4900,126,2.5
CN1810100000000,18,101,Martin County, IN,Jan-18,4987,4838,149,3.0
CN1810100000000,18,101,Martin County, IN,Feb-18,5027,4880,147,2.9
CN1810100000000,18,101,Martin County, IN,Mar-18,5077,4945,132,2.6
CN1810100000000,18,101,Martin County, IN,Apr-18(p),5091,4967,124,2.4
CN3402500000000,34,025,Monmouth County, NJ,Mar-17,329124,315617,13507,4.1
CN3402500000000,34,025,Monmouth County, NJ,Apr-17,329068,316295,12773,3.9
CN3402500000000,34,025,Monmouth County, NJ,May-17,330330,317377,12953,3.9
CN3402500000000,34,025,Monmouth County, NJ,Jun-17,335685,322081,13604,4.1
CN3402500000000,34,025,Monmouth County, NJ,Jul-17,338273,322966,15307,4.5
CN3402500000000,34,025,Monmouth County, NJ,Aug-17,335171,320552,14619,4.4
CN3402500000000,34,025,Monmouth County, NJ,Sep-17,329501,315958,13543,4.1
CN3402500000000,34,025,Monmouth County, NJ,Oct-17,329182,316356,12826,3.9
CN3402500000000,34,025,Monmouth County, NJ,Nov-17,328081,315487,12594,3.8
CN3402500000000,34,025,Monmouth County, NJ,Dec-17,327541,315652,11889,3.6
CN3402500000000,34,025,Monmouth County, NJ,Jan-18,325820,311797,14023,4.3
CN3402500000000,34,025,Monmouth County, NJ,Feb-18,328573,314258,14315,4.4
CN3402500000000,34,025,Monmouth County, NJ,Mar-18,326819,313272,13547,4.1
CN3402500000000,34,025,Monmouth County, NJ,Apr-18(p),324452,312929,11523,3.6
CN3106700000000,31,067,Gage County, NE,Mar-17,10910,10533,377,3.5
CN3106700000000,31,067,Gage County, NE,Apr-17,10946,10608,338,3.1
CN3106700000000,31,067,Gage County, NE,May-17,11010,10684,326,3.0
CN3106700000000,31,067,Gage County, NE,Jun-17,11132,10754,378,3.4
CN3106700000000,31,067,Gage County, NE,Jul-17,11118,10716,402,3.6
CN3106700000000,31,067,Gage County, NE,Aug-17,10907,10546,361,3.3
CN3106700000000,31,067,Gage County, NE,Sep-17,10894,10280,614,5.6
CN3106700000000,31,067,Gage County, NE,Oct-17,10613,10308,305,2.9
CN3106700000000,31,067,Gage County, NE,Nov-17,10626,10332,294,2.8
CN3106700000000,31,067,Gage County, NE,Dec-17,10651,10302,349,3.3
CN3106700000000,31,067,Gage County, NE,Jan-18,10765,10357,408,3.8
CN3106700000000,31,067,Gage County, NE,Feb-18,10841,10458,383,3.5
CN3106700000000,31,067,Gage County, NE,Mar-18,10751,10390,361,3.4
CN3106700000000,31,067,Gage County, NE,Apr-18(p),10693,10362,331,3.1
CN4709100000000,47,091,Johnson County, TN,Mar-17,7678,7348,330,4.3
CN4709100000000,47,091,Johnson County, TN,Apr-17,7670,7419,251,3.3
CN4709100000000,47,091,Johnson County, TN,May-17,7648,7409,239,3.1
CN4709100000000,47,091,Johnson County, TN,Jun-17,7573,7273,300,4.0
CN4709100000000,47,091,Johnson County, TN,Jul-17,7577,7277,300,4.0
CN4709100000000,47,091,Johnson County, TN,Aug-17,7603,7314,289,3.8
CN4709100000000,47,091,Johnson County, TN,Sep-17,7602,7345,257,3.4
CN4709100000000,47,091,Johnson County, TN,Oct-17,7589,7340,249,3.3
CN4709100000000,47,091,Johnson County, TN,Nov-17,7569,7320,249,3.3
CN4709100000000,47,091,Johnson County, TN,Dec-17,7574,7321,253,3.3
CN4709100000000,47,091,Johnson County, TN,Jan-18,7569,7246,323,4.3
CN4709100000000,47,091,Johnson County, TN,Feb-18,7613,7284,329,4.3
CN4709100000000,47,091,Johnson County, TN,Mar-18,7563,7284,279,3.7
CN4709100000000,47,091,Johnson County, TN,Apr-18(p),7676,7453,223,2.9
CN2502300000000,25,023,Plymouth County, MA,Mar-17,274470,262483,11987,4.4
CN2502300000000,25,023,Plymouth County, MA,Apr-17,273708,263398,10310,3.8
CN2502300000000,25,023,Plymouth County, MA,May-17,273231,262644,10587,3.9
CN2502300000000,25,023,Plymouth County, MA,Jun-17,277062,265652,11410,4.1
CN2502300000000,25,023,Plymouth County, MA,Jul-17,278720,266903,11817,4.2
CN2502300000000,25,023,Plymouth County, MA,Aug-17,277084,266376,10708,3.9
CN2502300000000,25,023,Plymouth County, MA,Sep-17,272811,262862,9949,3.6
CN2502300000000,25,023,Plymouth County, MA,Oct-17,272652,264009,8643,3.2
CN2502300000000,25,023,Plymouth County, MA,Nov-17,272973,264525,8448,3.1
CN2502300000000,25,023,Plymouth County, MA,Dec-17,272532,263879,8653,3.2
CN2502300000000,25,023,Plymouth County, MA,Jan-18,274348,262564,11784,4.3
CN2502300000000,25,023,Plymouth County, MA,Feb-18,278169,266023,12146,4.4
CN2502300000000,25,023,Plymouth County, MA,Mar-18,280092,268531,11561,4.1
CN2502300000000,25,023,Plymouth County, MA,Apr-18(p),282021,272298,9723,3.4
CN4502300000000,45,023,Chester County, SC,Mar-17,13430,12685,745,5.5
CN4502300000000,45,023,Chester County, SC,Apr-17,13427,12738,689,5.1
CN4502300000000,45,023,Chester County, SC,May-17,13514,12782,732,5.4
CN4502300000000,45,023,Chester County, SC,Jun-17,13698,12848,850,6.2
CN4502300000000,45,023,Chester County, SC,Jul-17,13650,12777,873,6.4
CN4502300000000,45,023,Chester County, SC,Aug-17,13747,12806,941,6.8
CN4502300000000,45,023,Chester County, SC,Sep-17,13683,12874,809,5.9
CN4502300000000,45,023,Chester County, SC,Oct-17,13747,12947,800,5.8
CN4502300000000,45,023,Chester County, SC,Nov-17,13619,12866,753,5.5
CN4502300000000,45,023,Chester County, SC,Dec-17,13662,12882,780,5.7
CN4502300000000,45,023,Chester County, SC,Jan-18,13701,12795,906,6.6
CN4502300000000,45,023,Chester County, SC,Feb-18,13675,12842,833,6.1
CN4502300000000,45,023,Chester County, SC,Mar-18,13667,12910,757,5.5
CN4502300000000,45,023,Chester County, SC,Apr-18(p),13491,12931,560,4.2
CN1211300000000,12,113,Santa Rosa County, FL,Mar-17,77747,74744,3003,3.9
CN1211300000000,12,113,Santa Rosa County, FL,Apr-17,78033,75206,2827,3.6
CN1211300000000,12,113,Santa Rosa County, FL,May-17,78441,75557,2884,3.7
CN1211300000000,12,113,Santa Rosa County, FL,Jun-17,79199,75946,3253,4.1
CN1211300000000,12,113,Santa Rosa County, FL,Jul-17,79091,75843,3248,4.1
CN1211300000000,12,113,Santa Rosa County, FL,Aug-17,78848,75723,3125,4.0
CN1211300000000,12,113,Santa Rosa County, FL,Sep-17,80679,77862,2817,3.5
CN1211300000000,12,113,Santa Rosa County, FL,Oct-17,79026,76318,2708,3.4
CN1211300000000,12,113,Santa Rosa County, FL,Nov-17,78330,75572,2758,3.5
CN1211300000000,12,113,Santa Rosa County, FL,Dec-17,77565,74986,2579,3.3
CN1211300000000,12,113,Santa Rosa County, FL,Jan-18,78059,74853,3206,4.1
CN1211300000000,12,113,Santa Rosa County, FL,Feb-18,78244,75431,2813,3.6
CN1211300000000,12,113,Santa Rosa County, FL,Mar-18,78704,75985,2719,3.5
CN1211300000000,12,113,Santa Rosa County, FL,Apr-18(p),78560,76101,2459,3.1
CN1900700000000,19,007,Appanoose County, IA,Mar-17,6057,5827,230,3.8
CN1900700000000,19,007,Appanoose County, IA,Apr-17,6100,5882,218,3.6
CN1900700000000,19,007,Appanoose County, IA,May-17,6080,5876,204,3.4
CN1900700000000,19,007,Appanoose County, IA,Jun-17,6264,6026,238,3.8
CN1900700000000,19,007,Appanoose County, IA,Jul-17,6206,5973,233,3.8
CN1900700000000,19,007,Appanoose County, IA,Aug-17,6097,5848,249,4.1
CN1900700000000,19,007,Appanoose County, IA,Sep-17,5981,5754,227,3.8
CN1900700000000,19,007,Appanoose County, IA,Oct-17,5945,5761,184,3.1
CN1900700000000,19,007,Appanoose County, IA,Nov-17,5904,5719,185,3.1
CN1900700000000,19,007,Appanoose County, IA,Dec-17,5899,5685,214,3.6
CN1900700000000,19,007,Appanoose County, IA,Jan-18,5889,5648,241,4.1
CN1900700000000,19,007,Appanoose County, IA,Feb-18,5923,5692,231,3.9
CN1900700000000,19,007,Appanoose County, IA,Mar-18,5877,5687,190,3.2
CN1900700000000,19,007,Appanoose County, IA,Apr-18(p),5942,5762,180,3.0
CN3202300000000,32,023,Nye County, NV,Mar-17,16621,15552,1069,6.4
CN3202300000000,32,023,Nye County, NV,Apr-17,16500,15423,1077,6.5
CN3202300000000,32,023,Nye County, NV,May-17,16605,15546,1059,6.4
CN3202300000000,32,023,Nye County, NV,Jun-17,16795,15724,1071,6.4
CN3202300000000,32,023,Nye County, NV,Jul-17,16284,15228,1056,6.5
CN3202300000000,32,023,Nye County, NV,Aug-17,16182,15161,1021,6.3
CN3202300000000,32,023,Nye County, NV,Sep-17,16390,15329,1061,6.5
CN3202300000000,32,023,Nye County, NV,Oct-17,16292,15289,1003,6.2
CN3202300000000,32,023,Nye County, NV,Nov-17,16330,15341,989,6.1
CN3202300000000,32,023,Nye County, NV,Dec-17,16361,15391,970,5.9
CN3202300000000,32,023,Nye County, NV,Jan-18,16413,15316,1097,6.7
CN3202300000000,32,023,Nye County, NV,Feb-18,16570,15545,1025,6.2
CN3202300000000,32,023,Nye County, NV,Mar-18,16742,15740,1002,6.0
CN3202300000000,32,023,Nye County, NV,Apr-18(p),16538,15585,953,5.8
CN4009100000000,40,091,McIntosh County, OK,Mar-17,6972,6402,570,8.2
CN4009100000000,40,091,McIntosh County, OK,Apr-17,6964,6449,515,7.4
CN4009100000000,40,091,McIntosh County, OK,May-17,6966,6432,534,7.7
CN4009100000000,40,091,McIntosh County, OK,Jun-17,6920,6361,559,8.1
CN4009100000000,40,091,McIntosh County, OK,Jul-17,6810,6287,523,7.7
CN4009100000000,40,091,McIntosh County, OK,Aug-17,6786,6280,506,7.5
CN4009100000000,40,091,McIntosh County, OK,Sep-17,6943,6448,495,7.1
CN4009100000000,40,091,McIntosh County, OK,Oct-17,6925,6411,514,7.4
CN4009100000000,40,091,McIntosh County, OK,Nov-17,6964,6457,507,7.3
CN4009100000000,40,091,McIntosh County, OK,Dec-17,6881,6362,519,7.5
CN4009100000000,40,091,McIntosh County, OK,Jan-18,6857,6304,553,8.1
CN4009100000000,40,091,McIntosh County, OK,Feb-18,6863,6374,489,7.1
CN4009100000000,40,091,McIntosh County, OK,Mar-18,6869,6407,462,6.7
CN4009100000000,40,091,McIntosh County, OK,Apr-18(p),6860,6398,462,6.7
CN7205100000000,72,051,Dorado Municipio, PR,Mar-17,12939,12073,866,6.7
CN7205100000000,72,051,Dorado Municipio, PR,Apr-17,12887,11957,930,7.2
CN7205100000000,72,051,Dorado Municipio, PR,May-17,12673,11900,773,6.1
CN7205100000000,72,051,Dorado Municipio, PR,Jun-17,12591,11844,747,5.9
CN7205100000000,72,051,Dorado Municipio, PR,Jul-17,12732,11802,930,7.3
CN7205100000000,72,051,Dorado Municipio, PR,Aug-17,12743,11655,1088,8.5
CN7205100000000,72,051,Dorado Municipio, PR,Sep-17(y),12830,11774,1056,8.2
CN7205100000000,72,051,Dorado Municipio, PR,Oct-17,12150,11280,870,7.2
CN7205100000000,72,051,Dorado Municipio, PR,Nov-17,12801,11990,811,6.3
CN7205100000000,72,051,Dorado Municipio, PR,Dec-17,12847,12091,756,5.9
CN7205100000000,72,051,Dorado Municipio, PR,Jan-18,12681,11851,830,6.5
CN7205100000000,72,051,Dorado Municipio, PR,Feb-18,12629,11853,776,6.1
CN7205100000000,72,051,Dorado Municipio, PR,Mar-18,12625,11867,758,6.0
CN7205100000000,72,051,Dorado Municipio, PR,Apr-18(p),12761,11977,784,6.1
CN1202300000000,12,023,Columbia County, FL,Mar-17,29456,28195,1261,4.3
CN1202300000000,12,023,Columbia County, FL,Apr-17,29203,28007,1196,4.1
CN1202300000000,12,023,Columbia County, FL,May-17,29325,28099,1226,4.2
CN1202300000000,12,023,Columbia County, FL,Jun-17,29242,27941,1301,4.4
CN1202300000000,12,023,Columbia County, FL,Jul-17,29115,27803,1312,4.5
CN1202300000000,12,023,Columbia County, FL,Aug-17,29454,28135,1319,4.5
CN1202300000000,12,023,Columbia County, FL,Sep-17,29901,28714,1187,4.0
CN1202300000000,12,023,Columbia County, FL,Oct-17,29471,28324,1147,3.9
CN1202300000000,12,023,Columbia County, FL,Nov-17,29296,28118,1178,4.0
CN1202300000000,12,023,Columbia County, FL,Dec-17,29172,28056,1116,3.8
CN1202300000000,12,023,Columbia County, FL,Jan-18,29095,27832,1263,4.3
CN1202300000000,12,023,Columbia County, FL,Feb-18,29337,28164,1173,4.0
CN1202300000000,12,023,Columbia County, FL,Mar-18,29228,28083,1145,3.9
CN1202300000000,12,023,Columbia County, FL,Apr-18(p),29238,28217,1021,3.5
CN3900700000000,39,007,Ashtabula County, OH,Mar-17,44008,41108,2900,6.6
CN3900700000000,39,007,Ashtabula County, OH,Apr-17,43871,41372,2499,5.7
CN3900700000000,39,007,Ashtabula County, OH,May-17,44151,41887,2264,5.1
CN3900700000000,39,007,Ashtabula County, OH,Jun-17,44999,42500,2499,5.6
CN3900700000000,39,007,Ashtabula County, OH,Jul-17,45098,42595,2503,5.6
CN3900700000000,39,007,Ashtabula County, OH,Aug-17,45112,42616,2496,5.5
CN3900700000000,39,007,Ashtabula County, OH,Sep-17,44621,42308,2313,5.2
CN3900700000000,39,007,Ashtabula County, OH,Oct-17,44320,42047,2273,5.1
CN3900700000000,39,007,Ashtabula County, OH,Nov-17,44048,41692,2356,5.3
CN3900700000000,39,007,Ashtabula County, OH,Dec-17,43865,41314,2551,5.8
CN3900700000000,39,007,Ashtabula County, OH,Jan-18,43192,40338,2854,6.6
CN3900700000000,39,007,Ashtabula County, OH,Feb-18,43742,41061,2681,6.1
CN3900700000000,39,007,Ashtabula County, OH,Mar-18,44229,41806,2423,5.5
CN3900700000000,39,007,Ashtabula County, OH,Apr-18(p),43992,41848,2144,4.9
CN1918500000000,19,185,Wayne County, IA,Mar-17,2737,2655,82,3.0
CN1918500000000,19,185,Wayne County, IA,Apr-17,2757,2681,76,2.8
CN1918500000000,19,185,Wayne County, IA,May-17,2765,2692,73,2.6
CN1918500000000,19,185,Wayne County, IA,Jun-17,2802,2724,78,2.8
CN1918500000000,19,185,Wayne County, IA,Jul-17,2833,2751,82,2.9
CN1918500000000,19,185,Wayne County, IA,Aug-17,2757,2669,88,3.2
CN1918500000000,19,185,Wayne County, IA,Sep-17,2781,2698,83,3.0
CN1918500000000,19,185,Wayne County, IA,Oct-17,2817,2742,75,2.7
CN1918500000000,19,185,Wayne County, IA,Nov-17,2817,2736,81,2.9
CN1918500000000,19,185,Wayne County, IA,Dec-17,2792,2716,76,2.7
CN1918500000000,19,185,Wayne County, IA,Jan-18,2766,2656,110,4.0
CN1918500000000,19,185,Wayne County, IA,Feb-18,2794,2686,108,3.9
CN1918500000000,19,185,Wayne County, IA,Mar-18,2728,2641,87,3.2
CN1918500000000,19,185,Wayne County, IA,Apr-18(p),2710,2640,70,2.6
CN7202300000000,72,023,Cabo Rojo Municipio, PR,Mar-17,14401,12434,1967,13.7
CN7202300000000,72,023,Cabo Rojo Municipio, PR,Apr-17,14164,12132,2032,14.3
CN7202300000000,72,023,Cabo Rojo Municipio, PR,May-17,13951,12147,1804,12.9
CN7202300000000,72,023,Cabo Rojo Municipio, PR,Jun-17,13851,12082,1769,12.8
CN7202300000000,72,023,Cabo Rojo Municipio, PR,Jul-17,13650,11871,1779,13.0
CN7202300000000,72,023,Cabo Rojo Municipio, PR,Aug-17,13684,11698,1986,14.5
CN7202300000000,72,023,Cabo Rojo Municipio, PR,Sep-17(y),13790,11782,2008,14.6
CN7202300000000,72,023,Cabo Rojo Municipio, PR,Oct-17,13581,11440,2141,15.8
CN7202300000000,72,023,Cabo Rojo Municipio, PR,Nov-17,13944,12090,1854,13.3
CN7202300000000,72,023,Cabo Rojo Municipio, PR,Dec-17,13972,12252,1720,12.3
CN7202300000000,72,023,Cabo Rojo Municipio, PR,Jan-18,13558,11794,1764,13.0
CN7202300000000,72,023,Cabo Rojo Municipio, PR,Feb-18,13261,11728,1533,11.6
CN7202300000000,72,023,Cabo Rojo Municipio, PR,Mar-18,13356,11794,1562,11.7
CN7202300000000,72,023,Cabo Rojo Municipio, PR,Apr-18(p),13347,11908,1439,10.8
CN2113700000000,21,137,Lincoln County, KY,Mar-17,9513,8896,617,6.5
CN2113700000000,21,137,Lincoln County, KY,Apr-17,9529,9005,524,5.5
CN2113700000000,21,137,Lincoln County, KY,May-17,9441,8912,529,5.6
CN2113700000000,21,137,Lincoln County, KY,Jun-17,9545,8972,573,6.0
CN2113700000000,21,137,Lincoln County, KY,Jul-17,9332,8766,566,6.1
CN2113700000000,21,137,Lincoln County, KY,Aug-17,9294,8785,509,5.5
CN2113700000000,21,137,Lincoln County, KY,Sep-17,9353,8882,471,5.0
CN2113700000000,21,137,Lincoln County, KY,Oct-17,9299,8865,434,4.7
CN2113700000000,21,137,Lincoln County, KY,Nov-17,9294,8873,421,4.5
CN2113700000000,21,137,Lincoln County, KY,Dec-17,9292,8852,440,4.7
CN2113700000000,21,137,Lincoln County, KY,Jan-18,9310,8819,491,5.3
CN2113700000000,21,137,Lincoln County, KY,Feb-18,9271,8751,520,5.6
CN2113700000000,21,137,Lincoln County, KY,Mar-18,9414,8930,484,5.1
CN2113700000000,21,137,Lincoln County, KY,Apr-18(p),9417,9002,415,4.4
CN2208700000000,22,087,St. Bernard Parish, LA,Mar-17,19358,18314,1044,5.4
CN2208700000000,22,087,St. Bernard Parish, LA,Apr-17,19507,18511,996,5.1
CN2208700000000,22,087,St. Bernard Parish, LA,May-17,19530,18549,981,5.0
CN2208700000000,22,087,St. Bernard Parish, LA,Jun-17,19745,18602,1143,5.8
CN2208700000000,22,087,St. Bernard Parish, LA,Jul-17,19701,18572,1129,5.7
CN2208700000000,22,087,St. Bernard Parish, LA,Aug-17,19497,18372,1125,5.8
CN2208700000000,22,087,St. Bernard Parish, LA,Sep-17,19477,18446,1031,5.3
CN2208700000000,22,087,St. Bernard Parish, LA,Oct-17,19488,18601,887,4.6
CN2208700000000,22,087,St. Bernard Parish, LA,Nov-17,19490,18636,854,4.4
CN2208700000000,22,087,St. Bernard Parish, LA,Dec-17,19366,18588,778,4.0
CN2208700000000,22,087,St. Bernard Parish, LA,Jan-18,19514,18637,877,4.5
CN2208700000000,22,087,St. Bernard Parish, LA,Feb-18,19615,18821,794,4.0
CN2208700000000,22,087,St. Bernard Parish, LA,Mar-18,19685,18825,860,4.4
CN2208700000000,22,087,St. Bernard Parish, LA,Apr-18(p),19817,18943,874,4.4
CN3716100000000,37,161,Rutherford County, NC,Mar-17,24854,23395,1459,5.9
CN3716100000000,37,161,Rutherford County, NC,Apr-17,24568,23161,1407,5.7
CN3716100000000,37,161,Rutherford County, NC,May-17,24537,23093,1444,5.9
CN3716100000000,37,161,Rutherford County, NC,Jun-17,24715,23185,1530,6.2
CN3716100000000,37,161,Rutherford County, NC,Jul-17,24339,22725,1614,6.6
CN3716100000000,37,161,Rutherford County, NC,Aug-17,24356,22735,1621,6.7
CN3716100000000,37,161,Rutherford County, NC,Sep-17,24795,23376,1419,5.7
CN3716100000000,37,161,Rutherford County, NC,Oct-17,24735,23326,1409,5.7
CN3716100000000,37,161,Rutherford County, NC,Nov-17,24723,23227,1496,6.1
CN3716100000000,37,161,Rutherford County, NC,Dec-17,24425,22998,1427,5.8
CN3716100000000,37,161,Rutherford County, NC,Jan-18,24441,22856,1585,6.5
CN3716100000000,37,161,Rutherford County, NC,Feb-18,24284,22775,1509,6.2
CN3716100000000,37,161,Rutherford County, NC,Mar-18,24426,23000,1426,5.8
CN3716100000000,37,161,Rutherford County, NC,Apr-18(p),24193,22972,1221,5.0
CN5404700000000,54,047,McDowell County, WV,Mar-17,4933,4484,449,9.1
CN5404700000000,54,047,McDowell County, WV,Apr-17,4995,4569,426,8.5
CN5404700000000,54,047,McDowell County, WV,May-17,4993,4607,386,7.7
CN5404700000000,54,047,McDowell County, WV,Jun-17,5126,4676,450,8.8
CN5404700000000,54,047,McDowell County, WV,Jul-17,4957,4498,459,9.3
CN5404700000000,54,047,McDowell County, WV,Aug-17,4910,4483,427,8.7
CN5404700000000,54,047,McDowell County, WV,Sep-17,5062,4696,366,7.2
CN5404700000000,54,047,McDowell County, WV,Oct-17,5066,4710,356,7.0
CN5404700000000,54,047,McDowell County, WV,Nov-17,5056,4674,382,7.6
CN5404700000000,54,047,McDowell County, WV,Dec-17,4997,4639,358,7.2
CN5404700000000,54,047,McDowell County, WV,Jan-18,5083,4708,375,7.4
CN5404700000000,54,047,McDowell County, WV,Feb-18,5126,4713,413,8.1
CN5404700000000,54,047,McDowell County, WV,Mar-18,5071,4659,412,8.1
CN5404700000000,54,047,McDowell County, WV,Apr-18(p),5111,4689,422,8.3
CN7211300000000,72,113,Ponce Municipio, PR,Mar-17,47007,41522,5485,11.7
CN7211300000000,72,113,Ponce Municipio, PR,Apr-17,46850,41121,5729,12.2
CN7211300000000,72,113,Ponce Municipio, PR,May-17,46053,40810,5243,11.4
CN7211300000000,72,113,Ponce Municipio, PR,Jun-17,45012,40408,4604,10.2
CN7211300000000,72,113,Ponce Municipio, PR,Jul-17,45318,40311,5007,11.0
CN7211300000000,72,113,Ponce Municipio, PR,Aug-17,45420,39616,5804,12.8
CN7211300000000,72,113,Ponce Municipio, PR,Sep-17(y),45654,40039,5615,12.3
CN7211300000000,72,113,Ponce Municipio, PR,Oct-17,44606,39156,5450,12.2
CN7211300000000,72,113,Ponce Municipio, PR,Nov-17,46374,41293,5081,11.0
CN7211300000000,72,113,Ponce Municipio, PR,Dec-17,46562,41815,4747,10.2
CN7211300000000,72,113,Ponce Municipio, PR,Jan-18,45831,40952,4879,10.6
CN7211300000000,72,113,Ponce Municipio, PR,Feb-18,45388,40844,4544,10.0
CN7211300000000,72,113,Ponce Municipio, PR,Mar-18,45305,40830,4475,9.9
CN7211300000000,72,113,Ponce Municipio, PR,Apr-18(p),45674,41269,4405,9.6
CN2122700000000,21,227,Warren County, KY,Mar-17,63359,60693,2666,4.2
CN2122700000000,21,227,Warren County, KY,Apr-17,63992,61578,2414,3.8
CN2122700000000,21,227,Warren County, KY,May-17,63686,61228,2458,3.9
CN2122700000000,21,227,Warren County, KY,Jun-17,64318,61275,3043,4.7
CN2122700000000,21,227,Warren County, KY,Jul-17,62633,59768,2865,4.6
CN2122700000000,21,227,Warren County, KY,Aug-17,62577,59895,2682,4.3
CN2122700000000,21,227,Warren County, KY,Sep-17,64115,61489,2626,4.1
CN2122700000000,21,227,Warren County, KY,Oct-17,63307,61042,2265,3.6
CN2122700000000,21,227,Warren County, KY,Nov-17,63604,61594,2010,3.2
CN2122700000000,21,227,Warren County, KY,Dec-17,63515,61565,1950,3.1
CN2122700000000,21,227,Warren County, KY,Jan-18,62512,60263,2249,3.6
CN2122700000000,21,227,Warren County, KY,Feb-18,64426,61815,2611,4.1
CN2122700000000,21,227,Warren County, KY,Mar-18,64949,62576,2373,3.7
CN2122700000000,21,227,Warren County, KY,Apr-18(p),65237,63183,2054,3.1
CN2701900000000,27,019,Carver County, MN,Mar-17,56882,54930,1952,3.4
CN2701900000000,27,019,Carver County, MN,Apr-17,56973,55344,1629,2.9
CN2701900000000,27,019,Carver County, MN,May-17,57085,55556,1529,2.7
CN2701900000000,27,019,Carver County, MN,Jun-17,57510,55777,1733,3.0
CN2701900000000,27,019,Carver County, MN,Jul-17,58076,56426,1650,2.8
CN2701900000000,27,019,Carver County, MN,Aug-17,57840,56144,1696,2.9
CN2701900000000,27,019,Carver County, MN,Sep-17,57628,56160,1468,2.5
CN2701900000000,27,019,Carver County, MN,Oct-17,57311,56088,1223,2.1
CN2701900000000,27,019,Carver County, MN,Nov-17,57280,55958,1322,2.3
CN2701900000000,27,019,Carver County, MN,Dec-17,57078,55504,1574,2.8
CN2701900000000,27,019,Carver County, MN,Jan-18,57619,55798,1821,3.2
CN2701900000000,27,019,Carver County, MN,Feb-18,58021,56172,1849,3.2
CN2701900000000,27,019,Carver County, MN,Mar-18,57892,56095,1797,3.1
CN2701900000000,27,019,Carver County, MN,Apr-18(p),57933,56435,1498,2.6
CN3907300000000,39,073,Hocking County, OH,Mar-17,13182,12390,792,6.0
CN3907300000000,39,073,Hocking County, OH,Apr-17,13115,12458,657,5.0
CN3907300000000,39,073,Hocking County, OH,May-17,13141,12553,588,4.5
CN3907300000000,39,073,Hocking County, OH,Jun-17,13324,12627,697,5.2
CN3907300000000,39,073,Hocking County, OH,Jul-17,13422,12733,689,5.1
CN3907300000000,39,073,Hocking County, OH,Aug-17,13340,12681,659,4.9
CN3907300000000,39,073,Hocking County, OH,Sep-17,13204,12610,594,4.5
CN3907300000000,39,073,Hocking County, OH,Oct-17,13181,12609,572,4.3
CN3907300000000,39,073,Hocking County, OH,Nov-17,13259,12603,656,4.9
CN3907300000000,39,073,Hocking County, OH,Dec-17,13346,12630,716,5.4
CN3907300000000,39,073,Hocking County, OH,Jan-18,13220,12378,842,6.4
CN3907300000000,39,073,Hocking County, OH,Feb-18,13336,12557,779,5.8
CN3907300000000,39,073,Hocking County, OH,Mar-18,13423,12727,696,5.2
CN3907300000000,39,073,Hocking County, OH,Apr-18(p),13361,12720,641,4.8
CN2616300000000,26,163,Wayne County, MI,Mar-17,787079,744567,42512,5.4
CN2616300000000,26,163,Wayne County, MI,Apr-17,775431,743681,31750,4.1
CN2616300000000,26,163,Wayne County, MI,May-17,778231,746592,31639,4.1
CN2616300000000,26,163,Wayne County, MI,Jun-17,785411,746227,39184,5.0
CN2616300000000,26,163,Wayne County, MI,Jul-17,797808,747156,50652,6.3
CN2616300000000,26,163,Wayne County, MI,Aug-17,801707,751421,50286,6.3
CN2616300000000,26,163,Wayne County, MI,Sep-17,801271,754922,46349,5.8
CN2616300000000,26,163,Wayne County, MI,Oct-17,793709,751539,42170,5.3
CN2616300000000,26,163,Wayne County, MI,Nov-17,788748,751629,37119,4.7
CN2616300000000,26,163,Wayne County, MI,Dec-17,788952,750189,38763,4.9
CN2616300000000,26,163,Wayne County, MI,Jan-18,778976,733922,45054,5.8
CN2616300000000,26,163,Wayne County, MI,Feb-18,787465,743937,43528,5.5
CN2616300000000,26,163,Wayne County, MI,Mar-18,790080,750360,39720,5.0
CN2616300000000,26,163,Wayne County, MI,Apr-18(p),783281,749751,33530,4.3
CN2715900000000,27,159,Wadena County, MN,Mar-17,5931,5486,445,7.5
CN2715900000000,27,159,Wadena County, MN,Apr-17,5911,5596,315,5.3
CN2715900000000,27,159,Wadena County, MN,May-17,5853,5613,240,4.1
CN2715900000000,27,159,Wadena County, MN,Jun-17,5845,5580,265,4.5
CN2715900000000,27,159,Wadena County, MN,Jul-17,5652,5406,246,4.4
CN2715900000000,27,159,Wadena County, MN,Aug-17,5706,5442,264,4.6
CN2715900000000,27,159,Wadena County, MN,Sep-17,5655,5449,206,3.6
CN2715900000000,27,159,Wadena County, MN,Oct-17,5710,5526,184,3.2
CN2715900000000,27,159,Wadena County, MN,Nov-17,5807,5499,308,5.3
CN2715900000000,27,159,Wadena County, MN,Dec-17,5895,5490,405,6.9
CN2715900000000,27,159,Wadena County, MN,Jan-18,5846,5357,489,8.4
CN2715900000000,27,159,Wadena County, MN,Feb-18,5870,5389,481,8.2
CN2715900000000,27,159,Wadena County, MN,Mar-18,5885,5415,470,8.0
CN2715900000000,27,159,Wadena County, MN,Apr-18(p),5884,5498,386,6.6
CN0102500000000,01,025,Clarke County, AL,Mar-17,7822,7124,698,8.9
CN0102500000000,01,025,Clarke County, AL,Apr-17,7720,7106,614,8.0
CN0102500000000,01,025,Clarke County, AL,May-17,7639,7059,580,7.6
CN0102500000000,01,025,Clarke County, AL,Jun-17,7856,7088,768,9.8
CN0102500000000,01,025,Clarke County, AL,Jul-17,7741,7001,740,9.6
CN0102500000000,01,025,Clarke County, AL,Aug-17,7636,6986,650,8.5
CN0102500000000,01,025,Clarke County, AL,Sep-17,7645,7092,553,7.2
CN0102500000000,01,025,Clarke County, AL,Oct-17,7614,7102,512,6.7
CN0102500000000,01,025,Clarke County, AL,Nov-17,7559,7072,487,6.4
CN0102500000000,01,025,Clarke County, AL,Dec-17,7562,7060,502,6.6
CN0102500000000,01,025,Clarke County, AL,Jan-18,7569,6956,613,8.1
CN0102500000000,01,025,Clarke County, AL,Feb-18,7574,6968,606,8.0
CN0102500000000,01,025,Clarke County, AL,Mar-18,7604,7047,557,7.3
CN0102500000000,01,025,Clarke County, AL,Apr-18(p),7559,7060,499,6.6
CN1200700000000,12,007,Bradford County, FL,Mar-17,11372,10962,410,3.6
CN1200700000000,12,007,Bradford County, FL,Apr-17,11365,10986,379,3.3
CN1200700000000,12,007,Bradford County, FL,May-17,11327,10937,390,3.4
CN1200700000000,12,007,Bradford County, FL,Jun-17,11197,10776,421,3.8
CN1200700000000,12,007,Bradford County, FL,Jul-17,11200,10759,441,3.9
CN1200700000000,12,007,Bradford County, FL,Aug-17,11301,10877,424,3.8
CN1200700000000,12,007,Bradford County, FL,Sep-17,11510,11126,384,3.3
CN1200700000000,12,007,Bradford County, FL,Oct-17,11324,10959,365,3.2
CN1200700000000,12,007,Bradford County, FL,Nov-17,11260,10874,386,3.4
CN1200700000000,12,007,Bradford County, FL,Dec-17,11178,10806,372,3.3
CN1200700000000,12,007,Bradford County, FL,Jan-18,11259,10814,445,4.0
CN1200700000000,12,007,Bradford County, FL,Feb-18,11330,10933,397,3.5
CN1200700000000,12,007,Bradford County, FL,Mar-18,11340,10950,390,3.4
CN1200700000000,12,007,Bradford County, FL,Apr-18(p),11308,10956,352,3.1
CN7200700000000,72,007,Aguas Buenas Municipio, PR,Mar-17,6780,5907,873,12.9
CN7200700000000,72,007,Aguas Buenas Municipio, PR,Apr-17,6774,5854,920,13.6
CN7200700000000,72,007,Aguas Buenas Municipio, PR,May-17,6640,5837,803,12.1
CN7200700000000,72,007,Aguas Buenas Municipio, PR,Jun-17,6524,5810,714,10.9
CN7200700000000,72,007,Aguas Buenas Municipio, PR,Jul-17,6574,5800,774,11.8
CN7200700000000,72,007,Aguas Buenas Municipio, PR,Aug-17,6608,5731,877,13.3
CN7200700000000,72,007,Aguas Buenas Municipio, PR,Sep-17(y),6595,5777,818,12.4
CN7200700000000,72,007,Aguas Buenas Municipio, PR,Oct-17,6361,5529,832,13.1
CN7200700000000,72,007,Aguas Buenas Municipio, PR,Nov-17,6662,5860,802,12.0
CN7200700000000,72,007,Aguas Buenas Municipio, PR,Dec-17,6626,5896,730,11.0
CN7200700000000,72,007,Aguas Buenas Municipio, PR,Jan-18,6540,5783,757,11.6
CN7200700000000,72,007,Aguas Buenas Municipio, PR,Feb-18,6476,5790,686,10.6
CN7200700000000,72,007,Aguas Buenas Municipio, PR,Mar-18,6485,5799,686,10.6
CN7200700000000,72,007,Aguas Buenas Municipio, PR,Apr-18(p),6510,5831,679,10.4
CN1907900000000,19,079,Hamilton County, IA,Mar-17,7024,6754,270,3.8
CN1907900000000,19,079,Hamilton County, IA,Apr-17,7065,6837,228,3.2
CN1907900000000,19,079,Hamilton County, IA,May-17,7074,6854,220,3.1
CN1907900000000,19,079,Hamilton County, IA,Jun-17,7063,6822,241,3.4
CN1907900000000,19,079,Hamilton County, IA,Jul-17,7173,6944,229,3.2
CN1907900000000,19,079,Hamilton County, IA,Aug-17,7104,6881,223,3.1
CN1907900000000,19,079,Hamilton County, IA,Sep-17,7091,6897,194,2.7
CN1907900000000,19,079,Hamilton County, IA,Oct-17,7095,6933,162,2.3
CN1907900000000,19,079,Hamilton County, IA,Nov-17,7038,6871,167,2.4
CN1907900000000,19,079,Hamilton County, IA,Dec-17,7012,6798,214,3.1
CN1907900000000,19,079,Hamilton County, IA,Jan-18,6891,6639,252,3.7
CN1907900000000,19,079,Hamilton County, IA,Feb-18,7002,6745,257,3.7
CN1907900000000,19,079,Hamilton County, IA,Mar-18,6947,6710,237,3.4
CN1907900000000,19,079,Hamilton County, IA,Apr-18(p),6949,6748,201,2.9
CN0510700000000,05,107,Phillips County, AR,Mar-17,6559,6196,363,5.5
CN0510700000000,05,107,Phillips County, AR,Apr-17,6652,6326,326,4.9
CN0510700000000,05,107,Phillips County, AR,May-17,6676,6325,351,5.3
CN0510700000000,05,107,Phillips County, AR,Jun-17,6841,6443,398,5.8
CN0510700000000,05,107,Phillips County, AR,Jul-17,6524,6103,421,6.5
CN0510700000000,05,107,Phillips County, AR,Aug-17,6514,6125,389,6.0
CN0510700000000,05,107,Phillips County, AR,Sep-17,6521,6142,379,5.8
CN0510700000000,05,107,Phillips County, AR,Oct-17,6567,6222,345,5.3
CN0510700000000,05,107,Phillips County, AR,Nov-17,6515,6160,355,5.4
CN0510700000000,05,107,Phillips County, AR,Dec-17,6516,6115,401,6.2
CN0510700000000,05,107,Phillips County, AR,Jan-18,6428,5915,513,8.0
CN0510700000000,05,107,Phillips County, AR,Feb-18,6396,5890,506,7.9
CN0510700000000,05,107,Phillips County, AR,Mar-18,6413,5954,459,7.2
CN0510700000000,05,107,Phillips County, AR,Apr-18(p),6421,6026,395,6.2
CN5500900000000,55,009,Brown County, WI,Mar-17,141777,137150,4627,3.3
CN5500900000000,55,009,Brown County, WI,Apr-17,142160,138287,3873,2.7
CN5500900000000,55,009,Brown County, WI,May-17,142645,138675,3970,2.8
CN5500900000000,55,009,Brown County, WI,Jun-17,145784,141015,4769,3.3
CN5500900000000,55,009,Brown County, WI,Jul-17,145813,141297,4516,3.1
CN5500900000000,55,009,Brown County, WI,Aug-17,145200,141010,4190,2.9
CN5500900000000,55,009,Brown County, WI,Sep-17,144408,140636,3772,2.6
CN5500900000000,55,009,Brown County, WI,Oct-17,143639,140025,3614,2.5
CN5500900000000,55,009,Brown County, WI,Nov-17,143382,139718,3664,2.6
CN5500900000000,55,009,Brown County, WI,Dec-17,141917,138463,3454,2.4
CN5500900000000,55,009,Brown County, WI,Jan-18,142085,138071,4014,2.8
CN5500900000000,55,009,Brown County, WI,Feb-18,143869,139458,4411,3.1
CN5500900000000,55,009,Brown County, WI,Mar-18,144142,140005,4137,2.9
CN5500900000000,55,009,Brown County, WI,Apr-18(p),143833,140296,3537,2.5
CN4850100000000,48,501,Yoakum County, TX,Mar-17,3953,3798,155,3.9
CN4850100000000,48,501,Yoakum County, TX,Apr-17,3892,3751,141,3.6
CN4850100000000,48,501,Yoakum County, TX,May-17,3881,3743,138,3.6
CN4850100000000,48,501,Yoakum County, TX,Jun-17,3906,3764,142,3.6
CN4850100000000,48,501,Yoakum County, TX,Jul-17,3745,3612,133,3.6
CN4850100000000,48,501,Yoakum County, TX,Aug-17,3761,3625,136,3.6
CN4850100000000,48,501,Yoakum County, TX,Sep-17,3754,3636,118,3.1
CN4850100000000,48,501,Yoakum County, TX,Oct-17,3753,3648,105,2.8
CN4850100000000,48,501,Yoakum County, TX,Nov-17,3714,3603,111,3.0
CN4850100000000,48,501,Yoakum County, TX,Dec-17,3732,3628,104,2.8
CN4850100000000,48,501,Yoakum County, TX,Jan-18,3778,3663,115,3.0
CN4850100000000,48,501,Yoakum County, TX,Feb-18,3816,3702,114,3.0
CN4850100000000,48,501,Yoakum County, TX,Mar-18,3881,3767,114,2.9
CN4850100000000,48,501,Yoakum County, TX,Apr-18(p),3864,3759,105,2.7
CN2017500000000,20,175,Seward County, KS,Mar-17,9889,9520,369,3.7
CN2017500000000,20,175,Seward County, KS,Apr-17,9856,9497,359,3.6
CN2017500000000,20,175,Seward County, KS,May-17,9926,9571,355,3.6
CN2017500000000,20,175,Seward County, KS,Jun-17,10047,9648,399,4.0
CN2017500000000,20,175,Seward County, KS,Jul-17,9981,9571,410,4.1
CN2017500000000,20,175,Seward County, KS,Aug-17,9862,9507,355,3.6
CN2017500000000,20,175,Seward County, KS,Sep-17,9837,9538,299,3.0
CN2017500000000,20,175,Seward County, KS,Oct-17,9808,9526,282,2.9
CN2017500000000,20,175,Seward County, KS,Nov-17,9786,9508,278,2.8
CN2017500000000,20,175,Seward County, KS,Dec-17,9730,9460,270,2.8
CN2017500000000,20,175,Seward County, KS,Jan-18,9427,9137,290,3.1
CN2017500000000,20,175,Seward County, KS,Feb-18,9487,9165,322,3.4
CN2017500000000,20,175,Seward County, KS,Mar-18,9444,9135,309,3.3
CN2017500000000,20,175,Seward County, KS,Apr-18(p),9380,9078,302,3.2
CN2006900000000,20,069,Gray County, KS,Mar-17,3372,3301,71,2.1
CN2006900000000,20,069,Gray County, KS,Apr-17,3301,3232,69,2.1
CN2006900000000,20,069,Gray County, KS,May-17,3326,3255,71,2.1
CN2006900000000,20,069,Gray County, KS,Jun-17,3488,3413,75,2.2
CN2006900000000,20,069,Gray County, KS,Jul-17,3330,3245,85,2.6
CN2006900000000,20,069,Gray County, KS,Aug-17,3370,3295,75,2.2
CN2006900000000,20,069,Gray County, KS,Sep-17,3514,3454,60,1.7
CN2006900000000,20,069,Gray County, KS,Oct-17,3649,3596,53,1.5
CN2006900000000,20,069,Gray County, KS,Nov-17,3544,3482,62,1.7
CN2006900000000,20,069,Gray County, KS,Dec-17,3491,3435,56,1.6
CN2006900000000,20,069,Gray County, KS,Jan-18,3388,3330,58,1.7
CN2006900000000,20,069,Gray County, KS,Feb-18,3396,3332,64,1.9
CN2006900000000,20,069,Gray County, KS,Mar-18,3398,3332,66,1.9
CN2006900000000,20,069,Gray County, KS,Apr-18(p),3196,3132,64,2.0
CN3801700000000,38,017,Cass County, ND,Mar-17,101836,99124,2712,2.7
CN3801700000000,38,017,Cass County, ND,Apr-17,102134,100047,2087,2.0
CN3801700000000,38,017,Cass County, ND,May-17,102820,101108,1712,1.7
CN3801700000000,38,017,Cass County, ND,Jun-17,103188,101013,2175,2.1
CN3801700000000,38,017,Cass County, ND,Jul-17,103832,101990,1842,1.8
CN3801700000000,38,017,Cass County, ND,Aug-17,103555,101691,1864,1.8
CN3801700000000,38,017,Cass County, ND,Sep-17,101995,100268,1727,1.7
CN3801700000000,38,017,Cass County, ND,Oct-17,101852,100298,1554,1.5
CN3801700000000,38,017,Cass County, ND,Nov-17,101687,99685,2002,2.0
CN3801700000000,38,017,Cass County, ND,Dec-17,101383,99104,2279,2.2
CN3801700000000,38,017,Cass County, ND,Jan-18,102561,99554,3007,2.9
CN3801700000000,38,017,Cass County, ND,Feb-18,103710,100739,2971,2.9
CN3801700000000,38,017,Cass County, ND,Mar-18,103150,100284,2866,2.8
CN3801700000000,38,017,Cass County, ND,Apr-18(p),102446,99878,2568,2.5
CN4212100000000,42,121,Venango County, PA,Mar-17,23089,21510,1579,6.8
CN4212100000000,42,121,Venango County, PA,Apr-17,23027,21693,1334,5.8
CN4212100000000,42,121,Venango County, PA,May-17,23180,21796,1384,6.0
CN4212100000000,42,121,Venango County, PA,Jun-17,23404,21970,1434,6.1
CN4212100000000,42,121,Venango County, PA,Jul-17,23536,22090,1446,6.1
CN4212100000000,42,121,Venango County, PA,Aug-17,23358,21849,1509,6.5
CN4212100000000,42,121,Venango County, PA,Sep-17,22961,21778,1183,5.2
CN4212100000000,42,121,Venango County, PA,Oct-17,22664,21559,1105,4.9
CN4212100000000,42,121,Venango County, PA,Nov-17,22715,21513,1202,5.3
CN4212100000000,42,121,Venango County, PA,Dec-17,22602,21409,1193,5.3
CN4212100000000,42,121,Venango County, PA,Jan-18,22685,21228,1457,6.4
CN4212100000000,42,121,Venango County, PA,Feb-18,22589,21167,1422,6.3
CN4212100000000,42,121,Venango County, PA,Mar-18,22352,21131,1221,5.5
CN4212100000000,42,121,Venango County, PA,Apr-18(p),22294,21299,995,4.5
CN2803100000000,28,031,Covington County, MS,Mar-17,8171,7781,390,4.8
CN2803100000000,28,031,Covington County, MS,Apr-17,8174,7812,362,4.4
CN2803100000000,28,031,Covington County, MS,May-17,8355,7934,421,5.0
CN2803100000000,28,031,Covington County, MS,Jun-17,8536,8055,481,5.6
CN2803100000000,28,031,Covington County, MS,Jul-17,8490,8034,456,5.4
CN2803100000000,28,031,Covington County, MS,Aug-17,8302,7899,403,4.9
CN2803100000000,28,031,Covington County, MS,Sep-17,8229,7870,359,4.4
CN2803100000000,28,031,Covington County, MS,Oct-17,8183,7836,347,4.2
CN2803100000000,28,031,Covington County, MS,Nov-17,8195,7850,345,4.2
CN2803100000000,28,031,Covington County, MS,Dec-17,8145,7796,349,4.3
CN2803100000000,28,031,Covington County, MS,Jan-18,7965,7621,344,4.3
CN2803100000000,28,031,Covington County, MS,Feb-18,8027,7681,346,4.3
CN2803100000000,28,031,Covington County, MS,Mar-18,8076,7744,332,4.1
CN2803100000000,28,031,Covington County, MS,Apr-18(p),8154,7815,339,4.2
CN3705500000000,37,055,Dare County, NC,Mar-17,18032,16674,1358,7.5
CN3705500000000,37,055,Dare County, NC,Apr-17,19642,18544,1098,5.6
CN3705500000000,37,055,Dare County, NC,May-17,20583,19562,1021,5.0
CN3705500000000,37,055,Dare County, NC,Jun-17,22950,21973,977,4.3
CN3705500000000,37,055,Dare County, NC,Jul-17,23896,22938,958,4.0
CN3705500000000,37,055,Dare County, NC,Aug-17,23081,22140,941,4.1
CN3705500000000,37,055,Dare County, NC,Sep-17,21604,20747,857,4.0
CN3705500000000,37,055,Dare County, NC,Oct-17,19991,19132,859,4.3
CN3705500000000,37,055,Dare County, NC,Nov-17,18844,17873,971,5.2
CN3705500000000,37,055,Dare County, NC,Dec-17,17945,16749,1196,6.7
CN3705500000000,37,055,Dare County, NC,Jan-18,17706,15844,1862,10.5
CN3705500000000,37,055,Dare County, NC,Feb-18,17703,15807,1896,10.7
CN3705500000000,37,055,Dare County, NC,Mar-18,17956,16564,1392,7.8
CN3705500000000,37,055,Dare County, NC,Apr-18(p),19305,18332,973,5.0
CN0608500000000,06,085,Santa Clara County, CA,Mar-17,1035949,1000486,35463,3.4
CN0608500000000,06,085,Santa Clara County, CA,Apr-17,1030944,998579,32365,3.1
CN0608500000000,06,085,Santa Clara County, CA,May-17,1030263,999366,30897,3.0
CN0608500000000,06,085,Santa Clara County, CA,Jun-17,1040325,1005277,35048,3.4
CN0608500000000,06,085,Santa Clara County, CA,Jul-17,1050320,1013258,37062,3.5
CN0608500000000,06,085,Santa Clara County, CA,Aug-17,1047246,1011371,35875,3.4
CN0608500000000,06,085,Santa Clara County, CA,Sep-17,1046466,1015497,30969,3.0
CN0608500000000,06,085,Santa Clara County, CA,Oct-17,1044944,1014991,29953,2.9
CN0608500000000,06,085,Santa Clara County, CA,Nov-17,1047368,1018181,29187,2.8
CN0608500000000,06,085,Santa Clara County, CA,Dec-17,1048528,1020719,27809,2.7
CN0608500000000,06,085,Santa Clara County, CA,Jan-18,1045626,1015129,30497,2.9
CN0608500000000,06,085,Santa Clara County, CA,Feb-18,1052913,1023188,29725,2.8
CN0608500000000,06,085,Santa Clara County, CA,Mar-18,1046980,1019724,27256,2.6
CN0608500000000,06,085,Santa Clara County, CA,Apr-18(p),1043083,1018549,24534,2.4
CN1325900000000,13,259,Stewart County, GA,Mar-17,2249,2115,134,6.0
CN1325900000000,13,259,Stewart County, GA,Apr-17,2236,2102,134,6.0
CN1325900000000,13,259,Stewart County, GA,May-17,2262,2126,136,6.0
CN1325900000000,13,259,Stewart County, GA,Jun-17,2296,2161,135,5.9
CN1325900000000,13,259,Stewart County, GA,Jul-17,2282,2143,139,6.1
CN1325900000000,13,259,Stewart County, GA,Aug-17,2276,2147,129,5.7
CN1325900000000,13,259,Stewart County, GA,Sep-17,2278,2163,115,5.0
CN1325900000000,13,259,Stewart County, GA,Oct-17,2277,2158,119,5.2
CN1325900000000,13,259,Stewart County, GA,Nov-17,2262,2154,108,4.8
CN1325900000000,13,259,Stewart County, GA,Dec-17,2267,2158,109,4.8
CN1325900000000,13,259,Stewart County, GA,Jan-18,2312,2174,138,6.0
CN1325900000000,13,259,Stewart County, GA,Feb-18,2258,2138,120,5.3
CN1325900000000,13,259,Stewart County, GA,Mar-18,2251,2147,104,4.6
CN1325900000000,13,259,Stewart County, GA,Apr-18(p),2243,2151,92,4.1
CN2917700000000,29,177,Ray County, MO,Mar-17,11186,10597,589,5.3
CN2917700000000,29,177,Ray County, MO,Apr-17,11118,10707,411,3.7
CN2917700000000,29,177,Ray County, MO,May-17,11096,10663,433,3.9
CN2917700000000,29,177,Ray County, MO,Jun-17,11254,10755,499,4.4
CN2917700000000,29,177,Ray County, MO,Jul-17,11646,10830,816,7.0
CN2917700000000,29,177,Ray County, MO,Aug-17,11294,10670,624,5.5
CN2917700000000,29,177,Ray County, MO,Sep-17,11123,10743,380,3.4
CN2917700000000,29,177,Ray County, MO,Oct-17,11380,10743,637,5.6
CN2917700000000,29,177,Ray County, MO,Nov-17,11043,10680,363,3.3
CN2917700000000,29,177,Ray County, MO,Dec-17,11028,10631,397,3.6
CN2917700000000,29,177,Ray County, MO,Jan-18,11055,10526,529,4.8
CN2917700000000,29,177,Ray County, MO,Feb-18,11110,10626,484,4.4
CN2917700000000,29,177,Ray County, MO,Mar-18,11058,10648,410,3.7
CN2917700000000,29,177,Ray County, MO,Apr-18(p),11087,10709,378,3.4
CN0811500000000,08,115,Sedgwick County, CO,Mar-17,1131,1103,28,2.5
CN0811500000000,08,115,Sedgwick County, CO,Apr-17,1197,1173,24,2.0
CN0811500000000,08,115,Sedgwick County, CO,May-17,1222,1199,23,1.9
CN0811500000000,08,115,Sedgwick County, CO,Jun-17,1221,1192,29,2.4
CN0811500000000,08,115,Sedgwick County, CO,Jul-17,1242,1216,26,2.1
CN0811500000000,08,115,Sedgwick County, CO,Aug-17,1229,1203,26,2.1
CN0811500000000,08,115,Sedgwick County, CO,Sep-17,1204,1179,25,2.1
CN0811500000000,08,115,Sedgwick County, CO,Oct-17,1298,1271,27,2.1
CN0811500000000,08,115,Sedgwick County, CO,Nov-17,1260,1235,25,2.0
CN0811500000000,08,115,Sedgwick County, CO,Dec-17,1271,1243,28,2.2
CN0811500000000,08,115,Sedgwick County, CO,Jan-18,1206,1173,33,2.7
CN0811500000000,08,115,Sedgwick County, CO,Feb-18,1151,1121,30,2.6
CN0811500000000,08,115,Sedgwick County, CO,Mar-18,1165,1137,28,2.4
CN0811500000000,08,115,Sedgwick County, CO,Apr-18(p),1220,1192,28,2.3
CN4201500000000,42,015,Bradford County, PA,Mar-17,29423,27726,1697,5.8
CN4201500000000,42,015,Bradford County, PA,Apr-17,29365,27946,1419,4.8
CN4201500000000,42,015,Bradford County, PA,May-17,29396,27947,1449,4.9
CN4201500000000,42,015,Bradford County, PA,Jun-17,30021,28557,1464,4.9
CN4201500000000,42,015,Bradford County, PA,Jul-17,30055,28509,1546,5.1
CN4201500000000,42,015,Bradford County, PA,Aug-17,29766,28232,1534,5.2
CN4201500000000,42,015,Bradford County, PA,Sep-17,29274,27993,1281,4.4
CN4201500000000,42,015,Bradford County, PA,Oct-17,28855,27597,1258,4.4
CN4201500000000,42,015,Bradford County, PA,Nov-17,28740,27435,1305,4.5
CN4201500000000,42,015,Bradford County, PA,Dec-17,28830,27467,1363,4.7
CN4201500000000,42,015,Bradford County, PA,Jan-18,29065,27448,1617,5.6
CN4201500000000,42,015,Bradford County, PA,Feb-18,29163,27564,1599,5.5
CN4201500000000,42,015,Bradford County, PA,Mar-18,28694,27303,1391,4.8
CN4201500000000,42,015,Bradford County, PA,Apr-18(p),28532,27363,1169,4.1
CN2403900000000,24,039,Somerset County, MD,Mar-17,9377,8709,668,7.1
CN2403900000000,24,039,Somerset County, MD,Apr-17,9588,8985,603,6.3
CN2403900000000,24,039,Somerset County, MD,May-17,9476,8914,562,5.9
CN2403900000000,24,039,Somerset County, MD,Jun-17,10019,9388,631,6.3
CN2403900000000,24,039,Somerset County, MD,Jul-17,10176,9544,632,6.2
CN2403900000000,24,039,Somerset County, MD,Aug-17,9655,9031,624,6.5
CN2403900000000,24,039,Somerset County, MD,Sep-17,9342,8786,556,6.0
CN2403900000000,24,039,Somerset County, MD,Oct-17,9371,8776,595,6.3
CN2403900000000,24,039,Somerset County, MD,Nov-17,8952,8348,604,6.7
CN2403900000000,24,039,Somerset County, MD,Dec-17,9146,8504,642,7.0
CN2403900000000,24,039,Somerset County, MD,Jan-18,9436,8573,863,9.1
CN2403900000000,24,039,Somerset County, MD,Feb-18,9448,8636,812,8.6
CN2403900000000,24,039,Somerset County, MD,Mar-18,9487,8713,774,8.2
CN2403900000000,24,039,Somerset County, MD,Apr-18(p),9562,8910,652,6.8
CN4105300000000,41,053,Polk County, OR,Mar-17,38933,37194,1739,4.5
CN4105300000000,41,053,Polk County, OR,Apr-17,39073,37535,1538,3.9
CN4105300000000,41,053,Polk County, OR,May-17,39175,37671,1504,3.8
CN4105300000000,41,053,Polk County, OR,Jun-17,39876,38027,1849,4.6
CN4105300000000,41,053,Polk County, OR,Jul-17,40248,38264,1984,4.9
CN4105300000000,41,053,Polk County, OR,Aug-17,40292,38336,1956,4.9
CN4105300000000,41,053,Polk County, OR,Sep-17,40219,38509,1710,4.3
CN4105300000000,41,053,Polk County, OR,Oct-17,40002,38350,1652,4.1
CN4105300000000,41,053,Polk County, OR,Nov-17,40122,38504,1618,4.0
CN4105300000000,41,053,Polk County, OR,Dec-17,39633,38089,1544,3.9
CN4105300000000,41,053,Polk County, OR,Jan-18,39232,37528,1704,4.3
CN4105300000000,41,053,Polk County, OR,Feb-18,39682,37901,1781,4.5
CN4105300000000,41,053,Polk County, OR,Mar-18,39284,37509,1775,4.5
CN4105300000000,41,053,Polk County, OR,Apr-18(p),38951,37384,1567,4.0
CN0800900000000,08,009,Baca County, CO,Mar-17,1997,1961,36,1.8
CN0800900000000,08,009,Baca County, CO,Apr-17,2118,2084,34,1.6
CN0800900000000,08,009,Baca County, CO,May-17,2152,2115,37,1.7
CN0800900000000,08,009,Baca County, CO,Jun-17,2158,2115,43,2.0
CN0800900000000,08,009,Baca County, CO,Jul-17,2196,2166,30,1.4
CN0800900000000,08,009,Baca County, CO,Aug-17,2160,2129,31,1.4
CN0800900000000,08,009,Baca County, CO,Sep-17,2134,2101,33,1.5
CN0800900000000,08,009,Baca County, CO,Oct-17,2257,2219,38,1.7
CN0800900000000,08,009,Baca County, CO,Nov-17,2188,2154,34,1.6
CN0800900000000,08,009,Baca County, CO,Dec-17,2166,2133,33,1.5
CN0800900000000,08,009,Baca County, CO,Jan-18,2131,2094,37,1.7
CN0800900000000,08,009,Baca County, CO,Feb-18,1992,1952,40,2.0
CN0800900000000,08,009,Baca County, CO,Mar-18,1987,1955,32,1.6
CN0800900000000,08,009,Baca County, CO,Apr-18(p),2092,2059,33,1.6
CN3505300000000,35,053,Socorro County, NM,Mar-17,6431,6014,417,6.5
CN3505300000000,35,053,Socorro County, NM,Apr-17,6414,6045,369,5.8
CN3505300000000,35,053,Socorro County, NM,May-17,6401,6016,385,6.0
CN3505300000000,35,053,Socorro County, NM,Jun-17,6500,5997,503,7.7
CN3505300000000,35,053,Socorro County, NM,Jul-17,6495,5995,500,7.7
CN3505300000000,35,053,Socorro County, NM,Aug-17,6479,6030,449,6.9
CN3505300000000,35,053,Socorro County, NM,Sep-17,6519,6108,411,6.3
CN3505300000000,35,053,Socorro County, NM,Oct-17,6556,6158,398,6.1
CN3505300000000,35,053,Socorro County, NM,Nov-17,6597,6208,389,5.9
CN3505300000000,35,053,Socorro County, NM,Dec-17,6596,6218,378,5.7
CN3505300000000,35,053,Socorro County, NM,Jan-18,6467,6084,383,5.9
CN3505300000000,35,053,Socorro County, NM,Feb-18,6504,6131,373,5.7
CN3505300000000,35,053,Socorro County, NM,Mar-18,6487,6146,341,5.3
CN3505300000000,35,053,Socorro County, NM,Apr-18(p),6455,6170,285,4.4
CN1713900000000,17,139,Moultrie County, IL,Mar-17,7274,6983,291,4.0
CN1713900000000,17,139,Moultrie County, IL,Apr-17,7334,7085,249,3.4
CN1713900000000,17,139,Moultrie County, IL,May-17,7333,7084,249,3.4
CN1713900000000,17,139,Moultrie County, IL,Jun-17,7367,7091,276,3.7
CN1713900000000,17,139,Moultrie County, IL,Jul-17,7315,7031,284,3.9
CN1713900000000,17,139,Moultrie County, IL,Aug-17,7211,6921,290,4.0
CN1713900000000,17,139,Moultrie County, IL,Sep-17,7243,6995,248,3.4
CN1713900000000,17,139,Moultrie County, IL,Oct-17,7215,6965,250,3.5
CN1713900000000,17,139,Moultrie County, IL,Nov-17,7224,6968,256,3.5
CN1713900000000,17,139,Moultrie County, IL,Dec-17,7157,6905,252,3.5
CN1713900000000,17,139,Moultrie County, IL,Jan-18,7126,6855,271,3.8
CN1713900000000,17,139,Moultrie County, IL,Feb-18,7202,6957,245,3.4
CN1713900000000,17,139,Moultrie County, IL,Mar-18,7332,7077,255,3.5
CN1713900000000,17,139,Moultrie County, IL,Apr-18(p),7347,7150,197,2.7
CN0502900000000,05,029,Conway County, AR,Mar-17,8270,7869,401,4.8
CN0502900000000,05,029,Conway County, AR,Apr-17,8262,7930,332,4.0
CN0502900000000,05,029,Conway County, AR,May-17,8240,7863,377,4.6
CN0502900000000,05,029,Conway County, AR,Jun-17,8457,8039,418,4.9
CN0502900000000,05,029,Conway County, AR,Jul-17,8324,7885,439,5.3
CN0502900000000,05,029,Conway County, AR,Aug-17,8325,7938,387,4.6
CN0502900000000,05,029,Conway County, AR,Sep-17,8287,7925,362,4.4
CN0502900000000,05,029,Conway County, AR,Oct-17,8261,7940,321,3.9
CN0502900000000,05,029,Conway County, AR,Nov-17,8223,7906,317,3.9
CN0502900000000,05,029,Conway County, AR,Dec-17,8214,7849,365,4.4
CN0502900000000,05,029,Conway County, AR,Jan-18,8066,7648,418,5.2
CN0502900000000,05,029,Conway County, AR,Feb-18,8115,7690,425,5.2
CN0502900000000,05,029,Conway County, AR,Mar-18,8128,7757,371,4.6
CN0502900000000,05,029,Conway County, AR,Apr-18(p),8089,7755,334,4.1
CN1205700000000,12,057,Hillsborough County, FL,Mar-17,722982,695411,27571,3.8
CN1205700000000,12,057,Hillsborough County, FL,Apr-17,719619,693438,26181,3.6
CN1205700000000,12,057,Hillsborough County, FL,May-17,722092,695243,26849,3.7
CN1205700000000,12,057,Hillsborough County, FL,Jun-17,725600,696202,29398,4.1
CN1205700000000,12,057,Hillsborough County, FL,Jul-17,727094,697480,29614,4.1
CN1205700000000,12,057,Hillsborough County, FL,Aug-17,723849,694923,28926,4.0
CN1205700000000,12,057,Hillsborough County, FL,Sep-17,734513,707657,26856,3.7
CN1205700000000,12,057,Hillsborough County, FL,Oct-17,728099,702543,25556,3.5
CN1205700000000,12,057,Hillsborough County, FL,Nov-17,726994,701113,25881,3.6
CN1205700000000,12,057,Hillsborough County, FL,Dec-17,724909,700674,24235,3.3
CN1205700000000,12,057,Hillsborough County, FL,Jan-18,730680,702859,27821,3.8
CN1205700000000,12,057,Hillsborough County, FL,Feb-18,737064,711429,25635,3.5
CN1205700000000,12,057,Hillsborough County, FL,Mar-18,737754,712367,25387,3.4
CN1205700000000,12,057,Hillsborough County, FL,Apr-18(p),733551,710453,23098,3.1
CN2713100000000,27,131,Rice County, MN,Mar-17,36480,35063,1417,3.9
CN2713100000000,27,131,Rice County, MN,Apr-17,36453,35344,1109,3.0
CN2713100000000,27,131,Rice County, MN,May-17,36624,35616,1008,2.8
CN2713100000000,27,131,Rice County, MN,Jun-17,37260,36036,1224,3.3
CN2713100000000,27,131,Rice County, MN,Jul-17,36657,35464,1193,3.3
CN2713100000000,27,131,Rice County, MN,Aug-17,36756,35501,1255,3.4
CN2713100000000,27,131,Rice County, MN,Sep-17,36791,35827,964,2.6
CN2713100000000,27,131,Rice County, MN,Oct-17,36545,35801,744,2.0
CN2713100000000,27,131,Rice County, MN,Nov-17,36614,35780,834,2.3
CN2713100000000,27,131,Rice County, MN,Dec-17,36737,35614,1123,3.1
CN2713100000000,27,131,Rice County, MN,Jan-18,37155,35772,1383,3.7
CN2713100000000,27,131,Rice County, MN,Feb-18,37355,35991,1364,3.7
CN2713100000000,27,131,Rice County, MN,Mar-18,37376,36051,1325,3.5
CN2713100000000,27,131,Rice County, MN,Apr-18(p),37511,36428,1083,2.9
CN2300500000000,23,005,Cumberland County, ME,Mar-17,161930,157449,4481,2.8
CN2300500000000,23,005,Cumberland County, ME,Apr-17,162539,158304,4235,2.6
CN2300500000000,23,005,Cumberland County, ME,May-17,164688,160278,4410,2.7
CN2300500000000,23,005,Cumberland County, ME,Jun-17,168641,163890,4751,2.8
CN2300500000000,23,005,Cumberland County, ME,Jul-17,170244,165719,4525,2.7
CN2300500000000,23,005,Cumberland County, ME,Aug-17,169993,166043,3950,2.3
CN2300500000000,23,005,Cumberland County, ME,Sep-17,166735,162868,3867,2.3
CN2300500000000,23,005,Cumberland County, ME,Oct-17,166122,162324,3798,2.3
CN2300500000000,23,005,Cumberland County, ME,Nov-17,165070,161107,3963,2.4
CN2300500000000,23,005,Cumberland County, ME,Dec-17,164065,160966,3099,1.9
CN2300500000000,23,005,Cumberland County, ME,Jan-18,163500,159535,3965,2.4
CN2300500000000,23,005,Cumberland County, ME,Feb-18,162254,158436,3818,2.4
CN2300500000000,23,005,Cumberland County, ME,Mar-18,163337,159508,3829,2.3
CN2300500000000,23,005,Cumberland County, ME,Apr-18(p),164645,160712,3933,2.4
CN2808100000000,28,081,Lee County, MS,Mar-17,40396,38801,1595,3.9
CN2808100000000,28,081,Lee County, MS,Apr-17,40434,38983,1451,3.6
CN2808100000000,28,081,Lee County, MS,May-17,40855,39059,1796,4.4
CN2808100000000,28,081,Lee County, MS,Jun-17,41531,39570,1961,4.7
CN2808100000000,28,081,Lee County, MS,Jul-17,41403,39461,1942,4.7
CN2808100000000,28,081,Lee County, MS,Aug-17,40599,38971,1628,4.0
CN2808100000000,28,081,Lee County, MS,Sep-17,40726,39153,1573,3.9
CN2808100000000,28,081,Lee County, MS,Oct-17,40457,38952,1505,3.7
CN2808100000000,28,081,Lee County, MS,Nov-17,40838,39407,1431,3.5
CN2808100000000,28,081,Lee County, MS,Dec-17,40897,39486,1411,3.5
CN2808100000000,28,081,Lee County, MS,Jan-18,40433,39011,1422,3.5
CN2808100000000,28,081,Lee County, MS,Feb-18,40607,39195,1412,3.5
CN2808100000000,28,081,Lee County, MS,Mar-18,40380,39038,1342,3.3
CN2808100000000,28,081,Lee County, MS,Apr-18(p),40641,39245,1396,3.4
CN4204300000000,42,043,Dauphin County, PA,Mar-17,141220,134693,6527,4.6
CN4204300000000,42,043,Dauphin County, PA,Apr-17,141983,136130,5853,4.1
CN4204300000000,42,043,Dauphin County, PA,May-17,142256,135776,6480,4.6
CN4204300000000,42,043,Dauphin County, PA,Jun-17,143813,136975,6838,4.8
CN4204300000000,42,043,Dauphin County, PA,Jul-17,145200,138107,7093,4.9
CN4204300000000,42,043,Dauphin County, PA,Aug-17,143919,136809,7110,4.9
CN4204300000000,42,043,Dauphin County, PA,Sep-17,141944,136052,5892,4.2
CN4204300000000,42,043,Dauphin County, PA,Oct-17,140738,135070,5668,4.0
CN4204300000000,42,043,Dauphin County, PA,Nov-17,140638,134937,5701,4.1
CN4204300000000,42,043,Dauphin County, PA,Dec-17,139693,133999,5694,4.1
CN4204300000000,42,043,Dauphin County, PA,Jan-18,139639,133031,6608,4.7
CN4204300000000,42,043,Dauphin County, PA,Feb-18,139648,133054,6594,4.7
CN4204300000000,42,043,Dauphin County, PA,Mar-18,138845,133134,5711,4.1
CN4204300000000,42,043,Dauphin County, PA,Apr-18(p),139210,134121,5089,3.7
CN5501500000000,55,015,Calumet County, WI,Mar-17,27699,26886,813,2.9
CN5501500000000,55,015,Calumet County, WI,Apr-17,27892,27181,711,2.5
CN5501500000000,55,015,Calumet County, WI,May-17,27977,27234,743,2.7
CN5501500000000,55,015,Calumet County, WI,Jun-17,28657,27760,897,3.1
CN5501500000000,55,015,Calumet County, WI,Jul-17,28483,27680,803,2.8
CN5501500000000,55,015,Calumet County, WI,Aug-17,28194,27423,771,2.7
CN5501500000000,55,015,Calumet County, WI,Sep-17,27914,27226,688,2.5
CN5501500000000,55,015,Calumet County, WI,Oct-17,28076,27362,714,2.5
CN5501500000000,55,015,Calumet County, WI,Nov-17,28132,27436,696,2.5
CN5501500000000,55,015,Calumet County, WI,Dec-17,28001,27363,638,2.3
CN5501500000000,55,015,Calumet County, WI,Jan-18,28070,27315,755,2.7
CN5501500000000,55,015,Calumet County, WI,Feb-18,28205,27422,783,2.8
CN5501500000000,55,015,Calumet County, WI,Mar-18,28309,27563,746,2.6
CN5501500000000,55,015,Calumet County, WI,Apr-18(p),28225,27600,625,2.2
CN5512100000000,55,121,Trempealeau County, WI,Mar-17,16551,15933,618,3.7
CN5512100000000,55,121,Trempealeau County, WI,Apr-17,16724,16230,494,3.0
CN5512100000000,55,121,Trempealeau County, WI,May-17,16743,16287,456,2.7
CN5512100000000,55,121,Trempealeau County, WI,Jun-17,17121,16580,541,3.2
CN5512100000000,55,121,Trempealeau County, WI,Jul-17,16551,16067,484,2.9
CN5512100000000,55,121,Trempealeau County, WI,Aug-17,16345,15887,458,2.8
CN5512100000000,55,121,Trempealeau County, WI,Sep-17,16387,15961,426,2.6
CN5512100000000,55,121,Trempealeau County, WI,Oct-17,16525,16157,368,2.2
CN5512100000000,55,121,Trempealeau County, WI,Nov-17,16579,16211,368,2.2
CN5512100000000,55,121,Trempealeau County, WI,Dec-17,16652,16211,441,2.6
CN5512100000000,55,121,Trempealeau County, WI,Jan-18,16611,16097,514,3.1
CN5512100000000,55,121,Trempealeau County, WI,Feb-18,16601,16025,576,3.5
CN5512100000000,55,121,Trempealeau County, WI,Mar-18,16703,16156,547,3.3
CN5512100000000,55,121,Trempealeau County, WI,Apr-18(p),16960,16485,475,2.8
CN1602700000000,16,027,Canyon County, ID,Mar-17,95009,91257,3752,3.9
CN1602700000000,16,027,Canyon County, ID,Apr-17,94929,91613,3316,3.5
CN1602700000000,16,027,Canyon County, ID,May-17,95377,92385,2992,3.1
CN1602700000000,16,027,Canyon County, ID,Jun-17,96926,93587,3339,3.4
CN1602700000000,16,027,Canyon County, ID,Jul-17,97922,94536,3386,3.5
CN1602700000000,16,027,Canyon County, ID,Aug-17,97450,94285,3165,3.2
CN1602700000000,16,027,Canyon County, ID,Sep-17,97409,94511,2898,3.0
CN1602700000000,16,027,Canyon County, ID,Oct-17,97214,94392,2822,2.9
CN1602700000000,16,027,Canyon County, ID,Nov-17,97609,94423,3186,3.3
CN1602700000000,16,027,Canyon County, ID,Dec-17,97422,94358,3064,3.1
CN1602700000000,16,027,Canyon County, ID,Jan-18,98524,94288,4236,4.3
CN1602700000000,16,027,Canyon County, ID,Feb-18,98321,94780,3541,3.6
CN1602700000000,16,027,Canyon County, ID,Mar-18,98445,95242,3203,3.3
CN1602700000000,16,027,Canyon County, ID,Apr-18(p),98044,95196,2848,2.9
CN0507900000000,05,079,Lincoln County, AR,Mar-17,4044,3873,171,4.2
CN0507900000000,05,079,Lincoln County, AR,Apr-17,4081,3919,162,4.0
CN0507900000000,05,079,Lincoln County, AR,May-17,4085,3917,168,4.1
CN0507900000000,05,079,Lincoln County, AR,Jun-17,4095,3922,173,4.2
CN0507900000000,05,079,Lincoln County, AR,Jul-17,4091,3911,180,4.4
CN0507900000000,05,079,Lincoln County, AR,Aug-17,4000,3840,160,4.0
CN0507900000000,05,079,Lincoln County, AR,Sep-17,4009,3854,155,3.9
CN0507900000000,05,079,Lincoln County, AR,Oct-17,4031,3889,142,3.5
CN0507900000000,05,079,Lincoln County, AR,Nov-17,4018,3870,148,3.7
CN0507900000000,05,079,Lincoln County, AR,Dec-17,3984,3822,162,4.1
CN0507900000000,05,079,Lincoln County, AR,Jan-18,3891,3690,201,5.2
CN0507900000000,05,079,Lincoln County, AR,Feb-18,3970,3763,207,5.2
CN0507900000000,05,079,Lincoln County, AR,Mar-18,3971,3781,190,4.8
CN0507900000000,05,079,Lincoln County, AR,Apr-18(p),3953,3795,158,4.0
CN1328700000000,13,287,Turner County, GA,Mar-17,3304,3115,189,5.7
CN1328700000000,13,287,Turner County, GA,Apr-17,3273,3094,179,5.5
CN1328700000000,13,287,Turner County, GA,May-17,3304,3128,176,5.3
CN1328700000000,13,287,Turner County, GA,Jun-17,3327,3140,187,5.6
CN1328700000000,13,287,Turner County, GA,Jul-17,3275,3087,188,5.7
CN1328700000000,13,287,Turner County, GA,Aug-17,3263,3074,189,5.8
CN1328700000000,13,287,Turner County, GA,Sep-17,3275,3098,177,5.4
CN1328700000000,13,287,Turner County, GA,Oct-17,3330,3158,172,5.2
CN1328700000000,13,287,Turner County, GA,Nov-17,3322,3153,169,5.1
CN1328700000000,13,287,Turner County, GA,Dec-17,3317,3141,176,5.3
CN1328700000000,13,287,Turner County, GA,Jan-18,3380,3159,221,6.5
CN1328700000000,13,287,Turner County, GA,Feb-18,3295,3092,203,6.2
CN1328700000000,13,287,Turner County, GA,Mar-18,3283,3111,172,5.2
CN1328700000000,13,287,Turner County, GA,Apr-18(p),3249,3096,153,4.7
CN3109500000000,31,095,Jefferson County, NE,Mar-17,4094,3993,101,2.5
CN3109500000000,31,095,Jefferson County, NE,Apr-17,4171,4077,94,2.3
CN3109500000000,31,095,Jefferson County, NE,May-17,4219,4120,99,2.3
CN3109500000000,31,095,Jefferson County, NE,Jun-17,4312,4207,105,2.4
CN3109500000000,31,095,Jefferson County, NE,Jul-17,4283,4169,114,2.7
CN3109500000000,31,095,Jefferson County, NE,Aug-17,4215,4111,104,2.5
CN3109500000000,31,095,Jefferson County, NE,Sep-17,4139,4027,112,2.7
CN3109500000000,31,095,Jefferson County, NE,Oct-17,4131,4038,93,2.3
CN3109500000000,31,095,Jefferson County, NE,Nov-17,4117,4031,86,2.1
CN3109500000000,31,095,Jefferson County, NE,Dec-17,4107,4012,95,2.3
CN3109500000000,31,095,Jefferson County, NE,Jan-18,4159,4055,104,2.5
CN3109500000000,31,095,Jefferson County, NE,Feb-18,4161,4060,101,2.4
CN3109500000000,31,095,Jefferson County, NE,Mar-18,4149,4050,99,2.4
CN3109500000000,31,095,Jefferson County, NE,Apr-18(p),4046,3934,112,2.8
CN3714500000000,37,145,Person County, NC,Mar-17,18353,17483,870,4.7
CN3714500000000,37,145,Person County, NC,Apr-17,18295,17512,783,4.3
CN3714500000000,37,145,Person County, NC,May-17,18334,17537,797,4.3
CN3714500000000,37,145,Person County, NC,Jun-17,18281,17444,837,4.6
CN3714500000000,37,145,Person County, NC,Jul-17,18585,17697,888,4.8
CN3714500000000,37,145,Person County, NC,Aug-17,18303,17407,896,4.9
CN3714500000000,37,145,Person County, NC,Sep-17,18473,17653,820,4.4
CN3714500000000,37,145,Person County, NC,Oct-17,18423,17613,810,4.4
CN3714500000000,37,145,Person County, NC,Nov-17,18344,17508,836,4.6
CN3714500000000,37,145,Person County, NC,Dec-17,18159,17373,786,4.3
CN3714500000000,37,145,Person County, NC,Jan-18,18221,17370,851,4.7
CN3714500000000,37,145,Person County, NC,Feb-18,18530,17637,893,4.8
CN3714500000000,37,145,Person County, NC,Mar-18,18618,17756,862,4.6
CN3714500000000,37,145,Person County, NC,Apr-18(p),18482,17754,728,3.9
CN0226100000000,02,261,Valdez-Cordova Census Area, AK,Mar-17,4344,3868,476,11.0
CN0226100000000,02,261,Valdez-Cordova Census Area, AK,Apr-17,4578,4154,424,9.3
CN0226100000000,02,261,Valdez-Cordova Census Area, AK,May-17,4890,4542,348,7.1
CN0226100000000,02,261,Valdez-Cordova Census Area, AK,Jun-17,5587,5239,348,6.2
CN0226100000000,02,261,Valdez-Cordova Census Area, AK,Jul-17,6434,6111,323,5.0
CN0226100000000,02,261,Valdez-Cordova Census Area, AK,Aug-17,6299,5999,300,4.8
CN0226100000000,02,261,Valdez-Cordova Census Area, AK,Sep-17,5261,4961,300,5.7
CN0226100000000,02,261,Valdez-Cordova Census Area, AK,Oct-17,4507,4127,380,8.4
CN0226100000000,02,261,Valdez-Cordova Census Area, AK,Nov-17,4265,3858,407,9.5
CN0226100000000,02,261,Valdez-Cordova Census Area, AK,Dec-17,4263,3842,421,9.9
CN0226100000000,02,261,Valdez-Cordova Census Area, AK,Jan-18,4237,3752,485,11.4
CN0226100000000,02,261,Valdez-Cordova Census Area, AK,Feb-18,4298,3773,525,12.2
CN0226100000000,02,261,Valdez-Cordova Census Area, AK,Mar-18,4434,3939,495,11.2
CN0226100000000,02,261,Valdez-Cordova Census Area, AK,Apr-18(p),4628,4201,427,9.2
CN3703900000000,37,039,Cherokee County, NC,Mar-17,11162,10622,540,4.8
CN3703900000000,37,039,Cherokee County, NC,Apr-17,11118,10626,492,4.4
CN3703900000000,37,039,Cherokee County, NC,May-17,11126,10597,529,4.8
CN3703900000000,37,039,Cherokee County, NC,Jun-17,11193,10628,565,5.0
CN3703900000000,37,039,Cherokee County, NC,Jul-17,11331,10750,581,5.1
CN3703900000000,37,039,Cherokee County, NC,Aug-17,11278,10688,590,5.2
CN3703900000000,37,039,Cherokee County, NC,Sep-17,11458,10908,550,4.8
CN3703900000000,37,039,Cherokee County, NC,Oct-17,11089,10555,534,4.8
CN3703900000000,37,039,Cherokee County, NC,Nov-17,11164,10596,568,5.1
CN3703900000000,37,039,Cherokee County, NC,Dec-17,10967,10385,582,5.3
CN3703900000000,37,039,Cherokee County, NC,Jan-18,11014,10387,627,5.7
CN3703900000000,37,039,Cherokee County, NC,Feb-18,11247,10667,580,5.2
CN3703900000000,37,039,Cherokee County, NC,Mar-18,11363,10811,552,4.9
CN3703900000000,37,039,Cherokee County, NC,Apr-18(p),11347,10886,461,4.1
CN1500300000000,15,003,Honolulu County/city, HI,Mar-17,474558,463522,11036,2.3
CN1500300000000,15,003,Honolulu County/city, HI,Apr-17,473633,463147,10486,2.2
CN1500300000000,15,003,Honolulu County/city, HI,May-17,470804,460295,10509,2.2
CN1500300000000,15,003,Honolulu County/city, HI,Jun-17,470933,457909,13024,2.8
CN1500300000000,15,003,Honolulu County/city, HI,Jul-17,471224,460850,10374,2.2
CN1500300000000,15,003,Honolulu County/city, HI,Aug-17,466330,456485,9845,2.1
CN1500300000000,15,003,Honolulu County/city, HI,Sep-17,467674,457485,10189,2.2
CN1500300000000,15,003,Honolulu County/city, HI,Oct-17,467092,457917,9175,2.0
CN1500300000000,15,003,Honolulu County/city, HI,Nov-17,472077,462410,9667,2.0
CN1500300000000,15,003,Honolulu County/city, HI,Dec-17,471688,463613,8075,1.7
CN1500300000000,15,003,Honolulu County/city, HI,Jan-18,473077,463648,9429,2.0
CN1500300000000,15,003,Honolulu County/city, HI,Feb-18,473348,464433,8915,1.9
CN1500300000000,15,003,Honolulu County/city, HI,Mar-18,475394,466288,9106,1.9
CN1500300000000,15,003,Honolulu County/city, HI,Apr-18(p),474605,465769,8836,1.9
CN2908700000000,29,087,Holt County, MO,Mar-17,2687,2604,83,3.1
CN2908700000000,29,087,Holt County, MO,Apr-17,2810,2742,68,2.4
CN2908700000000,29,087,Holt County, MO,May-17,2748,2662,86,3.1
CN2908700000000,29,087,Holt County, MO,Jun-17,2758,2662,96,3.5
CN2908700000000,29,087,Holt County, MO,Jul-17,2622,2521,101,3.9
CN2908700000000,29,087,Holt County, MO,Aug-17,2600,2520,80,3.1
CN2908700000000,29,087,Holt County, MO,Sep-17,2622,2556,66,2.5
CN2908700000000,29,087,Holt County, MO,Oct-17,2658,2615,43,1.6
CN2908700000000,29,087,Holt County, MO,Nov-17,2645,2593,52,2.0
CN2908700000000,29,087,Holt County, MO,Dec-17,2610,2541,69,2.6
CN2908700000000,29,087,Holt County, MO,Jan-18,2609,2526,83,3.2
CN2908700000000,29,087,Holt County, MO,Feb-18,2671,2590,81,3.0
CN2908700000000,29,087,Holt County, MO,Mar-18,2683,2596,87,3.2
CN2908700000000,29,087,Holt County, MO,Apr-18(p),2744,2678,66,2.4
CN3007100000000,30,071,Phillips County, MT,Mar-17,1881,1769,112,6.0
CN3007100000000,30,071,Phillips County, MT,Apr-17,1935,1846,89,4.6
CN3007100000000,30,071,Phillips County, MT,May-17,1938,1874,64,3.3
CN3007100000000,30,071,Phillips County, MT,Jun-17,1891,1813,78,4.1
CN3007100000000,30,071,Phillips County, MT,Jul-17,1916,1840,76,4.0
CN3007100000000,30,071,Phillips County, MT,Aug-17,1872,1805,67,3.6
CN3007100000000,30,071,Phillips County, MT,Sep-17,1879,1817,62,3.3
CN3007100000000,30,071,Phillips County, MT,Oct-17,1896,1835,61,3.2
CN3007100000000,30,071,Phillips County, MT,Nov-17,1894,1810,84,4.4
CN3007100000000,30,071,Phillips County, MT,Dec-17,1896,1796,100,5.3
CN3007100000000,30,071,Phillips County, MT,Jan-18,1921,1779,142,7.4
CN3007100000000,30,071,Phillips County, MT,Feb-18,1904,1764,140,7.4
CN3007100000000,30,071,Phillips County, MT,Mar-18,1864,1732,132,7.1
CN3007100000000,30,071,Phillips County, MT,Apr-18(p),1872,1771,101,5.4
CN2807500000000,28,075,Lauderdale County, MS,Mar-17,32185,30493,1692,5.3
CN2807500000000,28,075,Lauderdale County, MS,Apr-17,31785,30226,1559,4.9
CN2807500000000,28,075,Lauderdale County, MS,May-17,31858,29998,1860,5.8
CN2807500000000,28,075,Lauderdale County, MS,Jun-17,32132,30064,2068,6.4
CN2807500000000,28,075,Lauderdale County, MS,Jul-17,31795,29775,2020,6.4
CN2807500000000,28,075,Lauderdale County, MS,Aug-17,31248,29573,1675,5.4
CN2807500000000,28,075,Lauderdale County, MS,Sep-17,31205,29573,1632,5.2
CN2807500000000,28,075,Lauderdale County, MS,Oct-17,30631,29079,1552,5.1
CN2807500000000,28,075,Lauderdale County, MS,Nov-17,30814,29305,1509,4.9
CN2807500000000,28,075,Lauderdale County, MS,Dec-17,31192,29718,1474,4.7
CN2807500000000,28,075,Lauderdale County, MS,Jan-18,31095,29631,1464,4.7
CN2807500000000,28,075,Lauderdale County, MS,Feb-18,31282,29825,1457,4.7
CN2807500000000,28,075,Lauderdale County, MS,Mar-18,30969,29560,1409,4.5
CN2807500000000,28,075,Lauderdale County, MS,Apr-18(p),30910,29512,1398,4.5
CN3002700000000,30,027,Fergus County, MT,Mar-17,5754,5464,290,5.0
CN3002700000000,30,027,Fergus County, MT,Apr-17,5791,5572,219,3.8
CN3002700000000,30,027,Fergus County, MT,May-17,5834,5661,173,3.0
CN3002700000000,30,027,Fergus County, MT,Jun-17,5803,5604,199,3.4
CN3002700000000,30,027,Fergus County, MT,Jul-17,5888,5699,189,3.2
CN3002700000000,30,027,Fergus County, MT,Aug-17,5872,5698,174,3.0
CN3002700000000,30,027,Fergus County, MT,Sep-17,5761,5583,178,3.1
CN3002700000000,30,027,Fergus County, MT,Oct-17,5772,5580,192,3.3
CN3002700000000,30,027,Fergus County, MT,Nov-17,5724,5490,234,4.1
CN3002700000000,30,027,Fergus County, MT,Dec-17,5705,5424,281,4.9
CN3002700000000,30,027,Fergus County, MT,Jan-18,5726,5375,351,6.1
CN3002700000000,30,027,Fergus County, MT,Feb-18,5707,5371,336,5.9
CN3002700000000,30,027,Fergus County, MT,Mar-18,5694,5372,322,5.7
CN3002700000000,30,027,Fergus County, MT,Apr-18(p),5721,5492,229,4.0
CN4605100000000,46,051,Grant County, SD,Mar-17,4483,4277,206,4.6
CN4605100000000,46,051,Grant County, SD,Apr-17,4535,4376,159,3.5
CN4605100000000,46,051,Grant County, SD,May-17,4548,4416,132,2.9
CN4605100000000,46,051,Grant County, SD,Jun-17,4645,4512,133,2.9
CN4605100000000,46,051,Grant County, SD,Jul-17,4559,4429,130,2.9
CN4605100000000,46,051,Grant County, SD,Aug-17,4448,4314,134,3.0
CN4605100000000,46,051,Grant County, SD,Sep-17,4420,4289,131,3.0
CN4605100000000,46,051,Grant County, SD,Oct-17,4391,4268,123,2.8
CN4605100000000,46,051,Grant County, SD,Nov-17,4373,4230,143,3.3
CN4605100000000,46,051,Grant County, SD,Dec-17,4442,4261,181,4.1
CN4605100000000,46,051,Grant County, SD,Jan-18,4488,4256,232,5.2
CN4605100000000,46,051,Grant County, SD,Feb-18,4493,4253,240,5.3
CN4605100000000,46,051,Grant County, SD,Mar-18,4543,4328,215,4.7
CN4605100000000,46,051,Grant County, SD,Apr-18(p),4495,4296,199,4.4
CN5601500000000,56,015,Goshen County, WY,Mar-17,6850,6644,206,3.0
CN5601500000000,56,015,Goshen County, WY,Apr-17,6820,6640,180,2.6
CN5601500000000,56,015,Goshen County, WY,May-17,6876,6694,182,2.6
CN5601500000000,56,015,Goshen County, WY,Jun-17,7072,6852,220,3.1
CN5601500000000,56,015,Goshen County, WY,Jul-17,7069,6860,209,3.0
CN5601500000000,56,015,Goshen County, WY,Aug-17,7082,6874,208,2.9
CN5601500000000,56,015,Goshen County, WY,Sep-17,6942,6765,177,2.5
CN5601500000000,56,015,Goshen County, WY,Oct-17,7145,6962,183,2.6
CN5601500000000,56,015,Goshen County, WY,Nov-17,7232,7047,185,2.6
CN5601500000000,56,015,Goshen County, WY,Dec-17,7012,6831,181,2.6
CN5601500000000,56,015,Goshen County, WY,Jan-18,6903,6685,218,3.2
CN5601500000000,56,015,Goshen County, WY,Feb-18,6815,6620,195,2.9
CN5601500000000,56,015,Goshen County, WY,Mar-18,6587,6388,199,3.0
CN5601500000000,56,015,Goshen County, WY,Apr-18(p),6532,6328,204,3.1
CN3108300000000,31,083,Harlan County, NE,Mar-17,1711,1667,44,2.6
CN3108300000000,31,083,Harlan County, NE,Apr-17,1743,1701,42,2.4
CN3108300000000,31,083,Harlan County, NE,May-17,1822,1772,50,2.7
CN3108300000000,31,083,Harlan County, NE,Jun-17,1881,1832,49,2.6
CN3108300000000,31,083,Harlan County, NE,Jul-17,1887,1838,49,2.6
CN3108300000000,31,083,Harlan County, NE,Aug-17,1790,1746,44,2.5
CN3108300000000,31,083,Harlan County, NE,Sep-17,1709,1670,39,2.3
CN3108300000000,31,083,Harlan County, NE,Oct-17,1689,1650,39,2.3
CN3108300000000,31,083,Harlan County, NE,Nov-17,1691,1656,35,2.1
CN3108300000000,31,083,Harlan County, NE,Dec-17,1687,1646,41,2.4
CN3108300000000,31,083,Harlan County, NE,Jan-18,1724,1682,42,2.4
CN3108300000000,31,083,Harlan County, NE,Feb-18,1711,1672,39,2.3
CN3108300000000,31,083,Harlan County, NE,Mar-18,1748,1709,39,2.2
CN3108300000000,31,083,Harlan County, NE,Apr-18(p),1761,1716,45,2.6
CN4203100000000,42,031,Clarion County, PA,Mar-17,17992,16922,1070,5.9
CN4203100000000,42,031,Clarion County, PA,Apr-17,17943,17048,895,5.0
CN4203100000000,42,031,Clarion County, PA,May-17,18062,17028,1034,5.7
CN4203100000000,42,031,Clarion County, PA,Jun-17,17518,16505,1013,5.8
CN4203100000000,42,031,Clarion County, PA,Jul-17,17532,16488,1044,6.0
CN4203100000000,42,031,Clarion County, PA,Aug-17,17387,16363,1024,5.9
CN4203100000000,42,031,Clarion County, PA,Sep-17,17898,17079,819,4.6
CN4203100000000,42,031,Clarion County, PA,Oct-17,17643,16865,778,4.4
CN4203100000000,42,031,Clarion County, PA,Nov-17,17633,16782,851,4.8
CN4203100000000,42,031,Clarion County, PA,Dec-17,17346,16446,900,5.2
CN4203100000000,42,031,Clarion County, PA,Jan-18,17298,16200,1098,6.3
CN4203100000000,42,031,Clarion County, PA,Feb-18,17616,16557,1059,6.0
CN4203100000000,42,031,Clarion County, PA,Mar-18,17417,16538,879,5.0
CN4203100000000,42,031,Clarion County, PA,Apr-18(p),17534,16802,732,4.2
CN0113100000000,01,131,Wilcox County, AL,Mar-17,2827,2469,358,12.7
CN0113100000000,01,131,Wilcox County, AL,Apr-17,2746,2449,297,10.8
CN0113100000000,01,131,Wilcox County, AL,May-17,2734,2451,283,10.4
CN0113100000000,01,131,Wilcox County, AL,Jun-17,2850,2498,352,12.4
CN0113100000000,01,131,Wilcox County, AL,Jul-17,2884,2521,363,12.6
CN0113100000000,01,131,Wilcox County, AL,Aug-17,2821,2507,314,11.1
CN0113100000000,01,131,Wilcox County, AL,Sep-17,2818,2546,272,9.7
CN0113100000000,01,131,Wilcox County, AL,Oct-17,2805,2545,260,9.3
CN0113100000000,01,131,Wilcox County, AL,Nov-17,2753,2508,245,8.9
CN0113100000000,01,131,Wilcox County, AL,Dec-17,2740,2479,261,9.5
CN0113100000000,01,131,Wilcox County, AL,Jan-18,2756,2469,287,10.4
CN0113100000000,01,131,Wilcox County, AL,Feb-18,2795,2502,293,10.5
CN0113100000000,01,131,Wilcox County, AL,Mar-18,2750,2493,257,9.3
CN0113100000000,01,131,Wilcox County, AL,Apr-18(p),2744,2508,236,8.6
CN3115700000000,31,157,Scotts Bluff County, NE,Mar-17,18412,17751,661,3.6
CN3115700000000,31,157,Scotts Bluff County, NE,Apr-17,18286,17669,617,3.4
CN3115700000000,31,157,Scotts Bluff County, NE,May-17,18290,17704,586,3.2
CN3115700000000,31,157,Scotts Bluff County, NE,Jun-17,18506,17864,642,3.5
CN3115700000000,31,157,Scotts Bluff County, NE,Jul-17,18532,17877,655,3.5
CN3115700000000,31,157,Scotts Bluff County, NE,Aug-17,18268,17654,614,3.4
CN3115700000000,31,157,Scotts Bluff County, NE,Sep-17,18255,17673,582,3.2
CN3115700000000,31,157,Scotts Bluff County, NE,Oct-17,18387,17867,520,2.8
CN3115700000000,31,157,Scotts Bluff County, NE,Nov-17,18317,17748,569,3.1
CN3115700000000,31,157,Scotts Bluff County, NE,Dec-17,18155,17567,588,3.2
CN3115700000000,31,157,Scotts Bluff County, NE,Jan-18,18239,17623,616,3.4
CN3115700000000,31,157,Scotts Bluff County, NE,Feb-18,18397,17807,590,3.2
CN3115700000000,31,157,Scotts Bluff County, NE,Mar-18,18615,18019,596,3.2
CN3115700000000,31,157,Scotts Bluff County, NE,Apr-18(p),18332,17736,596,3.3
CN4506700000000,45,067,Marion County, SC,Mar-17,12400,11496,904,7.3
CN4506700000000,45,067,Marion County, SC,Apr-17,12507,11642,865,6.9
CN4506700000000,45,067,Marion County, SC,May-17,12526,11695,831,6.6
CN4506700000000,45,067,Marion County, SC,Jun-17,12782,11832,950,7.4
CN4506700000000,45,067,Marion County, SC,Jul-17,12755,11818,937,7.3
CN4506700000000,45,067,Marion County, SC,Aug-17,12673,11691,982,7.7
CN4506700000000,45,067,Marion County, SC,Sep-17,12483,11659,824,6.6
CN4506700000000,45,067,Marion County, SC,Oct-17,12501,11625,876,7.0
CN4506700000000,45,067,Marion County, SC,Nov-17,12470,11611,859,6.9
CN4506700000000,45,067,Marion County, SC,Dec-17,12530,11629,901,7.2
CN4506700000000,45,067,Marion County, SC,Jan-18,12615,11560,1055,8.4
CN4506700000000,45,067,Marion County, SC,Feb-18,12673,11694,979,7.7
CN4506700000000,45,067,Marion County, SC,Mar-18,12535,11701,834,6.7
CN4506700000000,45,067,Marion County, SC,Apr-18(p),12366,11764,602,4.9
CN0605100000000,06,051,Mono County, CA,Mar-17,8862,8493,369,4.2
CN0605100000000,06,051,Mono County, CA,Apr-17,8744,8430,314,3.6
CN0605100000000,06,051,Mono County, CA,May-17,8002,7637,365,4.6
CN0605100000000,06,051,Mono County, CA,Jun-17,8399,7995,404,4.8
CN0605100000000,06,051,Mono County, CA,Jul-17,8721,8305,416,4.8
CN0605100000000,06,051,Mono County, CA,Aug-17,8644,8234,410,4.7
CN0605100000000,06,051,Mono County, CA,Sep-17,8367,8001,366,4.4
CN0605100000000,06,051,Mono County, CA,Oct-17,7914,7531,383,4.8
CN0605100000000,06,051,Mono County, CA,Nov-17,7998,7629,369,4.6
CN0605100000000,06,051,Mono County, CA,Dec-17,9103,8757,346,3.8
CN0605100000000,06,051,Mono County, CA,Jan-18,9440,9094,346,3.7
CN0605100000000,06,051,Mono County, CA,Feb-18,9368,9017,351,3.7
CN0605100000000,06,051,Mono County, CA,Mar-18,9175,8853,322,3.5
CN0605100000000,06,051,Mono County, CA,Apr-18(p),8730,8462,268,3.1
CN1707700000000,17,077,Jackson County, IL,Mar-17,28520,27262,1258,4.4
CN1707700000000,17,077,Jackson County, IL,Apr-17,28410,27359,1051,3.7
CN1707700000000,17,077,Jackson County, IL,May-17,27501,26418,1083,3.9
CN1707700000000,17,077,Jackson County, IL,Jun-17,26989,25718,1271,4.7
CN1707700000000,17,077,Jackson County, IL,Jul-17,27969,26656,1313,4.7
CN1707700000000,17,077,Jackson County, IL,Aug-17,27609,26334,1275,4.6
CN1707700000000,17,077,Jackson County, IL,Sep-17,28110,26982,1128,4.0
CN1707700000000,17,077,Jackson County, IL,Oct-17,28214,27099,1115,4.0
CN1707700000000,17,077,Jackson County, IL,Nov-17,28319,27165,1154,4.1
CN1707700000000,17,077,Jackson County, IL,Dec-17,27754,26650,1104,4.0
CN1707700000000,17,077,Jackson County, IL,Jan-18,27112,25928,1184,4.4
CN1707700000000,17,077,Jackson County, IL,Feb-18,27313,26246,1067,3.9
CN1707700000000,17,077,Jackson County, IL,Mar-18,28138,26993,1145,4.1
CN1707700000000,17,077,Jackson County, IL,Apr-18(p),28315,27357,958,3.4
CN2802500000000,28,025,Clay County, MS,Mar-17,7909,7387,522,6.6
CN2802500000000,28,025,Clay County, MS,Apr-17,7947,7485,462,5.8
CN2802500000000,28,025,Clay County, MS,May-17,7906,7373,533,6.7
CN2802500000000,28,025,Clay County, MS,Jun-17,7984,7351,633,7.9
CN2802500000000,28,025,Clay County, MS,Jul-17,8076,7381,695,8.6
CN2802500000000,28,025,Clay County, MS,Aug-17,7799,7288,511,6.6
CN2802500000000,28,025,Clay County, MS,Sep-17,7836,7359,477,6.1
CN2802500000000,28,025,Clay County, MS,Oct-17,7748,7272,476,6.1
CN2802500000000,28,025,Clay County, MS,Nov-17,7714,7262,452,5.9
CN2802500000000,28,025,Clay County, MS,Dec-17,7713,7269,444,5.8
CN2802500000000,28,025,Clay County, MS,Jan-18,7600,7161,439,5.8
CN2802500000000,28,025,Clay County, MS,Feb-18,7655,7230,425,5.6
CN2802500000000,28,025,Clay County, MS,Mar-18,7728,7315,413,5.3
CN2802500000000,28,025,Clay County, MS,Apr-18(p),7768,7365,403,5.2
CN3404100000000,34,041,Warren County, NJ,Mar-17,56801,54370,2431,4.3
CN3404100000000,34,041,Warren County, NJ,Apr-17,56502,54421,2081,3.7
CN3404100000000,34,041,Warren County, NJ,May-17,56698,54508,2190,3.9
CN3404100000000,34,041,Warren County, NJ,Jun-17,56440,54157,2283,4.0
CN3404100000000,34,041,Warren County, NJ,Jul-17,56804,54151,2653,4.7
CN3404100000000,34,041,Warren County, NJ,Aug-17,56391,53811,2580,4.6
CN3404100000000,34,041,Warren County, NJ,Sep-17,56464,54180,2284,4.0
CN3404100000000,34,041,Warren County, NJ,Oct-17,56660,54491,2169,3.8
CN3404100000000,34,041,Warren County, NJ,Nov-17,56440,54304,2136,3.8
CN3404100000000,34,041,Warren County, NJ,Dec-17,56027,53957,2070,3.7
CN3404100000000,34,041,Warren County, NJ,Jan-18,56055,53486,2569,4.6
CN3404100000000,34,041,Warren County, NJ,Feb-18,56457,53845,2612,4.6
CN3404100000000,34,041,Warren County, NJ,Mar-18,55990,53514,2476,4.4
CN3404100000000,34,041,Warren County, NJ,Apr-18(p),55988,53878,2110,3.8
CN0105900000000,01,059,Franklin County, AL,Mar-17,14054,13364,690,4.9
CN0105900000000,01,059,Franklin County, AL,Apr-17,13949,13392,557,4.0
CN0105900000000,01,059,Franklin County, AL,May-17,13842,13301,541,3.9
CN0105900000000,01,059,Franklin County, AL,Jun-17,13962,13320,642,4.6
CN0105900000000,01,059,Franklin County, AL,Jul-17,13921,13327,594,4.3
CN0105900000000,01,059,Franklin County, AL,Aug-17,13889,13310,579,4.2
CN0105900000000,01,059,Franklin County, AL,Sep-17,14026,13545,481,3.4
CN0105900000000,01,059,Franklin County, AL,Oct-17,14009,13539,470,3.4
CN0105900000000,01,059,Franklin County, AL,Nov-17,13986,13542,444,3.2
CN0105900000000,01,059,Franklin County, AL,Dec-17,13901,13443,458,3.3
CN0105900000000,01,059,Franklin County, AL,Jan-18,13768,13215,553,4.0
CN0105900000000,01,059,Franklin County, AL,Feb-18,13988,13433,555,4.0
CN0105900000000,01,059,Franklin County, AL,Mar-18,14053,13532,521,3.7
CN0105900000000,01,059,Franklin County, AL,Apr-18(p),14125,13674,451,3.2
CN4718100000000,47,181,Wayne County, TN,Mar-17,6070,5742,328,5.4
CN4718100000000,47,181,Wayne County, TN,Apr-17,6051,5770,281,4.6
CN4718100000000,47,181,Wayne County, TN,May-17,6108,5827,281,4.6
CN4718100000000,47,181,Wayne County, TN,Jun-17,6197,5849,348,5.6
CN4718100000000,47,181,Wayne County, TN,Jul-17,6238,5900,338,5.4
CN4718100000000,47,181,Wayne County, TN,Aug-17,6237,5918,319,5.1
CN4718100000000,47,181,Wayne County, TN,Sep-17,6217,5960,257,4.1
CN4718100000000,47,181,Wayne County, TN,Oct-17,6169,5903,266,4.3
CN4718100000000,47,181,Wayne County, TN,Nov-17,6127,5870,257,4.2
CN4718100000000,47,181,Wayne County, TN,Dec-17,6134,5861,273,4.5
CN4718100000000,47,181,Wayne County, TN,Jan-18,6147,5795,352,5.7
CN4718100000000,47,181,Wayne County, TN,Feb-18,6215,5872,343,5.5
CN4718100000000,47,181,Wayne County, TN,Mar-18,6111,5840,271,4.4
CN4718100000000,47,181,Wayne County, TN,Apr-18(p),6129,5893,236,3.9
CN1332100000000,13,321,Worth County, GA,Mar-17,9431,8966,465,4.9
CN1332100000000,13,321,Worth County, GA,Apr-17,9251,8816,435,4.7
CN1332100000000,13,321,Worth County, GA,May-17,9288,8845,443,4.8
CN1332100000000,13,321,Worth County, GA,Jun-17,9322,8838,484,5.2
CN1332100000000,13,321,Worth County, GA,Jul-17,9234,8765,469,5.1
CN1332100000000,13,321,Worth County, GA,Aug-17,9236,8767,469,5.1
CN1332100000000,13,321,Worth County, GA,Sep-17,9292,8862,430,4.6
CN1332100000000,13,321,Worth County, GA,Oct-17,9415,8983,432,4.6
CN1332100000000,13,321,Worth County, GA,Nov-17,9433,9007,426,4.5
CN1332100000000,13,321,Worth County, GA,Dec-17,9484,9040,444,4.7
CN1332100000000,13,321,Worth County, GA,Jan-18,9539,9078,461,4.8
CN1332100000000,13,321,Worth County, GA,Feb-18,9477,9028,449,4.7
CN1332100000000,13,321,Worth County, GA,Mar-18,9409,8995,414,4.4
CN1332100000000,13,321,Worth County, GA,Apr-18(p),9339,8970,369,4.0
CN2813100000000,28,131,Stone County, MS,Mar-17,6513,6109,404,6.2
CN2813100000000,28,131,Stone County, MS,Apr-17,6613,6247,366,5.5
CN2813100000000,28,131,Stone County, MS,May-17,6652,6210,442,6.6
CN2813100000000,28,131,Stone County, MS,Jun-17,6710,6204,506,7.5
CN2813100000000,28,131,Stone County, MS,Jul-17,6730,6265,465,6.9
CN2813100000000,28,131,Stone County, MS,Aug-17,6557,6182,375,5.7
CN2813100000000,28,131,Stone County, MS,Sep-17,6528,6180,348,5.3
CN2813100000000,28,131,Stone County, MS,Oct-17,6536,6214,322,4.9
CN2813100000000,28,131,Stone County, MS,Nov-17,6571,6244,327,5.0
CN2813100000000,28,131,Stone County, MS,Dec-17,6542,6218,324,5.0
CN2813100000000,28,131,Stone County, MS,Jan-18,6440,6107,333,5.2
CN2813100000000,28,131,Stone County, MS,Feb-18,6510,6176,334,5.1
CN2813100000000,28,131,Stone County, MS,Mar-18,6536,6206,330,5.0
CN2813100000000,28,131,Stone County, MS,Apr-18(p),6558,6221,337,5.1
CN0510100000000,05,101,Newton County, AR,Mar-17,3395,3278,117,3.4
CN0510100000000,05,101,Newton County, AR,Apr-17,3397,3296,101,3.0
CN0510100000000,05,101,Newton County, AR,May-17,3422,3308,114,3.3
CN0510100000000,05,101,Newton County, AR,Jun-17,3499,3379,120,3.4
CN0510100000000,05,101,Newton County, AR,Jul-17,3355,3220,135,4.0
CN0510100000000,05,101,Newton County, AR,Aug-17,3321,3199,122,3.7
CN0510100000000,05,101,Newton County, AR,Sep-17,3377,3256,121,3.6
CN0510100000000,05,101,Newton County, AR,Oct-17,3364,3261,103,3.1
CN0510100000000,05,101,Newton County, AR,Nov-17,3357,3261,96,2.9
CN0510100000000,05,101,Newton County, AR,Dec-17,3347,3229,118,3.5
CN0510100000000,05,101,Newton County, AR,Jan-18,3311,3159,152,4.6
CN0510100000000,05,101,Newton County, AR,Feb-18,3338,3189,149,4.5
CN0510100000000,05,101,Newton County, AR,Mar-18,3332,3221,111,3.3
CN0510100000000,05,101,Newton County, AR,Apr-18(p),3339,3241,98,2.9
CN0611300000000,06,113,Yolo County, CA,Mar-17,107970,101570,6400,5.9
CN0611300000000,06,113,Yolo County, CA,Apr-17,107428,101907,5521,5.1
CN0611300000000,06,113,Yolo County, CA,May-17,107111,102432,4679,4.4
CN0611300000000,06,113,Yolo County, CA,Jun-17,108068,102787,5281,4.9
CN0611300000000,06,113,Yolo County, CA,Jul-17,109385,103897,5488,5.0
CN0611300000000,06,113,Yolo County, CA,Aug-17,108631,103473,5158,4.7
CN0611300000000,06,113,Yolo County, CA,Sep-17,108032,103638,4394,4.1
CN0611300000000,06,113,Yolo County, CA,Oct-17,107352,103000,4352,4.1
CN0611300000000,06,113,Yolo County, CA,Nov-17,107557,102902,4655,4.3
CN0611300000000,06,113,Yolo County, CA,Dec-17,107509,102650,4859,4.5
CN0611300000000,06,113,Yolo County, CA,Jan-18,107861,102306,5555,5.2
CN0611300000000,06,113,Yolo County, CA,Feb-18,108278,102694,5584,5.2
CN0611300000000,06,113,Yolo County, CA,Mar-18,107594,102439,5155,4.8
CN0611300000000,06,113,Yolo County, CA,Apr-18(p),106662,102358,4304,4.0
CN3902300000000,39,023,Clark County, OH,Mar-17,63886,60754,3132,4.9
CN3902300000000,39,023,Clark County, OH,Apr-17,63702,60941,2761,4.3
CN3902300000000,39,023,Clark County, OH,May-17,64150,61368,2782,4.3
CN3902300000000,39,023,Clark County, OH,Jun-17,64492,61238,3254,5.0
CN3902300000000,39,023,Clark County, OH,Jul-17,63995,60427,3568,5.6
CN3902300000000,39,023,Clark County, OH,Aug-17,64284,61136,3148,4.9
CN3902300000000,39,023,Clark County, OH,Sep-17,63659,60834,2825,4.4
CN3902300000000,39,023,Clark County, OH,Oct-17,63636,60937,2699,4.2
CN3902300000000,39,023,Clark County, OH,Nov-17,63631,60835,2796,4.4
CN3902300000000,39,023,Clark County, OH,Dec-17,63483,60657,2826,4.5
CN3902300000000,39,023,Clark County, OH,Jan-18,62426,59532,2894,4.6
CN3902300000000,39,023,Clark County, OH,Feb-18,63503,60735,2768,4.4
CN3902300000000,39,023,Clark County, OH,Mar-18,64042,61458,2584,4.0
CN3902300000000,39,023,Clark County, OH,Apr-18(p),63807,61313,2494,3.9
CN2118100000000,21,181,Nicholas County, KY,Mar-17,3421,3209,212,6.2
CN2118100000000,21,181,Nicholas County, KY,Apr-17,3427,3248,179,5.2
CN2118100000000,21,181,Nicholas County, KY,May-17,3460,3270,190,5.5
CN2118100000000,21,181,Nicholas County, KY,Jun-17,3579,3371,208,5.8
CN2118100000000,21,181,Nicholas County, KY,Jul-17,3502,3308,194,5.5
CN2118100000000,21,181,Nicholas County, KY,Aug-17,3485,3299,186,5.3
CN2118100000000,21,181,Nicholas County, KY,Sep-17,3419,3268,151,4.4
CN2118100000000,21,181,Nicholas County, KY,Oct-17,3451,3309,142,4.1
CN2118100000000,21,181,Nicholas County, KY,Nov-17,3452,3319,133,3.9
CN2118100000000,21,181,Nicholas County, KY,Dec-17,3466,3327,139,4.0
CN2118100000000,21,181,Nicholas County, KY,Jan-18,3360,3203,157,4.7
CN2118100000000,21,181,Nicholas County, KY,Feb-18,3314,3150,164,4.9
CN2118100000000,21,181,Nicholas County, KY,Mar-18,3347,3197,150,4.5
CN2118100000000,21,181,Nicholas County, KY,Apr-18(p),3356,3219,137,4.1
CN5602100000000,56,021,Laramie County, WY,Mar-17,49020,47022,1998,4.1
CN5602100000000,56,021,Laramie County, WY,Apr-17,48571,46918,1653,3.4
CN5602100000000,56,021,Laramie County, WY,May-17,47814,46194,1620,3.4
CN5602100000000,56,021,Laramie County, WY,Jun-17,47665,45887,1778,3.7
CN5602100000000,56,021,Laramie County, WY,Jul-17,48512,46865,1647,3.4
CN5602100000000,56,021,Laramie County, WY,Aug-17,47739,46123,1616,3.4
CN5602100000000,56,021,Laramie County, WY,Sep-17,47242,45640,1602,3.4
CN5602100000000,56,021,Laramie County, WY,Oct-17,47665,45994,1671,3.5
CN5602100000000,56,021,Laramie County, WY,Nov-17,47806,46130,1676,3.5
CN5602100000000,56,021,Laramie County, WY,Dec-17,47661,45922,1739,3.6
CN5602100000000,56,021,Laramie County, WY,Jan-18,47291,45272,2019,4.3
CN5602100000000,56,021,Laramie County, WY,Feb-18,47841,45891,1950,4.1
CN5602100000000,56,021,Laramie County, WY,Mar-18,47934,46114,1820,3.8
CN5602100000000,56,021,Laramie County, WY,Apr-18(p),47761,46131,1630,3.4
CN0513500000000,05,135,Sharp County, AR,Mar-17,6048,5736,312,5.2
CN0513500000000,05,135,Sharp County, AR,Apr-17,6055,5775,280,4.6
CN0513500000000,05,135,Sharp County, AR,May-17,6099,5803,296,4.9
CN0513500000000,05,135,Sharp County, AR,Jun-17,6283,5969,314,5.0
CN0513500000000,05,135,Sharp County, AR,Jul-17,6054,5730,324,5.4
CN0513500000000,05,135,Sharp County, AR,Aug-17,5953,5666,287,4.8
CN0513500000000,05,135,Sharp County, AR,Sep-17,6141,5877,264,4.3
CN0513500000000,05,135,Sharp County, AR,Oct-17,6031,5775,256,4.2
CN0513500000000,05,135,Sharp County, AR,Nov-17,6015,5773,242,4.0
CN0513500000000,05,135,Sharp County, AR,Dec-17,5962,5706,256,4.3
CN0513500000000,05,135,Sharp County, AR,Jan-18,5935,5606,329,5.5
CN0513500000000,05,135,Sharp County, AR,Feb-18,5998,5696,302,5.0
CN0513500000000,05,135,Sharp County, AR,Mar-18,6036,5750,286,4.7
CN0513500000000,05,135,Sharp County, AR,Apr-18(p),6058,5811,247,4.1
CN2813700000000,28,137,Tate County, MS,Mar-17,12055,11487,568,4.7
CN2813700000000,28,137,Tate County, MS,Apr-17,12057,11533,524,4.3
CN2813700000000,28,137,Tate County, MS,May-17,12124,11476,648,5.3
CN2813700000000,28,137,Tate County, MS,Jun-17,12275,11516,759,6.2
CN2813700000000,28,137,Tate County, MS,Jul-17,12299,11594,705,5.7
CN2813700000000,28,137,Tate County, MS,Aug-17,12072,11472,600,5.0
CN2813700000000,28,137,Tate County, MS,Sep-17,12152,11556,596,4.9
CN2813700000000,28,137,Tate County, MS,Oct-17,12129,11573,556,4.6
CN2813700000000,28,137,Tate County, MS,Nov-17,12259,11722,537,4.4
CN2813700000000,28,137,Tate County, MS,Dec-17,12242,11695,547,4.5
CN2813700000000,28,137,Tate County, MS,Jan-18,11982,11436,546,4.6
CN2813700000000,28,137,Tate County, MS,Feb-18,12091,11552,539,4.5
CN2813700000000,28,137,Tate County, MS,Mar-18,12156,11632,524,4.3
CN2813700000000,28,137,Tate County, MS,Apr-18(p),12173,11633,540,4.4
CN3804500000000,38,045,LaMoure County, ND,Mar-17,2266,2213,53,2.3
CN3804500000000,38,045,LaMoure County, ND,Apr-17,2310,2261,49,2.1
CN3804500000000,38,045,LaMoure County, ND,May-17,2323,2288,35,1.5
CN3804500000000,38,045,LaMoure County, ND,Jun-17,2425,2379,46,1.9
CN3804500000000,38,045,LaMoure County, ND,Jul-17,2319,2281,38,1.6
CN3804500000000,38,045,LaMoure County, ND,Aug-17,2325,2284,41,1.8
CN3804500000000,38,045,LaMoure County, ND,Sep-17,2368,2336,32,1.4
CN3804500000000,38,045,LaMoure County, ND,Oct-17,2343,2314,29,1.2
CN3804500000000,38,045,LaMoure County, ND,Nov-17,2272,2239,33,1.5
CN3804500000000,38,045,LaMoure County, ND,Dec-17,2259,2222,37,1.6
CN3804500000000,38,045,LaMoure County, ND,Jan-18,2176,2123,53,2.4
CN3804500000000,38,045,LaMoure County, ND,Feb-18,2141,2087,54,2.5
CN3804500000000,38,045,LaMoure County, ND,Mar-18,2179,2134,45,2.1
CN3804500000000,38,045,LaMoure County, ND,Apr-18(p),2179,2137,42,1.9
CN2108100000000,21,081,Grant County, KY,Mar-17,11544,10897,647,5.6
CN2108100000000,21,081,Grant County, KY,Apr-17,11532,10994,538,4.7
CN2108100000000,21,081,Grant County, KY,May-17,11590,11033,557,4.8
CN2108100000000,21,081,Grant County, KY,Jun-17,11711,11116,595,5.1
CN2108100000000,21,081,Grant County, KY,Jul-17,11739,11144,595,5.1
CN2108100000000,21,081,Grant County, KY,Aug-17,11566,11047,519,4.5
CN2108100000000,21,081,Grant County, KY,Sep-17,11565,11078,487,4.2
CN2108100000000,21,081,Grant County, KY,Oct-17,11472,10990,482,4.2
CN2108100000000,21,081,Grant County, KY,Nov-17,11434,10974,460,4.0
CN2108100000000,21,081,Grant County, KY,Dec-17,11373,10907,466,4.1
CN2108100000000,21,081,Grant County, KY,Jan-18,11359,10818,541,4.8
CN2108100000000,21,081,Grant County, KY,Feb-18,11538,10949,589,5.1
CN2108100000000,21,081,Grant County, KY,Mar-18,11607,11074,533,4.6
CN2108100000000,21,081,Grant County, KY,Apr-18(p),11593,11146,447,3.9
CN2712500000000,27,125,Red Lake County, MN,Mar-17,2333,2079,254,10.9
CN2712500000000,27,125,Red Lake County, MN,Apr-17,2309,2103,206,8.9
CN2712500000000,27,125,Red Lake County, MN,May-17,2265,2161,104,4.6
CN2712500000000,27,125,Red Lake County, MN,Jun-17,2250,2151,99,4.4
CN2712500000000,27,125,Red Lake County, MN,Jul-17,2181,2089,92,4.2
CN2712500000000,27,125,Red Lake County, MN,Aug-17,2172,2067,105,4.8
CN2712500000000,27,125,Red Lake County, MN,Sep-17,2163,2094,69,3.2
CN2712500000000,27,125,Red Lake County, MN,Oct-17,2210,2145,65,2.9
CN2712500000000,27,125,Red Lake County, MN,Nov-17,2216,2128,88,4.0
CN2712500000000,27,125,Red Lake County, MN,Dec-17,2275,2117,158,6.9
CN2712500000000,27,125,Red Lake County, MN,Jan-18,2268,2076,192,8.5
CN2712500000000,27,125,Red Lake County, MN,Feb-18,2257,2083,174,7.7
CN2712500000000,27,125,Red Lake County, MN,Mar-18,2292,2085,207,9.0
CN2712500000000,27,125,Red Lake County, MN,Apr-18(p),2263,2125,138,6.1
CN0103100000000,01,031,Coffee County, AL,Mar-17,20718,19673,1045,5.0
CN0103100000000,01,031,Coffee County, AL,Apr-17,20833,19958,875,4.2
CN0103100000000,01,031,Coffee County, AL,May-17,20762,19926,836,4.0
CN0103100000000,01,031,Coffee County, AL,Jun-17,20888,19881,1007,4.8
CN0103100000000,01,031,Coffee County, AL,Jul-17,20635,19697,938,4.5
CN0103100000000,01,031,Coffee County, AL,Aug-17,20615,19739,876,4.2
CN0103100000000,01,031,Coffee County, AL,Sep-17,20823,20078,745,3.6
CN0103100000000,01,031,Coffee County, AL,Oct-17,20711,19962,749,3.6
CN0103100000000,01,031,Coffee County, AL,Nov-17,20500,19797,703,3.4
CN0103100000000,01,031,Coffee County, AL,Dec-17,20326,19638,688,3.4
CN0103100000000,01,031,Coffee County, AL,Jan-18,20304,19468,836,4.1
CN0103100000000,01,031,Coffee County, AL,Feb-18,20335,19468,867,4.3
CN0103100000000,01,031,Coffee County, AL,Mar-18,20325,19547,778,3.8
CN0103100000000,01,031,Coffee County, AL,Apr-18(p),20534,19813,721,3.5
CN3809500000000,38,095,Towner County, ND,Mar-17,1247,1205,42,3.4
CN3809500000000,38,095,Towner County, ND,Apr-17,1250,1218,32,2.6
CN3809500000000,38,095,Towner County, ND,May-17,1259,1232,27,2.1
CN3809500000000,38,095,Towner County, ND,Jun-17,1314,1282,32,2.4
CN3809500000000,38,095,Towner County, ND,Jul-17,1267,1240,27,2.1
CN3809500000000,38,095,Towner County, ND,Aug-17,1293,1265,28,2.2
CN3809500000000,38,095,Towner County, ND,Sep-17,1278,1256,22,1.7
CN3809500000000,38,095,Towner County, ND,Oct-17,1241,1222,19,1.5
CN3809500000000,38,095,Towner County, ND,Nov-17,1178,1149,29,2.5
CN3809500000000,38,095,Towner County, ND,Dec-17,1126,1094,32,2.8
CN3809500000000,38,095,Towner County, ND,Jan-18,1075,1040,35,3.3
CN3809500000000,38,095,Towner County, ND,Feb-18,1049,1012,37,3.5
CN3809500000000,38,095,Towner County, ND,Mar-18,1079,1048,31,2.9
CN3809500000000,38,095,Towner County, ND,Apr-18(p),1118,1085,33,3.0
CN4004700000000,40,047,Garfield County, OK,Mar-17,28118,26974,1144,4.1
CN4004700000000,40,047,Garfield County, OK,Apr-17,28023,26987,1036,3.7
CN4004700000000,40,047,Garfield County, OK,May-17,27962,26812,1150,4.1
CN4004700000000,40,047,Garfield County, OK,Jun-17,28204,27025,1179,4.2
CN4004700000000,40,047,Garfield County, OK,Jul-17,28159,27075,1084,3.8
CN4004700000000,40,047,Garfield County, OK,Aug-17,27718,26641,1077,3.9
CN4004700000000,40,047,Garfield County, OK,Sep-17,27714,26652,1062,3.8
CN4004700000000,40,047,Garfield County, OK,Oct-17,27719,26696,1023,3.7
CN4004700000000,40,047,Garfield County, OK,Nov-17,27598,26627,971,3.5
CN4004700000000,40,047,Garfield County, OK,Dec-17,27411,26463,948,3.5
CN4004700000000,40,047,Garfield County, OK,Jan-18,27056,26020,1036,3.8
CN4004700000000,40,047,Garfield County, OK,Feb-18,27193,26191,1002,3.7
CN4004700000000,40,047,Garfield County, OK,Mar-18,27598,26618,980,3.6
CN4004700000000,40,047,Garfield County, OK,Apr-18(p),27359,26414,945,3.5
CN0400500000000,04,005,Coconino County, AZ,Mar-17,74490,69960,4530,6.1
CN0400500000000,04,005,Coconino County, AZ,Apr-17,75209,71289,3920,5.2
CN0400500000000,04,005,Coconino County, AZ,May-17,75304,71528,3776,5.0
CN0400500000000,04,005,Coconino County, AZ,Jun-17,75892,71494,4398,5.8
CN0400500000000,04,005,Coconino County, AZ,Jul-17,76649,72219,4430,5.8
CN0400500000000,04,005,Coconino County, AZ,Aug-17,75699,71512,4187,5.5
CN0400500000000,04,005,Coconino County, AZ,Sep-17,77751,73896,3855,5.0
CN0400500000000,04,005,Coconino County, AZ,Oct-17,76582,72810,3772,4.9
CN0400500000000,04,005,Coconino County, AZ,Nov-17,75624,71904,3720,4.9
CN0400500000000,04,005,Coconino County, AZ,Dec-17,74643,70563,4080,5.5
CN0400500000000,04,005,Coconino County, AZ,Jan-18,74630,69923,4707,6.3
CN0400500000000,04,005,Coconino County, AZ,Feb-18,75350,70820,4530,6.0
CN0400500000000,04,005,Coconino County, AZ,Mar-18,75682,71559,4123,5.4
CN0400500000000,04,005,Coconino County, AZ,Apr-18(p),75866,72194,3672,4.8
CN2614700000000,26,147,St. Clair County, MI,Mar-17,75348,71155,4193,5.6
CN2614700000000,26,147,St. Clair County, MI,Apr-17,74135,71208,2927,3.9
CN2614700000000,26,147,St. Clair County, MI,May-17,74675,71897,2778,3.7
CN2614700000000,26,147,St. Clair County, MI,Jun-17,75262,72026,3236,4.3
CN2614700000000,26,147,St. Clair County, MI,Jul-17,76510,72354,4156,5.4
CN2614700000000,26,147,St. Clair County, MI,Aug-17,76107,72136,3971,5.2
CN2614700000000,26,147,St. Clair County, MI,Sep-17,76010,72538,3472,4.6
CN2614700000000,26,147,St. Clair County, MI,Oct-17,75600,72127,3473,4.6
CN2614700000000,26,147,St. Clair County, MI,Nov-17,75268,72127,3141,4.2
CN2614700000000,26,147,St. Clair County, MI,Dec-17,75451,71928,3523,4.7
CN2614700000000,26,147,St. Clair County, MI,Jan-18,74803,70337,4466,6.0
CN2614700000000,26,147,St. Clair County, MI,Feb-18,75250,70964,4286,5.7
CN2614700000000,26,147,St. Clair County, MI,Mar-18,75321,71428,3893,5.2
CN2614700000000,26,147,St. Clair County, MI,Apr-18(p),74597,71443,3154,4.2
CN1708300000000,17,083,Jersey County, IL,Mar-17,10950,10391,559,5.1
CN1708300000000,17,083,Jersey County, IL,Apr-17,10950,10487,463,4.2
CN1708300000000,17,083,Jersey County, IL,May-17,10910,10421,489,4.5
CN1708300000000,17,083,Jersey County, IL,Jun-17,11008,10497,511,4.6
CN1708300000000,17,083,Jersey County, IL,Jul-17,10998,10468,530,4.8
CN1708300000000,17,083,Jersey County, IL,Aug-17,10899,10386,513,4.7
CN1708300000000,17,083,Jersey County, IL,Sep-17,10884,10426,458,4.2
CN1708300000000,17,083,Jersey County, IL,Oct-17,10874,10439,435,4.0
CN1708300000000,17,083,Jersey County, IL,Nov-17,10901,10443,458,4.2
CN1708300000000,17,083,Jersey County, IL,Dec-17,10829,10364,465,4.3
CN1708300000000,17,083,Jersey County, IL,Jan-18,10846,10302,544,5.0
CN1708300000000,17,083,Jersey County, IL,Feb-18,10954,10439,515,4.7
CN1708300000000,17,083,Jersey County, IL,Mar-18,11121,10618,503,4.5
CN1708300000000,17,083,Jersey County, IL,Apr-18(p),11130,10717,413,3.7
CN4717500000000,47,175,Van Buren County, TN,Mar-17,2098,1995,103,4.9
CN4717500000000,47,175,Van Buren County, TN,Apr-17,2086,2008,78,3.7
CN4717500000000,47,175,Van Buren County, TN,May-17,2102,2026,76,3.6
CN4717500000000,47,175,Van Buren County, TN,Jun-17,2088,1986,102,4.9
CN4717500000000,47,175,Van Buren County, TN,Jul-17,2097,2000,97,4.6
CN4717500000000,47,175,Van Buren County, TN,Aug-17,2124,2034,90,4.2
CN4717500000000,47,175,Van Buren County, TN,Sep-17,2131,2054,77,3.6
CN4717500000000,47,175,Van Buren County, TN,Oct-17,2113,2041,72,3.4
CN4717500000000,47,175,Van Buren County, TN,Nov-17,2086,2010,76,3.6
CN4717500000000,47,175,Van Buren County, TN,Dec-17,2077,2003,74,3.6
CN4717500000000,47,175,Van Buren County, TN,Jan-18,2104,2006,98,4.7
CN4717500000000,47,175,Van Buren County, TN,Feb-18,2111,2022,89,4.2
CN4717500000000,47,175,Van Buren County, TN,Mar-18,2088,1998,90,4.3
CN4717500000000,47,175,Van Buren County, TN,Apr-18(p),2110,2025,85,4.0
CN1607100000000,16,071,Oneida County, ID,Mar-17,2208,2137,71,3.2
CN1607100000000,16,071,Oneida County, ID,Apr-17,2233,2176,57,2.6
CN1607100000000,16,071,Oneida County, ID,May-17,2268,2209,59,2.6
CN1607100000000,16,071,Oneida County, ID,Jun-17,2307,2245,62,2.7
CN1607100000000,16,071,Oneida County, ID,Jul-17,2297,2237,60,2.6
CN1607100000000,16,071,Oneida County, ID,Aug-17,2298,2239,59,2.6
CN1607100000000,16,071,Oneida County, ID,Sep-17,2278,2217,61,2.7
CN1607100000000,16,071,Oneida County, ID,Oct-17,2328,2274,54,2.3
CN1607100000000,16,071,Oneida County, ID,Nov-17,2245,2189,56,2.5
CN1607100000000,16,071,Oneida County, ID,Dec-17,2244,2192,52,2.3
CN1607100000000,16,071,Oneida County, ID,Jan-18,2199,2129,70,3.2
CN1607100000000,16,071,Oneida County, ID,Feb-18,2234,2173,61,2.7
CN1607100000000,16,071,Oneida County, ID,Mar-18,2277,2223,54,2.4
CN1607100000000,16,071,Oneida County, ID,Apr-18(p),2281,2230,51,2.2
CN1205100000000,12,051,Hendry County, FL,Mar-17,16914,15935,979,5.8
CN1205100000000,12,051,Hendry County, FL,Apr-17,15886,14975,911,5.7
CN1205100000000,12,051,Hendry County, FL,May-17,15439,14457,982,6.4
CN1205100000000,12,051,Hendry County, FL,Jun-17,14895,13584,1311,8.8
CN1205100000000,12,051,Hendry County, FL,Jul-17,14373,12926,1447,10.1
CN1205100000000,12,051,Hendry County, FL,Aug-17,14771,13341,1430,9.7
CN1205100000000,12,051,Hendry County, FL,Sep-17,14711,13394,1317,9.0
CN1205100000000,12,051,Hendry County, FL,Oct-17,15117,14036,1081,7.2
CN1205100000000,12,051,Hendry County, FL,Nov-17,15405,14386,1019,6.6
CN1205100000000,12,051,Hendry County, FL,Dec-17,15757,14833,924,5.9
CN1205100000000,12,051,Hendry County, FL,Jan-18,17437,16456,981,5.6
CN1205100000000,12,051,Hendry County, FL,Feb-18,17089,16206,883,5.2
CN1205100000000,12,051,Hendry County, FL,Mar-18,16792,15933,859,5.1
CN1205100000000,12,051,Hendry County, FL,Apr-18(p),15720,14978,742,4.7
CN4612500000000,46,125,Turner County, SD,Mar-17,4720,4548,172,3.6
CN4612500000000,46,125,Turner County, SD,Apr-17,4752,4609,143,3.0
CN4612500000000,46,125,Turner County, SD,May-17,4750,4609,141,3.0
CN4612500000000,46,125,Turner County, SD,Jun-17,4816,4674,142,2.9
CN4612500000000,46,125,Turner County, SD,Jul-17,4792,4656,136,2.8
CN4612500000000,46,125,Turner County, SD,Aug-17,4692,4536,156,3.3
CN4612500000000,46,125,Turner County, SD,Sep-17,4657,4512,145,3.1
CN4612500000000,46,125,Turner County, SD,Oct-17,4647,4511,136,2.9
CN4612500000000,46,125,Turner County, SD,Nov-17,4637,4490,147,3.2
CN4612500000000,46,125,Turner County, SD,Dec-17,4674,4521,153,3.3
CN4612500000000,46,125,Turner County, SD,Jan-18,4695,4514,181,3.9
CN4612500000000,46,125,Turner County, SD,Feb-18,4750,4570,180,3.8
CN4612500000000,46,125,Turner County, SD,Mar-18,4797,4628,169,3.5
CN4612500000000,46,125,Turner County, SD,Apr-18(p),4755,4592,163,3.4
CN0805900000000,08,059,Jefferson County, CO,Mar-17,320587,312309,8278,2.6
CN0805900000000,08,059,Jefferson County, CO,Apr-17,321052,313359,7693,2.4
CN0805900000000,08,059,Jefferson County, CO,May-17,322974,315356,7618,2.4
CN0805900000000,08,059,Jefferson County, CO,Jun-17,327479,318543,8936,2.7
CN0805900000000,08,059,Jefferson County, CO,Jul-17,328670,320167,8503,2.6
CN0805900000000,08,059,Jefferson County, CO,Aug-17,328628,320066,8562,2.6
CN0805900000000,08,059,Jefferson County, CO,Sep-17,330239,321797,8442,2.6
CN0805900000000,08,059,Jefferson County, CO,Oct-17,329431,320827,8604,2.6
CN0805900000000,08,059,Jefferson County, CO,Nov-17,329742,321018,8724,2.6
CN0805900000000,08,059,Jefferson County, CO,Dec-17,328638,319647,8991,2.7
CN0805900000000,08,059,Jefferson County, CO,Jan-18,327574,317550,10024,3.1
CN0805900000000,08,059,Jefferson County, CO,Feb-18,332327,322351,9976,3.0
CN0805900000000,08,059,Jefferson County, CO,Mar-18,332569,323724,8845,2.7
CN0805900000000,08,059,Jefferson County, CO,Apr-18(p),332254,324399,7855,2.4
CN5110100000000,51,101,King William County, VA,Mar-17,8854,8534,320,3.6
CN5110100000000,51,101,King William County, VA,Apr-17,8837,8566,271,3.1
CN5110100000000,51,101,King William County, VA,May-17,8864,8571,293,3.3
CN5110100000000,51,101,King William County, VA,Jun-17,8965,8642,323,3.6
CN5110100000000,51,101,King William County, VA,Jul-17,8987,8670,317,3.5
CN5110100000000,51,101,King William County, VA,Aug-17,8868,8556,312,3.5
CN5110100000000,51,101,King William County, VA,Sep-17,8896,8604,292,3.3
CN5110100000000,51,101,King William County, VA,Oct-17,8839,8555,284,3.2
CN5110100000000,51,101,King William County, VA,Nov-17,8804,8518,286,3.2
CN5110100000000,51,101,King William County, VA,Dec-17,8807,8525,282,3.2
CN5110100000000,51,101,King William County, VA,Jan-18,8781,8472,309,3.5
CN5110100000000,51,101,King William County, VA,Feb-18,8886,8612,274,3.1
CN5110100000000,51,101,King William County, VA,Mar-18,8943,8663,280,3.1
CN5110100000000,51,101,King William County, VA,Apr-18(p),8953,8724,229,2.6
CN0600700000000,06,007,Butte County, CA,Mar-17,103330,96580,6750,6.5
CN0600700000000,06,007,Butte County, CA,Apr-17,103341,97294,6047,5.9
CN0600700000000,06,007,Butte County, CA,May-17,103127,97751,5376,5.2
CN0600700000000,06,007,Butte County, CA,Jun-17,102041,96066,5975,5.9
CN0600700000000,06,007,Butte County, CA,Jul-17,102370,96095,6275,6.1
CN0600700000000,06,007,Butte County, CA,Aug-17,102231,96272,5959,5.8
CN0600700000000,06,007,Butte County, CA,Sep-17,104353,99392,4961,4.8
CN0600700000000,06,007,Butte County, CA,Oct-17,104572,99740,4832,4.6
CN0600700000000,06,007,Butte County, CA,Nov-17,103417,98442,4975,4.8
CN0600700000000,06,007,Butte County, CA,Dec-17,102717,97503,5214,5.1
CN0600700000000,06,007,Butte County, CA,Jan-18,102614,96762,5852,5.7
CN0600700000000,06,007,Butte County, CA,Feb-18,102796,96934,5862,5.7
CN0600700000000,06,007,Butte County, CA,Mar-18,103057,97661,5396,5.2
CN0600700000000,06,007,Butte County, CA,Apr-18(p),102960,98166,4794,4.7
CN4204900000000,42,049,Erie County, PA,Mar-17,131540,123212,8328,6.3
CN4204900000000,42,049,Erie County, PA,Apr-17,131207,123935,7272,5.5
CN4204900000000,42,049,Erie County, PA,May-17,130589,123212,7377,5.6
CN4204900000000,42,049,Erie County, PA,Jun-17,131226,123573,7653,5.8
CN4204900000000,42,049,Erie County, PA,Jul-17,131596,123600,7996,6.1
CN4204900000000,42,049,Erie County, PA,Aug-17,130067,122313,7754,6.0
CN4204900000000,42,049,Erie County, PA,Sep-17,130995,124560,6435,4.9
CN4204900000000,42,049,Erie County, PA,Oct-17,129819,123538,6281,4.8
CN4204900000000,42,049,Erie County, PA,Nov-17,130156,123595,6561,5.0
CN4204900000000,42,049,Erie County, PA,Dec-17,128656,122051,6605,5.1
CN4204900000000,42,049,Erie County, PA,Jan-18,128398,120596,7802,6.1
CN4204900000000,42,049,Erie County, PA,Feb-18,129408,121563,7845,6.1
CN4204900000000,42,049,Erie County, PA,Mar-18,127686,120790,6896,5.4
CN4204900000000,42,049,Erie County, PA,Apr-18(p),127404,121542,5862,4.6
CN1321500000000,13,215,Muscogee County, GA,Mar-17,79736,74919,4817,6.0
CN1321500000000,13,215,Muscogee County, GA,Apr-17,79130,74672,4458,5.6
CN1321500000000,13,215,Muscogee County, GA,May-17,79236,74652,4584,5.8
CN1321500000000,13,215,Muscogee County, GA,Jun-17,79199,74266,4933,6.2
CN1321500000000,13,215,Muscogee County, GA,Jul-17,79785,74727,5058,6.3
CN1321500000000,13,215,Muscogee County, GA,Aug-17,79128,74114,5014,6.3
CN1321500000000,13,215,Muscogee County, GA,Sep-17,79893,75374,4519,5.7
CN1321500000000,13,215,Muscogee County, GA,Oct-17,79608,75181,4427,5.6
CN1321500000000,13,215,Muscogee County, GA,Nov-17,79767,75436,4331,5.4
CN1321500000000,13,215,Muscogee County, GA,Dec-17,79990,75515,4475,5.6
CN1321500000000,13,215,Muscogee County, GA,Jan-18,80560,75386,5174,6.4
CN1321500000000,13,215,Muscogee County, GA,Feb-18,80999,76262,4737,5.8
CN1321500000000,13,215,Muscogee County, GA,Mar-18,81008,76687,4321,5.3
CN1321500000000,13,215,Muscogee County, GA,Apr-18(p),80108,76205,3903,4.9
CN2814900000000,28,149,Warren County, MS,Mar-17,20370,19198,1172,5.8
CN2814900000000,28,149,Warren County, MS,Apr-17,20502,19430,1072,5.2
CN2814900000000,28,149,Warren County, MS,May-17,20684,19465,1219,5.9
CN2814900000000,28,149,Warren County, MS,Jun-17,20909,19524,1385,6.6
CN2814900000000,28,149,Warren County, MS,Jul-17,21045,19729,1316,6.3
CN2814900000000,28,149,Warren County, MS,Aug-17,20604,19437,1167,5.7
CN2814900000000,28,149,Warren County, MS,Sep-17,20603,19539,1064,5.2
CN2814900000000,28,149,Warren County, MS,Oct-17,20435,19397,1038,5.1
CN2814900000000,28,149,Warren County, MS,Nov-17,20555,19523,1032,5.0
CN2814900000000,28,149,Warren County, MS,Dec-17,20655,19604,1051,5.1
CN2814900000000,28,149,Warren County, MS,Jan-18,20362,19289,1073,5.3
CN2814900000000,28,149,Warren County, MS,Feb-18,20632,19593,1039,5.0
CN2814900000000,28,149,Warren County, MS,Mar-18,20664,19650,1014,4.9
CN2814900000000,28,149,Warren County, MS,Apr-18(p),20798,19827,971,4.7
CN5508700000000,55,087,Outagamie County, WI,Mar-17,103887,100535,3352,3.2
CN5508700000000,55,087,Outagamie County, WI,Apr-17,104175,101247,2928,2.8
CN5508700000000,55,087,Outagamie County, WI,May-17,104181,101307,2874,2.8
CN5508700000000,55,087,Outagamie County, WI,Jun-17,106235,102750,3485,3.3
CN5508700000000,55,087,Outagamie County, WI,Jul-17,106546,103219,3327,3.1
CN5508700000000,55,087,Outagamie County, WI,Aug-17,105704,102548,3156,3.0
CN5508700000000,55,087,Outagamie County, WI,Sep-17,104678,101954,2724,2.6
CN5508700000000,55,087,Outagamie County, WI,Oct-17,104726,101863,2863,2.7
CN5508700000000,55,087,Outagamie County, WI,Nov-17,104611,101818,2793,2.7
CN5508700000000,55,087,Outagamie County, WI,Dec-17,104117,101478,2639,2.5
CN5508700000000,55,087,Outagamie County, WI,Jan-18,104173,101213,2960,2.8
CN5508700000000,55,087,Outagamie County, WI,Feb-18,105526,102361,3165,3.0
CN5508700000000,55,087,Outagamie County, WI,Mar-18,105691,102601,3090,2.9
CN5508700000000,55,087,Outagamie County, WI,Apr-18(p),105053,102393,2660,2.5
CN1711100000000,17,111,McHenry County, IL,Mar-17,167378,159775,7603,4.5
CN1711100000000,17,111,McHenry County, IL,Apr-17,166220,159077,7143,4.3
CN1711100000000,17,111,McHenry County, IL,May-17,166709,160176,6533,3.9
CN1711100000000,17,111,McHenry County, IL,Jun-17,169919,161935,7984,4.7
CN1711100000000,17,111,McHenry County, IL,Jul-17,169327,161658,7669,4.5
CN1711100000000,17,111,McHenry County, IL,Aug-17,167447,159521,7926,4.7
CN1711100000000,17,111,McHenry County, IL,Sep-17,167161,160313,6848,4.1
CN1711100000000,17,111,McHenry County, IL,Oct-17,166940,159970,6970,4.2
CN1711100000000,17,111,McHenry County, IL,Nov-17,167304,160278,7026,4.2
CN1711100000000,17,111,McHenry County, IL,Dec-17,166919,159402,7517,4.5
CN1711100000000,17,111,McHenry County, IL,Jan-18,165643,156613,9030,5.5
CN1711100000000,17,111,McHenry County, IL,Feb-18,167979,159196,8783,5.2
CN1711100000000,17,111,McHenry County, IL,Mar-18,166435,159662,6773,4.1
CN1711100000000,17,111,McHenry County, IL,Apr-18(p),163974,158626,5348,3.3
CN2107500000000,21,075,Fulton County, KY,Mar-17,2101,1935,166,7.9
CN2107500000000,21,075,Fulton County, KY,Apr-17,2125,1979,146,6.9
CN2107500000000,21,075,Fulton County, KY,May-17,2134,1980,154,7.2
CN2107500000000,21,075,Fulton County, KY,Jun-17,2116,1953,163,7.7
CN2107500000000,21,075,Fulton County, KY,Jul-17,2093,1923,170,8.1
CN2107500000000,21,075,Fulton County, KY,Aug-17,2074,1919,155,7.5
CN2107500000000,21,075,Fulton County, KY,Sep-17,2072,1919,153,7.4
CN2107500000000,21,075,Fulton County, KY,Oct-17,2055,1925,130,6.3
CN2107500000000,21,075,Fulton County, KY,Nov-17,2046,1941,105,5.1
CN2107500000000,21,075,Fulton County, KY,Dec-17,2030,1923,107,5.3
CN2107500000000,21,075,Fulton County, KY,Jan-18,2029,1915,114,5.6
CN2107500000000,21,075,Fulton County, KY,Feb-18,2039,1910,129,6.3
CN2107500000000,21,075,Fulton County, KY,Mar-18,2045,1923,122,6.0
CN2107500000000,21,075,Fulton County, KY,Apr-18(p),2040,1935,105,5.1
CN4015300000000,40,153,Woodward County, OK,Mar-17,9387,8958,429,4.6
CN4015300000000,40,153,Woodward County, OK,Apr-17,9399,8994,405,4.3
CN4015300000000,40,153,Woodward County, OK,May-17,9358,8936,422,4.5
CN4015300000000,40,153,Woodward County, OK,Jun-17,9404,8973,431,4.6
CN4015300000000,40,153,Woodward County, OK,Jul-17,9639,9241,398,4.1
CN4015300000000,40,153,Woodward County, OK,Aug-17,9496,9109,387,4.1
CN4015300000000,40,153,Woodward County, OK,Sep-17,9437,9079,358,3.8
CN4015300000000,40,153,Woodward County, OK,Oct-17,9355,9020,335,3.6
CN4015300000000,40,153,Woodward County, OK,Nov-17,9425,9100,325,3.4
CN4015300000000,40,153,Woodward County, OK,Dec-17,9285,8970,315,3.4
CN4015300000000,40,153,Woodward County, OK,Jan-18,9298,8951,347,3.7
CN4015300000000,40,153,Woodward County, OK,Feb-18,9409,9094,315,3.3
CN4015300000000,40,153,Woodward County, OK,Mar-18,9410,9101,309,3.3
CN4015300000000,40,153,Woodward County, OK,Apr-18(p),9242,8945,297,3.2
CN2012500000000,20,125,Montgomery County, KS,Mar-17,15128,14305,823,5.4
CN2012500000000,20,125,Montgomery County, KS,Apr-17,14868,14118,750,5.0
CN2012500000000,20,125,Montgomery County, KS,May-17,14884,14096,788,5.3
CN2012500000000,20,125,Montgomery County, KS,Jun-17,15193,14324,869,5.7
CN2012500000000,20,125,Montgomery County, KS,Jul-17,15175,14208,967,6.4
CN2012500000000,20,125,Montgomery County, KS,Aug-17,14742,13912,830,5.6
CN2012500000000,20,125,Montgomery County, KS,Sep-17,14812,14133,679,4.6
CN2012500000000,20,125,Montgomery County, KS,Oct-17,14847,14227,620,4.2
CN2012500000000,20,125,Montgomery County, KS,Nov-17,14938,14306,632,4.2
CN2012500000000,20,125,Montgomery County, KS,Dec-17,14774,14180,594,4.0
CN2012500000000,20,125,Montgomery County, KS,Jan-18,14447,13822,625,4.3
CN2012500000000,20,125,Montgomery County, KS,Feb-18,14404,13716,688,4.8
CN2012500000000,20,125,Montgomery County, KS,Mar-18,14389,13750,639,4.4
CN2012500000000,20,125,Montgomery County, KS,Apr-18(p),14293,13679,614,4.3
CN0500100000000,05,001,Arkansas County, AR,Mar-17,8912,8630,282,3.2
CN0500100000000,05,001,Arkansas County, AR,Apr-17,8972,8723,249,2.8
CN0500100000000,05,001,Arkansas County, AR,May-17,9020,8752,268,3.0
CN0500100000000,05,001,Arkansas County, AR,Jun-17,9216,8914,302,3.3
CN0500100000000,05,001,Arkansas County, AR,Jul-17,9173,8859,314,3.4
CN0500100000000,05,001,Arkansas County, AR,Aug-17,9064,8780,284,3.1
CN0500100000000,05,001,Arkansas County, AR,Sep-17,9075,8793,282,3.1
CN0500100000000,05,001,Arkansas County, AR,Oct-17,9092,8832,260,2.9
CN0500100000000,05,001,Arkansas County, AR,Nov-17,8962,8687,275,3.1
CN0500100000000,05,001,Arkansas County, AR,Dec-17,8995,8673,322,3.6
CN0500100000000,05,001,Arkansas County, AR,Jan-18,8686,8280,406,4.7
CN0500100000000,05,001,Arkansas County, AR,Feb-18,8710,8329,381,4.4
CN0500100000000,05,001,Arkansas County, AR,Mar-18,8738,8398,340,3.9
CN0500100000000,05,001,Arkansas County, AR,Apr-18(p),8751,8465,286,3.3
CN3702100000000,37,021,Buncombe County, NC,Mar-17,136200,131392,4808,3.5
CN3702100000000,37,021,Buncombe County, NC,Apr-17,135912,131729,4183,3.1
CN3702100000000,37,021,Buncombe County, NC,May-17,136647,132191,4456,3.3
CN3702100000000,37,021,Buncombe County, NC,Jun-17,136964,132228,4736,3.5
CN3702100000000,37,021,Buncombe County, NC,Jul-17,138142,133076,5066,3.7
CN3702100000000,37,021,Buncombe County, NC,Aug-17,136522,131459,5063,3.7
CN3702100000000,37,021,Buncombe County, NC,Sep-17,138855,134359,4496,3.2
CN3702100000000,37,021,Buncombe County, NC,Oct-17,138462,134026,4436,3.2
CN3702100000000,37,021,Buncombe County, NC,Nov-17,138629,133924,4705,3.4
CN3702100000000,37,021,Buncombe County, NC,Dec-17,137399,132794,4605,3.4
CN3702100000000,37,021,Buncombe County, NC,Jan-18,137704,132796,4908,3.6
CN3702100000000,37,021,Buncombe County, NC,Feb-18,138286,133483,4803,3.5
CN3702100000000,37,021,Buncombe County, NC,Mar-18,138477,133838,4639,3.4
CN3702100000000,37,021,Buncombe County, NC,Apr-18(p),138666,134734,3932,2.8
CN3009900000000,30,099,Teton County, MT,Mar-17,2799,2668,131,4.7
CN3009900000000,30,099,Teton County, MT,Apr-17,2835,2724,111,3.9
CN3009900000000,30,099,Teton County, MT,May-17,2857,2765,92,3.2
CN3009900000000,30,099,Teton County, MT,Jun-17,2822,2723,99,3.5
CN3009900000000,30,099,Teton County, MT,Jul-17,2810,2711,99,3.5
CN3009900000000,30,099,Teton County, MT,Aug-17,2770,2677,93,3.4
CN3009900000000,30,099,Teton County, MT,Sep-17,2723,2636,87,3.2
CN3009900000000,30,099,Teton County, MT,Oct-17,2731,2640,91,3.3
CN3009900000000,30,099,Teton County, MT,Nov-17,2716,2612,104,3.8
CN3009900000000,30,099,Teton County, MT,Dec-17,2671,2560,111,4.2
CN3009900000000,30,099,Teton County, MT,Jan-18,2703,2571,132,4.9
CN3009900000000,30,099,Teton County, MT,Feb-18,2717,2585,132,4.9
CN3009900000000,30,099,Teton County, MT,Mar-18,2681,2563,118,4.4
CN3009900000000,30,099,Teton County, MT,Apr-18(p),2671,2584,87,3.3
CN3002100000000,30,021,Dawson County, MT,Mar-17,4705,4527,178,3.8
CN3002100000000,30,021,Dawson County, MT,Apr-17,4777,4631,146,3.1
CN3002100000000,30,021,Dawson County, MT,May-17,4791,4638,153,3.2
CN3002100000000,30,021,Dawson County, MT,Jun-17,4667,4504,163,3.5
CN3002100000000,30,021,Dawson County, MT,Jul-17,4690,4541,149,3.2
CN3002100000000,30,021,Dawson County, MT,Aug-17,4652,4518,134,2.9
CN3002100000000,30,021,Dawson County, MT,Sep-17,4603,4479,124,2.7
CN3002100000000,30,021,Dawson County, MT,Oct-17,4603,4476,127,2.8
CN3002100000000,30,021,Dawson County, MT,Nov-17,4627,4503,124,2.7
CN3002100000000,30,021,Dawson County, MT,Dec-17,4620,4491,129,2.8
CN3002100000000,30,021,Dawson County, MT,Jan-18,4645,4498,147,3.2
CN3002100000000,30,021,Dawson County, MT,Feb-18,4676,4522,154,3.3
CN3002100000000,30,021,Dawson County, MT,Mar-18,4600,4439,161,3.5
CN3002100000000,30,021,Dawson County, MT,Apr-18(p),4581,4449,132,2.9
CN4833900000000,48,339,Montgomery County, TX,Mar-17,267340,254922,12418,4.6
CN4833900000000,48,339,Montgomery County, TX,Apr-17,267303,255908,11395,4.3
CN4833900000000,48,339,Montgomery County, TX,May-17,266833,255436,11397,4.3
CN4833900000000,48,339,Montgomery County, TX,Jun-17,267551,255534,12017,4.5
CN4833900000000,48,339,Montgomery County, TX,Jul-17,268144,256321,11823,4.4
CN4833900000000,48,339,Montgomery County, TX,Aug-17,266625,254872,11753,4.4
CN4833900000000,48,339,Montgomery County, TX,Sep-17,267747,256864,10883,4.1
CN4833900000000,48,339,Montgomery County, TX,Oct-17,266517,256606,9911,3.7
CN4833900000000,48,339,Montgomery County, TX,Nov-17,268432,258262,10170,3.8
CN4833900000000,48,339,Montgomery County, TX,Dec-17,268796,258911,9885,3.7
CN4833900000000,48,339,Montgomery County, TX,Jan-18,269062,258016,11046,4.1
CN4833900000000,48,339,Montgomery County, TX,Feb-18,272830,261660,11170,4.1
CN4833900000000,48,339,Montgomery County, TX,Mar-18,273248,262258,10990,4.0
CN4833900000000,48,339,Montgomery County, TX,Apr-18(p),274235,264114,10121,3.7
CN2602900000000,26,029,Charlevoix County, MI,Mar-17,12557,11642,915,7.3
CN2602900000000,26,029,Charlevoix County, MI,Apr-17,12323,11651,672,5.5
CN2602900000000,26,029,Charlevoix County, MI,May-17,13007,12389,618,4.8
CN2602900000000,26,029,Charlevoix County, MI,Jun-17,14000,13339,661,4.7
CN2602900000000,26,029,Charlevoix County, MI,Jul-17,14311,13516,795,5.6
CN2602900000000,26,029,Charlevoix County, MI,Aug-17,14041,13346,695,4.9
CN2602900000000,26,029,Charlevoix County, MI,Sep-17,13270,12678,592,4.5
CN2602900000000,26,029,Charlevoix County, MI,Oct-17,12743,12194,549,4.3
CN2602900000000,26,029,Charlevoix County, MI,Nov-17,12485,11850,635,5.1
CN2602900000000,26,029,Charlevoix County, MI,Dec-17,12689,11855,834,6.6
CN2602900000000,26,029,Charlevoix County, MI,Jan-18,12732,11778,954,7.5
CN2602900000000,26,029,Charlevoix County, MI,Feb-18,12793,11763,1030,8.1
CN2602900000000,26,029,Charlevoix County, MI,Mar-18,12657,11778,879,6.9
CN2602900000000,26,029,Charlevoix County, MI,Apr-18(p),12539,11791,748,6.0
CN4827700000000,48,277,Lamar County, TX,Mar-17,23794,22718,1076,4.5
CN4827700000000,48,277,Lamar County, TX,Apr-17,23834,22889,945,4.0
CN4827700000000,48,277,Lamar County, TX,May-17,23675,22724,951,4.0
CN4827700000000,48,277,Lamar County, TX,Jun-17,23866,22860,1006,4.2
CN4827700000000,48,277,Lamar County, TX,Jul-17,23673,22671,1002,4.2
CN4827700000000,48,277,Lamar County, TX,Aug-17,23494,22476,1018,4.3
CN4827700000000,48,277,Lamar County, TX,Sep-17,23830,22912,918,3.9
CN4827700000000,48,277,Lamar County, TX,Oct-17,23536,22670,866,3.7
CN4827700000000,48,277,Lamar County, TX,Nov-17,23462,22529,933,4.0
CN4827700000000,48,277,Lamar County, TX,Dec-17,23586,22671,915,3.9
CN4827700000000,48,277,Lamar County, TX,Jan-18,24010,22992,1018,4.2
CN4827700000000,48,277,Lamar County, TX,Feb-18,24351,23328,1023,4.2
CN4827700000000,48,277,Lamar County, TX,Mar-18,24487,23429,1058,4.3
CN4827700000000,48,277,Lamar County, TX,Apr-18(p),24690,23753,937,3.8
CN2013100000000,20,131,Nemaha County, KS,Mar-17,5529,5394,135,2.4
CN2013100000000,20,131,Nemaha County, KS,Apr-17,5449,5316,133,2.4
CN2013100000000,20,131,Nemaha County, KS,May-17,5458,5315,143,2.6
CN2013100000000,20,131,Nemaha County, KS,Jun-17,5697,5545,152,2.7
CN2013100000000,20,131,Nemaha County, KS,Jul-17,5640,5487,153,2.7
CN2013100000000,20,131,Nemaha County, KS,Aug-17,5613,5471,142,2.5
CN2013100000000,20,131,Nemaha County, KS,Sep-17,5619,5500,119,2.1
CN2013100000000,20,131,Nemaha County, KS,Oct-17,5633,5527,106,1.9
CN2013100000000,20,131,Nemaha County, KS,Nov-17,5601,5485,116,2.1
CN2013100000000,20,131,Nemaha County, KS,Dec-17,5583,5477,106,1.9
CN2013100000000,20,131,Nemaha County, KS,Jan-18,5510,5383,127,2.3
CN2013100000000,20,131,Nemaha County, KS,Feb-18,5479,5345,134,2.4
CN2013100000000,20,131,Nemaha County, KS,Mar-18,5459,5327,132,2.4
CN2013100000000,20,131,Nemaha County, KS,Apr-18(p),5283,5157,126,2.4
CN1806100000000,18,061,Harrison County, IN,Mar-17,19901,19154,747,3.8
CN1806100000000,18,061,Harrison County, IN,Apr-17,19936,19352,584,2.9
CN1806100000000,18,061,Harrison County, IN,May-17,19955,19356,599,3.0
CN1806100000000,18,061,Harrison County, IN,Jun-17,20329,19667,662,3.3
CN1806100000000,18,061,Harrison County, IN,Jul-17,20455,19761,694,3.4
CN1806100000000,18,061,Harrison County, IN,Aug-17,20118,19363,755,3.8
CN1806100000000,18,061,Harrison County, IN,Sep-17,20011,19386,625,3.1
CN1806100000000,18,061,Harrison County, IN,Oct-17,19915,19320,595,3.0
CN1806100000000,18,061,Harrison County, IN,Nov-17,19968,19359,609,3.0
CN1806100000000,18,061,Harrison County, IN,Dec-17,19949,19319,630,3.2
CN1806100000000,18,061,Harrison County, IN,Jan-18,19768,19029,739,3.7
CN1806100000000,18,061,Harrison County, IN,Feb-18,20017,19266,751,3.8
CN1806100000000,18,061,Harrison County, IN,Mar-18,20209,19522,687,3.4
CN1806100000000,18,061,Harrison County, IN,Apr-18(p),20346,19749,597,2.9
CN1910700000000,19,107,Keokuk County, IA,Mar-17,5153,4927,226,4.4
CN1910700000000,19,107,Keokuk County, IA,Apr-17,5218,5046,172,3.3
CN1910700000000,19,107,Keokuk County, IA,May-17,5223,5069,154,2.9
CN1910700000000,19,107,Keokuk County, IA,Jun-17,5273,5110,163,3.1
CN1910700000000,19,107,Keokuk County, IA,Jul-17,5295,5116,179,3.4
CN1910700000000,19,107,Keokuk County, IA,Aug-17,5205,5025,180,3.5
CN1910700000000,19,107,Keokuk County, IA,Sep-17,5162,4991,171,3.3
CN1910700000000,19,107,Keokuk County, IA,Oct-17,5202,5054,148,2.8
CN1910700000000,19,107,Keokuk County, IA,Nov-17,5125,4987,138,2.7
CN1910700000000,19,107,Keokuk County, IA,Dec-17,5142,4972,170,3.3
CN1910700000000,19,107,Keokuk County, IA,Jan-18,5051,4835,216,4.3
CN1910700000000,19,107,Keokuk County, IA,Feb-18,5092,4875,217,4.3
CN1910700000000,19,107,Keokuk County, IA,Mar-18,5013,4839,174,3.5
CN1910700000000,19,107,Keokuk County, IA,Apr-18(p),5049,4912,137,2.7
CN2613500000000,26,135,Oscoda County, MI,Mar-17,2764,2539,225,8.1
CN2613500000000,26,135,Oscoda County, MI,Apr-17,2877,2649,228,7.9
CN2613500000000,26,135,Oscoda County, MI,May-17,2986,2800,186,6.2
CN2613500000000,26,135,Oscoda County, MI,Jun-17,3083,2870,213,6.9
CN2613500000000,26,135,Oscoda County, MI,Jul-17,3170,2918,252,7.9
CN2613500000000,26,135,Oscoda County, MI,Aug-17,3111,2883,228,7.3
CN2613500000000,26,135,Oscoda County, MI,Sep-17,3013,2823,190,6.3
CN2613500000000,26,135,Oscoda County, MI,Oct-17,2937,2771,166,5.7
CN2613500000000,26,135,Oscoda County, MI,Nov-17,2870,2664,206,7.2
CN2613500000000,26,135,Oscoda County, MI,Dec-17,2873,2620,253,8.8
CN2613500000000,26,135,Oscoda County, MI,Jan-18,2863,2596,267,9.3
CN2613500000000,26,135,Oscoda County, MI,Feb-18,2865,2600,265,9.2
CN2613500000000,26,135,Oscoda County, MI,Mar-18,2816,2578,238,8.5
CN2613500000000,26,135,Oscoda County, MI,Apr-18(p),2893,2692,201,6.9
CN2702500000000,27,025,Chisago County, MN,Mar-17,29687,28097,1590,5.4
CN2702500000000,27,025,Chisago County, MN,Apr-17,29455,28304,1151,3.9
CN2702500000000,27,025,Chisago County, MN,May-17,29413,28434,979,3.3
CN2702500000000,27,025,Chisago County, MN,Jun-17,29627,28568,1059,3.6
CN2702500000000,27,025,Chisago County, MN,Jul-17,29949,28929,1020,3.4
CN2702500000000,27,025,Chisago County, MN,Aug-17,29798,28787,1011,3.4
CN2702500000000,27,025,Chisago County, MN,Sep-17,29668,28795,873,2.9
CN2702500000000,27,025,Chisago County, MN,Oct-17,29451,28712,739,2.5
CN2702500000000,27,025,Chisago County, MN,Nov-17,29575,28652,923,3.1
CN2702500000000,27,025,Chisago County, MN,Dec-17,29672,28435,1237,4.2
CN2702500000000,27,025,Chisago County, MN,Jan-18,30109,28582,1527,5.1
CN2702500000000,27,025,Chisago County, MN,Feb-18,30238,28758,1480,4.9
CN2702500000000,27,025,Chisago County, MN,Mar-18,30172,28692,1480,4.9
CN2702500000000,27,025,Chisago County, MN,Apr-18(p),30043,28879,1164,3.9
CN4209300000000,42,093,Montour County, PA,Mar-17,9160,8798,362,4.0
CN4209300000000,42,093,Montour County, PA,Apr-17,9221,8888,333,3.6
CN4209300000000,42,093,Montour County, PA,May-17,9213,8879,334,3.6
CN4209300000000,42,093,Montour County, PA,Jun-17,9097,8748,349,3.8
CN4209300000000,42,093,Montour County, PA,Jul-17,9153,8760,393,4.3
CN4209300000000,42,093,Montour County, PA,Aug-17,9068,8684,384,4.2
CN4209300000000,42,093,Montour County, PA,Sep-17,9144,8821,323,3.5
CN4209300000000,42,093,Montour County, PA,Oct-17,9080,8769,311,3.4
CN4209300000000,42,093,Montour County, PA,Nov-17,9029,8707,322,3.6
CN4209300000000,42,093,Montour County, PA,Dec-17,8923,8604,319,3.6
CN4209300000000,42,093,Montour County, PA,Jan-18,8865,8474,391,4.4
CN4209300000000,42,093,Montour County, PA,Feb-18,9110,8705,405,4.4
CN4209300000000,42,093,Montour County, PA,Mar-18,8963,8631,332,3.7
CN4209300000000,42,093,Montour County, PA,Apr-18(p),8975,8691,284,3.2
CN5304100000000,53,041,Lewis County, WA,Mar-17,33263,30879,2384,7.2
CN5304100000000,53,041,Lewis County, WA,Apr-17,32780,30621,2159,6.6
CN5304100000000,53,041,Lewis County, WA,May-17,32842,30763,2079,6.3
CN5304100000000,53,041,Lewis County, WA,Jun-17,32717,30702,2015,6.2
CN5304100000000,53,041,Lewis County, WA,Jul-17,33146,31050,2096,6.3
CN5304100000000,53,041,Lewis County, WA,Aug-17,33140,30997,2143,6.5
CN5304100000000,53,041,Lewis County, WA,Sep-17,32987,31020,1967,6.0
CN5304100000000,53,041,Lewis County, WA,Oct-17,33317,31383,1934,5.8
CN5304100000000,53,041,Lewis County, WA,Nov-17,33756,31634,2122,6.3
CN5304100000000,53,041,Lewis County, WA,Dec-17,33403,31117,2286,6.8
CN5304100000000,53,041,Lewis County, WA,Jan-18,33038,30586,2452,7.4
CN5304100000000,53,041,Lewis County, WA,Feb-18,32988,30425,2563,7.8
CN5304100000000,53,041,Lewis County, WA,Mar-18,33619,31236,2383,7.1
CN5304100000000,53,041,Lewis County, WA,Apr-18(p),33313,31092,2221,6.7
CN1807300000000,18,073,Jasper County, IN,Mar-17,16354,15589,765,4.7
CN1807300000000,18,073,Jasper County, IN,Apr-17,16344,15740,604,3.7
CN1807300000000,18,073,Jasper County, IN,May-17,16733,16125,608,3.6
CN1807300000000,18,073,Jasper County, IN,Jun-17,16668,15961,707,4.2
CN1807300000000,18,073,Jasper County, IN,Jul-17,16581,15858,723,4.4
CN1807300000000,18,073,Jasper County, IN,Aug-17,16365,15618,747,4.6
CN1807300000000,18,073,Jasper County, IN,Sep-17,16210,15595,615,3.8
CN1807300000000,18,073,Jasper County, IN,Oct-17,16248,15668,580,3.6
CN1807300000000,18,073,Jasper County, IN,Nov-17,16268,15668,600,3.7
CN1807300000000,18,073,Jasper County, IN,Dec-17,15953,15358,595,3.7
CN1807300000000,18,073,Jasper County, IN,Jan-18,15879,15085,794,5.0
CN1807300000000,18,073,Jasper County, IN,Feb-18,16201,15363,838,5.2
CN1807300000000,18,073,Jasper County, IN,Mar-18,16325,15630,695,4.3
CN1807300000000,18,073,Jasper County, IN,Apr-18(p),16340,15777,563,3.4
CN2002500000000,20,025,Clark County, KS,Mar-17,1109,1080,29,2.6
CN2002500000000,20,025,Clark County, KS,Apr-17,1052,1023,29,2.8
CN2002500000000,20,025,Clark County, KS,May-17,1052,1026,26,2.5
CN2002500000000,20,025,Clark County, KS,Jun-17,1104,1073,31,2.8
CN2002500000000,20,025,Clark County, KS,Jul-17,1085,1052,33,3.0
CN2002500000000,20,025,Clark County, KS,Aug-17,1074,1047,27,2.5
CN2002500000000,20,025,Clark County, KS,Sep-17,1102,1077,25,2.3
CN2002500000000,20,025,Clark County, KS,Oct-17,1120,1099,21,1.9
CN2002500000000,20,025,Clark County, KS,Nov-17,1116,1091,25,2.2
CN2002500000000,20,025,Clark County, KS,Dec-17,1117,1088,29,2.6
CN2002500000000,20,025,Clark County, KS,Jan-18,1087,1059,28,2.6
CN2002500000000,20,025,Clark County, KS,Feb-18,1079,1048,31,2.9
CN2002500000000,20,025,Clark County, KS,Mar-18,1030,1002,28,2.7
CN2002500000000,20,025,Clark County, KS,Apr-18(p),958,929,29,3.0
CN1315300000000,13,153,Houston County, GA,Mar-17,69263,65939,3324,4.8
CN1315300000000,13,153,Houston County, GA,Apr-17,69076,65963,3113,4.5
CN1315300000000,13,153,Houston County, GA,May-17,69061,65865,3196,4.6
CN1315300000000,13,153,Houston County, GA,Jun-17,68885,65500,3385,4.9
CN1315300000000,13,153,Houston County, GA,Jul-17,69449,66017,3432,4.9
CN1315300000000,13,153,Houston County, GA,Aug-17,69325,65951,3374,4.9
CN1315300000000,13,153,Houston County, GA,Sep-17,69669,66593,3076,4.4
CN1315300000000,13,153,Houston County, GA,Oct-17,69338,65972,3366,4.9
CN1315300000000,13,153,Houston County, GA,Nov-17,69137,66220,2917,4.2
CN1315300000000,13,153,Houston County, GA,Dec-17,69257,66256,3001,4.3
CN1315300000000,13,153,Houston County, GA,Jan-18,70043,66694,3349,4.8
CN1315300000000,13,153,Houston County, GA,Feb-18,70610,67514,3096,4.4
CN1315300000000,13,153,Houston County, GA,Mar-18,70751,67894,2857,4.0
CN1315300000000,13,153,Houston County, GA,Apr-18(p),70293,67752,2541,3.6
CN3003900000000,30,039,Granite County, MT,Mar-17,1620,1495,125,7.7
CN3003900000000,30,039,Granite County, MT,Apr-17,1623,1519,104,6.4
CN3003900000000,30,039,Granite County, MT,May-17,1555,1468,87,5.6
CN3003900000000,30,039,Granite County, MT,Jun-17,1710,1621,89,5.2
CN3003900000000,30,039,Granite County, MT,Jul-17,1710,1628,82,4.8
CN3003900000000,30,039,Granite County, MT,Aug-17,1727,1643,84,4.9
CN3003900000000,30,039,Granite County, MT,Sep-17,1612,1535,77,4.8
CN3003900000000,30,039,Granite County, MT,Oct-17,1571,1493,78,5.0
CN3003900000000,30,039,Granite County, MT,Nov-17,1522,1434,88,5.8
CN3003900000000,30,039,Granite County, MT,Dec-17,1569,1482,87,5.5
CN3003900000000,30,039,Granite County, MT,Jan-18,1673,1530,143,8.5
CN3003900000000,30,039,Granite County, MT,Feb-18,1686,1556,130,7.7
CN3003900000000,30,039,Granite County, MT,Mar-18,1640,1522,118,7.2
CN3003900000000,30,039,Granite County, MT,Apr-18(p),1614,1515,99,6.1
CN4606300000000,46,063,Harding County, SD,Mar-17,729,701,28,3.8
CN4606300000000,46,063,Harding County, SD,Apr-17,749,726,23,3.1
CN4606300000000,46,063,Harding County, SD,May-17,766,745,21,2.7
CN4606300000000,46,063,Harding County, SD,Jun-17,799,777,22,2.8
CN4606300000000,46,063,Harding County, SD,Jul-17,759,738,21,2.8
CN4606300000000,46,063,Harding County, SD,Aug-17,721,697,24,3.3
CN4606300000000,46,063,Harding County, SD,Sep-17,725,700,25,3.4
CN4606300000000,46,063,Harding County, SD,Oct-17,697,669,28,4.0
CN4606300000000,46,063,Harding County, SD,Nov-17,683,658,25,3.7
CN4606300000000,46,063,Harding County, SD,Dec-17,721,696,25,3.5
CN4606300000000,46,063,Harding County, SD,Jan-18,716,696,20,2.8
CN4606300000000,46,063,Harding County, SD,Feb-18,743,723,20,2.7
CN4606300000000,46,063,Harding County, SD,Mar-18,760,741,19,2.5
CN4606300000000,46,063,Harding County, SD,Apr-18(p),712,692,20,2.8
CN1905100000000,19,051,Davis County, IA,Mar-17,4228,4086,142,3.4
CN1905100000000,19,051,Davis County, IA,Apr-17,4248,4123,125,2.9
CN1905100000000,19,051,Davis County, IA,May-17,4255,4129,126,3.0
CN1905100000000,19,051,Davis County, IA,Jun-17,4362,4222,140,3.2
CN1905100000000,19,051,Davis County, IA,Jul-17,4361,4228,133,3.0
CN1905100000000,19,051,Davis County, IA,Aug-17,4262,4106,156,3.7
CN1905100000000,19,051,Davis County, IA,Sep-17,4279,4105,174,4.1
CN1905100000000,19,051,Davis County, IA,Oct-17,4250,4103,147,3.5
CN1905100000000,19,051,Davis County, IA,Nov-17,4169,4061,108,2.6
CN1905100000000,19,051,Davis County, IA,Dec-17,4178,4068,110,2.6
CN1905100000000,19,051,Davis County, IA,Jan-18,4168,4011,157,3.8
CN1905100000000,19,051,Davis County, IA,Feb-18,4194,4049,145,3.5
CN1905100000000,19,051,Davis County, IA,Mar-18,4146,4029,117,2.8
CN1905100000000,19,051,Davis County, IA,Apr-18(p),4147,4044,103,2.5
CN1718300000000,17,183,Vermilion County, IL,Mar-17,34215,32005,2210,6.5
CN1718300000000,17,183,Vermilion County, IL,Apr-17,34340,32431,1909,5.6
CN1718300000000,17,183,Vermilion County, IL,May-17,33932,32000,1932,5.7
CN1718300000000,17,183,Vermilion County, IL,Jun-17,34019,31864,2155,6.3
CN1718300000000,17,183,Vermilion County, IL,Jul-17,34298,31966,2332,6.8
CN1718300000000,17,183,Vermilion County, IL,Aug-17,33948,31642,2306,6.8
CN1718300000000,17,183,Vermilion County, IL,Sep-17,34004,32036,1968,5.8
CN1718300000000,17,183,Vermilion County, IL,Oct-17,33906,32012,1894,5.6
CN1718300000000,17,183,Vermilion County, IL,Nov-17,33815,31898,1917,5.7
CN1718300000000,17,183,Vermilion County, IL,Dec-17,33613,31706,1907,5.7
CN1718300000000,17,183,Vermilion County, IL,Jan-18,33509,31473,2036,6.1
CN1718300000000,17,183,Vermilion County, IL,Feb-18,33736,31835,1901,5.6
CN1718300000000,17,183,Vermilion County, IL,Mar-18,34332,32336,1996,5.8
CN1718300000000,17,183,Vermilion County, IL,Apr-18(p),34279,32632,1647,4.8
CN1712300000000,17,123,Marshall County, IL,Mar-17,5456,5117,339,6.2
CN1712300000000,17,123,Marshall County, IL,Apr-17,5550,5270,280,5.0
CN1712300000000,17,123,Marshall County, IL,May-17,5546,5289,257,4.6
CN1712300000000,17,123,Marshall County, IL,Jun-17,5604,5342,262,4.7
CN1712300000000,17,123,Marshall County, IL,Jul-17,5528,5257,271,4.9
CN1712300000000,17,123,Marshall County, IL,Aug-17,5510,5235,275,5.0
CN1712300000000,17,123,Marshall County, IL,Sep-17,5432,5191,241,4.4
CN1712300000000,17,123,Marshall County, IL,Oct-17,5418,5189,229,4.2
CN1712300000000,17,123,Marshall County, IL,Nov-17,5401,5153,248,4.6
CN1712300000000,17,123,Marshall County, IL,Dec-17,5349,5085,264,4.9
CN1712300000000,17,123,Marshall County, IL,Jan-18,5323,5021,302,5.7
CN1712300000000,17,123,Marshall County, IL,Feb-18,5382,5082,300,5.6
CN1712300000000,17,123,Marshall County, IL,Mar-18,5520,5226,294,5.3
CN1712300000000,17,123,Marshall County, IL,Apr-18(p),5531,5295,236,4.3
CN2602300000000,26,023,Branch County, MI,Mar-17,19117,18191,926,4.8
CN2602300000000,26,023,Branch County, MI,Apr-17,19021,18258,763,4.0
CN2602300000000,26,023,Branch County, MI,May-17,19093,18283,810,4.2
CN2602300000000,26,023,Branch County, MI,Jun-17,19445,18546,899,4.6
CN2602300000000,26,023,Branch County, MI,Jul-17,19357,18225,1132,5.8
CN2602300000000,26,023,Branch County, MI,Aug-17,19205,18184,1021,5.3
CN2602300000000,26,023,Branch County, MI,Sep-17,19006,18147,859,4.5
CN2602300000000,26,023,Branch County, MI,Oct-17,18887,18095,792,4.2
CN2602300000000,26,023,Branch County, MI,Nov-17,19008,18227,781,4.1
CN2602300000000,26,023,Branch County, MI,Dec-17,18884,18092,792,4.2
CN2602300000000,26,023,Branch County, MI,Jan-18,18868,17932,936,5.0
CN2602300000000,26,023,Branch County, MI,Feb-18,19133,18197,936,4.9
CN2602300000000,26,023,Branch County, MI,Mar-18,19107,18294,813,4.3
CN2602300000000,26,023,Branch County, MI,Apr-18(p),19064,18376,688,3.6
CN1700500000000,17,005,Bond County, IL,Mar-17,7812,7452,360,4.6
CN1700500000000,17,005,Bond County, IL,Apr-17,7867,7581,286,3.6
CN1700500000000,17,005,Bond County, IL,May-17,7844,7547,297,3.8
CN1700500000000,17,005,Bond County, IL,Jun-17,7957,7623,334,4.2
CN1700500000000,17,005,Bond County, IL,Jul-17,7896,7550,346,4.4
CN1700500000000,17,005,Bond County, IL,Aug-17,7817,7478,339,4.3
CN1700500000000,17,005,Bond County, IL,Sep-17,7783,7478,305,3.9
CN1700500000000,17,005,Bond County, IL,Oct-17,7781,7488,293,3.8
CN1700500000000,17,005,Bond County, IL,Nov-17,7774,7471,303,3.9
CN1700500000000,17,005,Bond County, IL,Dec-17,7651,7356,295,3.9
CN1700500000000,17,005,Bond County, IL,Jan-18,7679,7325,354,4.6
CN1700500000000,17,005,Bond County, IL,Feb-18,7735,7427,308,4.0
CN1700500000000,17,005,Bond County, IL,Mar-18,7886,7576,310,3.9
CN1700500000000,17,005,Bond County, IL,Apr-18(p),7948,7687,261,3.3
CN2001900000000,20,019,Chautauqua County, KS,Mar-17,1457,1393,64,4.4
CN2001900000000,20,019,Chautauqua County, KS,Apr-17,1435,1364,71,4.9
CN2001900000000,20,019,Chautauqua County, KS,May-17,1430,1358,72,5.0
CN2001900000000,20,019,Chautauqua County, KS,Jun-17,1504,1435,69,4.6
CN2001900000000,20,019,Chautauqua County, KS,Jul-17,1418,1332,86,6.1
CN2001900000000,20,019,Chautauqua County, KS,Aug-17,1415,1340,75,5.3
CN2001900000000,20,019,Chautauqua County, KS,Sep-17,1424,1369,55,3.9
CN2001900000000,20,019,Chautauqua County, KS,Oct-17,1444,1392,52,3.6
CN2001900000000,20,019,Chautauqua County, KS,Nov-17,1442,1385,57,4.0
CN2001900000000,20,019,Chautauqua County, KS,Dec-17,1428,1375,53,3.7
CN2001900000000,20,019,Chautauqua County, KS,Jan-18,1413,1353,60,4.2
CN2001900000000,20,019,Chautauqua County, KS,Feb-18,1415,1347,68,4.8
CN2001900000000,20,019,Chautauqua County, KS,Mar-18,1424,1361,63,4.4
CN2001900000000,20,019,Chautauqua County, KS,Apr-18(p),1384,1327,57,4.1
CN5159000000000,51,590,Danville city, VA,Mar-17,19324,18197,1127,5.8
CN5159000000000,51,590,Danville city, VA,Apr-17,19133,18018,1115,5.8
CN5159000000000,51,590,Danville city, VA,May-17,19040,17930,1110,5.8
CN5159000000000,51,590,Danville city, VA,Jun-17,19075,17832,1243,6.5
CN5159000000000,51,590,Danville city, VA,Jul-17,19118,17842,1276,6.7
CN5159000000000,51,590,Danville city, VA,Aug-17,18943,17726,1217,6.4
CN5159000000000,51,590,Danville city, VA,Sep-17,18965,17869,1096,5.8
CN5159000000000,51,590,Danville city, VA,Oct-17,19146,18097,1049,5.5
CN5159000000000,51,590,Danville city, VA,Nov-17,19240,18193,1047,5.4
CN5159000000000,51,590,Danville city, VA,Dec-17,19230,18156,1074,5.6
CN5159000000000,51,590,Danville city, VA,Jan-18,19048,17930,1118,5.9
CN5159000000000,51,590,Danville city, VA,Feb-18,18835,17719,1116,5.9
CN5159000000000,51,590,Danville city, VA,Mar-18,19114,17896,1218,6.4
CN5159000000000,51,590,Danville city, VA,Apr-18(p),19032,17850,1182,6.2
CN4507300000000,45,073,Oconee County, SC,Mar-17,34067,32702,1365,4.0
CN4507300000000,45,073,Oconee County, SC,Apr-17,33755,32535,1220,3.6
CN4507300000000,45,073,Oconee County, SC,May-17,34042,32751,1291,3.8
CN4507300000000,45,073,Oconee County, SC,Jun-17,34633,33001,1632,4.7
CN4507300000000,45,073,Oconee County, SC,Jul-17,34796,32966,1830,5.3
CN4507300000000,45,073,Oconee County, SC,Aug-17,34419,32747,1672,4.9
CN4507300000000,45,073,Oconee County, SC,Sep-17,34434,32946,1488,4.3
CN4507300000000,45,073,Oconee County, SC,Oct-17,34497,33089,1408,4.1
CN4507300000000,45,073,Oconee County, SC,Nov-17,34508,33162,1346,3.9
CN4507300000000,45,073,Oconee County, SC,Dec-17,34762,33340,1422,4.1
CN4507300000000,45,073,Oconee County, SC,Jan-18,34819,33066,1753,5.0
CN4507300000000,45,073,Oconee County, SC,Feb-18,35042,33450,1592,4.5
CN4507300000000,45,073,Oconee County, SC,Mar-18,34699,33306,1393,4.0
CN4507300000000,45,073,Oconee County, SC,Apr-18(p),34185,33262,923,2.7
CN3914700000000,39,147,Seneca County, OH,Mar-17,27542,26157,1385,5.0
CN3914700000000,39,147,Seneca County, OH,Apr-17,27470,26292,1178,4.3
CN3914700000000,39,147,Seneca County, OH,May-17,27460,26313,1147,4.2
CN3914700000000,39,147,Seneca County, OH,Jun-17,27673,26344,1329,4.8
CN3914700000000,39,147,Seneca County, OH,Jul-17,27491,26038,1453,5.3
CN3914700000000,39,147,Seneca County, OH,Aug-17,27548,26249,1299,4.7
CN3914700000000,39,147,Seneca County, OH,Sep-17,27262,26108,1154,4.2
CN3914700000000,39,147,Seneca County, OH,Oct-17,27228,26118,1110,4.1
CN3914700000000,39,147,Seneca County, OH,Nov-17,27060,25949,1111,4.1
CN3914700000000,39,147,Seneca County, OH,Dec-17,26896,25663,1233,4.6
CN3914700000000,39,147,Seneca County, OH,Jan-18,26589,25234,1355,5.1
CN3914700000000,39,147,Seneca County, OH,Feb-18,27354,26091,1263,4.6
CN3914700000000,39,147,Seneca County, OH,Mar-18,27706,26560,1146,4.1
CN3914700000000,39,147,Seneca County, OH,Apr-18(p),27667,26600,1067,3.9
CN1718900000000,17,189,Washington County, IL,Mar-17,9487,9198,289,3.0
CN1718900000000,17,189,Washington County, IL,Apr-17,9546,9305,241,2.5
CN1718900000000,17,189,Washington County, IL,May-17,9571,9316,255,2.7
CN1718900000000,17,189,Washington County, IL,Jun-17,9829,9540,289,2.9
CN1718900000000,17,189,Washington County, IL,Jul-17,9728,9424,304,3.1
CN1718900000000,17,189,Washington County, IL,Aug-17,9578,9297,281,2.9
CN1718900000000,17,189,Washington County, IL,Sep-17,9534,9279,255,2.7
CN1718900000000,17,189,Washington County, IL,Oct-17,9484,9243,241,2.5
CN1718900000000,17,189,Washington County, IL,Nov-17,9516,9275,241,2.5
CN1718900000000,17,189,Washington County, IL,Dec-17,9430,9188,242,2.6
CN1718900000000,17,189,Washington County, IL,Jan-18,9294,9001,293,3.2
CN1718900000000,17,189,Washington County, IL,Feb-18,9414,9156,258,2.7
CN1718900000000,17,189,Washington County, IL,Mar-18,9665,9398,267,2.8
CN1718900000000,17,189,Washington County, IL,Apr-18(p),9740,9546,194,2.0
CN4843900000000,48,439,Tarrant County, TX,Mar-17,1025975,985358,40617,4.0
CN4843900000000,48,439,Tarrant County, TX,Apr-17,1027560,991269,36291,3.5
CN4843900000000,48,439,Tarrant County, TX,May-17,1025923,989157,36766,3.6
CN4843900000000,48,439,Tarrant County, TX,Jun-17,1031814,991661,40153,3.9
CN4843900000000,48,439,Tarrant County, TX,Jul-17,1039760,999194,40566,3.9
CN4843900000000,48,439,Tarrant County, TX,Aug-17,1037463,997044,40419,3.9
CN4843900000000,48,439,Tarrant County, TX,Sep-17,1046095,1010526,35569,3.4
CN4843900000000,48,439,Tarrant County, TX,Oct-17,1037602,1004374,33228,3.2
CN4843900000000,48,439,Tarrant County, TX,Nov-17,1042769,1008575,34194,3.3
CN4843900000000,48,439,Tarrant County, TX,Dec-17,1040675,1007642,33033,3.2
CN4843900000000,48,439,Tarrant County, TX,Jan-18,1040137,1002379,37758,3.6
CN4843900000000,48,439,Tarrant County, TX,Feb-18,1053389,1014880,38509,3.7
CN4843900000000,48,439,Tarrant County, TX,Mar-18,1053954,1014786,39168,3.7
CN4843900000000,48,439,Tarrant County, TX,Apr-18(p),1060037,1024427,35610,3.4
CN2708500000000,27,085,McLeod County, MN,Mar-17,19696,18712,984,5.0
CN2708500000000,27,085,McLeod County, MN,Apr-17,19621,18875,746,3.8
CN2708500000000,27,085,McLeod County, MN,May-17,19601,18963,638,3.3
CN2708500000000,27,085,McLeod County, MN,Jun-17,19733,19030,703,3.6
CN2708500000000,27,085,McLeod County, MN,Jul-17,19752,19070,682,3.5
CN2708500000000,27,085,McLeod County, MN,Aug-17,19604,18942,662,3.4
CN2708500000000,27,085,McLeod County, MN,Sep-17,19320,18766,554,2.9
CN2708500000000,27,085,McLeod County, MN,Oct-17,19378,18899,479,2.5
CN2708500000000,27,085,McLeod County, MN,Nov-17,19391,18835,556,2.9
CN2708500000000,27,085,McLeod County, MN,Dec-17,19483,18734,749,3.8
CN2708500000000,27,085,McLeod County, MN,Jan-18,19567,18651,916,4.7
CN2708500000000,27,085,McLeod County, MN,Feb-18,19621,18716,905,4.6
CN2708500000000,27,085,McLeod County, MN,Mar-18,19651,18765,886,4.5
CN2708500000000,27,085,McLeod County, MN,Apr-18(p),19687,18968,719,3.7
CN4904300000000,49,043,Summit County, UT,Mar-17,26328,25599,729,2.8
CN4904300000000,49,043,Summit County, UT,Apr-17,23870,23123,747,3.1
CN4904300000000,49,043,Summit County, UT,May-17,22742,21686,1056,4.6
CN4904300000000,49,043,Summit County, UT,Jun-17,23662,22788,874,3.7
CN4904300000000,49,043,Summit County, UT,Jul-17,24459,23730,729,3.0
CN4904300000000,49,043,Summit County, UT,Aug-17,24177,23447,730,3.0
CN4904300000000,49,043,Summit County, UT,Sep-17,23584,22892,692,2.9
CN4904300000000,49,043,Summit County, UT,Oct-17,23203,22435,768,3.3
CN4904300000000,49,043,Summit County, UT,Nov-17,23803,23041,762,3.2
CN4904300000000,49,043,Summit County, UT,Dec-17,26099,25502,597,2.3
CN4904300000000,49,043,Summit County, UT,Jan-18,27052,26434,618,2.3
CN4904300000000,49,043,Summit County, UT,Feb-18,26898,26210,688,2.6
CN4904300000000,49,043,Summit County, UT,Mar-18,26584,25867,717,2.7
CN4904300000000,49,043,Summit County, UT,Apr-18(p),24528,23713,815,3.3
CN5117900000000,51,179,Stafford County, VA,Mar-17,69470,66890,2580,3.7
CN5117900000000,51,179,Stafford County, VA,Apr-17,69513,67200,2313,3.3
CN5117900000000,51,179,Stafford County, VA,May-17,69854,67406,2448,3.5
CN5117900000000,51,179,Stafford County, VA,Jun-17,70270,67627,2643,3.8
CN5117900000000,51,179,Stafford County, VA,Jul-17,70852,68166,2686,3.8
CN5117900000000,51,179,Stafford County, VA,Aug-17,69845,67156,2689,3.8
CN5117900000000,51,179,Stafford County, VA,Sep-17,69916,67430,2486,3.6
CN5117900000000,51,179,Stafford County, VA,Oct-17,69761,67456,2305,3.3
CN5117900000000,51,179,Stafford County, VA,Nov-17,69683,67336,2347,3.4
CN5117900000000,51,179,Stafford County, VA,Dec-17,69361,67121,2240,3.2
CN5117900000000,51,179,Stafford County, VA,Jan-18,69988,67528,2460,3.5
CN5117900000000,51,179,Stafford County, VA,Feb-18,70480,68232,2248,3.2
CN5117900000000,51,179,Stafford County, VA,Mar-18,70644,68369,2275,3.2
CN5117900000000,51,179,Stafford County, VA,Apr-18(p),70459,68529,1930,2.7
CN3301900000000,33,019,Sullivan County, NH,Mar-17,23090,22508,582,2.5
CN3301900000000,33,019,Sullivan County, NH,Apr-17,22826,22322,504,2.2
CN3301900000000,33,019,Sullivan County, NH,May-17,22860,22377,483,2.1
CN3301900000000,33,019,Sullivan County, NH,Jun-17,23319,22827,492,2.1
CN3301900000000,33,019,Sullivan County, NH,Jul-17,23431,22926,505,2.2
CN3301900000000,33,019,Sullivan County, NH,Aug-17,23305,22824,481,2.1
CN3301900000000,33,019,Sullivan County, NH,Sep-17,23007,22526,481,2.1
CN3301900000000,33,019,Sullivan County, NH,Oct-17,22905,22464,441,1.9
CN3301900000000,33,019,Sullivan County, NH,Nov-17,22904,22429,475,2.1
CN3301900000000,33,019,Sullivan County, NH,Dec-17,22815,22385,430,1.9
CN3301900000000,33,019,Sullivan County, NH,Jan-18,22911,22341,570,2.5
CN3301900000000,33,019,Sullivan County, NH,Feb-18,22996,22417,579,2.5
CN3301900000000,33,019,Sullivan County, NH,Mar-18,23200,22618,582,2.5
CN3301900000000,33,019,Sullivan County, NH,Apr-18(p),23072,22542,530,2.3
CN2100300000000,21,003,Allen County, KY,Mar-17,9021,8624,397,4.4
CN2100300000000,21,003,Allen County, KY,Apr-17,9224,8865,359,3.9
CN2100300000000,21,003,Allen County, KY,May-17,9163,8788,375,4.1
CN2100300000000,21,003,Allen County, KY,Jun-17,9170,8743,427,4.7
CN2100300000000,21,003,Allen County, KY,Jul-17,8773,8375,398,4.5
CN2100300000000,21,003,Allen County, KY,Aug-17,8700,8351,349,4.0
CN2100300000000,21,003,Allen County, KY,Sep-17,8843,8503,340,3.8
CN2100300000000,21,003,Allen County, KY,Oct-17,8895,8586,309,3.5
CN2100300000000,21,003,Allen County, KY,Nov-17,8994,8700,294,3.3
CN2100300000000,21,003,Allen County, KY,Dec-17,8935,8659,276,3.1
CN2100300000000,21,003,Allen County, KY,Jan-18,8820,8517,303,3.4
CN2100300000000,21,003,Allen County, KY,Feb-18,8934,8565,369,4.1
CN2100300000000,21,003,Allen County, KY,Mar-18,9030,8682,348,3.9
CN2100300000000,21,003,Allen County, KY,Apr-18(p),9103,8811,292,3.2
CN1320900000000,13,209,Montgomery County, GA,Mar-17,3739,3510,229,6.1
CN1320900000000,13,209,Montgomery County, GA,Apr-17,3787,3546,241,6.4
CN1320900000000,13,209,Montgomery County, GA,May-17,3830,3595,235,6.1
CN1320900000000,13,209,Montgomery County, GA,Jun-17,3885,3609,276,7.1
CN1320900000000,13,209,Montgomery County, GA,Jul-17,3851,3580,271,7.0
CN1320900000000,13,209,Montgomery County, GA,Aug-17,3834,3569,265,6.9
CN1320900000000,13,209,Montgomery County, GA,Sep-17,3860,3609,251,6.5
CN1320900000000,13,209,Montgomery County, GA,Oct-17,3827,3588,239,6.2
CN1320900000000,13,209,Montgomery County, GA,Nov-17,3822,3592,230,6.0
CN1320900000000,13,209,Montgomery County, GA,Dec-17,3832,3590,242,6.3
CN1320900000000,13,209,Montgomery County, GA,Jan-18,3908,3633,275,7.0
CN1320900000000,13,209,Montgomery County, GA,Feb-18,3720,3473,247,6.6
CN1320900000000,13,209,Montgomery County, GA,Mar-18,3716,3498,218,5.9
CN1320900000000,13,209,Montgomery County, GA,Apr-18(p),3709,3508,201,5.4
CN1331500000000,13,315,Wilcox County, GA,Mar-17,2797,2631,166,5.9
CN1331500000000,13,315,Wilcox County, GA,Apr-17,2757,2605,152,5.5
CN1331500000000,13,315,Wilcox County, GA,May-17,2755,2597,158,5.7
CN1331500000000,13,315,Wilcox County, GA,Jun-17,2796,2626,170,6.1
CN1331500000000,13,315,Wilcox County, GA,Jul-17,2687,2513,174,6.5
CN1331500000000,13,315,Wilcox County, GA,Aug-17,2668,2505,163,6.1
CN1331500000000,13,315,Wilcox County, GA,Sep-17,2687,2539,148,5.5
CN1331500000000,13,315,Wilcox County, GA,Oct-17,2737,2576,161,5.9
CN1331500000000,13,315,Wilcox County, GA,Nov-17,2702,2560,142,5.3
CN1331500000000,13,315,Wilcox County, GA,Dec-17,2718,2573,145,5.3
CN1331500000000,13,315,Wilcox County, GA,Jan-18,2812,2641,171,6.1
CN1331500000000,13,315,Wilcox County, GA,Feb-18,2795,2632,163,5.8
CN1331500000000,13,315,Wilcox County, GA,Mar-18,2790,2650,140,5.0
CN1331500000000,13,315,Wilcox County, GA,Apr-18(p),2771,2647,124,4.5
CN0506100000000,05,061,Howard County, AR,Mar-17,5977,5807,170,2.8
CN0506100000000,05,061,Howard County, AR,Apr-17,6021,5865,156,2.6
CN0506100000000,05,061,Howard County, AR,May-17,6047,5876,171,2.8
CN0506100000000,05,061,Howard County, AR,Jun-17,6177,5968,209,3.4
CN0506100000000,05,061,Howard County, AR,Jul-17,5968,5755,213,3.6
CN0506100000000,05,061,Howard County, AR,Aug-17,5955,5774,181,3.0
CN0506100000000,05,061,Howard County, AR,Sep-17,5977,5801,176,2.9
CN0506100000000,05,061,Howard County, AR,Oct-17,5926,5773,153,2.6
CN0506100000000,05,061,Howard County, AR,Nov-17,5809,5657,152,2.6
CN0506100000000,05,061,Howard County, AR,Dec-17,5795,5622,173,3.0
CN0506100000000,05,061,Howard County, AR,Jan-18,5803,5595,208,3.6
CN0506100000000,05,061,Howard County, AR,Feb-18,5915,5709,206,3.5
CN0506100000000,05,061,Howard County, AR,Mar-18,5981,5775,206,3.4
CN0506100000000,05,061,Howard County, AR,Apr-18(p),5969,5799,170,2.8
CN4611900000000,46,119,Sully County, SD,Mar-17,847,811,36,4.3
CN4611900000000,46,119,Sully County, SD,Apr-17,858,830,28,3.3
CN4611900000000,46,119,Sully County, SD,May-17,880,851,29,3.3
CN4611900000000,46,119,Sully County, SD,Jun-17,906,879,27,3.0
CN4611900000000,46,119,Sully County, SD,Jul-17,874,852,22,2.5
CN4611900000000,46,119,Sully County, SD,Aug-17,841,814,27,3.2
CN4611900000000,46,119,Sully County, SD,Sep-17,834,811,23,2.8
CN4611900000000,46,119,Sully County, SD,Oct-17,810,788,22,2.7
CN4611900000000,46,119,Sully County, SD,Nov-17,802,780,22,2.7
CN4611900000000,46,119,Sully County, SD,Dec-17,830,804,26,3.1
CN4611900000000,46,119,Sully County, SD,Jan-18,837,808,29,3.5
CN4611900000000,46,119,Sully County, SD,Feb-18,836,808,28,3.3
CN4611900000000,46,119,Sully County, SD,Mar-18,854,824,30,3.5
CN4611900000000,46,119,Sully County, SD,Apr-18(p),815,791,24,2.9
CN2709700000000,27,097,Morrison County, MN,Mar-17,18003,16618,1385,7.7
CN2709700000000,27,097,Morrison County, MN,Apr-17,17758,16801,957,5.4
CN2709700000000,27,097,Morrison County, MN,May-17,17681,17012,669,3.8
CN2709700000000,27,097,Morrison County, MN,Jun-17,17733,17033,700,3.9
CN2709700000000,27,097,Morrison County, MN,Jul-17,17512,16839,673,3.8
CN2709700000000,27,097,Morrison County, MN,Aug-17,17318,16625,693,4.0
CN2709700000000,27,097,Morrison County, MN,Sep-17,17105,16535,570,3.3
CN2709700000000,27,097,Morrison County, MN,Oct-17,17468,16964,504,2.9
CN2709700000000,27,097,Morrison County, MN,Nov-17,17732,16839,893,5.0
CN2709700000000,27,097,Morrison County, MN,Dec-17,18031,16739,1292,7.2
CN2709700000000,27,097,Morrison County, MN,Jan-18,18181,16635,1546,8.5
CN2709700000000,27,097,Morrison County, MN,Feb-18,18137,16754,1383,7.6
CN2709700000000,27,097,Morrison County, MN,Mar-18,18113,16814,1299,7.2
CN2709700000000,27,097,Morrison County, MN,Apr-18(p),18067,17084,983,5.4
CN3604300000000,36,043,Herkimer County, NY,Mar-17,28627,26745,1882,6.6
CN3604300000000,36,043,Herkimer County, NY,Apr-17,28462,26790,1672,5.9
CN3604300000000,36,043,Herkimer County, NY,May-17,28144,26646,1498,5.3
CN3604300000000,36,043,Herkimer County, NY,Jun-17,28676,27206,1470,5.1
CN3604300000000,36,043,Herkimer County, NY,Jul-17,28788,27300,1488,5.2
CN3604300000000,36,043,Herkimer County, NY,Aug-17,28436,26993,1443,5.1
CN3604300000000,36,043,Herkimer County, NY,Sep-17,27987,26587,1400,5.0
CN3604300000000,36,043,Herkimer County, NY,Oct-17,27801,26402,1399,5.0
CN3604300000000,36,043,Herkimer County, NY,Nov-17,27888,26315,1573,5.6
CN3604300000000,36,043,Herkimer County, NY,Dec-17,27726,25995,1731,6.2
CN3604300000000,36,043,Herkimer County, NY,Jan-18,28124,26040,2084,7.4
CN3604300000000,36,043,Herkimer County, NY,Feb-18,28007,25872,2135,7.6
CN3604300000000,36,043,Herkimer County, NY,Mar-18,27613,25667,1946,7.0
CN3604300000000,36,043,Herkimer County, NY,Apr-18(p),27541,25929,1612,5.9
CN5409700000000,54,097,Upshur County, WV,Mar-17,9530,8901,629,6.6
CN5409700000000,54,097,Upshur County, WV,Apr-17,9661,9078,583,6.0
CN5409700000000,54,097,Upshur County, WV,May-17,9437,8924,513,5.4
CN5409700000000,54,097,Upshur County, WV,Jun-17,9511,8914,597,6.3
CN5409700000000,54,097,Upshur County, WV,Jul-17,9301,8721,580,6.2
CN5409700000000,54,097,Upshur County, WV,Aug-17,9554,8986,568,5.9
CN5409700000000,54,097,Upshur County, WV,Sep-17,9732,9261,471,4.8
CN5409700000000,54,097,Upshur County, WV,Oct-17,9642,9159,483,5.0
CN5409700000000,54,097,Upshur County, WV,Nov-17,9536,9015,521,5.5
CN5409700000000,54,097,Upshur County, WV,Dec-17,9296,8772,524,5.6
CN5409700000000,54,097,Upshur County, WV,Jan-18,9519,8936,583,6.1
CN5409700000000,54,097,Upshur County, WV,Feb-18,9688,9030,658,6.8
CN5409700000000,54,097,Upshur County, WV,Mar-18,9624,9052,572,5.9
CN5409700000000,54,097,Upshur County, WV,Apr-18(p),9699,9178,521,5.4
CN2118700000000,21,187,Owen County, KY,Mar-17,5603,5320,283,5.1
CN2118700000000,21,187,Owen County, KY,Apr-17,5661,5425,236,4.2
CN2118700000000,21,187,Owen County, KY,May-17,5660,5420,240,4.2
CN2118700000000,21,187,Owen County, KY,Jun-17,5724,5469,255,4.5
CN2118700000000,21,187,Owen County, KY,Jul-17,5592,5352,240,4.3
CN2118700000000,21,187,Owen County, KY,Aug-17,5636,5424,212,3.8
CN2118700000000,21,187,Owen County, KY,Sep-17,5564,5362,202,3.6
CN2118700000000,21,187,Owen County, KY,Oct-17,5520,5333,187,3.4
CN2118700000000,21,187,Owen County, KY,Nov-17,5457,5275,182,3.3
CN2118700000000,21,187,Owen County, KY,Dec-17,5420,5226,194,3.6
CN2118700000000,21,187,Owen County, KY,Jan-18,5443,5224,219,4.0
CN2118700000000,21,187,Owen County, KY,Feb-18,5431,5186,245,4.5
CN2118700000000,21,187,Owen County, KY,Mar-18,5521,5290,231,4.2
CN2118700000000,21,187,Owen County, KY,Apr-18(p),5600,5389,211,3.8
CN0109100000000,01,091,Marengo County, AL,Mar-17,7765,7284,481,6.2
CN0109100000000,01,091,Marengo County, AL,Apr-17,7635,7242,393,5.1
CN0109100000000,01,091,Marengo County, AL,May-17,7644,7269,375,4.9
CN0109100000000,01,091,Marengo County, AL,Jun-17,7711,7247,464,6.0
CN0109100000000,01,091,Marengo County, AL,Jul-17,7564,7117,447,5.9
CN0109100000000,01,091,Marengo County, AL,Aug-17,7536,7093,443,5.9
CN0109100000000,01,091,Marengo County, AL,Sep-17,7614,7233,381,5.0
CN0109100000000,01,091,Marengo County, AL,Oct-17,7599,7220,379,5.0
CN0109100000000,01,091,Marengo County, AL,Nov-17,7485,7139,346,4.6
CN0109100000000,01,091,Marengo County, AL,Dec-17,7391,7048,343,4.6
CN0109100000000,01,091,Marengo County, AL,Jan-18,7378,6969,409,5.5
CN0109100000000,01,091,Marengo County, AL,Feb-18,7478,7057,421,5.6
CN0109100000000,01,091,Marengo County, AL,Mar-18,7473,7106,367,4.9
CN0109100000000,01,091,Marengo County, AL,Apr-18(p),7525,7192,333,4.4
CN2912700000000,29,127,Marion County, MO,Mar-17,14298,13709,589,4.1
CN2912700000000,29,127,Marion County, MO,Apr-17,14501,13980,521,3.6
CN2912700000000,29,127,Marion County, MO,May-17,14416,13888,528,3.7
CN2912700000000,29,127,Marion County, MO,Jun-17,14552,14018,534,3.7
CN2912700000000,29,127,Marion County, MO,Jul-17,14366,13816,550,3.8
CN2912700000000,29,127,Marion County, MO,Aug-17,14028,13449,579,4.1
CN2912700000000,29,127,Marion County, MO,Sep-17,14109,13650,459,3.3
CN2912700000000,29,127,Marion County, MO,Oct-17,14237,13893,344,2.4
CN2912700000000,29,127,Marion County, MO,Nov-17,14448,14031,417,2.9
CN2912700000000,29,127,Marion County, MO,Dec-17,14280,13836,444,3.1
CN2912700000000,29,127,Marion County, MO,Jan-18,13976,13421,555,4.0
CN2912700000000,29,127,Marion County, MO,Feb-18,13914,13315,599,4.3
CN2912700000000,29,127,Marion County, MO,Mar-18,13942,13352,590,4.2
CN2912700000000,29,127,Marion County, MO,Apr-18(p),14140,13642,498,3.5
CN4710300000000,47,103,Lincoln County, TN,Mar-17,16307,15705,602,3.7
CN4710300000000,47,103,Lincoln County, TN,Apr-17,16348,15890,458,2.8
CN4710300000000,47,103,Lincoln County, TN,May-17,16395,15930,465,2.8
CN4710300000000,47,103,Lincoln County, TN,Jun-17,16381,15787,594,3.6
CN4710300000000,47,103,Lincoln County, TN,Jul-17,16378,15806,572,3.5
CN4710300000000,47,103,Lincoln County, TN,Aug-17,16389,15874,515,3.1
CN4710300000000,47,103,Lincoln County, TN,Sep-17,16520,16062,458,2.8
CN4710300000000,47,103,Lincoln County, TN,Oct-17,16357,15916,441,2.7
CN4710300000000,47,103,Lincoln County, TN,Nov-17,16273,15794,479,2.9
CN4710300000000,47,103,Lincoln County, TN,Dec-17,16212,15750,462,2.8
CN4710300000000,47,103,Lincoln County, TN,Jan-18,16135,15605,530,3.3
CN4710300000000,47,103,Lincoln County, TN,Feb-18,16352,15824,528,3.2
CN4710300000000,47,103,Lincoln County, TN,Mar-18,16329,15827,502,3.1
CN4710300000000,47,103,Lincoln County, TN,Apr-18(p),16496,16047,449,2.7
CN4004100000000,40,041,Delaware County, OK,Mar-17,18186,17362,824,4.5
CN4004100000000,40,041,Delaware County, OK,Apr-17,18312,17554,758,4.1
CN4004100000000,40,041,Delaware County, OK,May-17,18521,17701,820,4.4
CN4004100000000,40,041,Delaware County, OK,Jun-17,19052,18183,869,4.6
CN4004100000000,40,041,Delaware County, OK,Jul-17,19066,18253,813,4.3
CN4004100000000,40,041,Delaware County, OK,Aug-17,18626,17829,797,4.3
CN4004100000000,40,041,Delaware County, OK,Sep-17,18641,17888,753,4.0
CN4004100000000,40,041,Delaware County, OK,Oct-17,18416,17684,732,4.0
CN4004100000000,40,041,Delaware County, OK,Nov-17,18544,17789,755,4.1
CN4004100000000,40,041,Delaware County, OK,Dec-17,18312,17513,799,4.4
CN4004100000000,40,041,Delaware County, OK,Jan-18,18299,17391,908,5.0
CN4004100000000,40,041,Delaware County, OK,Feb-18,18664,17843,821,4.4
CN4004100000000,40,041,Delaware County, OK,Mar-18,18764,17981,783,4.2
CN4004100000000,40,041,Delaware County, OK,Apr-18(p),18715,17963,752,4.0
CN3300100000000,33,001,Belknap County, NH,Mar-17,30091,29138,953,3.2
CN3300100000000,33,001,Belknap County, NH,Apr-17,29651,28851,800,2.7
CN3300100000000,33,001,Belknap County, NH,May-17,30539,29788,751,2.5
CN3300100000000,33,001,Belknap County, NH,Jun-17,31999,31222,777,2.4
CN3300100000000,33,001,Belknap County, NH,Jul-17,33012,32255,757,2.3
CN3300100000000,33,001,Belknap County, NH,Aug-17,32853,32101,752,2.3
CN3300100000000,33,001,Belknap County, NH,Sep-17,31178,30417,761,2.4
CN3300100000000,33,001,Belknap County, NH,Oct-17,30604,29929,675,2.2
CN3300100000000,33,001,Belknap County, NH,Nov-17,30162,29442,720,2.4
CN3300100000000,33,001,Belknap County, NH,Dec-17,29905,29208,697,2.3
CN3300100000000,33,001,Belknap County, NH,Jan-18,30142,29157,985,3.3
CN3300100000000,33,001,Belknap County, NH,Feb-18,30176,29202,974,3.2
CN3300100000000,33,001,Belknap County, NH,Mar-18,30359,29401,958,3.2
CN3300100000000,33,001,Belknap County, NH,Apr-18(p),30268,29397,871,2.9
CN5401300000000,54,013,Calhoun County, WV,Mar-17,2435,2108,327,13.4
CN5401300000000,54,013,Calhoun County, WV,Apr-17,2441,2185,256,10.5
CN5401300000000,54,013,Calhoun County, WV,May-17,2366,2176,190,8.0
CN5401300000000,54,013,Calhoun County, WV,Jun-17,2451,2257,194,7.9
CN5401300000000,54,013,Calhoun County, WV,Jul-17,2403,2216,187,7.8
CN5401300000000,54,013,Calhoun County, WV,Aug-17,2498,2291,207,8.3
CN5401300000000,54,013,Calhoun County, WV,Sep-17,2519,2336,183,7.3
CN5401300000000,54,013,Calhoun County, WV,Oct-17,2530,2329,201,7.9
CN5401300000000,54,013,Calhoun County, WV,Nov-17,2534,2278,256,10.1
CN5401300000000,54,013,Calhoun County, WV,Dec-17,2550,2242,308,12.1
CN5401300000000,54,013,Calhoun County, WV,Jan-18,2619,2207,412,15.7
CN5401300000000,54,013,Calhoun County, WV,Feb-18,2583,2197,386,14.9
CN5401300000000,54,013,Calhoun County, WV,Mar-18,2533,2207,326,12.9
CN5401300000000,54,013,Calhoun County, WV,Apr-18(p),2521,2261,260,10.3
CN1208500000000,12,085,Martin County, FL,Mar-17,72646,69691,2955,4.1
CN1208500000000,12,085,Martin County, FL,Apr-17,72398,69536,2862,4.0
CN1208500000000,12,085,Martin County, FL,May-17,72757,69830,2927,4.0
CN1208500000000,12,085,Martin County, FL,Jun-17,72638,69519,3119,4.3
CN1208500000000,12,085,Martin County, FL,Jul-17,72535,69336,3199,4.4
CN1208500000000,12,085,Martin County, FL,Aug-17,72499,69360,3139,4.3
CN1208500000000,12,085,Martin County, FL,Sep-17,72790,69870,2920,4.0
CN1208500000000,12,085,Martin County, FL,Oct-17,72757,70059,2698,3.7
CN1208500000000,12,085,Martin County, FL,Nov-17,72310,69570,2740,3.8
CN1208500000000,12,085,Martin County, FL,Dec-17,71796,69217,2579,3.6
CN1208500000000,12,085,Martin County, FL,Jan-18,72267,69319,2948,4.1
CN1208500000000,12,085,Martin County, FL,Feb-18,73118,70414,2704,3.7
CN1208500000000,12,085,Martin County, FL,Mar-18,73467,70821,2646,3.6
CN1208500000000,12,085,Martin County, FL,Apr-18(p),73221,70810,2411,3.3
CN3006100000000,30,061,Mineral County, MT,Mar-17,1659,1505,154,9.3
CN3006100000000,30,061,Mineral County, MT,Apr-17,1693,1564,129,7.6
CN3006100000000,30,061,Mineral County, MT,May-17,1695,1592,103,6.1
CN3006100000000,30,061,Mineral County, MT,Jun-17,1763,1659,104,5.9
CN3006100000000,30,061,Mineral County, MT,Jul-17,1762,1659,103,5.8
CN3006100000000,30,061,Mineral County, MT,Aug-17,1742,1634,108,6.2
CN3006100000000,30,061,Mineral County, MT,Sep-17,1699,1582,117,6.9
CN3006100000000,30,061,Mineral County, MT,Oct-17,1640,1525,115,7.0
CN3006100000000,30,061,Mineral County, MT,Nov-17,1615,1488,127,7.9
CN3006100000000,30,061,Mineral County, MT,Dec-17,1584,1433,151,9.5
CN3006100000000,30,061,Mineral County, MT,Jan-18,1615,1426,189,11.7
CN3006100000000,30,061,Mineral County, MT,Feb-18,1650,1465,185,11.2
CN3006100000000,30,061,Mineral County, MT,Mar-18,1633,1465,168,10.3
CN3006100000000,30,061,Mineral County, MT,Apr-18(p),1641,1511,130,7.9
CN1704900000000,17,049,Effingham County, IL,Mar-17,18697,17930,767,4.1
CN1704900000000,17,049,Effingham County, IL,Apr-17,18614,18002,612,3.3
CN1704900000000,17,049,Effingham County, IL,May-17,18824,18217,607,3.2
CN1704900000000,17,049,Effingham County, IL,Jun-17,19141,18490,651,3.4
CN1704900000000,17,049,Effingham County, IL,Jul-17,19125,18450,675,3.5
CN1704900000000,17,049,Effingham County, IL,Aug-17,18839,18154,685,3.6
CN1704900000000,17,049,Effingham County, IL,Sep-17,18687,18060,627,3.4
CN1704900000000,17,049,Effingham County, IL,Oct-17,18641,18044,597,3.2
CN1704900000000,17,049,Effingham County, IL,Nov-17,18723,18107,616,3.3
CN1704900000000,17,049,Effingham County, IL,Dec-17,18789,18157,632,3.4
CN1704900000000,17,049,Effingham County, IL,Jan-18,18813,18031,782,4.2
CN1704900000000,17,049,Effingham County, IL,Feb-18,18756,18060,696,3.7
CN1704900000000,17,049,Effingham County, IL,Mar-18,19144,18456,688,3.6
CN1704900000000,17,049,Effingham County, IL,Apr-18(p),19117,18581,536,2.8
CN2205300000000,22,053,Jefferson Davis Parish, LA,Mar-17,13458,12780,678,5.0
CN2205300000000,22,053,Jefferson Davis Parish, LA,Apr-17,13642,13004,638,4.7
CN2205300000000,22,053,Jefferson Davis Parish, LA,May-17,13697,13043,654,4.8
CN2205300000000,22,053,Jefferson Davis Parish, LA,Jun-17,13962,13224,738,5.3
CN2205300000000,22,053,Jefferson Davis Parish, LA,Jul-17,13980,13252,728,5.2
CN2205300000000,22,053,Jefferson Davis Parish, LA,Aug-17,13845,13117,728,5.3
CN2205300000000,22,053,Jefferson Davis Parish, LA,Sep-17,13622,12971,651,4.8
CN2205300000000,22,053,Jefferson Davis Parish, LA,Oct-17,13784,13220,564,4.1
CN2205300000000,22,053,Jefferson Davis Parish, LA,Nov-17,13730,13157,573,4.2
CN2205300000000,22,053,Jefferson Davis Parish, LA,Dec-17,13520,13001,519,3.8
CN2205300000000,22,053,Jefferson Davis Parish, LA,Jan-18,13724,13137,587,4.3
CN2205300000000,22,053,Jefferson Davis Parish, LA,Feb-18,13691,13163,528,3.9
CN2205300000000,22,053,Jefferson Davis Parish, LA,Mar-18,13682,13097,585,4.3
CN2205300000000,22,053,Jefferson Davis Parish, LA,Apr-18(p),13753,13162,591,4.3
CN1309700000000,13,097,Douglas County, GA,Mar-17,72026,68433,3593,5.0
CN1309700000000,13,097,Douglas County, GA,Apr-17,72055,68606,3449,4.8
CN1309700000000,13,097,Douglas County, GA,May-17,72162,68717,3445,4.8
CN1309700000000,13,097,Douglas County, GA,Jun-17,72327,68638,3689,5.1
CN1309700000000,13,097,Douglas County, GA,Jul-17,72864,69140,3724,5.1
CN1309700000000,13,097,Douglas County, GA,Aug-17,72441,68791,3650,5.0
CN1309700000000,13,097,Douglas County, GA,Sep-17,73096,69741,3355,4.6
CN1309700000000,13,097,Douglas County, GA,Oct-17,72711,69438,3273,4.5
CN1309700000000,13,097,Douglas County, GA,Nov-17,72855,69667,3188,4.4
CN1309700000000,13,097,Douglas County, GA,Dec-17,72885,69633,3252,4.5
CN1309700000000,13,097,Douglas County, GA,Jan-18,72918,69503,3415,4.7
CN1309700000000,13,097,Douglas County, GA,Feb-18,74123,70697,3426,4.6
CN1309700000000,13,097,Douglas County, GA,Mar-18,74124,70939,3185,4.3
CN1309700000000,13,097,Douglas County, GA,Apr-18(p),73619,70761,2858,3.9
CN0508900000000,05,089,Marion County, AR,Mar-17,6496,6258,238,3.7
CN0508900000000,05,089,Marion County, AR,Apr-17,6519,6298,221,3.4
CN0508900000000,05,089,Marion County, AR,May-17,6552,6313,239,3.6
CN0508900000000,05,089,Marion County, AR,Jun-17,6654,6391,263,4.0
CN0508900000000,05,089,Marion County, AR,Jul-17,6566,6288,278,4.2
CN0508900000000,05,089,Marion County, AR,Aug-17,6516,6260,256,3.9
CN0508900000000,05,089,Marion County, AR,Sep-17,6576,6317,259,3.9
CN0508900000000,05,089,Marion County, AR,Oct-17,6404,6186,218,3.4
CN0508900000000,05,089,Marion County, AR,Nov-17,6420,6190,230,3.6
CN0508900000000,05,089,Marion County, AR,Dec-17,6385,6114,271,4.2
CN0508900000000,05,089,Marion County, AR,Jan-18,6343,6008,335,5.3
CN0508900000000,05,089,Marion County, AR,Feb-18,6405,6094,311,4.9
CN0508900000000,05,089,Marion County, AR,Mar-18,6442,6177,265,4.1
CN0508900000000,05,089,Marion County, AR,Apr-18(p),6457,6220,237,3.7
CN0606900000000,06,069,San Benito County, CA,Mar-17,30428,28226,2202,7.2
CN0606900000000,06,069,San Benito County, CA,Apr-17,30232,28355,1877,6.2
CN0606900000000,06,069,San Benito County, CA,May-17,30104,28426,1678,5.6
CN0606900000000,06,069,San Benito County, CA,Jun-17,30339,28630,1709,5.6
CN0606900000000,06,069,San Benito County, CA,Jul-17,30649,28936,1713,5.6
CN0606900000000,06,069,San Benito County, CA,Aug-17,30444,28840,1604,5.3
CN0606900000000,06,069,San Benito County, CA,Sep-17,30308,28932,1376,4.5
CN0606900000000,06,069,San Benito County, CA,Oct-17,30328,28932,1396,4.6
CN0606900000000,06,069,San Benito County, CA,Nov-17,30269,28787,1482,4.9
CN0606900000000,06,069,San Benito County, CA,Dec-17,30296,28645,1651,5.4
CN0606900000000,06,069,San Benito County, CA,Jan-18,30283,28449,1834,6.1
CN0606900000000,06,069,San Benito County, CA,Feb-18,30625,28689,1936,6.3
CN0606900000000,06,069,San Benito County, CA,Mar-18,30489,28650,1839,6.0
CN0606900000000,06,069,San Benito County, CA,Apr-18(p),30202,28660,1542,5.1
CN1603700000000,16,037,Custer County, ID,Mar-17,1944,1827,117,6.0
CN1603700000000,16,037,Custer County, ID,Apr-17,1980,1886,94,4.7
CN1603700000000,16,037,Custer County, ID,May-17,2093,2021,72,3.4
CN1603700000000,16,037,Custer County, ID,Jun-17,2409,2336,73,3.0
CN1603700000000,16,037,Custer County, ID,Jul-17,2483,2413,70,2.8
CN1603700000000,16,037,Custer County, ID,Aug-17,2481,2410,71,2.9
CN1603700000000,16,037,Custer County, ID,Sep-17,2311,2246,65,2.8
CN1603700000000,16,037,Custer County, ID,Oct-17,2171,2111,60,2.8
CN1603700000000,16,037,Custer County, ID,Nov-17,2046,1950,96,4.7
CN1603700000000,16,037,Custer County, ID,Dec-17,2040,1924,116,5.7
CN1603700000000,16,037,Custer County, ID,Jan-18,1976,1844,132,6.7
CN1603700000000,16,037,Custer County, ID,Feb-18,1990,1862,128,6.4
CN1603700000000,16,037,Custer County, ID,Mar-18,1990,1874,116,5.8
CN1603700000000,16,037,Custer County, ID,Apr-18(p),2036,1947,89,4.4
CN1701700000000,17,017,Cass County, IL,Mar-17,6206,5903,303,4.9
CN1701700000000,17,017,Cass County, IL,Apr-17,6226,5980,246,4.0
CN1701700000000,17,017,Cass County, IL,May-17,6167,5925,242,3.9
CN1701700000000,17,017,Cass County, IL,Jun-17,6252,5989,263,4.2
CN1701700000000,17,017,Cass County, IL,Jul-17,6203,5938,265,4.3
CN1701700000000,17,017,Cass County, IL,Aug-17,6126,5856,270,4.4
CN1701700000000,17,017,Cass County, IL,Sep-17,6119,5881,238,3.9
CN1701700000000,17,017,Cass County, IL,Oct-17,6073,5846,227,3.7
CN1701700000000,17,017,Cass County, IL,Nov-17,6093,5845,248,4.1
CN1701700000000,17,017,Cass County, IL,Dec-17,6005,5738,267,4.4
CN1701700000000,17,017,Cass County, IL,Jan-18,6070,5778,292,4.8
CN1701700000000,17,017,Cass County, IL,Feb-18,6067,5803,264,4.4
CN1701700000000,17,017,Cass County, IL,Mar-18,6166,5890,276,4.5
CN1701700000000,17,017,Cass County, IL,Apr-18(p),6156,5934,222,3.6
CN2404500000000,24,045,Wicomico County, MD,Mar-17,50045,46899,3146,6.3
CN2404500000000,24,045,Wicomico County, MD,Apr-17,50692,47966,2726,5.4
CN2404500000000,24,045,Wicomico County, MD,May-17,51624,49076,2548,4.9
CN2404500000000,24,045,Wicomico County, MD,Jun-17,54677,51942,2735,5.0
CN2404500000000,24,045,Wicomico County, MD,Jul-17,55930,53127,2803,5.0
CN2404500000000,24,045,Wicomico County, MD,Aug-17,54601,51891,2710,5.0
CN2404500000000,24,045,Wicomico County, MD,Sep-17,52330,49830,2500,4.8
CN2404500000000,24,045,Wicomico County, MD,Oct-17,50738,48130,2608,5.1
CN2404500000000,24,045,Wicomico County, MD,Nov-17,49512,46671,2841,5.7
CN2404500000000,24,045,Wicomico County, MD,Dec-17,49522,46424,3098,6.3
CN2404500000000,24,045,Wicomico County, MD,Jan-18,49314,45783,3531,7.2
CN2404500000000,24,045,Wicomico County, MD,Feb-18,49858,46320,3538,7.1
CN2404500000000,24,045,Wicomico County, MD,Mar-18,50108,46915,3193,6.4
CN2404500000000,24,045,Wicomico County, MD,Apr-18(p),50662,47981,2681,5.3
CN3401300000000,34,013,Essex County, NJ,Mar-17,371012,350873,20139,5.4
CN3401300000000,34,013,Essex County, NJ,Apr-17,371161,351848,19313,5.2
CN3401300000000,34,013,Essex County, NJ,May-17,370562,350731,19831,5.4
CN3401300000000,34,013,Essex County, NJ,Jun-17,375198,353391,21807,5.8
CN3401300000000,34,013,Essex County, NJ,Jul-17,376727,352925,23802,6.3
CN3401300000000,34,013,Essex County, NJ,Aug-17,372473,349296,23177,6.2
CN3401300000000,34,013,Essex County, NJ,Sep-17,369000,347296,21704,5.9
CN3401300000000,34,013,Essex County, NJ,Oct-17,368169,347764,20405,5.5
CN3401300000000,34,013,Essex County, NJ,Nov-17,366375,346547,19828,5.4
CN3401300000000,34,013,Essex County, NJ,Dec-17,365198,346354,18844,5.2
CN3401300000000,34,013,Essex County, NJ,Jan-18,364629,343649,20980,5.8
CN3401300000000,34,013,Essex County, NJ,Feb-18,369007,347465,21542,5.8
CN3401300000000,34,013,Essex County, NJ,Mar-18,365879,344901,20978,5.7
CN3401300000000,34,013,Essex County, NJ,Apr-18(p),362023,343393,18630,5.1
CN3116700000000,31,167,Stanton County, NE,Mar-17,3399,3297,102,3.0
CN3116700000000,31,167,Stanton County, NE,Apr-17,3455,3361,94,2.7
CN3116700000000,31,167,Stanton County, NE,May-17,3487,3393,94,2.7
CN3116700000000,31,167,Stanton County, NE,Jun-17,3570,3462,108,3.0
CN3116700000000,31,167,Stanton County, NE,Jul-17,3553,3438,115,3.2
CN3116700000000,31,167,Stanton County, NE,Aug-17,3475,3368,107,3.1
CN3116700000000,31,167,Stanton County, NE,Sep-17,3413,3330,83,2.4
CN3116700000000,31,167,Stanton County, NE,Oct-17,3426,3343,83,2.4
CN3116700000000,31,167,Stanton County, NE,Nov-17,3429,3350,79,2.3
CN3116700000000,31,167,Stanton County, NE,Dec-17,3404,3325,79,2.3
CN3116700000000,31,167,Stanton County, NE,Jan-18,3462,3367,95,2.7
CN3116700000000,31,167,Stanton County, NE,Feb-18,3483,3379,104,3.0
CN3116700000000,31,167,Stanton County, NE,Mar-18,3487,3384,103,3.0
CN3116700000000,31,167,Stanton County, NE,Apr-18(p),3493,3396,97,2.8
CN0511900000000,05,119,Pulaski County, AR,Mar-17,188204,182081,6123,3.3
CN0511900000000,05,119,Pulaski County, AR,Apr-17,188929,183287,5642,3.0
CN0511900000000,05,119,Pulaski County, AR,May-17,189781,183511,6270,3.3
CN0511900000000,05,119,Pulaski County, AR,Jun-17,192071,185217,6854,3.6
CN0511900000000,05,119,Pulaski County, AR,Jul-17,195303,187991,7312,3.7
CN0511900000000,05,119,Pulaski County, AR,Aug-17,192481,185778,6703,3.5
CN0511900000000,05,119,Pulaski County, AR,Sep-17,191758,185393,6365,3.3
CN0511900000000,05,119,Pulaski County, AR,Oct-17,190428,184713,5715,3.0
CN0511900000000,05,119,Pulaski County, AR,Nov-17,189725,184070,5655,3.0
CN0511900000000,05,119,Pulaski County, AR,Dec-17,188674,182314,6360,3.4
CN0511900000000,05,119,Pulaski County, AR,Jan-18,186563,179215,7348,3.9
CN0511900000000,05,119,Pulaski County, AR,Feb-18,188733,181326,7407,3.9
CN0511900000000,05,119,Pulaski County, AR,Mar-18,190223,183153,7070,3.7
CN0511900000000,05,119,Pulaski County, AR,Apr-18(p),189077,182769,6308,3.3
CN2211500000000,22,115,Vernon Parish, LA,Mar-17,16563,15541,1022,6.2
CN2211500000000,22,115,Vernon Parish, LA,Apr-17,16313,15241,1072,6.6
CN2211500000000,22,115,Vernon Parish, LA,May-17,16484,15392,1092,6.6
CN2211500000000,22,115,Vernon Parish, LA,Jun-17,16814,15678,1136,6.8
CN2211500000000,22,115,Vernon Parish, LA,Jul-17,16716,15484,1232,7.4
CN2211500000000,22,115,Vernon Parish, LA,Aug-17,15996,14909,1087,6.8
CN2211500000000,22,115,Vernon Parish, LA,Sep-17,16471,15330,1141,6.9
CN2211500000000,22,115,Vernon Parish, LA,Oct-17,16039,15203,836,5.2
CN2211500000000,22,115,Vernon Parish, LA,Nov-17,16147,15298,849,5.3
CN2211500000000,22,115,Vernon Parish, LA,Dec-17,15776,14905,871,5.5
CN2211500000000,22,115,Vernon Parish, LA,Jan-18,16345,15329,1016,6.2
CN2211500000000,22,115,Vernon Parish, LA,Feb-18,16294,15475,819,5.0
CN2211500000000,22,115,Vernon Parish, LA,Mar-18,16322,15453,869,5.3
CN2211500000000,22,115,Vernon Parish, LA,Apr-18(p),16116,15222,894,5.5
CN4211500000000,42,115,Susquehanna County, PA,Mar-17,20628,19405,1223,5.9
CN4211500000000,42,115,Susquehanna County, PA,Apr-17,20444,19541,903,4.4
CN4211500000000,42,115,Susquehanna County, PA,May-17,20631,19717,914,4.4
CN4211500000000,42,115,Susquehanna County, PA,Jun-17,21056,20153,903,4.3
CN4211500000000,42,115,Susquehanna County, PA,Jul-17,21159,20219,940,4.4
CN4211500000000,42,115,Susquehanna County, PA,Aug-17,21065,20128,937,4.4
CN4211500000000,42,115,Susquehanna County, PA,Sep-17,20576,19783,793,3.9
CN4211500000000,42,115,Susquehanna County, PA,Oct-17,20444,19681,763,3.7
CN4211500000000,42,115,Susquehanna County, PA,Nov-17,20365,19519,846,4.2
CN4211500000000,42,115,Susquehanna County, PA,Dec-17,20403,19502,901,4.4
CN4211500000000,42,115,Susquehanna County, PA,Jan-18,20567,19387,1180,5.7
CN4211500000000,42,115,Susquehanna County, PA,Feb-18,20568,19437,1131,5.5
CN4211500000000,42,115,Susquehanna County, PA,Mar-18,20233,19270,963,4.8
CN4211500000000,42,115,Susquehanna County, PA,Apr-18(p),20075,19313,762,3.8
CN2119900000000,21,199,Pulaski County, KY,Mar-17,25853,24240,1613,6.2
CN2119900000000,21,199,Pulaski County, KY,Apr-17,25804,24447,1357,5.3
CN2119900000000,21,199,Pulaski County, KY,May-17,25797,24373,1424,5.5
CN2119900000000,21,199,Pulaski County, KY,Jun-17,25835,24249,1586,6.1
CN2119900000000,21,199,Pulaski County, KY,Jul-17,25604,24004,1600,6.2
CN2119900000000,21,199,Pulaski County, KY,Aug-17,25509,24086,1423,5.6
CN2119900000000,21,199,Pulaski County, KY,Sep-17,25453,24163,1290,5.1
CN2119900000000,21,199,Pulaski County, KY,Oct-17,25206,24039,1167,4.6
CN2119900000000,21,199,Pulaski County, KY,Nov-17,25187,24033,1154,4.6
CN2119900000000,21,199,Pulaski County, KY,Dec-17,25009,23810,1199,4.8
CN2119900000000,21,199,Pulaski County, KY,Jan-18,25045,23732,1313,5.2
CN2119900000000,21,199,Pulaski County, KY,Feb-18,25583,24134,1449,5.7
CN2119900000000,21,199,Pulaski County, KY,Mar-18,25842,24445,1397,5.4
CN2119900000000,21,199,Pulaski County, KY,Apr-18(p),25823,24602,1221,4.7
CN4815300000000,48,153,Floyd County, TX,Mar-17,2808,2646,162,5.8
CN4815300000000,48,153,Floyd County, TX,Apr-17,2772,2609,163,5.9
CN4815300000000,48,153,Floyd County, TX,May-17,2799,2650,149,5.3
CN4815300000000,48,153,Floyd County, TX,Jun-17,2774,2619,155,5.6
CN4815300000000,48,153,Floyd County, TX,Jul-17,2683,2521,162,6.0
CN4815300000000,48,153,Floyd County, TX,Aug-17,2713,2562,151,5.6
CN4815300000000,48,153,Floyd County, TX,Sep-17,2604,2476,128,4.9
CN4815300000000,48,153,Floyd County, TX,Oct-17,2667,2543,124,4.6
CN4815300000000,48,153,Floyd County, TX,Nov-17,2596,2468,128,4.9
CN4815300000000,48,153,Floyd County, TX,Dec-17,2583,2455,128,5.0
CN4815300000000,48,153,Floyd County, TX,Jan-18,2568,2418,150,5.8
CN4815300000000,48,153,Floyd County, TX,Feb-18,2619,2466,153,5.8
CN4815300000000,48,153,Floyd County, TX,Mar-18,2729,2564,165,6.0
CN4815300000000,48,153,Floyd County, TX,Apr-18(p),2717,2566,151,5.6
CN4821500000000,48,215,Hidalgo County, TX,Mar-17,343954,317382,26572,7.7
CN4821500000000,48,215,Hidalgo County, TX,Apr-17,344548,319437,25111,7.3
CN4821500000000,48,215,Hidalgo County, TX,May-17,342672,318689,23983,7.0
CN4821500000000,48,215,Hidalgo County, TX,Jun-17,343771,316446,27325,7.9
CN4821500000000,48,215,Hidalgo County, TX,Jul-17,336020,309711,26309,7.8
CN4821500000000,48,215,Hidalgo County, TX,Aug-17,337787,311412,26375,7.8
CN4821500000000,48,215,Hidalgo County, TX,Sep-17,339158,316117,23041,6.8
CN4821500000000,48,215,Hidalgo County, TX,Oct-17,337542,317564,19978,5.9
CN4821500000000,48,215,Hidalgo County, TX,Nov-17,340994,319346,21648,6.3
CN4821500000000,48,215,Hidalgo County, TX,Dec-17,343867,321005,22862,6.6
CN4821500000000,48,215,Hidalgo County, TX,Jan-18,346735,320330,26405,7.6
CN4821500000000,48,215,Hidalgo County, TX,Feb-18,348775,324073,24702,7.1
CN4821500000000,48,215,Hidalgo County, TX,Mar-18,350257,326061,24196,6.9
CN4821500000000,48,215,Hidalgo County, TX,Apr-18(p),349027,326466,22561,6.5
CN4810900000000,48,109,Culberson County, TX,Mar-17,929,887,42,4.5
CN4810900000000,48,109,Culberson County, TX,Apr-17,910,877,33,3.6
CN4810900000000,48,109,Culberson County, TX,May-17,919,883,36,3.9
CN4810900000000,48,109,Culberson County, TX,Jun-17,922,888,34,3.7
CN4810900000000,48,109,Culberson County, TX,Jul-17,939,909,30,3.2
CN4810900000000,48,109,Culberson County, TX,Aug-17,929,896,33,3.6
CN4810900000000,48,109,Culberson County, TX,Sep-17,905,877,28,3.1
CN4810900000000,48,109,Culberson County, TX,Oct-17,875,849,26,3.0
CN4810900000000,48,109,Culberson County, TX,Nov-17,885,859,26,2.9
CN4810900000000,48,109,Culberson County, TX,Dec-17,911,885,26,2.9
CN4810900000000,48,109,Culberson County, TX,Jan-18,848,818,30,3.5
CN4810900000000,48,109,Culberson County, TX,Feb-18,850,817,33,3.9
CN4810900000000,48,109,Culberson County, TX,Mar-18,859,827,32,3.7
CN4810900000000,48,109,Culberson County, TX,Apr-18(p),833,805,28,3.4
CN4804700000000,48,047,Brooks County, TX,Mar-17,2486,2254,232,9.3
CN4804700000000,48,047,Brooks County, TX,Apr-17,2453,2248,205,8.4
CN4804700000000,48,047,Brooks County, TX,May-17,2433,2245,188,7.7
CN4804700000000,48,047,Brooks County, TX,Jun-17,2444,2225,219,9.0
CN4804700000000,48,047,Brooks County, TX,Jul-17,2432,2219,213,8.8
CN4804700000000,48,047,Brooks County, TX,Aug-17,2431,2220,211,8.7
CN4804700000000,48,047,Brooks County, TX,Sep-17,2395,2226,169,7.1
CN4804700000000,48,047,Brooks County, TX,Oct-17,2384,2234,150,6.3
CN4804700000000,48,047,Brooks County, TX,Nov-17,2369,2215,154,6.5
CN4804700000000,48,047,Brooks County, TX,Dec-17,2366,2216,150,6.3
CN4804700000000,48,047,Brooks County, TX,Jan-18,2416,2243,173,7.2
CN4804700000000,48,047,Brooks County, TX,Feb-18,2437,2261,176,7.2
CN4804700000000,48,047,Brooks County, TX,Mar-18,2476,2293,183,7.4
CN4804700000000,48,047,Brooks County, TX,Apr-18(p),2501,2344,157,6.3
CN2913300000000,29,133,Mississippi County, MO,Mar-17,6098,5771,327,5.4
CN2913300000000,29,133,Mississippi County, MO,Apr-17,6201,5894,307,5.0
CN2913300000000,29,133,Mississippi County, MO,May-17,6097,5807,290,4.8
CN2913300000000,29,133,Mississippi County, MO,Jun-17,6109,5747,362,5.9
CN2913300000000,29,133,Mississippi County, MO,Jul-17,5849,5460,389,6.7
CN2913300000000,29,133,Mississippi County, MO,Aug-17,5843,5515,328,5.6
CN2913300000000,29,133,Mississippi County, MO,Sep-17,5836,5592,244,4.2
CN2913300000000,29,133,Mississippi County, MO,Oct-17,5869,5686,183,3.1
CN2913300000000,29,133,Mississippi County, MO,Nov-17,5858,5636,222,3.8
CN2913300000000,29,133,Mississippi County, MO,Dec-17,5794,5558,236,4.1
CN2913300000000,29,133,Mississippi County, MO,Jan-18,5824,5566,258,4.4
CN2913300000000,29,133,Mississippi County, MO,Feb-18,5886,5631,255,4.3
CN2913300000000,29,133,Mississippi County, MO,Mar-18,5878,5626,252,4.3
CN2913300000000,29,133,Mississippi County, MO,Apr-18(p),5956,5721,235,3.9
CN0804100000000,08,041,El Paso County, CO,Mar-17,321950,311569,10381,3.2
CN0804100000000,08,041,El Paso County, CO,Apr-17,322633,313086,9547,3.0
CN0804100000000,08,041,El Paso County, CO,May-17,324961,315640,9321,2.9
CN0804100000000,08,041,El Paso County, CO,Jun-17,328969,317680,11289,3.4
CN0804100000000,08,041,El Paso County, CO,Jul-17,329189,318289,10900,3.3
CN0804100000000,08,041,El Paso County, CO,Aug-17,329117,318514,10603,3.2
CN0804100000000,08,041,El Paso County, CO,Sep-17,332598,322089,10509,3.2
CN0804100000000,08,041,El Paso County, CO,Oct-17,331171,320627,10544,3.2
CN0804100000000,08,041,El Paso County, CO,Nov-17,331170,320241,10929,3.3
CN0804100000000,08,041,El Paso County, CO,Dec-17,329377,318113,11264,3.4
CN0804100000000,08,041,El Paso County, CO,Jan-18,328200,315374,12826,3.9
CN0804100000000,08,041,El Paso County, CO,Feb-18,334461,321494,12967,3.9
CN0804100000000,08,041,El Paso County, CO,Mar-18,335321,323753,11568,3.4
CN0804100000000,08,041,El Paso County, CO,Apr-18(p),336010,325688,10322,3.1
CN4007500000000,40,075,Kiowa County, OK,Mar-17,3946,3729,217,5.5
CN4007500000000,40,075,Kiowa County, OK,Apr-17,3945,3737,208,5.3
CN4007500000000,40,075,Kiowa County, OK,May-17,3910,3694,216,5.5
CN4007500000000,40,075,Kiowa County, OK,Jun-17,3889,3662,227,5.8
CN4007500000000,40,075,Kiowa County, OK,Jul-17,3839,3629,210,5.5
CN4007500000000,40,075,Kiowa County, OK,Aug-17,3922,3714,208,5.3
CN4007500000000,40,075,Kiowa County, OK,Sep-17,3928,3728,200,5.1
CN4007500000000,40,075,Kiowa County, OK,Oct-17,4001,3804,197,4.9
CN4007500000000,40,075,Kiowa County, OK,Nov-17,4020,3826,194,4.8
CN4007500000000,40,075,Kiowa County, OK,Dec-17,3937,3743,194,4.9
CN4007500000000,40,075,Kiowa County, OK,Jan-18,3913,3712,201,5.1
CN4007500000000,40,075,Kiowa County, OK,Feb-18,3865,3681,184,4.8
CN4007500000000,40,075,Kiowa County, OK,Mar-18,3821,3643,178,4.7
CN4007500000000,40,075,Kiowa County, OK,Apr-18(p),3751,3580,171,4.6
CN2500700000000,25,007,Dukes County, MA,Mar-17,8091,7430,661,8.2
CN2500700000000,25,007,Dukes County, MA,Apr-17,8271,7796,475,5.7
CN2500700000000,25,007,Dukes County, MA,May-17,9009,8610,399,4.4
CN2500700000000,25,007,Dukes County, MA,Jun-17,11147,10780,367,3.3
CN2500700000000,25,007,Dukes County, MA,Jul-17,12355,12029,326,2.6
CN2500700000000,25,007,Dukes County, MA,Aug-17,12358,12055,303,2.5
CN2500700000000,25,007,Dukes County, MA,Sep-17,10275,9973,302,2.9
CN2500700000000,25,007,Dukes County, MA,Oct-17,9103,8804,299,3.3
CN2500700000000,25,007,Dukes County, MA,Nov-17,8489,8063,426,5.0
CN2500700000000,25,007,Dukes County, MA,Dec-17,8464,7962,502,5.9
CN2500700000000,25,007,Dukes County, MA,Jan-18,8250,7528,722,8.8
CN2500700000000,25,007,Dukes County, MA,Feb-18,8201,7458,743,9.1
CN2500700000000,25,007,Dukes County, MA,Mar-18,8226,7549,677,8.2
CN2500700000000,25,007,Dukes County, MA,Apr-18(p),8699,8207,492,5.7
CN1310900000000,13,109,Evans County, GA,Mar-17,4874,4654,220,4.5
CN1310900000000,13,109,Evans County, GA,Apr-17,4897,4689,208,4.2
CN1310900000000,13,109,Evans County, GA,May-17,4928,4721,207,4.2
CN1310900000000,13,109,Evans County, GA,Jun-17,4908,4692,216,4.4
CN1310900000000,13,109,Evans County, GA,Jul-17,4886,4669,217,4.4
CN1310900000000,13,109,Evans County, GA,Aug-17,4919,4693,226,4.6
CN1310900000000,13,109,Evans County, GA,Sep-17,4961,4759,202,4.1
CN1310900000000,13,109,Evans County, GA,Oct-17,4970,4766,204,4.1
CN1310900000000,13,109,Evans County, GA,Nov-17,4945,4746,199,4.0
CN1310900000000,13,109,Evans County, GA,Dec-17,4942,4745,197,4.0
CN1310900000000,13,109,Evans County, GA,Jan-18,5001,4788,213,4.3
CN1310900000000,13,109,Evans County, GA,Feb-18,4935,4730,205,4.2
CN1310900000000,13,109,Evans County, GA,Mar-18,4935,4730,205,4.2
CN1310900000000,13,109,Evans County, GA,Apr-18(p),4913,4740,173,3.5
CN4200900000000,42,009,Bedford County, PA,Mar-17,23781,22361,1420,6.0
CN4200900000000,42,009,Bedford County, PA,Apr-17,23731,22632,1099,4.6
CN4200900000000,42,009,Bedford County, PA,May-17,24050,22950,1100,4.6
CN4200900000000,42,009,Bedford County, PA,Jun-17,24456,23270,1186,4.8
CN4200900000000,42,009,Bedford County, PA,Jul-17,24284,23062,1222,5.0
CN4200900000000,42,009,Bedford County, PA,Aug-17,23991,22809,1182,4.9
CN4200900000000,42,009,Bedford County, PA,Sep-17,23703,22724,979,4.1
CN4200900000000,42,009,Bedford County, PA,Oct-17,23319,22355,964,4.1
CN4200900000000,42,009,Bedford County, PA,Nov-17,23148,22064,1084,4.7
CN4200900000000,42,009,Bedford County, PA,Dec-17,23206,21994,1212,5.2
CN4200900000000,42,009,Bedford County, PA,Jan-18,23477,21932,1545,6.6
CN4200900000000,42,009,Bedford County, PA,Feb-18,23514,22024,1490,6.3
CN4200900000000,42,009,Bedford County, PA,Mar-18,23138,21900,1238,5.4
CN4200900000000,42,009,Bedford County, PA,Apr-18(p),23143,22168,975,4.2
CN1715500000000,17,155,Putnam County, IL,Mar-17,2982,2818,164,5.5
CN1715500000000,17,155,Putnam County, IL,Apr-17,2995,2862,133,4.4
CN1715500000000,17,155,Putnam County, IL,May-17,2960,2842,118,4.0
CN1715500000000,17,155,Putnam County, IL,Jun-17,3009,2877,132,4.4
CN1715500000000,17,155,Putnam County, IL,Jul-17,3014,2876,138,4.6
CN1715500000000,17,155,Putnam County, IL,Aug-17,2994,2852,142,4.7
CN1715500000000,17,155,Putnam County, IL,Sep-17,2968,2844,124,4.2
CN1715500000000,17,155,Putnam County, IL,Oct-17,2988,2874,114,3.8
CN1715500000000,17,155,Putnam County, IL,Nov-17,2975,2851,124,4.2
CN1715500000000,17,155,Putnam County, IL,Dec-17,2980,2840,140,4.7
CN1715500000000,17,155,Putnam County, IL,Jan-18,3013,2841,172,5.7
CN1715500000000,17,155,Putnam County, IL,Feb-18,3000,2849,151,5.0
CN1715500000000,17,155,Putnam County, IL,Mar-18,3021,2868,153,5.1
CN1715500000000,17,155,Putnam County, IL,Apr-18(p),3039,2911,128,4.2
CN4500700000000,45,007,Anderson County, SC,Mar-17,89256,85976,3280,3.7
CN4500700000000,45,007,Anderson County, SC,Apr-17,89060,86082,2978,3.3
CN4500700000000,45,007,Anderson County, SC,May-17,89356,86199,3157,3.5
CN4500700000000,45,007,Anderson County, SC,Jun-17,90080,86334,3746,4.2
CN4500700000000,45,007,Anderson County, SC,Jul-17,90056,86174,3882,4.3
CN4500700000000,45,007,Anderson County, SC,Aug-17,89959,85960,3999,4.4
CN4500700000000,45,007,Anderson County, SC,Sep-17,89902,86435,3467,3.9
CN4500700000000,45,007,Anderson County, SC,Oct-17,89926,86549,3377,3.8
CN4500700000000,45,007,Anderson County, SC,Nov-17,89555,86317,3238,3.6
CN4500700000000,45,007,Anderson County, SC,Dec-17,89535,86171,3364,3.8
CN4500700000000,45,007,Anderson County, SC,Jan-18,90133,85885,4248,4.7
CN4500700000000,45,007,Anderson County, SC,Feb-18,90245,86400,3845,4.3
CN4500700000000,45,007,Anderson County, SC,Mar-18,90493,87041,3452,3.8
CN4500700000000,45,007,Anderson County, SC,Apr-18(p),89045,86719,2326,2.6
CN7206700000000,72,067,Hormigueros Municipio, PR,Mar-17,5669,4947,722,12.7
CN7206700000000,72,067,Hormigueros Municipio, PR,Apr-17,5658,4891,767,13.6
CN7206700000000,72,067,Hormigueros Municipio, PR,May-17,5586,4880,706,12.6
CN7206700000000,72,067,Hormigueros Municipio, PR,Jun-17,5541,4902,639,11.5
CN7206700000000,72,067,Hormigueros Municipio, PR,Jul-17,5440,4755,685,12.6
CN7206700000000,72,067,Hormigueros Municipio, PR,Aug-17,5398,4651,747,13.8
CN7206700000000,72,067,Hormigueros Municipio, PR,Sep-17(y),5436,4655,781,14.4
CN7206700000000,72,067,Hormigueros Municipio, PR,Oct-17,5298,4511,787,14.9
CN7206700000000,72,067,Hormigueros Municipio, PR,Nov-17,5441,4774,667,12.3
CN7206700000000,72,067,Hormigueros Municipio, PR,Dec-17,5442,4846,596,11.0
CN7206700000000,72,067,Hormigueros Municipio, PR,Jan-18,5310,4679,631,11.9
CN7206700000000,72,067,Hormigueros Municipio, PR,Feb-18,5209,4653,556,10.7
CN7206700000000,72,067,Hormigueros Municipio, PR,Mar-18,5262,4661,601,11.4
CN7206700000000,72,067,Hormigueros Municipio, PR,Apr-18(p),5238,4694,544,10.4
CN2115300000000,21,153,Magoffin County, KY,Mar-17,3268,2663,605,18.5
CN2115300000000,21,153,Magoffin County, KY,Apr-17,3179,2654,525,16.5
CN2115300000000,21,153,Magoffin County, KY,May-17,3191,2662,529,16.6
CN2115300000000,21,153,Magoffin County, KY,Jun-17,3141,2632,509,16.2
CN2115300000000,21,153,Magoffin County, KY,Jul-17,2906,2463,443,15.2
CN2115300000000,21,153,Magoffin County, KY,Aug-17,3065,2652,413,13.5
CN2115300000000,21,153,Magoffin County, KY,Sep-17,3036,2653,383,12.6
CN2115300000000,21,153,Magoffin County, KY,Oct-17,3001,2650,351,11.7
CN2115300000000,21,153,Magoffin County, KY,Nov-17,2945,2595,350,11.9
CN2115300000000,21,153,Magoffin County, KY,Dec-17,2990,2614,376,12.6
CN2115300000000,21,153,Magoffin County, KY,Jan-18,3026,2563,463,15.3
CN2115300000000,21,153,Magoffin County, KY,Feb-18,3073,2613,460,15.0
CN2115300000000,21,153,Magoffin County, KY,Mar-18,3031,2611,420,13.9
CN2115300000000,21,153,Magoffin County, KY,Apr-18(p),2939,2588,351,11.9
CN2200900000000,22,009,Avoyelles Parish, LA,Mar-17,15904,14918,986,6.2
CN2200900000000,22,009,Avoyelles Parish, LA,Apr-17,15841,14906,935,5.9
CN2200900000000,22,009,Avoyelles Parish, LA,May-17,15799,14864,935,5.9
CN2200900000000,22,009,Avoyelles Parish, LA,Jun-17,16004,14833,1171,7.3
CN2200900000000,22,009,Avoyelles Parish, LA,Jul-17,15854,14740,1114,7.0
CN2200900000000,22,009,Avoyelles Parish, LA,Aug-17,15628,14538,1090,7.0
CN2200900000000,22,009,Avoyelles Parish, LA,Sep-17,15435,14525,910,5.9
CN2200900000000,22,009,Avoyelles Parish, LA,Oct-17,15378,14615,763,5.0
CN2200900000000,22,009,Avoyelles Parish, LA,Nov-17,15324,14552,772,5.0
CN2200900000000,22,009,Avoyelles Parish, LA,Dec-17,15221,14475,746,4.9
CN2200900000000,22,009,Avoyelles Parish, LA,Jan-18,15435,14604,831,5.4
CN2200900000000,22,009,Avoyelles Parish, LA,Feb-18,15384,14657,727,4.7
CN2200900000000,22,009,Avoyelles Parish, LA,Mar-18,15563,14766,797,5.1
CN2200900000000,22,009,Avoyelles Parish, LA,Apr-18(p),15520,14721,799,5.1
CN2902700000000,29,027,Callaway County, MO,Mar-17,21728,20942,786,3.6
CN2902700000000,29,027,Callaway County, MO,Apr-17,21728,21033,695,3.2
CN2902700000000,29,027,Callaway County, MO,May-17,21729,21007,722,3.3
CN2902700000000,29,027,Callaway County, MO,Jun-17,21642,20820,822,3.8
CN2902700000000,29,027,Callaway County, MO,Jul-17,21860,20955,905,4.1
CN2902700000000,29,027,Callaway County, MO,Aug-17,21440,20554,886,4.1
CN2902700000000,29,027,Callaway County, MO,Sep-17,21327,20670,657,3.1
CN2902700000000,29,027,Callaway County, MO,Oct-17,21187,20707,480,2.3
CN2902700000000,29,027,Callaway County, MO,Nov-17,21200,20611,589,2.8
CN2902700000000,29,027,Callaway County, MO,Dec-17,21023,20402,621,3.0
CN2902700000000,29,027,Callaway County, MO,Jan-18,21050,20228,822,3.9
CN2902700000000,29,027,Callaway County, MO,Feb-18,21169,20423,746,3.5
CN2902700000000,29,027,Callaway County, MO,Mar-18,21299,20555,744,3.5
CN2902700000000,29,027,Callaway County, MO,Apr-18(p),21410,20769,641,3.0
CN4902700000000,49,027,Millard County, UT,Mar-17,6737,6494,243,3.6
CN4902700000000,49,027,Millard County, UT,Apr-17,6695,6493,202,3.0
CN4902700000000,49,027,Millard County, UT,May-17,6426,6218,208,3.2
CN4902700000000,49,027,Millard County, UT,Jun-17,6594,6359,235,3.6
CN4902700000000,49,027,Millard County, UT,Jul-17,6503,6288,215,3.3
CN4902700000000,49,027,Millard County, UT,Aug-17,6522,6311,211,3.2
CN4902700000000,49,027,Millard County, UT,Sep-17,6532,6350,182,2.8
CN4902700000000,49,027,Millard County, UT,Oct-17,6650,6466,184,2.8
CN4902700000000,49,027,Millard County, UT,Nov-17,6283,6107,176,2.8
CN4902700000000,49,027,Millard County, UT,Dec-17,6444,6249,195,3.0
CN4902700000000,49,027,Millard County, UT,Jan-18,6586,6372,214,3.2
CN4902700000000,49,027,Millard County, UT,Feb-18,6408,6175,233,3.6
CN4902700000000,49,027,Millard County, UT,Mar-18,6790,6549,241,3.5
CN4902700000000,49,027,Millard County, UT,Apr-18(p),6590,6386,204,3.1
CN2806500000000,28,065,Jefferson Davis County, MS,Mar-17,4170,3891,279,6.7
CN2806500000000,28,065,Jefferson Davis County, MS,Apr-17,4219,3972,247,5.9
CN2806500000000,28,065,Jefferson Davis County, MS,May-17,4232,3942,290,6.9
CN2806500000000,28,065,Jefferson Davis County, MS,Jun-17,4278,3912,366,8.6
CN2806500000000,28,065,Jefferson Davis County, MS,Jul-17,4349,3939,410,9.4
CN2806500000000,28,065,Jefferson Davis County, MS,Aug-17,4179,3854,325,7.8
CN2806500000000,28,065,Jefferson Davis County, MS,Sep-17,4217,3959,258,6.1
CN2806500000000,28,065,Jefferson Davis County, MS,Oct-17,4204,3969,235,5.6
CN2806500000000,28,065,Jefferson Davis County, MS,Nov-17,4168,3949,219,5.3
CN2806500000000,28,065,Jefferson Davis County, MS,Dec-17,4167,3938,229,5.5
CN2806500000000,28,065,Jefferson Davis County, MS,Jan-18,4168,3908,260,6.2
CN2806500000000,28,065,Jefferson Davis County, MS,Feb-18,4216,3957,259,6.1
CN2806500000000,28,065,Jefferson Davis County, MS,Mar-18,4219,3971,248,5.9
CN2806500000000,28,065,Jefferson Davis County, MS,Apr-18(p),4276,4040,236,5.5
CN2014100000000,20,141,Osborne County, KS,Mar-17,2000,1940,60,3.0
CN2014100000000,20,141,Osborne County, KS,Apr-17,1991,1937,54,2.7
CN2014100000000,20,141,Osborne County, KS,May-17,2043,1982,61,3.0
CN2014100000000,20,141,Osborne County, KS,Jun-17,2107,2047,60,2.8
CN2014100000000,20,141,Osborne County, KS,Jul-17,1984,1921,63,3.2
CN2014100000000,20,141,Osborne County, KS,Aug-17,1964,1904,60,3.1
CN2014100000000,20,141,Osborne County, KS,Sep-17,2004,1951,53,2.6
CN2014100000000,20,141,Osborne County, KS,Oct-17,2023,1978,45,2.2
CN2014100000000,20,141,Osborne County, KS,Nov-17,2002,1958,44,2.2
CN2014100000000,20,141,Osborne County, KS,Dec-17,1988,1945,43,2.2
CN2014100000000,20,141,Osborne County, KS,Jan-18,1967,1921,46,2.3
CN2014100000000,20,141,Osborne County, KS,Feb-18,1964,1908,56,2.9
CN2014100000000,20,141,Osborne County, KS,Mar-18,2004,1950,54,2.7
CN2014100000000,20,141,Osborne County, KS,Apr-18(p),1935,1885,50,2.6
CN2705300000000,27,053,Hennepin County, MN,Mar-17,690702,668709,21993,3.2
CN2705300000000,27,053,Hennepin County, MN,Apr-17,693461,673196,20265,2.9
CN2705300000000,27,053,Hennepin County, MN,May-17,696889,676459,20430,2.9
CN2705300000000,27,053,Hennepin County, MN,Jun-17,703484,680090,23394,3.3
CN2705300000000,27,053,Hennepin County, MN,Jul-17,711636,688668,22968,3.2
CN2705300000000,27,053,Hennepin County, MN,Aug-17,709851,686389,23462,3.3
CN2705300000000,27,053,Hennepin County, MN,Sep-17,706899,686922,19977,2.8
CN2705300000000,27,053,Hennepin County, MN,Oct-17,698611,681845,16766,2.4
CN2705300000000,27,053,Hennepin County, MN,Nov-17,698584,681363,17221,2.5
CN2705300000000,27,053,Hennepin County, MN,Dec-17,694993,676227,18766,2.7
CN2705300000000,27,053,Hennepin County, MN,Jan-18,701127,680461,20666,2.9
CN2705300000000,27,053,Hennepin County, MN,Feb-18,705513,684870,20643,2.9
CN2705300000000,27,053,Hennepin County, MN,Mar-18,703495,683478,20017,2.8
CN2705300000000,27,053,Hennepin County, MN,Apr-18(p),704700,687407,17293,2.5
CN7214700000000,72,147,Vieques Municipio, PR,Mar-17,3238,2794,444,13.7
CN7214700000000,72,147,Vieques Municipio, PR,Apr-17,3214,2796,418,13.0
CN7214700000000,72,147,Vieques Municipio, PR,May-17,3137,2761,376,12.0
CN7214700000000,72,147,Vieques Municipio, PR,Jun-17,3074,2766,308,10.0
CN7214700000000,72,147,Vieques Municipio, PR,Jul-17,3130,2755,375,12.0
CN7214700000000,72,147,Vieques Municipio, PR,Aug-17,3148,2721,427,13.6
CN7214700000000,72,147,Vieques Municipio, PR,Sep-17(y),3172,2738,434,13.7
CN7214700000000,72,147,Vieques Municipio, PR,Oct-17,3196,2684,512,16.0
CN7214700000000,72,147,Vieques Municipio, PR,Nov-17,3437,2840,597,17.4
CN7214700000000,72,147,Vieques Municipio, PR,Dec-17,3550,2926,624,17.6
CN7214700000000,72,147,Vieques Municipio, PR,Jan-18,3510,2830,680,19.4
CN7214700000000,72,147,Vieques Municipio, PR,Feb-18,3435,2837,598,17.4
CN7214700000000,72,147,Vieques Municipio, PR,Mar-18,3448,2850,598,17.3
CN7214700000000,72,147,Vieques Municipio, PR,Apr-18(p),3421,2883,538,15.7
CN3712900000000,37,129,New Hanover County, NC,Mar-17,117292,112426,4866,4.1
CN3712900000000,37,129,New Hanover County, NC,Apr-17,118113,113708,4405,3.7
CN3712900000000,37,129,New Hanover County, NC,May-17,119153,114541,4612,3.9
CN3712900000000,37,129,New Hanover County, NC,Jun-17,119715,114704,5011,4.2
CN3712900000000,37,129,New Hanover County, NC,Jul-17,120475,115239,5236,4.3
CN3712900000000,37,129,New Hanover County, NC,Aug-17,119857,114615,5242,4.4
CN3712900000000,37,129,New Hanover County, NC,Sep-17,120254,115672,4582,3.8
CN3712900000000,37,129,New Hanover County, NC,Oct-17,118588,113866,4722,4.0
CN3712900000000,37,129,New Hanover County, NC,Nov-17,119374,114339,5035,4.2
CN3712900000000,37,129,New Hanover County, NC,Dec-17,117357,112478,4879,4.2
CN3712900000000,37,129,New Hanover County, NC,Jan-18,116608,111417,5191,4.5
CN3712900000000,37,129,New Hanover County, NC,Feb-18,118325,113260,5065,4.3
CN3712900000000,37,129,New Hanover County, NC,Mar-18,119233,114431,4802,4.0
CN3712900000000,37,129,New Hanover County, NC,Apr-18(p),119399,115296,4103,3.4
CN5510500000000,55,105,Rock County, WI,Mar-17,85290,81514,3776,4.4
CN5510500000000,55,105,Rock County, WI,Apr-17,85343,82168,3175,3.7
CN5510500000000,55,105,Rock County, WI,May-17,85473,82374,3099,3.6
CN5510500000000,55,105,Rock County, WI,Jun-17,86892,83402,3490,4.0
CN5510500000000,55,105,Rock County, WI,Jul-17,87900,84746,3154,3.6
CN5510500000000,55,105,Rock County, WI,Aug-17,86743,83569,3174,3.7
CN5510500000000,55,105,Rock County, WI,Sep-17,85906,83142,2764,3.2
CN5510500000000,55,105,Rock County, WI,Oct-17,85471,82908,2563,3.0
CN5510500000000,55,105,Rock County, WI,Nov-17,85187,82604,2583,3.0
CN5510500000000,55,105,Rock County, WI,Dec-17,84824,82438,2386,2.8
CN5510500000000,55,105,Rock County, WI,Jan-18,84681,81888,2793,3.3
CN5510500000000,55,105,Rock County, WI,Feb-18,86061,82932,3129,3.6
CN5510500000000,55,105,Rock County, WI,Mar-18,86293,83312,2981,3.5
CN5510500000000,55,105,Rock County, WI,Apr-18(p),85930,83565,2365,2.8
CN2900300000000,29,003,Andrew County, MO,Mar-17,9961,9618,343,3.4
CN2900300000000,29,003,Andrew County, MO,Apr-17,9989,9688,301,3.0
CN2900300000000,29,003,Andrew County, MO,May-17,9926,9615,311,3.1
CN2900300000000,29,003,Andrew County, MO,Jun-17,10018,9685,333,3.3
CN2900300000000,29,003,Andrew County, MO,Jul-17,10061,9712,349,3.5
CN2900300000000,29,003,Andrew County, MO,Aug-17,9836,9503,333,3.4
CN2900300000000,29,003,Andrew County, MO,Sep-17,9805,9547,258,2.6
CN2900300000000,29,003,Andrew County, MO,Oct-17,9845,9631,214,2.2
CN2900300000000,29,003,Andrew County, MO,Nov-17,9834,9589,245,2.5
CN2900300000000,29,003,Andrew County, MO,Dec-17,9811,9569,242,2.5
CN2900300000000,29,003,Andrew County, MO,Jan-18,9770,9453,317,3.2
CN2900300000000,29,003,Andrew County, MO,Feb-18,9902,9566,336,3.4
CN2900300000000,29,003,Andrew County, MO,Mar-18,9931,9603,328,3.3
CN2900300000000,29,003,Andrew County, MO,Apr-18(p),9916,9649,267,2.7
CN5507800000000,55,078,Menominee County, WI,Mar-17,1565,1452,113,7.2
CN5507800000000,55,078,Menominee County, WI,Apr-17,1590,1483,107,6.7
CN5507800000000,55,078,Menominee County, WI,May-17,1586,1495,91,5.7
CN5507800000000,55,078,Menominee County, WI,Jun-17,1664,1552,112,6.7
CN5507800000000,55,078,Menominee County, WI,Jul-17,1636,1513,123,7.5
CN5507800000000,55,078,Menominee County, WI,Aug-17,1614,1495,119,7.4
CN5507800000000,55,078,Menominee County, WI,Sep-17,1572,1493,79,5.0
CN5507800000000,55,078,Menominee County, WI,Oct-17,1563,1491,72,4.6
CN5507800000000,55,078,Menominee County, WI,Nov-17,1581,1508,73,4.6
CN5507800000000,55,078,Menominee County, WI,Dec-17,1583,1513,70,4.4
CN5507800000000,55,078,Menominee County, WI,Jan-18,1570,1499,71,4.5
CN5507800000000,55,078,Menominee County, WI,Feb-18,1558,1486,72,4.6
CN5507800000000,55,078,Menominee County, WI,Mar-18,1579,1503,76,4.8
CN5507800000000,55,078,Menominee County, WI,Apr-18(p),1623,1513,110,6.8
CN2905300000000,29,053,Cooper County, MO,Mar-17,7373,7081,292,4.0
CN2905300000000,29,053,Cooper County, MO,Apr-17,7455,7199,256,3.4
CN2905300000000,29,053,Cooper County, MO,May-17,7488,7226,262,3.5
CN2905300000000,29,053,Cooper County, MO,Jun-17,7451,7183,268,3.6
CN2905300000000,29,053,Cooper County, MO,Jul-17,7250,6955,295,4.1
CN2905300000000,29,053,Cooper County, MO,Aug-17,7196,6896,300,4.2
CN2905300000000,29,053,Cooper County, MO,Sep-17,7380,7148,232,3.1
CN2905300000000,29,053,Cooper County, MO,Oct-17,7334,7156,178,2.4
CN2905300000000,29,053,Cooper County, MO,Nov-17,7330,7108,222,3.0
CN2905300000000,29,053,Cooper County, MO,Dec-17,7250,7021,229,3.2
CN2905300000000,29,053,Cooper County, MO,Jan-18,7141,6848,293,4.1
CN2905300000000,29,053,Cooper County, MO,Feb-18,7299,7020,279,3.8
CN2905300000000,29,053,Cooper County, MO,Mar-18,7337,7061,276,3.8
CN2905300000000,29,053,Cooper County, MO,Apr-18(p),7408,7173,235,3.2
CN1201700000000,12,017,Citrus County, FL,Mar-17,48076,45305,2771,5.8
CN1201700000000,12,017,Citrus County, FL,Apr-17,48292,45670,2622,5.4
CN1201700000000,12,017,Citrus County, FL,May-17,48402,45685,2717,5.6
CN1201700000000,12,017,Citrus County, FL,Jun-17,48371,45507,2864,5.9
CN1201700000000,12,017,Citrus County, FL,Jul-17,47495,44602,2893,6.1
CN1201700000000,12,017,Citrus County, FL,Aug-17,48145,45299,2846,5.9
CN1201700000000,12,017,Citrus County, FL,Sep-17,48524,45908,2616,5.4
CN1201700000000,12,017,Citrus County, FL,Oct-17,47710,45218,2492,5.2
CN1201700000000,12,017,Citrus County, FL,Nov-17,47588,45071,2517,5.3
CN1201700000000,12,017,Citrus County, FL,Dec-17,47209,44687,2522,5.3
CN1201700000000,12,017,Citrus County, FL,Jan-18,47410,44543,2867,6.0
CN1201700000000,12,017,Citrus County, FL,Feb-18,47843,45217,2626,5.5
CN1201700000000,12,017,Citrus County, FL,Mar-18,48488,45951,2537,5.2
CN1201700000000,12,017,Citrus County, FL,Apr-18(p),48155,45888,2267,4.7
CN2804100000000,28,041,Greene County, MS,Mar-17,4491,4182,309,6.9
CN2804100000000,28,041,Greene County, MS,Apr-17,4398,4133,265,6.0
CN2804100000000,28,041,Greene County, MS,May-17,4457,4119,338,7.6
CN2804100000000,28,041,Greene County, MS,Jun-17,4548,4131,417,9.2
CN2804100000000,28,041,Greene County, MS,Jul-17,4417,3997,420,9.5
CN2804100000000,28,041,Greene County, MS,Aug-17,4310,3974,336,7.8
CN2804100000000,28,041,Greene County, MS,Sep-17,4310,4014,296,6.9
CN2804100000000,28,041,Greene County, MS,Oct-17,4208,3969,239,5.7
CN2804100000000,28,041,Greene County, MS,Nov-17,4218,3965,253,6.0
CN2804100000000,28,041,Greene County, MS,Dec-17,4259,3945,314,7.4
CN2804100000000,28,041,Greene County, MS,Jan-18,4191,3902,289,6.9
CN2804100000000,28,041,Greene County, MS,Feb-18,4211,3957,254,6.0
CN2804100000000,28,041,Greene County, MS,Mar-18,4220,4005,215,5.1
CN2804100000000,28,041,Greene County, MS,Apr-18(p),4214,4004,210,5.0
CN1302900000000,13,029,Bryan County, GA,Mar-17,17287,16548,739,4.3
CN1302900000000,13,029,Bryan County, GA,Apr-17,17337,16648,689,4.0
CN1302900000000,13,029,Bryan County, GA,May-17,17410,16703,707,4.1
CN1302900000000,13,029,Bryan County, GA,Jun-17,17460,16678,782,4.5
CN1302900000000,13,029,Bryan County, GA,Jul-17,17610,16831,779,4.4
CN1302900000000,13,029,Bryan County, GA,Aug-17,17398,16634,764,4.4
CN1302900000000,13,029,Bryan County, GA,Sep-17,17281,16596,685,4.0
CN1302900000000,13,029,Bryan County, GA,Oct-17,17369,16687,682,3.9
CN1302900000000,13,029,Bryan County, GA,Nov-17,17303,16632,671,3.9
CN1302900000000,13,029,Bryan County, GA,Dec-17,17284,16625,659,3.8
CN1302900000000,13,029,Bryan County, GA,Jan-18,17323,16644,679,3.9
CN1302900000000,13,029,Bryan County, GA,Feb-18,17585,16893,692,3.9
CN1302900000000,13,029,Bryan County, GA,Mar-18,17632,17011,621,3.5
CN1302900000000,13,029,Bryan County, GA,Apr-18(p),17562,17004,558,3.2
CN5116100000000,51,161,Roanoke County, VA,Mar-17,49429,47720,1709,3.5
CN5116100000000,51,161,Roanoke County, VA,Apr-17,49242,47708,1534,3.1
CN5116100000000,51,161,Roanoke County, VA,May-17,49406,47726,1680,3.4
CN5116100000000,51,161,Roanoke County, VA,Jun-17,49200,47428,1772,3.6
CN5116100000000,51,161,Roanoke County, VA,Jul-17,49434,47633,1801,3.6
CN5116100000000,51,161,Roanoke County, VA,Aug-17,49124,47302,1822,3.7
CN5116100000000,51,161,Roanoke County, VA,Sep-17,49394,47724,1670,3.4
CN5116100000000,51,161,Roanoke County, VA,Oct-17,49098,47553,1545,3.1
CN5116100000000,51,161,Roanoke County, VA,Nov-17,48893,47340,1553,3.2
CN5116100000000,51,161,Roanoke County, VA,Dec-17,48574,47074,1500,3.1
CN5116100000000,51,161,Roanoke County, VA,Jan-18,48676,47063,1613,3.3
CN5116100000000,51,161,Roanoke County, VA,Feb-18,49121,47640,1481,3.0
CN5116100000000,51,161,Roanoke County, VA,Mar-18,49539,48012,1527,3.1
CN5116100000000,51,161,Roanoke County, VA,Apr-18(p),49516,48236,1280,2.6
CN1906700000000,19,067,Floyd County, IA,Mar-17,8640,8281,359,4.2
CN1906700000000,19,067,Floyd County, IA,Apr-17,8759,8481,278,3.2
CN1906700000000,19,067,Floyd County, IA,May-17,8759,8507,252,2.9
CN1906700000000,19,067,Floyd County, IA,Jun-17,8911,8643,268,3.0
CN1906700000000,19,067,Floyd County, IA,Jul-17,8974,8723,251,2.8
CN1906700000000,19,067,Floyd County, IA,Aug-17,8859,8597,262,3.0
CN1906700000000,19,067,Floyd County, IA,Sep-17,8784,8555,229,2.6
CN1906700000000,19,067,Floyd County, IA,Oct-17,8837,8631,206,2.3
CN1906700000000,19,067,Floyd County, IA,Nov-17,8794,8550,244,2.8
CN1906700000000,19,067,Floyd County, IA,Dec-17,8768,8444,324,3.7
CN1906700000000,19,067,Floyd County, IA,Jan-18,8715,8375,340,3.9
CN1906700000000,19,067,Floyd County, IA,Feb-18,8774,8443,331,3.8
CN1906700000000,19,067,Floyd County, IA,Mar-18,8655,8353,302,3.5
CN1906700000000,19,067,Floyd County, IA,Apr-18(p),8690,8430,260,3.0
CN3906700000000,39,067,Harrison County, OH,Mar-17,7296,6812,484,6.6
CN3906700000000,39,067,Harrison County, OH,Apr-17,7258,6835,423,5.8
CN3906700000000,39,067,Harrison County, OH,May-17,7169,6774,395,5.5
CN3906700000000,39,067,Harrison County, OH,Jun-17,7193,6774,419,5.8
CN3906700000000,39,067,Harrison County, OH,Jul-17,7186,6783,403,5.6
CN3906700000000,39,067,Harrison County, OH,Aug-17,7159,6758,401,5.6
CN3906700000000,39,067,Harrison County, OH,Sep-17,7097,6727,370,5.2
CN3906700000000,39,067,Harrison County, OH,Oct-17,7038,6686,352,5.0
CN3906700000000,39,067,Harrison County, OH,Nov-17,6988,6616,372,5.3
CN3906700000000,39,067,Harrison County, OH,Dec-17,6938,6556,382,5.5
CN3906700000000,39,067,Harrison County, OH,Jan-18,6792,6359,433,6.4
CN3906700000000,39,067,Harrison County, OH,Feb-18,7011,6611,400,5.7
CN3906700000000,39,067,Harrison County, OH,Mar-18,7117,6739,378,5.3
CN3906700000000,39,067,Harrison County, OH,Apr-18(p),7112,6795,317,4.5
CN1811700000000,18,117,Orange County, IN,Mar-17,8933,8558,375,4.2
CN1811700000000,18,117,Orange County, IN,Apr-17,8703,8428,275,3.2
CN1811700000000,18,117,Orange County, IN,May-17,8920,8623,297,3.3
CN1811700000000,18,117,Orange County, IN,Jun-17,8722,8398,324,3.7
CN1811700000000,18,117,Orange County, IN,Jul-17,8544,8220,324,3.8
CN1811700000000,18,117,Orange County, IN,Aug-17,8539,8185,354,4.1
CN1811700000000,18,117,Orange County, IN,Sep-17,8590,8271,319,3.7
CN1811700000000,18,117,Orange County, IN,Oct-17,8554,8255,299,3.5
CN1811700000000,18,117,Orange County, IN,Nov-17,8545,8227,318,3.7
CN1811700000000,18,117,Orange County, IN,Dec-17,8623,8311,312,3.6
CN1811700000000,18,117,Orange County, IN,Jan-18,8716,8351,365,4.2
CN1811700000000,18,117,Orange County, IN,Feb-18,8775,8365,410,4.7
CN1811700000000,18,117,Orange County, IN,Mar-18,8642,8287,355,4.1
CN1811700000000,18,117,Orange County, IN,Apr-18(p),8572,8263,309,3.6
CN1909500000000,19,095,Iowa County, IA,Mar-17,10218,9875,343,3.4
CN1909500000000,19,095,Iowa County, IA,Apr-17,10370,10102,268,2.6
CN1909500000000,19,095,Iowa County, IA,May-17,10308,10058,250,2.4
CN1909500000000,19,095,Iowa County, IA,Jun-17,10572,10309,263,2.5
CN1909500000000,19,095,Iowa County, IA,Jul-17,10646,10371,275,2.6
CN1909500000000,19,095,Iowa County, IA,Aug-17,10658,10414,244,2.3
CN1909500000000,19,095,Iowa County, IA,Sep-17,10668,10454,214,2.0
CN1909500000000,19,095,Iowa County, IA,Oct-17,10741,10540,201,1.9
CN1909500000000,19,095,Iowa County, IA,Nov-17,10599,10408,191,1.8
CN1909500000000,19,095,Iowa County, IA,Dec-17,10575,10314,261,2.5
CN1909500000000,19,095,Iowa County, IA,Jan-18,10456,10102,354,3.4
CN1909500000000,19,095,Iowa County, IA,Feb-18,10540,10210,330,3.1
CN1909500000000,19,095,Iowa County, IA,Mar-18,10486,10209,277,2.6
CN1909500000000,19,095,Iowa County, IA,Apr-18(p),10507,10281,226,2.2
CN0609100000000,06,091,Sierra County, CA,Mar-17,1296,1182,114,8.8
CN0609100000000,06,091,Sierra County, CA,Apr-17,1270,1173,97,7.6
CN0609100000000,06,091,Sierra County, CA,May-17,1303,1226,77,5.9
CN0609100000000,06,091,Sierra County, CA,Jun-17,1327,1256,71,5.4
CN0609100000000,06,091,Sierra County, CA,Jul-17,1316,1236,80,6.1
CN0609100000000,06,091,Sierra County, CA,Aug-17,1321,1246,75,5.7
CN0609100000000,06,091,Sierra County, CA,Sep-17,1326,1259,67,5.1
CN0609100000000,06,091,Sierra County, CA,Oct-17,1327,1263,64,4.8
CN0609100000000,06,091,Sierra County, CA,Nov-17,1285,1222,63,4.9
CN0609100000000,06,091,Sierra County, CA,Dec-17,1265,1194,71,5.6
CN0609100000000,06,091,Sierra County, CA,Jan-18,1283,1192,91,7.1
CN0609100000000,06,091,Sierra County, CA,Feb-18,1304,1202,102,7.8
CN0609100000000,06,091,Sierra County, CA,Mar-18,1293,1197,96,7.4
CN0609100000000,06,091,Sierra County, CA,Apr-18(p),1272,1196,76,6.0
CN0514100000000,05,141,Van Buren County, AR,Mar-17,6088,5742,346,5.7
CN0514100000000,05,141,Van Buren County, AR,Apr-17,6104,5800,304,5.0
CN0514100000000,05,141,Van Buren County, AR,May-17,6125,5807,318,5.2
CN0514100000000,05,141,Van Buren County, AR,Jun-17,6284,5954,330,5.3
CN0514100000000,05,141,Van Buren County, AR,Jul-17,6043,5686,357,5.9
CN0514100000000,05,141,Van Buren County, AR,Aug-17,6031,5720,311,5.2
CN0514100000000,05,141,Van Buren County, AR,Sep-17,6139,5837,302,4.9
CN0514100000000,05,141,Van Buren County, AR,Oct-17,6063,5783,280,4.6
CN0514100000000,05,141,Van Buren County, AR,Nov-17,6060,5779,281,4.6
CN0514100000000,05,141,Van Buren County, AR,Dec-17,5999,5688,311,5.2
CN0514100000000,05,141,Van Buren County, AR,Jan-18,6016,5633,383,6.4
CN0514100000000,05,141,Van Buren County, AR,Feb-18,6007,5641,366,6.1
CN0514100000000,05,141,Van Buren County, AR,Mar-18,6062,5733,329,5.4
CN0514100000000,05,141,Van Buren County, AR,Apr-18(p),5993,5696,297,5.0
CN7201700000000,72,017,Barceloneta Municipio, PR,Mar-17,5947,5122,825,13.9
CN7201700000000,72,017,Barceloneta Municipio, PR,Apr-17,5953,5052,901,15.1
CN7201700000000,72,017,Barceloneta Municipio, PR,May-17,5828,5029,799,13.7
CN7201700000000,72,017,Barceloneta Municipio, PR,Jun-17,5712,4998,714,12.5
CN7201700000000,72,017,Barceloneta Municipio, PR,Jul-17,5760,4975,785,13.6
CN7201700000000,72,017,Barceloneta Municipio, PR,Aug-17,5812,4904,908,15.6
CN7201700000000,72,017,Barceloneta Municipio, PR,Sep-17(y),5794,4959,835,14.4
CN7201700000000,72,017,Barceloneta Municipio, PR,Oct-17,5678,4767,911,16.0
CN7201700000000,72,017,Barceloneta Municipio, PR,Nov-17,5838,5027,811,13.9
CN7201700000000,72,017,Barceloneta Municipio, PR,Dec-17,5763,5060,703,12.2
CN7201700000000,72,017,Barceloneta Municipio, PR,Jan-18,5725,4968,757,13.2
CN7201700000000,72,017,Barceloneta Municipio, PR,Feb-18,5693,4993,700,12.3
CN7201700000000,72,017,Barceloneta Municipio, PR,Mar-18,5704,5003,701,12.3
CN7201700000000,72,017,Barceloneta Municipio, PR,Apr-18(p),5727,5027,700,12.2
CN2609100000000,26,091,Lenawee County, MI,Mar-17,47546,45338,2208,4.6
CN2609100000000,26,091,Lenawee County, MI,Apr-17,47320,45561,1759,3.7
CN2609100000000,26,091,Lenawee County, MI,May-17,47560,45634,1926,4.0
CN2609100000000,26,091,Lenawee County, MI,Jun-17,47422,45088,2334,4.9
CN2609100000000,26,091,Lenawee County, MI,Jul-17,47402,44370,3032,6.4
CN2609100000000,26,091,Lenawee County, MI,Aug-17,47345,44780,2565,5.4
CN2609100000000,26,091,Lenawee County, MI,Sep-17,47339,44961,2378,5.0
CN2609100000000,26,091,Lenawee County, MI,Oct-17,47324,45351,1973,4.2
CN2609100000000,26,091,Lenawee County, MI,Nov-17,47609,45703,1906,4.0
CN2609100000000,26,091,Lenawee County, MI,Dec-17,47342,45334,2008,4.2
CN2609100000000,26,091,Lenawee County, MI,Jan-18,46538,43923,2615,5.6
CN2609100000000,26,091,Lenawee County, MI,Feb-18,47679,45186,2493,5.2
CN2609100000000,26,091,Lenawee County, MI,Mar-18,47717,45582,2135,4.5
CN2609100000000,26,091,Lenawee County, MI,Apr-18(p),47734,45954,1780,3.7
CN3707100000000,37,071,Gaston County, NC,Mar-17,107853,102952,4901,4.5
CN3707100000000,37,071,Gaston County, NC,Apr-17,107721,103183,4538,4.2
CN3707100000000,37,071,Gaston County, NC,May-17,108363,103649,4714,4.4
CN3707100000000,37,071,Gaston County, NC,Jun-17,108803,103877,4926,4.5
CN3707100000000,37,071,Gaston County, NC,Jul-17,109383,104209,5174,4.7
CN3707100000000,37,071,Gaston County, NC,Aug-17,108586,103323,5263,4.8
CN3707100000000,37,071,Gaston County, NC,Sep-17,109832,105090,4742,4.3
CN3707100000000,37,071,Gaston County, NC,Oct-17,110150,105362,4788,4.3
CN3707100000000,37,071,Gaston County, NC,Nov-17,110028,104979,5049,4.6
CN3707100000000,37,071,Gaston County, NC,Dec-17,109620,104769,4851,4.4
CN3707100000000,37,071,Gaston County, NC,Jan-18,109584,104460,5124,4.7
CN3707100000000,37,071,Gaston County, NC,Feb-18,110028,105040,4988,4.5
CN3707100000000,37,071,Gaston County, NC,Mar-18,110921,106155,4766,4.3
CN3707100000000,37,071,Gaston County, NC,Apr-18(p),110332,106250,4082,3.7
CN2104700000000,21,047,Christian County, KY,Mar-17,25432,23667,1765,6.9
CN2104700000000,21,047,Christian County, KY,Apr-17,25445,23881,1564,6.1
CN2104700000000,21,047,Christian County, KY,May-17,25361,23698,1663,6.6
CN2104700000000,21,047,Christian County, KY,Jun-17,25282,23512,1770,7.0
CN2104700000000,21,047,Christian County, KY,Jul-17,25113,23368,1745,6.9
CN2104700000000,21,047,Christian County, KY,Aug-17,25026,23491,1535,6.1
CN2104700000000,21,047,Christian County, KY,Sep-17,25025,23675,1350,5.4
CN2104700000000,21,047,Christian County, KY,Oct-17,24765,23576,1189,4.8
CN2104700000000,21,047,Christian County, KY,Nov-17,24898,23736,1162,4.7
CN2104700000000,21,047,Christian County, KY,Dec-17,24691,23544,1147,4.6
CN2104700000000,21,047,Christian County, KY,Jan-18,24713,23501,1212,4.9
CN2104700000000,21,047,Christian County, KY,Feb-18,25196,23843,1353,5.4
CN2104700000000,21,047,Christian County, KY,Mar-18,25347,24035,1312,5.2
CN2104700000000,21,047,Christian County, KY,Apr-18(p),25372,24234,1138,4.5
CN3803300000000,38,033,Golden Valley County, ND,Mar-17,941,914,27,2.9
CN3803300000000,38,033,Golden Valley County, ND,Apr-17,954,932,22,2.3
CN3803300000000,38,033,Golden Valley County, ND,May-17,948,928,20,2.1
CN3803300000000,38,033,Golden Valley County, ND,Jun-17,1009,988,21,2.1
CN3803300000000,38,033,Golden Valley County, ND,Jul-17,979,963,16,1.6
CN3803300000000,38,033,Golden Valley County, ND,Aug-17,979,964,15,1.5
CN3803300000000,38,033,Golden Valley County, ND,Sep-17,971,955,16,1.6
CN3803300000000,38,033,Golden Valley County, ND,Oct-17,981,967,14,1.4
CN3803300000000,38,033,Golden Valley County, ND,Nov-17,927,912,15,1.6
CN3803300000000,38,033,Golden Valley County, ND,Dec-17,914,898,16,1.8
CN3803300000000,38,033,Golden Valley County, ND,Jan-18,916,895,21,2.3
CN3803300000000,38,033,Golden Valley County, ND,Feb-18,912,891,21,2.3
CN3803300000000,38,033,Golden Valley County, ND,Mar-18,913,895,18,2.0
CN3803300000000,38,033,Golden Valley County, ND,Apr-18(p),892,875,17,1.9
CN4832100000000,48,321,Matagorda County, TX,Mar-17,17504,16248,1256,7.2
CN4832100000000,48,321,Matagorda County, TX,Apr-17,17086,15926,1160,6.8
CN4832100000000,48,321,Matagorda County, TX,May-17,16796,15670,1126,6.7
CN4832100000000,48,321,Matagorda County, TX,Jun-17,17143,15886,1257,7.3
CN4832100000000,48,321,Matagorda County, TX,Jul-17,16844,15578,1266,7.5
CN4832100000000,48,321,Matagorda County, TX,Aug-17,16827,15554,1273,7.6
CN4832100000000,48,321,Matagorda County, TX,Sep-17,16880,15619,1261,7.5
CN4832100000000,48,321,Matagorda County, TX,Oct-17,17071,15969,1102,6.5
CN4832100000000,48,321,Matagorda County, TX,Nov-17,16722,15610,1112,6.6
CN4832100000000,48,321,Matagorda County, TX,Dec-17,16646,15538,1108,6.7
CN4832100000000,48,321,Matagorda County, TX,Jan-18,16813,15565,1248,7.4
CN4832100000000,48,321,Matagorda County, TX,Feb-18,17090,15892,1198,7.0
CN4832100000000,48,321,Matagorda County, TX,Mar-18,17558,16438,1120,6.4
CN4832100000000,48,321,Matagorda County, TX,Apr-18(p),17412,16400,1012,5.8
CN4839900000000,48,399,Runnels County, TX,Mar-17,4721,4542,179,3.8
CN4839900000000,48,399,Runnels County, TX,Apr-17,4665,4502,163,3.5
CN4839900000000,48,399,Runnels County, TX,May-17,4704,4522,182,3.9
CN4839900000000,48,399,Runnels County, TX,Jun-17,4666,4470,196,4.2
CN4839900000000,48,399,Runnels County, TX,Jul-17,4525,4334,191,4.2
CN4839900000000,48,399,Runnels County, TX,Aug-17,4523,4343,180,4.0
CN4839900000000,48,399,Runnels County, TX,Sep-17,4518,4365,153,3.4
CN4839900000000,48,399,Runnels County, TX,Oct-17,4503,4355,148,3.3
CN4839900000000,48,399,Runnels County, TX,Nov-17,4448,4295,153,3.4
CN4839900000000,48,399,Runnels County, TX,Dec-17,4463,4322,141,3.2
CN4839900000000,48,399,Runnels County, TX,Jan-18,4492,4331,161,3.6
CN4839900000000,48,399,Runnels County, TX,Feb-18,4550,4381,169,3.7
CN4839900000000,48,399,Runnels County, TX,Mar-18,4689,4521,168,3.6
CN4839900000000,48,399,Runnels County, TX,Apr-18(p),4694,4541,153,3.3
CN7210700000000,72,107,Orocovis Municipio, PR,Mar-17,5123,4432,691,13.5
CN7210700000000,72,107,Orocovis Municipio, PR,Apr-17,5052,4343,709,14.0
CN7210700000000,72,107,Orocovis Municipio, PR,May-17,4979,4392,587,11.8
CN7210700000000,72,107,Orocovis Municipio, PR,Jun-17,4976,4402,574,11.5
CN7210700000000,72,107,Orocovis Municipio, PR,Jul-17,5338,4412,926,17.3
CN7210700000000,72,107,Orocovis Municipio, PR,Aug-17,5185,4353,832,16.0
CN7210700000000,72,107,Orocovis Municipio, PR,Sep-17(y),5106,4347,759,14.9
CN7210700000000,72,107,Orocovis Municipio, PR,Oct-17,4919,4121,798,16.2
CN7210700000000,72,107,Orocovis Municipio, PR,Nov-17,5140,4397,743,14.5
CN7210700000000,72,107,Orocovis Municipio, PR,Dec-17,5148,4426,722,14.0
CN7210700000000,72,107,Orocovis Municipio, PR,Jan-18,5135,4333,802,15.6
CN7210700000000,72,107,Orocovis Municipio, PR,Feb-18,5032,4292,740,14.7
CN7210700000000,72,107,Orocovis Municipio, PR,Mar-18,5011,4308,703,14.0
CN7210700000000,72,107,Orocovis Municipio, PR,Apr-18(p),5004,4356,648,12.9
CN5405300000000,54,053,Mason County, WV,Mar-17,10028,9342,686,6.8
CN5405300000000,54,053,Mason County, WV,Apr-17,10048,9459,589,5.9
CN5405300000000,54,053,Mason County, WV,May-17,9967,9428,539,5.4
CN5405300000000,54,053,Mason County, WV,Jun-17,10174,9522,652,6.4
CN5405300000000,54,053,Mason County, WV,Jul-17,9826,9155,671,6.8
CN5405300000000,54,053,Mason County, WV,Aug-17,9795,9105,690,7.0
CN5405300000000,54,053,Mason County, WV,Sep-17,10006,9434,572,5.7
CN5405300000000,54,053,Mason County, WV,Oct-17,10006,9428,578,5.8
CN5405300000000,54,053,Mason County, WV,Nov-17,9967,9258,709,7.1
CN5405300000000,54,053,Mason County, WV,Dec-17,9828,9032,796,8.1
CN5405300000000,54,053,Mason County, WV,Jan-18,10029,9149,880,8.8
CN5405300000000,54,053,Mason County, WV,Feb-18,10147,9223,924,9.1
CN5405300000000,54,053,Mason County, WV,Mar-18,9976,9211,765,7.7
CN5405300000000,54,053,Mason County, WV,Apr-18(p),10015,9335,680,6.8
CN4714700000000,47,147,Robertson County, TN,Mar-17,35691,34470,1221,3.4
CN4714700000000,47,147,Robertson County, TN,Apr-17,35858,34670,1188,3.3
CN4714700000000,47,147,Robertson County, TN,May-17,35798,34662,1136,3.2
CN4714700000000,47,147,Robertson County, TN,Jun-17,36417,35043,1374,3.8
CN4714700000000,47,147,Robertson County, TN,Jul-17,36589,35274,1315,3.6
CN4714700000000,47,147,Robertson County, TN,Aug-17,36383,35094,1289,3.5
CN4714700000000,47,147,Robertson County, TN,Sep-17,36642,35523,1119,3.1
CN4714700000000,47,147,Robertson County, TN,Oct-17,36453,35397,1056,2.9
CN4714700000000,47,147,Robertson County, TN,Nov-17,36366,35317,1049,2.9
CN4714700000000,47,147,Robertson County, TN,Dec-17,36280,35267,1013,2.8
CN4714700000000,47,147,Robertson County, TN,Jan-18,36115,34930,1185,3.3
CN4714700000000,47,147,Robertson County, TN,Feb-18,36601,35431,1170,3.2
CN4714700000000,47,147,Robertson County, TN,Mar-18,36583,35449,1134,3.1
CN4714700000000,47,147,Robertson County, TN,Apr-18(p),36815,35853,962,2.6
CN4803700000000,48,037,Bowie County, TX,Mar-17,39605,37736,1869,4.7
CN4803700000000,48,037,Bowie County, TX,Apr-17,39600,37865,1735,4.4
CN4803700000000,48,037,Bowie County, TX,May-17,39407,37654,1753,4.4
CN4803700000000,48,037,Bowie County, TX,Jun-17,39411,37501,1910,4.8
CN4803700000000,48,037,Bowie County, TX,Jul-17,38819,36925,1894,4.9
CN4803700000000,48,037,Bowie County, TX,Aug-17,38700,36845,1855,4.8
CN4803700000000,48,037,Bowie County, TX,Sep-17,39415,37782,1633,4.1
CN4803700000000,48,037,Bowie County, TX,Oct-17,39119,37594,1525,3.9
CN4803700000000,48,037,Bowie County, TX,Nov-17,39401,37801,1600,4.1
CN4803700000000,48,037,Bowie County, TX,Dec-17,39367,37806,1561,4.0
CN4803700000000,48,037,Bowie County, TX,Jan-18,39266,37470,1796,4.6
CN4803700000000,48,037,Bowie County, TX,Feb-18,39732,37865,1867,4.7
CN4803700000000,48,037,Bowie County, TX,Mar-18,39887,38032,1855,4.7
CN4803700000000,48,037,Bowie County, TX,Apr-18(p),39858,38165,1693,4.2
CN3607700000000,36,077,Otsego County, NY,Mar-17,28095,26581,1514,5.4
CN3607700000000,36,077,Otsego County, NY,Apr-17,28328,27002,1326,4.7
CN3607700000000,36,077,Otsego County, NY,May-17,28158,26908,1250,4.4
CN3607700000000,36,077,Otsego County, NY,Jun-17,29180,27726,1454,5.0
CN3607700000000,36,077,Otsego County, NY,Jul-17,29304,27837,1467,5.0
CN3607700000000,36,077,Otsego County, NY,Aug-17,28857,27467,1390,4.8
CN3607700000000,36,077,Otsego County, NY,Sep-17,28218,26933,1285,4.6
CN3607700000000,36,077,Otsego County, NY,Oct-17,27953,26738,1215,4.3
CN3607700000000,36,077,Otsego County, NY,Nov-17,27881,26521,1360,4.9
CN3607700000000,36,077,Otsego County, NY,Dec-17,27119,25680,1439,5.3
CN3607700000000,36,077,Otsego County, NY,Jan-18,27414,25599,1815,6.6
CN3607700000000,36,077,Otsego County, NY,Feb-18,27700,25877,1823,6.6
CN3607700000000,36,077,Otsego County, NY,Mar-18,27355,25743,1612,5.9
CN3607700000000,36,077,Otsego County, NY,Apr-18(p),27706,26293,1413,5.1
CN1915700000000,19,157,Poweshiek County, IA,Mar-17,10557,10143,414,3.9
CN1915700000000,19,157,Poweshiek County, IA,Apr-17,10705,10392,313,2.9
CN1915700000000,19,157,Poweshiek County, IA,May-17,10741,10464,277,2.6
CN1915700000000,19,157,Poweshiek County, IA,Jun-17,10184,9881,303,3.0
CN1915700000000,19,157,Poweshiek County, IA,Jul-17,10247,9948,299,2.9
CN1915700000000,19,157,Poweshiek County, IA,Aug-17,10232,9899,333,3.3
CN1915700000000,19,157,Poweshiek County, IA,Sep-17,10761,10505,256,2.4
CN1915700000000,19,157,Poweshiek County, IA,Oct-17,10881,10592,289,2.7
CN1915700000000,19,157,Poweshiek County, IA,Nov-17,10654,10410,244,2.3
CN1915700000000,19,157,Poweshiek County, IA,Dec-17,10258,9980,278,2.7
CN1915700000000,19,157,Poweshiek County, IA,Jan-18,9443,9037,406,4.3
CN1915700000000,19,157,Poweshiek County, IA,Feb-18,10208,9835,373,3.7
CN1915700000000,19,157,Poweshiek County, IA,Mar-18,10155,9848,307,3.0
CN1915700000000,19,157,Poweshiek County, IA,Apr-18(p),10353,10097,256,2.5
CN5305700000000,53,057,Skagit County, WA,Mar-17,59148,55691,3457,5.8
CN5305700000000,53,057,Skagit County, WA,Apr-17,58813,55654,3159,5.4
CN5305700000000,53,057,Skagit County, WA,May-17,58939,55849,3090,5.2
CN5305700000000,53,057,Skagit County, WA,Jun-17,59835,56717,3118,5.2
CN5305700000000,53,057,Skagit County, WA,Jul-17,60135,57026,3109,5.2
CN5305700000000,53,057,Skagit County, WA,Aug-17,60036,56922,3114,5.2
CN5305700000000,53,057,Skagit County, WA,Sep-17,59690,56753,2937,4.9
CN5305700000000,53,057,Skagit County, WA,Oct-17,59699,56846,2853,4.8
CN5305700000000,53,057,Skagit County, WA,Nov-17,59596,56558,3038,5.1
CN5305700000000,53,057,Skagit County, WA,Dec-17,59418,55973,3445,5.8
CN5305700000000,53,057,Skagit County, WA,Jan-18,58443,54850,3593,6.1
CN5305700000000,53,057,Skagit County, WA,Feb-18,58322,54628,3694,6.3
CN5305700000000,53,057,Skagit County, WA,Mar-18,58712,55306,3406,5.8
CN5305700000000,53,057,Skagit County, WA,Apr-18(p),58511,55343,3168,5.4
CN1327500000000,13,275,Thomas County, GA,Mar-17,17655,16629,1026,5.8
CN1327500000000,13,275,Thomas County, GA,Apr-17,17470,16483,987,5.6
CN1327500000000,13,275,Thomas County, GA,May-17,17299,16329,970,5.6
CN1327500000000,13,275,Thomas County, GA,Jun-17,17232,16176,1056,6.1
CN1327500000000,13,275,Thomas County, GA,Jul-17,17150,16065,1085,6.3
CN1327500000000,13,275,Thomas County, GA,Aug-17,17093,16031,1062,6.2
CN1327500000000,13,275,Thomas County, GA,Sep-17,17212,16227,985,5.7
CN1327500000000,13,275,Thomas County, GA,Oct-17,17147,16186,961,5.6
CN1327500000000,13,275,Thomas County, GA,Nov-17,17098,16164,934,5.5
CN1327500000000,13,275,Thomas County, GA,Dec-17,17087,16162,925,5.4
CN1327500000000,13,275,Thomas County, GA,Jan-18,17132,16171,961,5.6
CN1327500000000,13,275,Thomas County, GA,Feb-18,17299,16358,941,5.4
CN1327500000000,13,275,Thomas County, GA,Mar-18,17300,16443,857,5.0
CN1327500000000,13,275,Thomas County, GA,Apr-18(p),17156,16401,755,4.4
CN1917300000000,19,173,Taylor County, IA,Mar-17,3198,3121,77,2.4
CN1917300000000,19,173,Taylor County, IA,Apr-17,3198,3134,64,2.0
CN1917300000000,19,173,Taylor County, IA,May-17,3212,3145,67,2.1
CN1917300000000,19,173,Taylor County, IA,Jun-17,3241,3162,79,2.4
CN1917300000000,19,173,Taylor County, IA,Jul-17,3308,3238,70,2.1
CN1917300000000,19,173,Taylor County, IA,Aug-17,3293,3217,76,2.3
CN1917300000000,19,173,Taylor County, IA,Sep-17,3249,3175,74,2.3
CN1917300000000,19,173,Taylor County, IA,Oct-17,3257,3194,63,1.9
CN1917300000000,19,173,Taylor County, IA,Nov-17,3232,3171,61,1.9
CN1917300000000,19,173,Taylor County, IA,Dec-17,3253,3190,63,1.9
CN1917300000000,19,173,Taylor County, IA,Jan-18,3205,3113,92,2.9
CN1917300000000,19,173,Taylor County, IA,Feb-18,3235,3145,90,2.8
CN1917300000000,19,173,Taylor County, IA,Mar-18,3188,3111,77,2.4
CN1917300000000,19,173,Taylor County, IA,Apr-18(p),3179,3111,68,2.1
CN3917300000000,39,173,Wood County, OH,Mar-17,71000,67910,3090,4.4
CN3917300000000,39,173,Wood County, OH,Apr-17,70126,67418,2708,3.9
CN3917300000000,39,173,Wood County, OH,May-17,70756,67870,2886,4.1
CN3917300000000,39,173,Wood County, OH,Jun-17,71086,67626,3460,4.9
CN3917300000000,39,173,Wood County, OH,Jul-17,71036,67385,3651,5.1
CN3917300000000,39,173,Wood County, OH,Aug-17,70467,67104,3363,4.8
CN3917300000000,39,173,Wood County, OH,Sep-17,70871,67857,3014,4.3
CN3917300000000,39,173,Wood County, OH,Oct-17,70787,68062,2725,3.8
CN3917300000000,39,173,Wood County, OH,Nov-17,70694,68055,2639,3.7
CN3917300000000,39,173,Wood County, OH,Dec-17,70382,67651,2731,3.9
CN3917300000000,39,173,Wood County, OH,Jan-18,69283,66299,2984,4.3
CN3917300000000,39,173,Wood County, OH,Feb-18,69867,67045,2822,4.0
CN3917300000000,39,173,Wood County, OH,Mar-18,70243,67682,2561,3.6
CN3917300000000,39,173,Wood County, OH,Apr-18(p),70220,67774,2446,3.5
CN1316900000000,13,169,Jones County, GA,Mar-17,14061,13451,610,4.3
CN1316900000000,13,169,Jones County, GA,Apr-17,13967,13391,576,4.1
CN1316900000000,13,169,Jones County, GA,May-17,13997,13408,589,4.2
CN1316900000000,13,169,Jones County, GA,Jun-17,14104,13461,643,4.6
CN1316900000000,13,169,Jones County, GA,Jul-17,14090,13435,655,4.6
CN1316900000000,13,169,Jones County, GA,Aug-17,14027,13385,642,4.6
CN1316900000000,13,169,Jones County, GA,Sep-17,14089,13491,598,4.2
CN1316900000000,13,169,Jones County, GA,Oct-17,14008,13423,585,4.2
CN1316900000000,13,169,Jones County, GA,Nov-17,14055,13487,568,4.0
CN1316900000000,13,169,Jones County, GA,Dec-17,14093,13524,569,4.0
CN1316900000000,13,169,Jones County, GA,Jan-18,14182,13569,613,4.3
CN1316900000000,13,169,Jones County, GA,Feb-18,14224,13633,591,4.2
CN1316900000000,13,169,Jones County, GA,Mar-18,14216,13669,547,3.8
CN1316900000000,13,169,Jones County, GA,Apr-18(p),14087,13615,472,3.4
CN0501100000000,05,011,Bradley County, AR,Mar-17,4331,4110,221,5.1
CN0501100000000,05,011,Bradley County, AR,Apr-17,4378,4186,192,4.4
CN0501100000000,05,011,Bradley County, AR,May-17,4425,4207,218,4.9
CN0501100000000,05,011,Bradley County, AR,Jun-17,4509,4300,209,4.6
CN0501100000000,05,011,Bradley County, AR,Jul-17,4283,4068,215,5.0
CN0501100000000,05,011,Bradley County, AR,Aug-17,4224,4024,200,4.7
CN0501100000000,05,011,Bradley County, AR,Sep-17,4368,4174,194,4.4
CN0501100000000,05,011,Bradley County, AR,Oct-17,4537,4369,168,3.7
CN0501100000000,05,011,Bradley County, AR,Nov-17,4475,4311,164,3.7
CN0501100000000,05,011,Bradley County, AR,Dec-17,4483,4311,172,3.8
CN0501100000000,05,011,Bradley County, AR,Jan-18,4389,4177,212,4.8
CN0501100000000,05,011,Bradley County, AR,Feb-18,4423,4187,236,5.3
CN0501100000000,05,011,Bradley County, AR,Mar-18,4446,4215,231,5.2
CN0501100000000,05,011,Bradley County, AR,Apr-18(p),4448,4259,189,4.2
CN2810300000000,28,103,Noxubee County, MS,Mar-17,3976,3698,278,7.0
CN2810300000000,28,103,Noxubee County, MS,Apr-17,3997,3746,251,6.3
CN2810300000000,28,103,Noxubee County, MS,May-17,3991,3693,298,7.5
CN2810300000000,28,103,Noxubee County, MS,Jun-17,3981,3635,346,8.7
CN2810300000000,28,103,Noxubee County, MS,Jul-17,4001,3627,374,9.3
CN2810300000000,28,103,Noxubee County, MS,Aug-17,3902,3614,288,7.4
CN2810300000000,28,103,Noxubee County, MS,Sep-17,3940,3653,287,7.3
CN2810300000000,28,103,Noxubee County, MS,Oct-17,3861,3608,253,6.6
CN2810300000000,28,103,Noxubee County, MS,Nov-17,3808,3556,252,6.6
CN2810300000000,28,103,Noxubee County, MS,Dec-17,3822,3574,248,6.5
CN2810300000000,28,103,Noxubee County, MS,Jan-18,3763,3506,257,6.8
CN2810300000000,28,103,Noxubee County, MS,Feb-18,3805,3562,243,6.4
CN2810300000000,28,103,Noxubee County, MS,Mar-18,3854,3628,226,5.9
CN2810300000000,28,103,Noxubee County, MS,Apr-18(p),3855,3627,228,5.9
CN4809700000000,48,097,Cooke County, TX,Mar-17,18983,18301,682,3.6
CN4809700000000,48,097,Cooke County, TX,Apr-17,18819,18182,637,3.4
CN4809700000000,48,097,Cooke County, TX,May-17,18820,18146,674,3.6
CN4809700000000,48,097,Cooke County, TX,Jun-17,18992,18265,727,3.8
CN4809700000000,48,097,Cooke County, TX,Jul-17,18886,18187,699,3.7
CN4809700000000,48,097,Cooke County, TX,Aug-17,18802,18132,670,3.6
CN4809700000000,48,097,Cooke County, TX,Sep-17,18756,18160,596,3.2
CN4809700000000,48,097,Cooke County, TX,Oct-17,18783,18144,639,3.4
CN4809700000000,48,097,Cooke County, TX,Nov-17,18804,18161,643,3.4
CN4809700000000,48,097,Cooke County, TX,Dec-17,18786,18185,601,3.2
CN4809700000000,48,097,Cooke County, TX,Jan-18,18566,17890,676,3.6
CN4809700000000,48,097,Cooke County, TX,Feb-18,18715,18086,629,3.4
CN4809700000000,48,097,Cooke County, TX,Mar-18,18801,18148,653,3.5
CN4809700000000,48,097,Cooke County, TX,Apr-18(p),18694,18127,567,3.0
CN5114500000000,51,145,Powhatan County, VA,Mar-17,13846,13389,457,3.3
CN5114500000000,51,145,Powhatan County, VA,Apr-17,13829,13413,416,3.0
CN5114500000000,51,145,Powhatan County, VA,May-17,13889,13430,459,3.3
CN5114500000000,51,145,Powhatan County, VA,Jun-17,13978,13502,476,3.4
CN5114500000000,51,145,Powhatan County, VA,Jul-17,14049,13568,481,3.4
CN5114500000000,51,145,Powhatan County, VA,Aug-17,13914,13417,497,3.6
CN5114500000000,51,145,Powhatan County, VA,Sep-17,13935,13482,453,3.3
CN5114500000000,51,145,Powhatan County, VA,Oct-17,13862,13428,434,3.1
CN5114500000000,51,145,Powhatan County, VA,Nov-17,13795,13357,438,3.2
CN5114500000000,51,145,Powhatan County, VA,Dec-17,13742,13329,413,3.0
CN5114500000000,51,145,Powhatan County, VA,Jan-18,13760,13302,458,3.3
CN5114500000000,51,145,Powhatan County, VA,Feb-18,13921,13502,419,3.0
CN5114500000000,51,145,Powhatan County, VA,Mar-18,14016,13598,418,3.0
CN5114500000000,51,145,Powhatan County, VA,Apr-18(p),14022,13660,362,2.6
CN1307300000000,13,073,Columbia County, GA,Mar-17,72825,69796,3029,4.2
CN1307300000000,13,073,Columbia County, GA,Apr-17,73209,70378,2831,3.9
CN1307300000000,13,073,Columbia County, GA,May-17,72367,69444,2923,4.0
CN1307300000000,13,073,Columbia County, GA,Jun-17,72383,69117,3266,4.5
CN1307300000000,13,073,Columbia County, GA,Jul-17,72664,69383,3281,4.5
CN1307300000000,13,073,Columbia County, GA,Aug-17,72498,69267,3231,4.5
CN1307300000000,13,073,Columbia County, GA,Sep-17,73209,70306,2903,4.0
CN1307300000000,13,073,Columbia County, GA,Oct-17,73297,70396,2901,4.0
CN1307300000000,13,073,Columbia County, GA,Nov-17,73627,70821,2806,3.8
CN1307300000000,13,073,Columbia County, GA,Dec-17,74189,71395,2794,3.8
CN1307300000000,13,073,Columbia County, GA,Jan-18,74753,71880,2873,3.8
CN1307300000000,13,073,Columbia County, GA,Feb-18,75652,72743,2909,3.8
CN1307300000000,13,073,Columbia County, GA,Mar-18,75858,73132,2726,3.6
CN1307300000000,13,073,Columbia County, GA,Apr-18(p),76019,73614,2405,3.2
CN5408100000000,54,081,Raleigh County, WV,Mar-17,28997,27329,1668,5.8
CN5408100000000,54,081,Raleigh County, WV,Apr-17,29384,27893,1491,5.1
CN5408100000000,54,081,Raleigh County, WV,May-17,29406,28005,1401,4.8
CN5408100000000,54,081,Raleigh County, WV,Jun-17,30007,28396,1611,5.4
CN5408100000000,54,081,Raleigh County, WV,Jul-17,30263,28709,1554,5.1
CN5408100000000,54,081,Raleigh County, WV,Aug-17,30117,28478,1639,5.4
CN5408100000000,54,081,Raleigh County, WV,Sep-17,29937,28512,1425,4.8
CN5408100000000,54,081,Raleigh County, WV,Oct-17,29717,28280,1437,4.8
CN5408100000000,54,081,Raleigh County, WV,Nov-17,29228,27674,1554,5.3
CN5408100000000,54,081,Raleigh County, WV,Dec-17,29043,27493,1550,5.3
CN5408100000000,54,081,Raleigh County, WV,Jan-18,29151,27480,1671,5.7
CN5408100000000,54,081,Raleigh County, WV,Feb-18,29436,27545,1891,6.4
CN5408100000000,54,081,Raleigh County, WV,Mar-18,29110,27296,1814,6.2
CN5408100000000,54,081,Raleigh County, WV,Apr-18(p),29431,27780,1651,5.6
CN4841100000000,48,411,San Saba County, TX,Mar-17,2490,2410,80,3.2
CN4841100000000,48,411,San Saba County, TX,Apr-17,2423,2350,73,3.0
CN4841100000000,48,411,San Saba County, TX,May-17,2408,2338,70,2.9
CN4841100000000,48,411,San Saba County, TX,Jun-17,2391,2313,78,3.3
CN4841100000000,48,411,San Saba County, TX,Jul-17,2377,2296,81,3.4
CN4841100000000,48,411,San Saba County, TX,Aug-17,2391,2315,76,3.2
CN4841100000000,48,411,San Saba County, TX,Sep-17,2367,2296,71,3.0
CN4841100000000,48,411,San Saba County, TX,Oct-17,2379,2308,71,3.0
CN4841100000000,48,411,San Saba County, TX,Nov-17,2369,2296,73,3.1
CN4841100000000,48,411,San Saba County, TX,Dec-17,2397,2329,68,2.8
CN4841100000000,48,411,San Saba County, TX,Jan-18,2351,2269,82,3.5
CN4841100000000,48,411,San Saba County, TX,Feb-18,2396,2314,82,3.4
CN4841100000000,48,411,San Saba County, TX,Mar-18,2464,2380,84,3.4
CN4841100000000,48,411,San Saba County, TX,Apr-18(p),2426,2353,73,3.0
CN5504300000000,55,043,Grant County, WI,Mar-17,27572,26507,1065,3.9
CN5504300000000,55,043,Grant County, WI,Apr-17,29037,28239,798,2.7
CN5504300000000,55,043,Grant County, WI,May-17,29235,28390,845,2.9
CN5504300000000,55,043,Grant County, WI,Jun-17,28487,27474,1013,3.6
CN5504300000000,55,043,Grant County, WI,Jul-17,27403,26468,935,3.4
CN5504300000000,55,043,Grant County, WI,Aug-17,26971,26135,836,3.1
CN5504300000000,55,043,Grant County, WI,Sep-17,28278,27539,739,2.6
CN5504300000000,55,043,Grant County, WI,Oct-17,29048,28355,693,2.4
CN5504300000000,55,043,Grant County, WI,Nov-17,29426,28709,717,2.4
CN5504300000000,55,043,Grant County, WI,Dec-17,29194,28490,704,2.4
CN5504300000000,55,043,Grant County, WI,Jan-18,28008,27089,919,3.3
CN5504300000000,55,043,Grant County, WI,Feb-18,28950,27906,1044,3.6
CN5504300000000,55,043,Grant County, WI,Mar-18,29272,28336,936,3.2
CN5504300000000,55,043,Grant County, WI,Apr-18(p),29514,28814,700,2.4
CN3201100000000,32,011,Eureka County, NV,Mar-17,1309,1274,35,2.7
CN3201100000000,32,011,Eureka County, NV,Apr-17,1093,1057,36,3.3
CN3201100000000,32,011,Eureka County, NV,May-17,1094,1062,32,2.9
CN3201100000000,32,011,Eureka County, NV,Jun-17,1111,1080,31,2.8
CN3201100000000,32,011,Eureka County, NV,Jul-17,1055,1021,34,3.2
CN3201100000000,32,011,Eureka County, NV,Aug-17,1037,1008,29,2.8
CN3201100000000,32,011,Eureka County, NV,Sep-17,1028,1000,28,2.7
CN3201100000000,32,011,Eureka County, NV,Oct-17,952,925,27,2.8
CN3201100000000,32,011,Eureka County, NV,Nov-17,982,955,27,2.7
CN3201100000000,32,011,Eureka County, NV,Dec-17,1048,1022,26,2.5
CN3201100000000,32,011,Eureka County, NV,Jan-18,1020,982,38,3.7
CN3201100000000,32,011,Eureka County, NV,Feb-18,1093,1054,39,3.6
CN3201100000000,32,011,Eureka County, NV,Mar-18,1223,1191,32,2.6
CN3201100000000,32,011,Eureka County, NV,Apr-18(p),990,961,29,2.9
CN2610300000000,26,103,Marquette County, MI,Mar-17,33265,31130,2135,6.4
CN2610300000000,26,103,Marquette County, MI,Apr-17,32940,31182,1758,5.3
CN2610300000000,26,103,Marquette County, MI,May-17,32074,30380,1694,5.3
CN2610300000000,26,103,Marquette County, MI,Jun-17,32548,30699,1849,5.7
CN2610300000000,26,103,Marquette County, MI,Jul-17,32375,30330,2045,6.3
CN2610300000000,26,103,Marquette County, MI,Aug-17,32437,30600,1837,5.7
CN2610300000000,26,103,Marquette County, MI,Sep-17,33114,31595,1519,4.6
CN2610300000000,26,103,Marquette County, MI,Oct-17,33034,31617,1417,4.3
CN2610300000000,26,103,Marquette County, MI,Nov-17,33127,31574,1553,4.7
CN2610300000000,26,103,Marquette County, MI,Dec-17,32713,30862,1851,5.7
CN2610300000000,26,103,Marquette County, MI,Jan-18,32064,29919,2145,6.7
CN2610300000000,26,103,Marquette County, MI,Feb-18,33406,31011,2395,7.2
CN2610300000000,26,103,Marquette County, MI,Mar-18,33251,31135,2116,6.4
CN2610300000000,26,103,Marquette County, MI,Apr-18(p),33080,31183,1897,5.7
CN3901300000000,39,013,Belmont County, OH,Mar-17,30985,28727,2258,7.3
CN3901300000000,39,013,Belmont County, OH,Apr-17,30673,28760,1913,6.2
CN3901300000000,39,013,Belmont County, OH,May-17,30738,29000,1738,5.7
CN3901300000000,39,013,Belmont County, OH,Jun-17,30774,28951,1823,5.9
CN3901300000000,39,013,Belmont County, OH,Jul-17,30800,28994,1806,5.9
CN3901300000000,39,013,Belmont County, OH,Aug-17,30538,28736,1802,5.9
CN3901300000000,39,013,Belmont County, OH,Sep-17,30371,28743,1628,5.4
CN3901300000000,39,013,Belmont County, OH,Oct-17,30513,28891,1622,5.3
CN3901300000000,39,013,Belmont County, OH,Nov-17,30550,28913,1637,5.4
CN3901300000000,39,013,Belmont County, OH,Dec-17,30546,28780,1766,5.8
CN3901300000000,39,013,Belmont County, OH,Jan-18,30058,27926,2132,7.1
CN3901300000000,39,013,Belmont County, OH,Feb-18,30413,28398,2015,6.6
CN3901300000000,39,013,Belmont County, OH,Mar-18,30696,28859,1837,6.0
CN3901300000000,39,013,Belmont County, OH,Apr-18(p),30422,28819,1603,5.3
CN4101900000000,41,019,Douglas County, OR,Mar-17,46052,43485,2567,5.6
CN4101900000000,41,019,Douglas County, OR,Apr-17,46058,43719,2339,5.1
CN4101900000000,41,019,Douglas County, OR,May-17,46172,43957,2215,4.8
CN4101900000000,41,019,Douglas County, OR,Jun-17,46816,44329,2487,5.3
CN4101900000000,41,019,Douglas County, OR,Jul-17,46954,44313,2641,5.6
CN4101900000000,41,019,Douglas County, OR,Aug-17,47464,44772,2692,5.7
CN4101900000000,41,019,Douglas County, OR,Sep-17,47389,44949,2440,5.1
CN4101900000000,41,019,Douglas County, OR,Oct-17,46858,44446,2412,5.1
CN4101900000000,41,019,Douglas County, OR,Nov-17,46870,44421,2449,5.2
CN4101900000000,41,019,Douglas County, OR,Dec-17,46458,44080,2378,5.1
CN4101900000000,41,019,Douglas County, OR,Jan-18,46883,44245,2638,5.6
CN4101900000000,41,019,Douglas County, OR,Feb-18,46887,44257,2630,5.6
CN4101900000000,41,019,Douglas County, OR,Mar-18,46563,43864,2699,5.8
CN4101900000000,41,019,Douglas County, OR,Apr-18(p),46233,43816,2417,5.2
CN4848900000000,48,489,Willacy County, TX,Mar-17,6562,5769,793,12.1
CN4848900000000,48,489,Willacy County, TX,Apr-17,6742,5951,791,11.7
CN4848900000000,48,489,Willacy County, TX,May-17,6525,5789,736,11.3
CN4848900000000,48,489,Willacy County, TX,Jun-17,6476,5718,758,11.7
CN4848900000000,48,489,Willacy County, TX,Jul-17,6133,5396,737,12.0
CN4848900000000,48,489,Willacy County, TX,Aug-17,6151,5471,680,11.1
CN4848900000000,48,489,Willacy County, TX,Sep-17,6114,5526,588,9.6
CN4848900000000,48,489,Willacy County, TX,Oct-17,6074,5535,539,8.9
CN4848900000000,48,489,Willacy County, TX,Nov-17,6017,5485,532,8.8
CN4848900000000,48,489,Willacy County, TX,Dec-17,6005,5463,542,9.0
CN4848900000000,48,489,Willacy County, TX,Jan-18,6135,5463,672,11.0
CN4848900000000,48,489,Willacy County, TX,Feb-18,6267,5555,712,11.4
CN4848900000000,48,489,Willacy County, TX,Mar-18,6317,5613,704,11.1
CN4848900000000,48,489,Willacy County, TX,Apr-18(p),6477,5759,718,11.1
CN4830500000000,48,305,Lynn County, TX,Mar-17,2803,2694,109,3.9
CN4830500000000,48,305,Lynn County, TX,Apr-17,2788,2694,94,3.4
CN4830500000000,48,305,Lynn County, TX,May-17,2798,2699,99,3.5
CN4830500000000,48,305,Lynn County, TX,Jun-17,2757,2642,115,4.2
CN4830500000000,48,305,Lynn County, TX,Jul-17,2680,2560,120,4.5
CN4830500000000,48,305,Lynn County, TX,Aug-17,2722,2606,116,4.3
CN4830500000000,48,305,Lynn County, TX,Sep-17,2679,2581,98,3.7
CN4830500000000,48,305,Lynn County, TX,Oct-17,2721,2637,84,3.1
CN4830500000000,48,305,Lynn County, TX,Nov-17,2677,2586,91,3.4
CN4830500000000,48,305,Lynn County, TX,Dec-17,2678,2592,86,3.2
CN4830500000000,48,305,Lynn County, TX,Jan-18,2644,2549,95,3.6
CN4830500000000,48,305,Lynn County, TX,Feb-18,2732,2629,103,3.8
CN4830500000000,48,305,Lynn County, TX,Mar-18,2828,2724,104,3.7
CN4830500000000,48,305,Lynn County, TX,Apr-18(p),2774,2679,95,3.4
CN0503500000000,05,035,Crittenden County, AR,Mar-17,21578,20663,915,4.2
CN0503500000000,05,035,Crittenden County, AR,Apr-17,21658,20824,834,3.9
CN0503500000000,05,035,Crittenden County, AR,May-17,21680,20774,906,4.2
CN0503500000000,05,035,Crittenden County, AR,Jun-17,22032,20982,1050,4.8
CN0503500000000,05,035,Crittenden County, AR,Jul-17,22447,21345,1102,4.9
CN0503500000000,05,035,Crittenden County, AR,Aug-17,22107,21088,1019,4.6
CN0503500000000,05,035,Crittenden County, AR,Sep-17,21781,20913,868,4.0
CN0503500000000,05,035,Crittenden County, AR,Oct-17,21789,21006,783,3.6
CN0503500000000,05,035,Crittenden County, AR,Nov-17,21942,21154,788,3.6
CN0503500000000,05,035,Crittenden County, AR,Dec-17,21827,20940,887,4.1
CN0503500000000,05,035,Crittenden County, AR,Jan-18,21393,20350,1043,4.9
CN0503500000000,05,035,Crittenden County, AR,Feb-18,21655,20638,1017,4.7
CN0503500000000,05,035,Crittenden County, AR,Mar-18,21761,20836,925,4.3
CN0503500000000,05,035,Crittenden County, AR,Apr-18(p),21687,20828,859,4.0
CN3010100000000,30,101,Toole County, MT,Mar-17,2149,2076,73,3.4
CN3010100000000,30,101,Toole County, MT,Apr-17,2188,2124,64,2.9
CN3010100000000,30,101,Toole County, MT,May-17,2213,2153,60,2.7
CN3010100000000,30,101,Toole County, MT,Jun-17,2235,2163,72,3.2
CN3010100000000,30,101,Toole County, MT,Jul-17,2233,2167,66,3.0
CN3010100000000,30,101,Toole County, MT,Aug-17,2208,2140,68,3.1
CN3010100000000,30,101,Toole County, MT,Sep-17,2122,2056,66,3.1
CN3010100000000,30,101,Toole County, MT,Oct-17,2106,2043,63,3.0
CN3010100000000,30,101,Toole County, MT,Nov-17,2070,2007,63,3.0
CN3010100000000,30,101,Toole County, MT,Dec-17,2054,1985,69,3.4
CN3010100000000,30,101,Toole County, MT,Jan-18,2057,1986,71,3.5
CN3010100000000,30,101,Toole County, MT,Feb-18,2052,1978,74,3.6
CN3010100000000,30,101,Toole County, MT,Mar-18,2041,1969,72,3.5
CN3010100000000,30,101,Toole County, MT,Apr-18(p),2057,1991,66,3.2
CN3719500000000,37,195,Wilson County, NC,Mar-17,36319,33842,2477,6.8
CN3719500000000,37,195,Wilson County, NC,Apr-17,36404,33749,2655,7.3
CN3719500000000,37,195,Wilson County, NC,May-17,36238,33494,2744,7.6
CN3719500000000,37,195,Wilson County, NC,Jun-17,36044,33225,2819,7.8
CN3719500000000,37,195,Wilson County, NC,Jul-17,36321,33527,2794,7.7
CN3719500000000,37,195,Wilson County, NC,Aug-17,35692,32948,2744,7.7
CN3719500000000,37,195,Wilson County, NC,Sep-17,36128,33711,2417,6.7
CN3719500000000,37,195,Wilson County, NC,Oct-17,35979,33538,2441,6.8
CN3719500000000,37,195,Wilson County, NC,Nov-17,35658,33160,2498,7.0
CN3719500000000,37,195,Wilson County, NC,Dec-17,35537,33176,2361,6.6
CN3719500000000,37,195,Wilson County, NC,Jan-18,35456,32910,2546,7.2
CN3719500000000,37,195,Wilson County, NC,Feb-18,35674,33239,2435,6.8
CN3719500000000,37,195,Wilson County, NC,Mar-18,35603,33295,2308,6.5
CN3719500000000,37,195,Wilson County, NC,Apr-18(p),35726,33525,2201,6.2
CN2005900000000,20,059,Franklin County, KS,Mar-17,14155,13595,560,4.0
CN2005900000000,20,059,Franklin County, KS,Apr-17,14062,13571,491,3.5
CN2005900000000,20,059,Franklin County, KS,May-17,13954,13457,497,3.6
CN2005900000000,20,059,Franklin County, KS,Jun-17,14294,13732,562,3.9
CN2005900000000,20,059,Franklin County, KS,Jul-17,14325,13723,602,4.2
CN2005900000000,20,059,Franklin County, KS,Aug-17,14076,13511,565,4.0
CN2005900000000,20,059,Franklin County, KS,Sep-17,14110,13662,448,3.2
CN2005900000000,20,059,Franklin County, KS,Oct-17,14042,13616,426,3.0
CN2005900000000,20,059,Franklin County, KS,Nov-17,14151,13713,438,3.1
CN2005900000000,20,059,Franklin County, KS,Dec-17,14013,13584,429,3.1
CN2005900000000,20,059,Franklin County, KS,Jan-18,14163,13577,586,4.1
CN2005900000000,20,059,Franklin County, KS,Feb-18,14240,13656,584,4.1
CN2005900000000,20,059,Franklin County, KS,Mar-18,14143,13630,513,3.6
CN2005900000000,20,059,Franklin County, KS,Apr-18(p),14108,13651,457,3.2
CN5002700000000,50,027,Windsor County, VT,Mar-17,29658,28832,826,2.8
CN5002700000000,50,027,Windsor County, VT,Apr-17,28606,27786,820,2.9
CN5002700000000,50,027,Windsor County, VT,May-17,28671,27917,754,2.6
CN5002700000000,50,027,Windsor County, VT,Jun-17,29331,28551,780,2.7
CN5002700000000,50,027,Windsor County, VT,Jul-17,29330,28534,796,2.7
CN5002700000000,50,027,Windsor County, VT,Aug-17,29616,28836,780,2.6
CN5002700000000,50,027,Windsor County, VT,Sep-17,28964,28229,735,2.5
CN5002700000000,50,027,Windsor County, VT,Oct-17,28892,28322,570,2.0
CN5002700000000,50,027,Windsor County, VT,Nov-17,29072,28394,678,2.3
CN5002700000000,50,027,Windsor County, VT,Dec-17,29567,28932,635,2.1
CN5002700000000,50,027,Windsor County, VT,Jan-18,30039,29302,737,2.5
CN5002700000000,50,027,Windsor County, VT,Feb-18,30309,29549,760,2.5
CN5002700000000,50,027,Windsor County, VT,Mar-18,30272,29508,764,2.5
CN5002700000000,50,027,Windsor County, VT,Apr-18(p),29065,28278,787,2.7
CN4609700000000,46,097,Miner County, SD,Mar-17,1195,1154,41,3.4
CN4609700000000,46,097,Miner County, SD,Apr-17,1210,1169,41,3.4
CN4609700000000,46,097,Miner County, SD,May-17,1221,1183,38,3.1
CN4609700000000,46,097,Miner County, SD,Jun-17,1257,1226,31,2.5
CN4609700000000,46,097,Miner County, SD,Jul-17,1216,1186,30,2.5
CN4609700000000,46,097,Miner County, SD,Aug-17,1189,1156,33,2.8
CN4609700000000,46,097,Miner County, SD,Sep-17,1175,1146,29,2.5
CN4609700000000,46,097,Miner County, SD,Oct-17,1180,1149,31,2.6
CN4609700000000,46,097,Miner County, SD,Nov-17,1170,1136,34,2.9
CN4609700000000,46,097,Miner County, SD,Dec-17,1203,1156,47,3.9
CN4609700000000,46,097,Miner County, SD,Jan-18,1200,1158,42,3.5
CN4609700000000,46,097,Miner County, SD,Feb-18,1203,1157,46,3.8
CN4609700000000,46,097,Miner County, SD,Mar-18,1211,1175,36,3.0
CN4609700000000,46,097,Miner County, SD,Apr-18(p),1185,1144,41,3.5
CN2922300000000,29,223,Wayne County, MO,Mar-17,5383,5061,322,6.0
CN2922300000000,29,223,Wayne County, MO,Apr-17,5415,5125,290,5.4
CN2922300000000,29,223,Wayne County, MO,May-17,5482,5197,285,5.2
CN2922300000000,29,223,Wayne County, MO,Jun-17,5590,5303,287,5.1
CN2922300000000,29,223,Wayne County, MO,Jul-17,5373,5068,305,5.7
CN2922300000000,29,223,Wayne County, MO,Aug-17,5454,5134,320,5.9
CN2922300000000,29,223,Wayne County, MO,Sep-17,5466,5233,233,4.3
CN2922300000000,29,223,Wayne County, MO,Oct-17,5396,5208,188,3.5
CN2922300000000,29,223,Wayne County, MO,Nov-17,5362,5148,214,4.0
CN2922300000000,29,223,Wayne County, MO,Dec-17,5354,5111,243,4.5
CN2922300000000,29,223,Wayne County, MO,Jan-18,5384,5093,291,5.4
CN2922300000000,29,223,Wayne County, MO,Feb-18,5378,5084,294,5.5
CN2922300000000,29,223,Wayne County, MO,Mar-18,5372,5098,274,5.1
CN2922300000000,29,223,Wayne County, MO,Apr-18(p),5397,5124,273,5.1
CN3600900000000,36,009,Cattaraugus County, NY,Mar-17,35271,32901,2370,6.7
CN3600900000000,36,009,Cattaraugus County, NY,Apr-17,34447,32318,2129,6.2
CN3600900000000,36,009,Cattaraugus County, NY,May-17,34124,32127,1997,5.9
CN3600900000000,36,009,Cattaraugus County, NY,Jun-17,34660,32683,1977,5.7
CN3600900000000,36,009,Cattaraugus County, NY,Jul-17,34942,32925,2017,5.8
CN3600900000000,36,009,Cattaraugus County, NY,Aug-17,34566,32591,1975,5.7
CN3600900000000,36,009,Cattaraugus County, NY,Sep-17,34394,32515,1879,5.5
CN3600900000000,36,009,Cattaraugus County, NY,Oct-17,34183,32340,1843,5.4
CN3600900000000,36,009,Cattaraugus County, NY,Nov-17,34429,32347,2082,6.0
CN3600900000000,36,009,Cattaraugus County, NY,Dec-17,34442,32156,2286,6.6
CN3600900000000,36,009,Cattaraugus County, NY,Jan-18,35001,32296,2705,7.7
CN3600900000000,36,009,Cattaraugus County, NY,Feb-18,34816,32084,2732,7.8
CN3600900000000,36,009,Cattaraugus County, NY,Mar-18,34123,31637,2486,7.3
CN3600900000000,36,009,Cattaraugus County, NY,Apr-18(p),33372,31234,2138,6.4
CN4808100000000,48,081,Coke County, TX,Mar-17,1391,1335,56,4.0
CN4808100000000,48,081,Coke County, TX,Apr-17,1383,1334,49,3.5
CN4808100000000,48,081,Coke County, TX,May-17,1404,1355,49,3.5
CN4808100000000,48,081,Coke County, TX,Jun-17,1431,1379,52,3.6
CN4808100000000,48,081,Coke County, TX,Jul-17,1399,1345,54,3.9
CN4808100000000,48,081,Coke County, TX,Aug-17,1414,1360,54,3.8
CN4808100000000,48,081,Coke County, TX,Sep-17,1411,1363,48,3.4
CN4808100000000,48,081,Coke County, TX,Oct-17,1392,1350,42,3.0
CN4808100000000,48,081,Coke County, TX,Nov-17,1383,1337,46,3.3
CN4808100000000,48,081,Coke County, TX,Dec-17,1396,1354,42,3.0
CN4808100000000,48,081,Coke County, TX,Jan-18,1386,1333,53,3.8
CN4808100000000,48,081,Coke County, TX,Feb-18,1414,1359,55,3.9
CN4808100000000,48,081,Coke County, TX,Mar-18,1417,1369,48,3.4
CN4808100000000,48,081,Coke County, TX,Apr-18(p),1414,1366,48,3.4
CN4824300000000,48,243,Jeff Davis County, TX,Mar-17,1097,1064,33,3.0
CN4824300000000,48,243,Jeff Davis County, TX,Apr-17,1089,1057,32,2.9
CN4824300000000,48,243,Jeff Davis County, TX,May-17,1095,1061,34,3.1
CN4824300000000,48,243,Jeff Davis County, TX,Jun-17,1103,1069,34,3.1
CN4824300000000,48,243,Jeff Davis County, TX,Jul-17,1053,1019,34,3.2
CN4824300000000,48,243,Jeff Davis County, TX,Aug-17,1051,1017,34,3.2
CN4824300000000,48,243,Jeff Davis County, TX,Sep-17,1025,993,32,3.1
CN4824300000000,48,243,Jeff Davis County, TX,Oct-17,1037,1009,28,2.7
CN4824300000000,48,243,Jeff Davis County, TX,Nov-17,1004,974,30,3.0
CN4824300000000,48,243,Jeff Davis County, TX,Dec-17,1008,980,28,2.8
CN4824300000000,48,243,Jeff Davis County, TX,Jan-18,989,960,29,2.9
CN4824300000000,48,243,Jeff Davis County, TX,Feb-18,1029,997,32,3.1
CN4824300000000,48,243,Jeff Davis County, TX,Mar-18,1102,1070,32,2.9
CN4824300000000,48,243,Jeff Davis County, TX,Apr-18(p),1071,1042,29,2.7
CN0812500000000,08,125,Yuma County, CO,Mar-17,5289,5197,92,1.7
CN0812500000000,08,125,Yuma County, CO,Apr-17,5585,5499,86,1.5
CN0812500000000,08,125,Yuma County, CO,May-17,5778,5687,91,1.6
CN0812500000000,08,125,Yuma County, CO,Jun-17,5740,5637,103,1.8
CN0812500000000,08,125,Yuma County, CO,Jul-17,5859,5771,88,1.5
CN0812500000000,08,125,Yuma County, CO,Aug-17,5796,5713,83,1.4
CN0812500000000,08,125,Yuma County, CO,Sep-17,5668,5581,87,1.5
CN0812500000000,08,125,Yuma County, CO,Oct-17,6149,6055,94,1.5
CN0812500000000,08,125,Yuma County, CO,Nov-17,5937,5842,95,1.6
CN0812500000000,08,125,Yuma County, CO,Dec-17,5966,5876,90,1.5
CN0812500000000,08,125,Yuma County, CO,Jan-18,5771,5659,112,1.9
CN0812500000000,08,125,Yuma County, CO,Feb-18,5482,5363,119,2.2
CN0812500000000,08,125,Yuma County, CO,Mar-18,5465,5361,104,1.9
CN0812500000000,08,125,Yuma County, CO,Apr-18(p),5665,5567,98,1.7
CN2610100000000,26,101,Manistee County, MI,Mar-17,10228,9398,830,8.1
CN2610100000000,26,101,Manistee County, MI,Apr-17,10192,9568,624,6.1
CN2610100000000,26,101,Manistee County, MI,May-17,10451,9866,585,5.6
CN2610100000000,26,101,Manistee County, MI,Jun-17,10832,10198,634,5.9
CN2610100000000,26,101,Manistee County, MI,Jul-17,10981,10244,737,6.7
CN2610100000000,26,101,Manistee County, MI,Aug-17,10808,10143,665,6.2
CN2610100000000,26,101,Manistee County, MI,Sep-17,10532,9969,563,5.3
CN2610100000000,26,101,Manistee County, MI,Oct-17,10357,9843,514,5.0
CN2610100000000,26,101,Manistee County, MI,Nov-17,10198,9614,584,5.7
CN2610100000000,26,101,Manistee County, MI,Dec-17,10189,9451,738,7.2
CN2610100000000,26,101,Manistee County, MI,Jan-18,10243,9381,862,8.4
CN2610100000000,26,101,Manistee County, MI,Feb-18,10342,9409,933,9.0
CN2610100000000,26,101,Manistee County, MI,Mar-18,10287,9435,852,8.3
CN2610100000000,26,101,Manistee County, MI,Apr-18(p),10308,9614,694,6.7
CN0209000000000,02,090,Fairbanks North Star Borough, AK,Mar-17,46232,43182,3050,6.6
CN0209000000000,02,090,Fairbanks North Star Borough, AK,Apr-17,46376,43444,2932,6.3
CN0209000000000,02,090,Fairbanks North Star Borough, AK,May-17,47473,44538,2935,6.2
CN0209000000000,02,090,Fairbanks North Star Borough, AK,Jun-17,46734,43737,2997,6.4
CN0209000000000,02,090,Fairbanks North Star Borough, AK,Jul-17,47102,44338,2764,5.9
CN0209000000000,02,090,Fairbanks North Star Borough, AK,Aug-17,47118,44507,2611,5.5
CN0209000000000,02,090,Fairbanks North Star Borough, AK,Sep-17,46885,44138,2747,5.9
CN0209000000000,02,090,Fairbanks North Star Borough, AK,Oct-17,46987,44207,2780,5.9
CN0209000000000,02,090,Fairbanks North Star Borough, AK,Nov-17,47013,44025,2988,6.4
CN0209000000000,02,090,Fairbanks North Star Borough, AK,Dec-17,46717,43667,3050,6.5
CN0209000000000,02,090,Fairbanks North Star Borough, AK,Jan-18,45799,42398,3401,7.4
CN0209000000000,02,090,Fairbanks North Star Borough, AK,Feb-18,45905,42523,3382,7.4
CN0209000000000,02,090,Fairbanks North Star Borough, AK,Mar-18,46246,43048,3198,6.9
CN0209000000000,02,090,Fairbanks North Star Borough, AK,Apr-18(p),46215,43046,3169,6.9
CN2705100000000,27,051,Grant County, MN,Mar-17,3260,3055,205,6.3
CN2705100000000,27,051,Grant County, MN,Apr-17,3279,3150,129,3.9
CN2705100000000,27,051,Grant County, MN,May-17,3296,3192,104,3.2
CN2705100000000,27,051,Grant County, MN,Jun-17,3362,3252,110,3.3
CN2705100000000,27,051,Grant County, MN,Jul-17,3315,3213,102,3.1
CN2705100000000,27,051,Grant County, MN,Aug-17,3219,3121,98,3.0
CN2705100000000,27,051,Grant County, MN,Sep-17,3170,3093,77,2.4
CN2705100000000,27,051,Grant County, MN,Oct-17,3275,3212,63,1.9
CN2705100000000,27,051,Grant County, MN,Nov-17,3280,3175,105,3.2
CN2705100000000,27,051,Grant County, MN,Dec-17,3319,3161,158,4.8
CN2705100000000,27,051,Grant County, MN,Jan-18,3283,3073,210,6.4
CN2705100000000,27,051,Grant County, MN,Feb-18,3269,3072,197,6.0
CN2705100000000,27,051,Grant County, MN,Mar-18,3280,3081,199,6.1
CN2705100000000,27,051,Grant County, MN,Apr-18(p),3346,3181,165,4.9
CN2015900000000,20,159,Rice County, KS,Mar-17,5394,5227,167,3.1
CN2015900000000,20,159,Rice County, KS,Apr-17,5353,5189,164,3.1
CN2015900000000,20,159,Rice County, KS,May-17,5374,5199,175,3.3
CN2015900000000,20,159,Rice County, KS,Jun-17,5523,5319,204,3.7
CN2015900000000,20,159,Rice County, KS,Jul-17,5438,5227,211,3.9
CN2015900000000,20,159,Rice County, KS,Aug-17,5327,5134,193,3.6
CN2015900000000,20,159,Rice County, KS,Sep-17,5412,5266,146,2.7
CN2015900000000,20,159,Rice County, KS,Oct-17,5416,5288,128,2.4
CN2015900000000,20,159,Rice County, KS,Nov-17,5415,5267,148,2.7
CN2015900000000,20,159,Rice County, KS,Dec-17,5415,5263,152,2.8
CN2015900000000,20,159,Rice County, KS,Jan-18,5378,5219,159,3.0
CN2015900000000,20,159,Rice County, KS,Feb-18,5389,5234,155,2.9
CN2015900000000,20,159,Rice County, KS,Mar-18,5314,5157,157,3.0
CN2015900000000,20,159,Rice County, KS,Apr-18(p),5259,5109,150,2.9
CN3110700000000,31,107,Knox County, NE,Mar-17,4677,4486,191,4.1
CN3110700000000,31,107,Knox County, NE,Apr-17,4732,4599,133,2.8
CN3110700000000,31,107,Knox County, NE,May-17,4810,4681,129,2.7
CN3110700000000,31,107,Knox County, NE,Jun-17,5007,4851,156,3.1
CN3110700000000,31,107,Knox County, NE,Jul-17,4915,4753,162,3.3
CN3110700000000,31,107,Knox County, NE,Aug-17,4702,4560,142,3.0
CN3110700000000,31,107,Knox County, NE,Sep-17,4519,4379,140,3.1
CN3110700000000,31,107,Knox County, NE,Oct-17,4537,4405,132,2.9
CN3110700000000,31,107,Knox County, NE,Nov-17,4592,4436,156,3.4
CN3110700000000,31,107,Knox County, NE,Dec-17,4599,4419,180,3.9
CN3110700000000,31,107,Knox County, NE,Jan-18,4700,4493,207,4.4
CN3110700000000,31,107,Knox County, NE,Feb-18,4619,4420,199,4.3
CN3110700000000,31,107,Knox County, NE,Mar-18,4694,4503,191,4.1
CN3110700000000,31,107,Knox County, NE,Apr-18(p),4678,4521,157,3.4
CN4713100000000,47,131,Obion County, TN,Mar-17,12359,11639,720,5.8
CN4713100000000,47,131,Obion County, TN,Apr-17,12296,11681,615,5.0
CN4713100000000,47,131,Obion County, TN,May-17,12315,11745,570,4.6
CN4713100000000,47,131,Obion County, TN,Jun-17,12320,11642,678,5.5
CN4713100000000,47,131,Obion County, TN,Jul-17,12332,11609,723,5.9
CN4713100000000,47,131,Obion County, TN,Aug-17,12342,11645,697,5.6
CN4713100000000,47,131,Obion County, TN,Sep-17,12270,11644,626,5.1
CN4713100000000,47,131,Obion County, TN,Oct-17,12129,11538,591,4.9
CN4713100000000,47,131,Obion County, TN,Nov-17,12032,11481,551,4.6
CN4713100000000,47,131,Obion County, TN,Dec-17,12014,11469,545,4.5
CN4713100000000,47,131,Obion County, TN,Jan-18,12128,11463,665,5.5
CN4713100000000,47,131,Obion County, TN,Feb-18,12144,11504,640,5.3
CN4713100000000,47,131,Obion County, TN,Mar-18,12127,11533,594,4.9
CN4713100000000,47,131,Obion County, TN,Apr-18(p),12171,11686,485,4.0
CN1803900000000,18,039,Elkhart County, IN,Mar-17,110307,107390,2917,2.6
CN1803900000000,18,039,Elkhart County, IN,Apr-17,110170,107818,2352,2.1
CN1803900000000,18,039,Elkhart County, IN,May-17,111281,108633,2648,2.4
CN1803900000000,18,039,Elkhart County, IN,Jun-17,113943,110975,2968,2.6
CN1803900000000,18,039,Elkhart County, IN,Jul-17,113737,110756,2981,2.6
CN1803900000000,18,039,Elkhart County, IN,Aug-17,112937,109692,3245,2.9
CN1803900000000,18,039,Elkhart County, IN,Sep-17,112532,109999,2533,2.3
CN1803900000000,18,039,Elkhart County, IN,Oct-17,112319,109865,2454,2.2
CN1803900000000,18,039,Elkhart County, IN,Nov-17,111944,109280,2664,2.4
CN1803900000000,18,039,Elkhart County, IN,Dec-17,112104,109732,2372,2.1
CN1803900000000,18,039,Elkhart County, IN,Jan-18,112683,109969,2714,2.4
CN1803900000000,18,039,Elkhart County, IN,Feb-18,114957,112113,2844,2.5
CN1803900000000,18,039,Elkhart County, IN,Mar-18,116311,113757,2554,2.2
CN1803900000000,18,039,Elkhart County, IN,Apr-18(p),116777,114451,2326,2.0
CN3601500000000,36,015,Chemung County, NY,Mar-17,36070,33972,2098,5.8
CN3601500000000,36,015,Chemung County, NY,Apr-17,35854,33917,1937,5.4
CN3601500000000,36,015,Chemung County, NY,May-17,35800,33868,1932,5.4
CN3601500000000,36,015,Chemung County, NY,Jun-17,36607,34619,1988,5.4
CN3601500000000,36,015,Chemung County, NY,Jul-17,36152,34155,1997,5.5
CN3601500000000,36,015,Chemung County, NY,Aug-17,36148,34202,1946,5.4
CN3601500000000,36,015,Chemung County, NY,Sep-17,35760,33826,1934,5.4
CN3601500000000,36,015,Chemung County, NY,Oct-17,35514,33668,1846,5.2
CN3601500000000,36,015,Chemung County, NY,Nov-17,35296,33407,1889,5.4
CN3601500000000,36,015,Chemung County, NY,Dec-17,35087,33155,1932,5.5
CN3601500000000,36,015,Chemung County, NY,Jan-18,35617,33398,2219,6.2
CN3601500000000,36,015,Chemung County, NY,Feb-18,35003,32684,2319,6.6
CN3601500000000,36,015,Chemung County, NY,Mar-18,34779,32674,2105,6.1
CN3601500000000,36,015,Chemung County, NY,Apr-18(p),34797,32951,1846,5.3
CN4814300000000,48,143,Erath County, TX,Mar-17,21256,20525,731,3.4
CN4814300000000,48,143,Erath County, TX,Apr-17,21329,20695,634,3.0
CN4814300000000,48,143,Erath County, TX,May-17,21267,20607,660,3.1
CN4814300000000,48,143,Erath County, TX,Jun-17,21070,20261,809,3.8
CN4814300000000,48,143,Erath County, TX,Jul-17,19541,18751,790,4.0
CN4814300000000,48,143,Erath County, TX,Aug-17,19736,18980,756,3.8
CN4814300000000,48,143,Erath County, TX,Sep-17,20337,19693,644,3.2
CN4814300000000,48,143,Erath County, TX,Oct-17,20809,20222,587,2.8
CN4814300000000,48,143,Erath County, TX,Nov-17,20581,19967,614,3.0
CN4814300000000,48,143,Erath County, TX,Dec-17,20475,19888,587,2.9
CN4814300000000,48,143,Erath County, TX,Jan-18,20298,19631,667,3.3
CN4814300000000,48,143,Erath County, TX,Feb-18,21224,20555,669,3.2
CN4814300000000,48,143,Erath County, TX,Mar-18,21610,20948,662,3.1
CN4814300000000,48,143,Erath County, TX,Apr-18(p),22001,21421,580,2.6
CN3500300000000,35,003,Catron County, NM,Mar-17,1110,1026,84,7.6
CN3500300000000,35,003,Catron County, NM,Apr-17,1079,1009,70,6.5
CN3500300000000,35,003,Catron County, NM,May-17,1152,1088,64,5.6
CN3500300000000,35,003,Catron County, NM,Jun-17,1186,1113,73,6.2
CN3500300000000,35,003,Catron County, NM,Jul-17,1221,1143,78,6.4
CN3500300000000,35,003,Catron County, NM,Aug-17,1174,1102,72,6.1
CN3500300000000,35,003,Catron County, NM,Sep-17,1173,1103,70,6.0
CN3500300000000,35,003,Catron County, NM,Oct-17,1168,1087,81,6.9
CN3500300000000,35,003,Catron County, NM,Nov-17,1163,1072,91,7.8
CN3500300000000,35,003,Catron County, NM,Dec-17,1153,1062,91,7.9
CN3500300000000,35,003,Catron County, NM,Jan-18,1160,1063,97,8.4
CN3500300000000,35,003,Catron County, NM,Feb-18,1128,1046,82,7.3
CN3500300000000,35,003,Catron County, NM,Mar-18,1149,1073,76,6.6
CN3500300000000,35,003,Catron County, NM,Apr-18(p),1238,1176,62,5.0
CN5108300000000,51,083,Halifax County, VA,Mar-17,14892,14100,792,5.3
CN5108300000000,51,083,Halifax County, VA,Apr-17,15014,14287,727,4.8
CN5108300000000,51,083,Halifax County, VA,May-17,15047,14326,721,4.8
CN5108300000000,51,083,Halifax County, VA,Jun-17,15183,14377,806,5.3
CN5108300000000,51,083,Halifax County, VA,Jul-17,14943,14135,808,5.4
CN5108300000000,51,083,Halifax County, VA,Aug-17,14936,14101,835,5.6
CN5108300000000,51,083,Halifax County, VA,Sep-17,15060,14281,779,5.2
CN5108300000000,51,083,Halifax County, VA,Oct-17,14738,14015,723,4.9
CN5108300000000,51,083,Halifax County, VA,Nov-17,14727,14017,710,4.8
CN5108300000000,51,083,Halifax County, VA,Dec-17,14756,14017,739,5.0
CN5108300000000,51,083,Halifax County, VA,Jan-18,14666,13906,760,5.2
CN5108300000000,51,083,Halifax County, VA,Feb-18,14881,14185,696,4.7
CN5108300000000,51,083,Halifax County, VA,Mar-18,15092,14386,706,4.7
CN5108300000000,51,083,Halifax County, VA,Apr-18(p),15141,14531,610,4.0
CN0802500000000,08,025,Crowley County, CO,Mar-17,1413,1372,41,2.9
CN0802500000000,08,025,Crowley County, CO,Apr-17,1432,1395,37,2.6
CN0802500000000,08,025,Crowley County, CO,May-17,1437,1400,37,2.6
CN0802500000000,08,025,Crowley County, CO,Jun-17,1441,1399,42,2.9
CN0802500000000,08,025,Crowley County, CO,Jul-17,1446,1403,43,3.0
CN0802500000000,08,025,Crowley County, CO,Aug-17,1459,1409,50,3.4
CN0802500000000,08,025,Crowley County, CO,Sep-17,1486,1437,49,3.3
CN0802500000000,08,025,Crowley County, CO,Oct-17,1534,1487,47,3.1
CN0802500000000,08,025,Crowley County, CO,Nov-17,1523,1474,49,3.2
CN0802500000000,08,025,Crowley County, CO,Dec-17,1483,1432,51,3.4
CN0802500000000,08,025,Crowley County, CO,Jan-18,1449,1398,51,3.5
CN0802500000000,08,025,Crowley County, CO,Feb-18,1474,1416,58,3.9
CN0802500000000,08,025,Crowley County, CO,Mar-18,1471,1411,60,4.1
CN0802500000000,08,025,Crowley County, CO,Apr-18(p),1483,1427,56,3.8
CN2921700000000,29,217,Vernon County, MO,Mar-17,9579,9146,433,4.5
CN2921700000000,29,217,Vernon County, MO,Apr-17,9897,9521,376,3.8
CN2921700000000,29,217,Vernon County, MO,May-17,9743,9379,364,3.7
CN2921700000000,29,217,Vernon County, MO,Jun-17,9779,9389,390,4.0
CN2921700000000,29,217,Vernon County, MO,Jul-17,9239,8823,416,4.5
CN2921700000000,29,217,Vernon County, MO,Aug-17,9159,8750,409,4.5
CN2921700000000,29,217,Vernon County, MO,Sep-17,9341,9022,319,3.4
CN2921700000000,29,217,Vernon County, MO,Oct-17,9478,9233,245,2.6
CN2921700000000,29,217,Vernon County, MO,Nov-17,9450,9158,292,3.1
CN2921700000000,29,217,Vernon County, MO,Dec-17,9332,9020,312,3.3
CN2921700000000,29,217,Vernon County, MO,Jan-18,9409,9045,364,3.9
CN2921700000000,29,217,Vernon County, MO,Feb-18,9489,9143,346,3.6
CN2921700000000,29,217,Vernon County, MO,Mar-18,9482,9121,361,3.8
CN2921700000000,29,217,Vernon County, MO,Apr-18(p),9631,9323,308,3.2
CN5183000000000,51,830,Williamsburg city, VA,Mar-17,6819,6454,365,5.4
CN5183000000000,51,830,Williamsburg city, VA,Apr-17,6811,6490,321,4.7
CN5183000000000,51,830,Williamsburg city, VA,May-17,6821,6492,329,4.8
CN5183000000000,51,830,Williamsburg city, VA,Jun-17,6941,6534,407,5.9
CN5183000000000,51,830,Williamsburg city, VA,Jul-17,6975,6583,392,5.6
CN5183000000000,51,830,Williamsburg city, VA,Aug-17,6910,6520,390,5.6
CN5183000000000,51,830,Williamsburg city, VA,Sep-17,6870,6501,369,5.4
CN5183000000000,51,830,Williamsburg city, VA,Oct-17,6774,6455,319,4.7
CN5183000000000,51,830,Williamsburg city, VA,Nov-17,6761,6417,344,5.1
CN5183000000000,51,830,Williamsburg city, VA,Dec-17,6661,6379,282,4.2
CN5183000000000,51,830,Williamsburg city, VA,Jan-18,6706,6359,347,5.2
CN5183000000000,51,830,Williamsburg city, VA,Feb-18,6776,6461,315,4.6
CN5183000000000,51,830,Williamsburg city, VA,Mar-18,6820,6516,304,4.5
CN5183000000000,51,830,Williamsburg city, VA,Apr-18(p),6788,6543,245,3.6
CN2203700000000,22,037,East Feliciana Parish, LA,Mar-17,8082,7702,380,4.7
CN2203700000000,22,037,East Feliciana Parish, LA,Apr-17,8107,7722,385,4.7
CN2203700000000,22,037,East Feliciana Parish, LA,May-17,8058,7694,364,4.5
CN2203700000000,22,037,East Feliciana Parish, LA,Jun-17,8176,7722,454,5.6
CN2203700000000,22,037,East Feliciana Parish, LA,Jul-17,8178,7754,424,5.2
CN2203700000000,22,037,East Feliciana Parish, LA,Aug-17,8154,7719,435,5.3
CN2203700000000,22,037,East Feliciana Parish, LA,Sep-17,8164,7773,391,4.8
CN2203700000000,22,037,East Feliciana Parish, LA,Oct-17,8128,7797,331,4.1
CN2203700000000,22,037,East Feliciana Parish, LA,Nov-17,8180,7835,345,4.2
CN2203700000000,22,037,East Feliciana Parish, LA,Dec-17,8080,7772,308,3.8
CN2203700000000,22,037,East Feliciana Parish, LA,Jan-18,8089,7755,334,4.1
CN2203700000000,22,037,East Feliciana Parish, LA,Feb-18,8187,7883,304,3.7
CN2203700000000,22,037,East Feliciana Parish, LA,Mar-18,8232,7903,329,4.0
CN2203700000000,22,037,East Feliciana Parish, LA,Apr-18(p),8260,7938,322,3.9
CN4001300000000,40,013,Bryan County, OK,Mar-17,19929,19145,784,3.9
CN4001300000000,40,013,Bryan County, OK,Apr-17,19917,19191,726,3.6
CN4001300000000,40,013,Bryan County, OK,May-17,19995,19176,819,4.1
CN4001300000000,40,013,Bryan County, OK,Jun-17,21261,20358,903,4.2
CN4001300000000,40,013,Bryan County, OK,Jul-17,21062,20235,827,3.9
CN4001300000000,40,013,Bryan County, OK,Aug-17,20411,19625,786,3.9
CN4001300000000,40,013,Bryan County, OK,Sep-17,20648,19876,772,3.7
CN4001300000000,40,013,Bryan County, OK,Oct-17,21001,20288,713,3.4
CN4001300000000,40,013,Bryan County, OK,Nov-17,21171,20453,718,3.4
CN4001300000000,40,013,Bryan County, OK,Dec-17,20997,20299,698,3.3
CN4001300000000,40,013,Bryan County, OK,Jan-18,21096,20323,773,3.7
CN4001300000000,40,013,Bryan County, OK,Feb-18,20950,20195,755,3.6
CN4001300000000,40,013,Bryan County, OK,Mar-18,21117,20357,760,3.6
CN4001300000000,40,013,Bryan County, OK,Apr-18(p),21009,20278,731,3.5
CN4840500000000,48,405,San Augustine County, TX,Mar-17,2877,2645,232,8.1
CN4840500000000,48,405,San Augustine County, TX,Apr-17,2851,2643,208,7.3
CN4840500000000,48,405,San Augustine County, TX,May-17,2874,2668,206,7.2
CN4840500000000,48,405,San Augustine County, TX,Jun-17,2876,2665,211,7.3
CN4840500000000,48,405,San Augustine County, TX,Jul-17,2859,2639,220,7.7
CN4840500000000,48,405,San Augustine County, TX,Aug-17,2817,2603,214,7.6
CN4840500000000,48,405,San Augustine County, TX,Sep-17,2928,2736,192,6.6
CN4840500000000,48,405,San Augustine County, TX,Oct-17,2893,2723,170,5.9
CN4840500000000,48,405,San Augustine County, TX,Nov-17,2886,2701,185,6.4
CN4840500000000,48,405,San Augustine County, TX,Dec-17,2933,2730,203,6.9
CN4840500000000,48,405,San Augustine County, TX,Jan-18,2981,2752,229,7.7
CN4840500000000,48,405,San Augustine County, TX,Feb-18,3023,2813,210,6.9
CN4840500000000,48,405,San Augustine County, TX,Mar-18,3049,2841,208,6.8
CN4840500000000,48,405,San Augustine County, TX,Apr-18(p),2985,2784,201,6.7
CN2911700000000,29,117,Livingston County, MO,Mar-17,7316,7075,241,3.3
CN2911700000000,29,117,Livingston County, MO,Apr-17,7536,7334,202,2.7
CN2911700000000,29,117,Livingston County, MO,May-17,7328,7124,204,2.8
CN2911700000000,29,117,Livingston County, MO,Jun-17,7403,7186,217,2.9
CN2911700000000,29,117,Livingston County, MO,Jul-17,7396,7162,234,3.2
CN2911700000000,29,117,Livingston County, MO,Aug-17,7193,6933,260,3.6
CN2911700000000,29,117,Livingston County, MO,Sep-17,7198,7005,193,2.7
CN2911700000000,29,117,Livingston County, MO,Oct-17,7172,7024,148,2.1
CN2911700000000,29,117,Livingston County, MO,Nov-17,7164,6985,179,2.5
CN2911700000000,29,117,Livingston County, MO,Dec-17,7142,6948,194,2.7
CN2911700000000,29,117,Livingston County, MO,Jan-18,7152,6904,248,3.5
CN2911700000000,29,117,Livingston County, MO,Feb-18,7363,7108,255,3.5
CN2911700000000,29,117,Livingston County, MO,Mar-18,7329,7105,224,3.1
CN2911700000000,29,117,Livingston County, MO,Apr-18(p),7448,7261,187,2.5
CN2810500000000,28,105,Oktibbeha County, MS,Mar-17,23288,22225,1063,4.6
CN2810500000000,28,105,Oktibbeha County, MS,Apr-17,23401,22419,982,4.2
CN2810500000000,28,105,Oktibbeha County, MS,May-17,24275,22978,1297,5.3
CN2810500000000,28,105,Oktibbeha County, MS,Jun-17,21755,20230,1525,7.0
CN2810500000000,28,105,Oktibbeha County, MS,Jul-17,21849,20502,1347,6.2
CN2810500000000,28,105,Oktibbeha County, MS,Aug-17,21618,20562,1056,4.9
CN2810500000000,28,105,Oktibbeha County, MS,Sep-17,23637,22625,1012,4.3
CN2810500000000,28,105,Oktibbeha County, MS,Oct-17,23397,22454,943,4.0
CN2810500000000,28,105,Oktibbeha County, MS,Nov-17,23451,22540,911,3.9
CN2810500000000,28,105,Oktibbeha County, MS,Dec-17,23228,22297,931,4.0
CN2810500000000,28,105,Oktibbeha County, MS,Jan-18,20589,19658,931,4.5
CN2810500000000,28,105,Oktibbeha County, MS,Feb-18,23204,22280,924,4.0
CN2810500000000,28,105,Oktibbeha County, MS,Mar-18,23082,22178,904,3.9
CN2810500000000,28,105,Oktibbeha County, MS,Apr-18(p),23419,22492,927,4.0
CN3706500000000,37,065,Edgecombe County, NC,Mar-17,22473,20824,1649,7.3
CN3706500000000,37,065,Edgecombe County, NC,Apr-17,22256,20546,1710,7.7
CN3706500000000,37,065,Edgecombe County, NC,May-17,22143,20428,1715,7.7
CN3706500000000,37,065,Edgecombe County, NC,Jun-17,21927,20209,1718,7.8
CN3706500000000,37,065,Edgecombe County, NC,Jul-17,22065,20342,1723,7.8
CN3706500000000,37,065,Edgecombe County, NC,Aug-17,21609,19875,1734,8.0
CN3706500000000,37,065,Edgecombe County, NC,Sep-17,22041,20456,1585,7.2
CN3706500000000,37,065,Edgecombe County, NC,Oct-17,22068,20465,1603,7.3
CN3706500000000,37,065,Edgecombe County, NC,Nov-17,22174,20476,1698,7.7
CN3706500000000,37,065,Edgecombe County, NC,Dec-17,21970,20316,1654,7.5
CN3706500000000,37,065,Edgecombe County, NC,Jan-18,21844,20009,1835,8.4
CN3706500000000,37,065,Edgecombe County, NC,Feb-18,22198,20390,1808,8.1
CN3706500000000,37,065,Edgecombe County, NC,Mar-18,22019,20358,1661,7.5
CN3706500000000,37,065,Edgecombe County, NC,Apr-18(p),21884,20331,1553,7.1
CN5504100000000,55,041,Forest County, WI,Mar-17,3983,3724,259,6.5
CN5504100000000,55,041,Forest County, WI,Apr-17,4011,3788,223,5.6
CN5504100000000,55,041,Forest County, WI,May-17,4046,3872,174,4.3
CN5504100000000,55,041,Forest County, WI,Jun-17,4292,4059,233,5.4
CN5504100000000,55,041,Forest County, WI,Jul-17,4162,3954,208,5.0
CN5504100000000,55,041,Forest County, WI,Aug-17,4076,3870,206,5.1
CN5504100000000,55,041,Forest County, WI,Sep-17,4047,3877,170,4.2
CN5504100000000,55,041,Forest County, WI,Oct-17,4088,3928,160,3.9
CN5504100000000,55,041,Forest County, WI,Nov-17,4066,3907,159,3.9
CN5504100000000,55,041,Forest County, WI,Dec-17,4042,3859,183,4.5
CN5504100000000,55,041,Forest County, WI,Jan-18,4043,3847,196,4.8
CN5504100000000,55,041,Forest County, WI,Feb-18,4035,3815,220,5.5
CN5504100000000,55,041,Forest County, WI,Mar-18,4063,3839,224,5.5
CN5504100000000,55,041,Forest County, WI,Apr-18(p),4045,3816,229,5.7
CN4813700000000,48,137,Edwards County, TX,Mar-17,903,868,35,3.9
CN4813700000000,48,137,Edwards County, TX,Apr-17,888,859,29,3.3
CN4813700000000,48,137,Edwards County, TX,May-17,902,873,29,3.2
CN4813700000000,48,137,Edwards County, TX,Jun-17,916,887,29,3.2
CN4813700000000,48,137,Edwards County, TX,Jul-17,932,903,29,3.1
CN4813700000000,48,137,Edwards County, TX,Aug-17,939,909,30,3.2
CN4813700000000,48,137,Edwards County, TX,Sep-17,894,871,23,2.6
CN4813700000000,48,137,Edwards County, TX,Oct-17,908,885,23,2.5
CN4813700000000,48,137,Edwards County, TX,Nov-17,897,873,24,2.7
CN4813700000000,48,137,Edwards County, TX,Dec-17,905,882,23,2.5
CN4813700000000,48,137,Edwards County, TX,Jan-18,905,880,25,2.8
CN4813700000000,48,137,Edwards County, TX,Feb-18,922,897,25,2.7
CN4813700000000,48,137,Edwards County, TX,Mar-18,946,918,28,3.0
CN4813700000000,48,137,Edwards County, TX,Apr-18(p),912,890,22,2.4
CN2204300000000,22,043,Grant Parish, LA,Mar-17,8085,7581,504,6.2
CN2204300000000,22,043,Grant Parish, LA,Apr-17,8158,7674,484,5.9
CN2204300000000,22,043,Grant Parish, LA,May-17,8137,7631,506,6.2
CN2204300000000,22,043,Grant Parish, LA,Jun-17,8355,7724,631,7.6
CN2204300000000,22,043,Grant Parish, LA,Jul-17,8365,7770,595,7.1
CN2204300000000,22,043,Grant Parish, LA,Aug-17,8263,7672,591,7.2
CN2204300000000,22,043,Grant Parish, LA,Sep-17,8195,7719,476,5.8
CN2204300000000,22,043,Grant Parish, LA,Oct-17,8167,7776,391,4.8
CN2204300000000,22,043,Grant Parish, LA,Nov-17,8178,7764,414,5.1
CN2204300000000,22,043,Grant Parish, LA,Dec-17,8182,7739,443,5.4
CN2204300000000,22,043,Grant Parish, LA,Jan-18,8242,7765,477,5.8
CN2204300000000,22,043,Grant Parish, LA,Feb-18,8234,7829,405,4.9
CN2204300000000,22,043,Grant Parish, LA,Mar-18,8245,7811,434,5.3
CN2204300000000,22,043,Grant Parish, LA,Apr-18(p),8226,7808,418,5.1
CN2103100000000,21,031,Butler County, KY,Mar-17,5386,5050,336,6.2
CN2103100000000,21,031,Butler County, KY,Apr-17,5385,5104,281,5.2
CN2103100000000,21,031,Butler County, KY,May-17,5341,5061,280,5.2
CN2103100000000,21,031,Butler County, KY,Jun-17,5321,5023,298,5.6
CN2103100000000,21,031,Butler County, KY,Jul-17,5119,4835,284,5.5
CN2103100000000,21,031,Butler County, KY,Aug-17,5101,4824,277,5.4
CN2103100000000,21,031,Butler County, KY,Sep-17,5215,4956,259,5.0
CN2103100000000,21,031,Butler County, KY,Oct-17,5229,4990,239,4.6
CN2103100000000,21,031,Butler County, KY,Nov-17,5230,4999,231,4.4
CN2103100000000,21,031,Butler County, KY,Dec-17,5249,5033,216,4.1
CN2103100000000,21,031,Butler County, KY,Jan-18,5222,4954,268,5.1
CN2103100000000,21,031,Butler County, KY,Feb-18,5347,5063,284,5.3
CN2103100000000,21,031,Butler County, KY,Mar-18,5453,5181,272,5.0
CN2103100000000,21,031,Butler County, KY,Apr-18(p),5449,5225,224,4.1
CN0402100000000,04,021,Pinal County, AZ,Mar-17,168615,159920,8695,5.2
CN0402100000000,04,021,Pinal County, AZ,Apr-17,167686,159564,8122,4.8
CN0402100000000,04,021,Pinal County, AZ,May-17,167209,159141,8068,4.8
CN0402100000000,04,021,Pinal County, AZ,Jun-17,167974,159212,8762,5.2
CN0402100000000,04,021,Pinal County, AZ,Jul-17,168261,159596,8665,5.1
CN0402100000000,04,021,Pinal County, AZ,Aug-17,168227,159467,8760,5.2
CN0402100000000,04,021,Pinal County, AZ,Sep-17,170513,162126,8387,4.9
CN0402100000000,04,021,Pinal County, AZ,Oct-17,170829,162879,7950,4.7
CN0402100000000,04,021,Pinal County, AZ,Nov-17,171545,163537,8008,4.7
CN0402100000000,04,021,Pinal County, AZ,Dec-17,171875,163719,8156,4.7
CN0402100000000,04,021,Pinal County, AZ,Jan-18,170755,161617,9138,5.4
CN0402100000000,04,021,Pinal County, AZ,Feb-18,172471,163454,9017,5.2
CN0402100000000,04,021,Pinal County, AZ,Mar-18,173655,165250,8405,4.8
CN0402100000000,04,021,Pinal County, AZ,Apr-18(p),171214,163350,7864,4.6
CN4106300000000,41,063,Wallowa County, OR,Mar-17,3203,2947,256,8.0
CN4106300000000,41,063,Wallowa County, OR,Apr-17,3254,3026,228,7.0
CN4106300000000,41,063,Wallowa County, OR,May-17,3330,3157,173,5.2
CN4106300000000,41,063,Wallowa County, OR,Jun-17,3480,3335,145,4.2
CN4106300000000,41,063,Wallowa County, OR,Jul-17,3576,3427,149,4.2
CN4106300000000,41,063,Wallowa County, OR,Aug-17,3593,3448,145,4.0
CN4106300000000,41,063,Wallowa County, OR,Sep-17,3534,3400,134,3.8
CN4106300000000,41,063,Wallowa County, OR,Oct-17,3440,3296,144,4.2
CN4106300000000,41,063,Wallowa County, OR,Nov-17,3321,3140,181,5.5
CN4106300000000,41,063,Wallowa County, OR,Dec-17,3241,3039,202,6.2
CN4106300000000,41,063,Wallowa County, OR,Jan-18,3228,2986,242,7.5
CN4106300000000,41,063,Wallowa County, OR,Feb-18,3284,3005,279,8.5
CN4106300000000,41,063,Wallowa County, OR,Mar-18,3194,2911,283,8.9
CN4106300000000,41,063,Wallowa County, OR,Apr-18(p),3204,2976,228,7.1
CN0801900000000,08,019,Clear Creek County, CO,Mar-17,5765,5617,148,2.6
CN0801900000000,08,019,Clear Creek County, CO,Apr-17,5773,5639,134,2.3
CN0801900000000,08,019,Clear Creek County, CO,May-17,5806,5674,132,2.3
CN0801900000000,08,019,Clear Creek County, CO,Jun-17,5903,5732,171,2.9
CN0801900000000,08,019,Clear Creek County, CO,Jul-17,5933,5762,171,2.9
CN0801900000000,08,019,Clear Creek County, CO,Aug-17,5917,5759,158,2.7
CN0801900000000,08,019,Clear Creek County, CO,Sep-17,5931,5788,143,2.4
CN0801900000000,08,019,Clear Creek County, CO,Oct-17,5913,5775,138,2.3
CN0801900000000,08,019,Clear Creek County, CO,Nov-17,5923,5776,147,2.5
CN0801900000000,08,019,Clear Creek County, CO,Dec-17,5902,5750,152,2.6
CN0801900000000,08,019,Clear Creek County, CO,Jan-18,5892,5713,179,3.0
CN0801900000000,08,019,Clear Creek County, CO,Feb-18,5968,5795,173,2.9
CN0801900000000,08,019,Clear Creek County, CO,Mar-18,5979,5823,156,2.6
CN0801900000000,08,019,Clear Creek County, CO,Apr-18(p),5981,5839,142,2.4
CN4842900000000,48,429,Stephens County, TX,Mar-17,4088,3870,218,5.3
CN4842900000000,48,429,Stephens County, TX,Apr-17,4084,3884,200,4.9
CN4842900000000,48,429,Stephens County, TX,May-17,4036,3837,199,4.9
CN4842900000000,48,429,Stephens County, TX,Jun-17,4072,3857,215,5.3
CN4842900000000,48,429,Stephens County, TX,Jul-17,4014,3819,195,4.9
CN4842900000000,48,429,Stephens County, TX,Aug-17,4029,3836,193,4.8
CN4842900000000,48,429,Stephens County, TX,Sep-17,4048,3883,165,4.1
CN4842900000000,48,429,Stephens County, TX,Oct-17,4042,3881,161,4.0
CN4842900000000,48,429,Stephens County, TX,Nov-17,4000,3840,160,4.0
CN4842900000000,48,429,Stephens County, TX,Dec-17,4021,3868,153,3.8
CN4842900000000,48,429,Stephens County, TX,Jan-18,4015,3839,176,4.4
CN4842900000000,48,429,Stephens County, TX,Feb-18,4057,3885,172,4.2
CN4842900000000,48,429,Stephens County, TX,Mar-18,4130,3958,172,4.2
CN4842900000000,48,429,Stephens County, TX,Apr-18(p),4086,3935,151,3.7
CN1212300000000,12,123,Taylor County, FL,Mar-17,8812,8409,403,4.6
CN1212300000000,12,123,Taylor County, FL,Apr-17,8854,8470,384,4.3
CN1212300000000,12,123,Taylor County, FL,May-17,8870,8478,392,4.4
CN1212300000000,12,123,Taylor County, FL,Jun-17,8820,8404,416,4.7
CN1212300000000,12,123,Taylor County, FL,Jul-17,8785,8354,431,4.9
CN1212300000000,12,123,Taylor County, FL,Aug-17,8745,8341,404,4.6
CN1212300000000,12,123,Taylor County, FL,Sep-17,9071,8703,368,4.1
CN1212300000000,12,123,Taylor County, FL,Oct-17,8757,8406,351,4.0
CN1212300000000,12,123,Taylor County, FL,Nov-17,8679,8321,358,4.1
CN1212300000000,12,123,Taylor County, FL,Dec-17,8607,8266,341,4.0
CN1212300000000,12,123,Taylor County, FL,Jan-18,8658,8277,381,4.4
CN1212300000000,12,123,Taylor County, FL,Feb-18,8674,8316,358,4.1
CN1212300000000,12,123,Taylor County, FL,Mar-18,8812,8468,344,3.9
CN1212300000000,12,123,Taylor County, FL,Apr-18(p),8784,8462,322,3.7
CN1804500000000,18,045,Fountain County, IN,Mar-17,7919,7582,337,4.3
CN1804500000000,18,045,Fountain County, IN,Apr-17,7873,7600,273,3.5
CN1804500000000,18,045,Fountain County, IN,May-17,8113,7819,294,3.6
CN1804500000000,18,045,Fountain County, IN,Jun-17,8021,7705,316,3.9
CN1804500000000,18,045,Fountain County, IN,Jul-17,7948,7629,319,4.0
CN1804500000000,18,045,Fountain County, IN,Aug-17,7955,7619,336,4.2
CN1804500000000,18,045,Fountain County, IN,Sep-17,7803,7512,291,3.7
CN1804500000000,18,045,Fountain County, IN,Oct-17,7845,7579,266,3.4
CN1804500000000,18,045,Fountain County, IN,Nov-17,7877,7600,277,3.5
CN1804500000000,18,045,Fountain County, IN,Dec-17,7742,7475,267,3.4
CN1804500000000,18,045,Fountain County, IN,Jan-18,7654,7334,320,4.2
CN1804500000000,18,045,Fountain County, IN,Feb-18,7781,7459,322,4.1
CN1804500000000,18,045,Fountain County, IN,Mar-18,7866,7576,290,3.7
CN1804500000000,18,045,Fountain County, IN,Apr-18(p),7882,7631,251,3.2
CN0100900000000,01,009,Blount County, AL,Mar-17,24565,23424,1141,4.6
CN0100900000000,01,009,Blount County, AL,Apr-17,24420,23493,927,3.8
CN0100900000000,01,009,Blount County, AL,May-17,24373,23479,894,3.7
CN0100900000000,01,009,Blount County, AL,Jun-17,24626,23533,1093,4.4
CN0100900000000,01,009,Blount County, AL,Jul-17,24697,23693,1004,4.1
CN0100900000000,01,009,Blount County, AL,Aug-17,24544,23573,971,4.0
CN0100900000000,01,009,Blount County, AL,Sep-17,24676,23860,816,3.3
CN0100900000000,01,009,Blount County, AL,Oct-17,24609,23793,816,3.3
CN0100900000000,01,009,Blount County, AL,Nov-17,24396,23641,755,3.1
CN0100900000000,01,009,Blount County, AL,Dec-17,24164,23434,730,3.0
CN0100900000000,01,009,Blount County, AL,Jan-18,24115,23237,878,3.6
CN0100900000000,01,009,Blount County, AL,Feb-18,24524,23617,907,3.7
CN0100900000000,01,009,Blount County, AL,Mar-18,24577,23737,840,3.4
CN0100900000000,01,009,Blount County, AL,Apr-18(p),24822,24051,771,3.1
CN3105100000000,31,051,Dixon County, NE,Mar-17,2970,2869,101,3.4
CN3105100000000,31,051,Dixon County, NE,Apr-17,3022,2931,91,3.0
CN3105100000000,31,051,Dixon County, NE,May-17,3057,2956,101,3.3
CN3105100000000,31,051,Dixon County, NE,Jun-17,3112,3009,103,3.3
CN3105100000000,31,051,Dixon County, NE,Jul-17,3066,2966,100,3.3
CN3105100000000,31,051,Dixon County, NE,Aug-17,2984,2898,86,2.9
CN3105100000000,31,051,Dixon County, NE,Sep-17,2927,2847,80,2.7
CN3105100000000,31,051,Dixon County, NE,Oct-17,2934,2865,69,2.4
CN3105100000000,31,051,Dixon County, NE,Nov-17,2961,2882,79,2.7
CN3105100000000,31,051,Dixon County, NE,Dec-17,2948,2862,86,2.9
CN3105100000000,31,051,Dixon County, NE,Jan-18,2983,2875,108,3.6
CN3105100000000,31,051,Dixon County, NE,Feb-18,2929,2845,84,2.9
CN3105100000000,31,051,Dixon County, NE,Mar-18,2978,2886,92,3.1
CN3105100000000,31,051,Dixon County, NE,Apr-18(p),3029,2924,105,3.5
CN3608300000000,36,083,Rensselaer County, NY,Mar-17,82338,78710,3628,4.4
CN3608300000000,36,083,Rensselaer County, NY,Apr-17,82559,79201,3358,4.1
CN3608300000000,36,083,Rensselaer County, NY,May-17,82131,78759,3372,4.1
CN3608300000000,36,083,Rensselaer County, NY,Jun-17,83418,79702,3716,4.5
CN3608300000000,36,083,Rensselaer County, NY,Jul-17,83294,79489,3805,4.6
CN3608300000000,36,083,Rensselaer County, NY,Aug-17,82607,78867,3740,4.5
CN3608300000000,36,083,Rensselaer County, NY,Sep-17,82503,78960,3543,4.3
CN3608300000000,36,083,Rensselaer County, NY,Oct-17,82077,78683,3394,4.1
CN3608300000000,36,083,Rensselaer County, NY,Nov-17,81685,78189,3496,4.3
CN3608300000000,36,083,Rensselaer County, NY,Dec-17,81142,77628,3514,4.3
CN3608300000000,36,083,Rensselaer County, NY,Jan-18,82235,77922,4313,5.2
CN3608300000000,36,083,Rensselaer County, NY,Feb-18,81653,77246,4407,5.4
CN3608300000000,36,083,Rensselaer County, NY,Mar-18,81500,77497,4003,4.9
CN3608300000000,36,083,Rensselaer County, NY,Apr-18(p),81447,77926,3521,4.3
CN1330500000000,13,305,Wayne County, GA,Mar-17,11485,10805,680,5.9
CN1330500000000,13,305,Wayne County, GA,Apr-17,11437,10813,624,5.5
CN1330500000000,13,305,Wayne County, GA,May-17,11469,10843,626,5.5
CN1330500000000,13,305,Wayne County, GA,Jun-17,11424,10727,697,6.1
CN1330500000000,13,305,Wayne County, GA,Jul-17,11361,10668,693,6.1
CN1330500000000,13,305,Wayne County, GA,Aug-17,11318,10657,661,5.8
CN1330500000000,13,305,Wayne County, GA,Sep-17,11382,10749,633,5.6
CN1330500000000,13,305,Wayne County, GA,Oct-17,11241,10661,580,5.2
CN1330500000000,13,305,Wayne County, GA,Nov-17,11242,10678,564,5.0
CN1330500000000,13,305,Wayne County, GA,Dec-17,11280,10675,605,5.4
CN1330500000000,13,305,Wayne County, GA,Jan-18,11358,10728,630,5.5
CN1330500000000,13,305,Wayne County, GA,Feb-18,11315,10714,601,5.3
CN1330500000000,13,305,Wayne County, GA,Mar-18,11346,10792,554,4.9
CN1330500000000,13,305,Wayne County, GA,Apr-18(p),11308,10832,476,4.2
CN1703300000000,17,033,Crawford County, IL,Mar-17,8772,8285,487,5.6
CN1703300000000,17,033,Crawford County, IL,Apr-17,8845,8441,404,4.6
CN1703300000000,17,033,Crawford County, IL,May-17,8766,8381,385,4.4
CN1703300000000,17,033,Crawford County, IL,Jun-17,8979,8537,442,4.9
CN1703300000000,17,033,Crawford County, IL,Jul-17,8810,8363,447,5.1
CN1703300000000,17,033,Crawford County, IL,Aug-17,8742,8284,458,5.2
CN1703300000000,17,033,Crawford County, IL,Sep-17,8856,8436,420,4.7
CN1703300000000,17,033,Crawford County, IL,Oct-17,8602,8227,375,4.4
CN1703300000000,17,033,Crawford County, IL,Nov-17,8616,8231,385,4.5
CN1703300000000,17,033,Crawford County, IL,Dec-17,8621,8201,420,4.9
CN1703300000000,17,033,Crawford County, IL,Jan-18,8545,8083,462,5.4
CN1703300000000,17,033,Crawford County, IL,Feb-18,8582,8130,452,5.3
CN1703300000000,17,033,Crawford County, IL,Mar-18,8854,8408,446,5.0
CN1703300000000,17,033,Crawford County, IL,Apr-18(p),8802,8461,341,3.9
CN1904100000000,19,041,Clay County, IA,Mar-17,8535,8193,342,4.0
CN1904100000000,19,041,Clay County, IA,Apr-17,8532,8265,267,3.1
CN1904100000000,19,041,Clay County, IA,May-17,8663,8340,323,3.7
CN1904100000000,19,041,Clay County, IA,Jun-17,8865,8552,313,3.5
CN1904100000000,19,041,Clay County, IA,Jul-17,8726,8407,319,3.7
CN1904100000000,19,041,Clay County, IA,Aug-17,8569,8242,327,3.8
CN1904100000000,19,041,Clay County, IA,Sep-17,8618,8343,275,3.2
CN1904100000000,19,041,Clay County, IA,Oct-17,8519,8261,258,3.0
CN1904100000000,19,041,Clay County, IA,Nov-17,8468,8188,280,3.3
CN1904100000000,19,041,Clay County, IA,Dec-17,8603,8215,388,4.5
CN1904100000000,19,041,Clay County, IA,Jan-18,8447,8057,390,4.6
CN1904100000000,19,041,Clay County, IA,Feb-18,8447,8076,371,4.4
CN1904100000000,19,041,Clay County, IA,Mar-18,8400,8068,332,4.0
CN1904100000000,19,041,Clay County, IA,Apr-18(p),8359,8063,296,3.5
CN5410900000000,54,109,Wyoming County, WV,Mar-17,7033,6496,537,7.6
CN5410900000000,54,109,Wyoming County, WV,Apr-17,7013,6531,482,6.9
CN5410900000000,54,109,Wyoming County, WV,May-17,6976,6550,426,6.1
CN5410900000000,54,109,Wyoming County, WV,Jun-17,7099,6586,513,7.2
CN5410900000000,54,109,Wyoming County, WV,Jul-17,7120,6621,499,7.0
CN5410900000000,54,109,Wyoming County, WV,Aug-17,7048,6550,498,7.1
CN5410900000000,54,109,Wyoming County, WV,Sep-17,6998,6577,421,6.0
CN5410900000000,54,109,Wyoming County, WV,Oct-17,6912,6487,425,6.1
CN5410900000000,54,109,Wyoming County, WV,Nov-17,6866,6427,439,6.4
CN5410900000000,54,109,Wyoming County, WV,Dec-17,6731,6284,447,6.6
CN5410900000000,54,109,Wyoming County, WV,Jan-18,6847,6372,475,6.9
CN5410900000000,54,109,Wyoming County, WV,Feb-18,6933,6409,524,7.6
CN5410900000000,54,109,Wyoming County, WV,Mar-18,6819,6340,479,7.0
CN5410900000000,54,109,Wyoming County, WV,Apr-18(p),6834,6376,458,6.7
CN5302500000000,53,025,Grant County, WA,Mar-17,43677,40313,3364,7.7
CN5302500000000,53,025,Grant County, WA,Apr-17,44036,41442,2594,5.9
CN5302500000000,53,025,Grant County, WA,May-17,44561,42079,2482,5.6
CN5302500000000,53,025,Grant County, WA,Jun-17,47893,45555,2338,4.9
CN5302500000000,53,025,Grant County, WA,Jul-17,49835,47471,2364,4.7
CN5302500000000,53,025,Grant County, WA,Aug-17,47444,44980,2464,5.2
CN5302500000000,53,025,Grant County, WA,Sep-17,48449,46358,2091,4.3
CN5302500000000,53,025,Grant County, WA,Oct-17,47012,44923,2089,4.4
CN5302500000000,53,025,Grant County, WA,Nov-17,43885,41411,2474,5.6
CN5302500000000,53,025,Grant County, WA,Dec-17,42740,39262,3478,8.1
CN5302500000000,53,025,Grant County, WA,Jan-18,42021,38100,3921,9.3
CN5302500000000,53,025,Grant County, WA,Feb-18,42957,39131,3826,8.9
CN5302500000000,53,025,Grant County, WA,Mar-18,43645,40215,3430,7.9
CN5302500000000,53,025,Grant County, WA,Apr-18(p),44035,41198,2837,6.4
CN2016500000000,20,165,Rush County, KS,Mar-17,1657,1602,55,3.3
CN2016500000000,20,165,Rush County, KS,Apr-17,1592,1542,50,3.1
CN2016500000000,20,165,Rush County, KS,May-17,1589,1535,54,3.4
CN2016500000000,20,165,Rush County, KS,Jun-17,1629,1575,54,3.3
CN2016500000000,20,165,Rush County, KS,Jul-17,1686,1626,60,3.6
CN2016500000000,20,165,Rush County, KS,Aug-17,1654,1600,54,3.3
CN2016500000000,20,165,Rush County, KS,Sep-17,1633,1580,53,3.2
CN2016500000000,20,165,Rush County, KS,Oct-17,1650,1607,43,2.6
CN2016500000000,20,165,Rush County, KS,Nov-17,1613,1573,40,2.5
CN2016500000000,20,165,Rush County, KS,Dec-17,1620,1581,39,2.4
CN2016500000000,20,165,Rush County, KS,Jan-18,1585,1545,40,2.5
CN2016500000000,20,165,Rush County, KS,Feb-18,1582,1541,41,2.6
CN2016500000000,20,165,Rush County, KS,Mar-18,1610,1567,43,2.7
CN2016500000000,20,165,Rush County, KS,Apr-18(p),1551,1511,40,2.6
CN4609500000000,46,095,Mellette County, SD,Mar-17,753,722,31,4.1
CN4609500000000,46,095,Mellette County, SD,Apr-17,773,742,31,4.0
CN4609500000000,46,095,Mellette County, SD,May-17,784,754,30,3.8
CN4609500000000,46,095,Mellette County, SD,Jun-17,814,766,48,5.9
CN4609500000000,46,095,Mellette County, SD,Jul-17,788,737,51,6.5
CN4609500000000,46,095,Mellette County, SD,Aug-17,765,713,52,6.8
CN4609500000000,46,095,Mellette County, SD,Sep-17,747,713,34,4.6
CN4609500000000,46,095,Mellette County, SD,Oct-17,717,684,33,4.6
CN4609500000000,46,095,Mellette County, SD,Nov-17,719,679,40,5.6
CN4609500000000,46,095,Mellette County, SD,Dec-17,748,711,37,4.9
CN4609500000000,46,095,Mellette County, SD,Jan-18,754,714,40,5.3
CN4609500000000,46,095,Mellette County, SD,Feb-18,775,734,41,5.3
CN4609500000000,46,095,Mellette County, SD,Mar-18,791,750,41,5.2
CN4609500000000,46,095,Mellette County, SD,Apr-18(p),771,719,52,6.7
CN5113900000000,51,139,Page County, VA,Mar-17,11444,10744,700,6.1
CN5113900000000,51,139,Page County, VA,Apr-17,11649,11097,552,4.7
CN5113900000000,51,139,Page County, VA,May-17,11669,11136,533,4.6
CN5113900000000,51,139,Page County, VA,Jun-17,11921,11394,527,4.4
CN5113900000000,51,139,Page County, VA,Jul-17,11865,11335,530,4.5
CN5113900000000,51,139,Page County, VA,Aug-17,11604,11093,511,4.4
CN5113900000000,51,139,Page County, VA,Sep-17,11683,11198,485,4.2
CN5113900000000,51,139,Page County, VA,Oct-17,11649,11175,474,4.1
CN5113900000000,51,139,Page County, VA,Nov-17,11518,11015,503,4.4
CN5113900000000,51,139,Page County, VA,Dec-17,11608,10873,735,6.3
CN5113900000000,51,139,Page County, VA,Jan-18,11409,10624,785,6.9
CN5113900000000,51,139,Page County, VA,Feb-18,11368,10633,735,6.5
CN5113900000000,51,139,Page County, VA,Mar-18,11299,10694,605,5.4
CN5113900000000,51,139,Page County, VA,Apr-18(p),11556,11097,459,4.0
CN4508300000000,45,083,Spartanburg County, SC,Mar-17,145249,139879,5370,3.7
CN4508300000000,45,083,Spartanburg County, SC,Apr-17,145215,140301,4914,3.4
CN4508300000000,45,083,Spartanburg County, SC,May-17,145385,140217,5168,3.6
CN4508300000000,45,083,Spartanburg County, SC,Jun-17,147056,140698,6358,4.3
CN4508300000000,45,083,Spartanburg County, SC,Jul-17,147321,140137,7184,4.9
CN4508300000000,45,083,Spartanburg County, SC,Aug-17,147056,140414,6642,4.5
CN4508300000000,45,083,Spartanburg County, SC,Sep-17,147766,142064,5702,3.9
CN4508300000000,45,083,Spartanburg County, SC,Oct-17,147076,141455,5621,3.8
CN4508300000000,45,083,Spartanburg County, SC,Nov-17,146591,141221,5370,3.7
CN4508300000000,45,083,Spartanburg County, SC,Dec-17,146690,141177,5513,3.8
CN4508300000000,45,083,Spartanburg County, SC,Jan-18,146913,140224,6689,4.6
CN4508300000000,45,083,Spartanburg County, SC,Feb-18,148082,142045,6037,4.1
CN4508300000000,45,083,Spartanburg County, SC,Mar-18,147449,142041,5408,3.7
CN4508300000000,45,083,Spartanburg County, SC,Apr-18(p),146117,142477,3640,2.5
CN0808700000000,08,087,Morgan County, CO,Mar-17,15070,14694,376,2.5
CN0808700000000,08,087,Morgan County, CO,Apr-17,15562,15218,344,2.2
CN0808700000000,08,087,Morgan County, CO,May-17,15678,15348,330,2.1
CN0808700000000,08,087,Morgan County, CO,Jun-17,15738,15349,389,2.5
CN0808700000000,08,087,Morgan County, CO,Jul-17,15702,15314,388,2.5
CN0808700000000,08,087,Morgan County, CO,Aug-17,15582,15207,375,2.4
CN0808700000000,08,087,Morgan County, CO,Sep-17,15787,15412,375,2.4
CN0808700000000,08,087,Morgan County, CO,Oct-17,16487,16113,374,2.3
CN0808700000000,08,087,Morgan County, CO,Nov-17,16381,15994,387,2.4
CN0808700000000,08,087,Morgan County, CO,Dec-17,16156,15745,411,2.5
CN0808700000000,08,087,Morgan County, CO,Jan-18,16023,15562,461,2.9
CN0808700000000,08,087,Morgan County, CO,Feb-18,15812,15344,468,3.0
CN0808700000000,08,087,Morgan County, CO,Mar-18,15804,15393,411,2.6
CN0808700000000,08,087,Morgan County, CO,Apr-18(p),16174,15809,365,2.3
CN2606300000000,26,063,Huron County, MI,Mar-17,15721,14779,942,6.0
CN2606300000000,26,063,Huron County, MI,Apr-17,15624,14902,722,4.6
CN2606300000000,26,063,Huron County, MI,May-17,15797,15048,749,4.7
CN2606300000000,26,063,Huron County, MI,Jun-17,15915,15108,807,5.1
CN2606300000000,26,063,Huron County, MI,Jul-17,16184,15136,1048,6.5
CN2606300000000,26,063,Huron County, MI,Aug-17,15721,14877,844,5.4
CN2606300000000,26,063,Huron County, MI,Sep-17,15622,14967,655,4.2
CN2606300000000,26,063,Huron County, MI,Oct-17,15764,15166,598,3.8
CN2606300000000,26,063,Huron County, MI,Nov-17,15453,14806,647,4.2
CN2606300000000,26,063,Huron County, MI,Dec-17,15558,14769,789,5.1
CN2606300000000,26,063,Huron County, MI,Jan-18,15629,14594,1035,6.6
CN2606300000000,26,063,Huron County, MI,Feb-18,15816,14729,1087,6.9
CN2606300000000,26,063,Huron County, MI,Mar-18,15747,14724,1023,6.5
CN2606300000000,26,063,Huron County, MI,Apr-18(p),15701,14857,844,5.4
CN1903500000000,19,035,Cherokee County, IA,Mar-17,6031,5823,208,3.4
CN1903500000000,19,035,Cherokee County, IA,Apr-17,6096,5953,143,2.3
CN1903500000000,19,035,Cherokee County, IA,May-17,6104,5972,132,2.2
CN1903500000000,19,035,Cherokee County, IA,Jun-17,6211,6061,150,2.4
CN1903500000000,19,035,Cherokee County, IA,Jul-17,6159,6013,146,2.4
CN1903500000000,19,035,Cherokee County, IA,Aug-17,6094,5952,142,2.3
CN1903500000000,19,035,Cherokee County, IA,Sep-17,6108,5982,126,2.1
CN1903500000000,19,035,Cherokee County, IA,Oct-17,6096,5993,103,1.7
CN1903500000000,19,035,Cherokee County, IA,Nov-17,5997,5886,111,1.9
CN1903500000000,19,035,Cherokee County, IA,Dec-17,5991,5856,135,2.3
CN1903500000000,19,035,Cherokee County, IA,Jan-18,5932,5742,190,3.2
CN1903500000000,19,035,Cherokee County, IA,Feb-18,5987,5813,174,2.9
CN1903500000000,19,035,Cherokee County, IA,Mar-18,5895,5734,161,2.7
CN1903500000000,19,035,Cherokee County, IA,Apr-18(p),5893,5761,132,2.2
CN2951000000000,29,510,St. Louis city, MO,Mar-17,155150,147891,7259,4.7
CN2951000000000,29,510,St. Louis city, MO,Apr-17,155178,148597,6581,4.2
CN2951000000000,29,510,St. Louis city, MO,May-17,155958,149164,6794,4.4
CN2951000000000,29,510,St. Louis city, MO,Jun-17,157736,150454,7282,4.6
CN2951000000000,29,510,St. Louis city, MO,Jul-17,159299,151294,8005,5.0
CN2951000000000,29,510,St. Louis city, MO,Aug-17,157270,149125,8145,5.2
CN2951000000000,29,510,St. Louis city, MO,Sep-17,155863,149657,6206,4.0
CN2951000000000,29,510,St. Louis city, MO,Oct-17,154092,149026,5066,3.3
CN2951000000000,29,510,St. Louis city, MO,Nov-17,154553,148778,5775,3.7
CN2951000000000,29,510,St. Louis city, MO,Dec-17,154002,147936,6066,3.9
CN2951000000000,29,510,St. Louis city, MO,Jan-18,151906,145254,6652,4.4
CN2951000000000,29,510,St. Louis city, MO,Feb-18,154450,147550,6900,4.5
CN2951000000000,29,510,St. Louis city, MO,Mar-18,154775,147837,6938,4.5
CN2951000000000,29,510,St. Louis city, MO,Apr-18(p),155061,148882,6179,4.0
CN1720100000000,17,201,Winnebago County, IL,Mar-17,137193,125889,11304,8.2
CN1720100000000,17,201,Winnebago County, IL,Apr-17,139206,130162,9044,6.5
CN1720100000000,17,201,Winnebago County, IL,May-17,138181,130081,8100,5.9
CN1720100000000,17,201,Winnebago County, IL,Jun-17,139071,131429,7642,5.5
CN1720100000000,17,201,Winnebago County, IL,Jul-17,140235,132338,7897,5.6
CN1720100000000,17,201,Winnebago County, IL,Aug-17,138577,130715,7862,5.7
CN1720100000000,17,201,Winnebago County, IL,Sep-17,138066,131056,7010,5.1
CN1720100000000,17,201,Winnebago County, IL,Oct-17,137996,131427,6569,4.8
CN1720100000000,17,201,Winnebago County, IL,Nov-17,138465,131714,6751,4.9
CN1720100000000,17,201,Winnebago County, IL,Dec-17,138881,132186,6695,4.8
CN1720100000000,17,201,Winnebago County, IL,Jan-18,137363,130314,7049,5.1
CN1720100000000,17,201,Winnebago County, IL,Feb-18,138169,131559,6610,4.8
CN1720100000000,17,201,Winnebago County, IL,Mar-18,139665,132653,7012,5.0
CN1720100000000,17,201,Winnebago County, IL,Apr-18(p),139663,133846,5817,4.2
CN2716900000000,27,169,Winona County, MN,Mar-17,29101,28063,1038,3.6
CN2716900000000,27,169,Winona County, MN,Apr-17,29386,28518,868,3.0
CN2716900000000,27,169,Winona County, MN,May-17,29308,28428,880,3.0
CN2716900000000,27,169,Winona County, MN,Jun-17,29087,28058,1029,3.5
CN2716900000000,27,169,Winona County, MN,Jul-17,28810,27856,954,3.3
CN2716900000000,27,169,Winona County, MN,Aug-17,28806,27876,930,3.2
CN2716900000000,27,169,Winona County, MN,Sep-17,28984,28199,785,2.7
CN2716900000000,27,169,Winona County, MN,Oct-17,29044,28428,616,2.1
CN2716900000000,27,169,Winona County, MN,Nov-17,28980,28355,625,2.2
CN2716900000000,27,169,Winona County, MN,Dec-17,29023,28242,781,2.7
CN2716900000000,27,169,Winona County, MN,Jan-18,29072,28144,928,3.2
CN2716900000000,27,169,Winona County, MN,Feb-18,29375,28389,986,3.4
CN2716900000000,27,169,Winona County, MN,Mar-18,29271,28357,914,3.1
CN2716900000000,27,169,Winona County, MN,Apr-18(p),29598,28871,727,2.5
CN2805900000000,28,059,Jackson County, MS,Mar-17,58953,55466,3487,5.9
CN2805900000000,28,059,Jackson County, MS,Apr-17,58896,55746,3150,5.3
CN2805900000000,28,059,Jackson County, MS,May-17,59255,55700,3555,6.0
CN2805900000000,28,059,Jackson County, MS,Jun-17,60236,56313,3923,6.5
CN2805900000000,28,059,Jackson County, MS,Jul-17,60598,56733,3865,6.4
CN2805900000000,28,059,Jackson County, MS,Aug-17,58828,55578,3250,5.5
CN2805900000000,28,059,Jackson County, MS,Sep-17,58442,55253,3189,5.5
CN2805900000000,28,059,Jackson County, MS,Oct-17,58282,55273,3009,5.2
CN2805900000000,28,059,Jackson County, MS,Nov-17,58739,55787,2952,5.0
CN2805900000000,28,059,Jackson County, MS,Dec-17,58742,55650,3092,5.3
CN2805900000000,28,059,Jackson County, MS,Jan-18,58249,55157,3092,5.3
CN2805900000000,28,059,Jackson County, MS,Feb-18,58352,55324,3028,5.2
CN2805900000000,28,059,Jackson County, MS,Mar-18,58171,55247,2924,5.0
CN2805900000000,28,059,Jackson County, MS,Apr-18(p),58403,55594,2809,4.8
CN4603500000000,46,035,Davison County, SD,Mar-17,11006,10655,351,3.2
CN4603500000000,46,035,Davison County, SD,Apr-17,11038,10717,321,2.9
CN4603500000000,46,035,Davison County, SD,May-17,11077,10778,299,2.7
CN4603500000000,46,035,Davison County, SD,Jun-17,11248,10936,312,2.8
CN4603500000000,46,035,Davison County, SD,Jul-17,11269,10973,296,2.6
CN4603500000000,46,035,Davison County, SD,Aug-17,11141,10835,306,2.7
CN4603500000000,46,035,Davison County, SD,Sep-17,11088,10805,283,2.6
CN4603500000000,46,035,Davison County, SD,Oct-17,11169,10874,295,2.6
CN4603500000000,46,035,Davison County, SD,Nov-17,11168,10837,331,3.0
CN4603500000000,46,035,Davison County, SD,Dec-17,11082,10722,360,3.2
CN4603500000000,46,035,Davison County, SD,Jan-18,11026,10652,374,3.4
CN4603500000000,46,035,Davison County, SD,Feb-18,10954,10581,373,3.4
CN4603500000000,46,035,Davison County, SD,Mar-18,10995,10643,352,3.2
CN4603500000000,46,035,Davison County, SD,Apr-18(p),11044,10714,330,3.0
CN0107500000000,01,075,Lamar County, AL,Mar-17,5733,5455,278,4.8
CN0107500000000,01,075,Lamar County, AL,Apr-17,5728,5502,226,3.9
CN0107500000000,01,075,Lamar County, AL,May-17,5670,5459,211,3.7
CN0107500000000,01,075,Lamar County, AL,Jun-17,5712,5441,271,4.7
CN0107500000000,01,075,Lamar County, AL,Jul-17,5680,5426,254,4.5
CN0107500000000,01,075,Lamar County, AL,Aug-17,5655,5426,229,4.0
CN0107500000000,01,075,Lamar County, AL,Sep-17,5747,5549,198,3.4
CN0107500000000,01,075,Lamar County, AL,Oct-17,5732,5530,202,3.5
CN0107500000000,01,075,Lamar County, AL,Nov-17,5688,5495,193,3.4
CN0107500000000,01,075,Lamar County, AL,Dec-17,5645,5454,191,3.4
CN0107500000000,01,075,Lamar County, AL,Jan-18,5598,5374,224,4.0
CN0107500000000,01,075,Lamar County, AL,Feb-18,5699,5468,231,4.1
CN0107500000000,01,075,Lamar County, AL,Mar-18,5722,5510,212,3.7
CN0107500000000,01,075,Lamar County, AL,Apr-18(p),5726,5533,193,3.4
CN2003500000000,20,035,Cowley County, KS,Mar-17,16962,16295,667,3.9
CN2003500000000,20,035,Cowley County, KS,Apr-17,17146,16509,637,3.7
CN2003500000000,20,035,Cowley County, KS,May-17,17056,16402,654,3.8
CN2003500000000,20,035,Cowley County, KS,Jun-17,17073,16343,730,4.3
CN2003500000000,20,035,Cowley County, KS,Jul-17,16840,16064,776,4.6
CN2003500000000,20,035,Cowley County, KS,Aug-17,16914,16210,704,4.2
CN2003500000000,20,035,Cowley County, KS,Sep-17,16981,16393,588,3.5
CN2003500000000,20,035,Cowley County, KS,Oct-17,17034,16527,507,3.0
CN2003500000000,20,035,Cowley County, KS,Nov-17,16866,16321,545,3.2
CN2003500000000,20,035,Cowley County, KS,Dec-17,16731,16223,508,3.0
CN2003500000000,20,035,Cowley County, KS,Jan-18,16747,16204,543,3.2
CN2003500000000,20,035,Cowley County, KS,Feb-18,16955,16379,576,3.4
CN2003500000000,20,035,Cowley County, KS,Mar-18,17042,16474,568,3.3
CN2003500000000,20,035,Cowley County, KS,Apr-18(p),17112,16561,551,3.2
CN3711100000000,37,111,McDowell County, NC,Mar-17,21077,20202,875,4.2
CN3711100000000,37,111,McDowell County, NC,Apr-17,21059,20274,785,3.7
CN3711100000000,37,111,McDowell County, NC,May-17,21005,20186,819,3.9
CN3711100000000,37,111,McDowell County, NC,Jun-17,20974,20105,869,4.1
CN3711100000000,37,111,McDowell County, NC,Jul-17,21113,20196,917,4.3
CN3711100000000,37,111,McDowell County, NC,Aug-17,20963,20055,908,4.3
CN3711100000000,37,111,McDowell County, NC,Sep-17,21339,20534,805,3.8
CN3711100000000,37,111,McDowell County, NC,Oct-17,20870,20072,798,3.8
CN3711100000000,37,111,McDowell County, NC,Nov-17,20763,19936,827,4.0
CN3711100000000,37,111,McDowell County, NC,Dec-17,20605,19793,812,3.9
CN3711100000000,37,111,McDowell County, NC,Jan-18,20658,19817,841,4.1
CN3711100000000,37,111,McDowell County, NC,Feb-18,20955,20096,859,4.1
CN3711100000000,37,111,McDowell County, NC,Mar-18,21095,20277,818,3.9
CN3711100000000,37,111,McDowell County, NC,Apr-18(p),21161,20461,700,3.3
CN2710900000000,27,109,Olmsted County, MN,Mar-17,85495,82851,2644,3.1
CN2710900000000,27,109,Olmsted County, MN,Apr-17,85622,83348,2274,2.7
CN2710900000000,27,109,Olmsted County, MN,May-17,86126,83922,2204,2.6
CN2710900000000,27,109,Olmsted County, MN,Jun-17,87722,85252,2470,2.8
CN2710900000000,27,109,Olmsted County, MN,Jul-17,88535,86199,2336,2.6
CN2710900000000,27,109,Olmsted County, MN,Aug-17,88216,85926,2290,2.6
CN2710900000000,27,109,Olmsted County, MN,Sep-17,86690,84703,1987,2.3
CN2710900000000,27,109,Olmsted County, MN,Oct-17,86083,84365,1718,2.0
CN2710900000000,27,109,Olmsted County, MN,Nov-17,86113,84236,1877,2.2
CN2710900000000,27,109,Olmsted County, MN,Dec-17,86141,83878,2263,2.6
CN2710900000000,27,109,Olmsted County, MN,Jan-18,86308,83600,2708,3.1
CN2710900000000,27,109,Olmsted County, MN,Feb-18,86658,83970,2688,3.1
CN2710900000000,27,109,Olmsted County, MN,Mar-18,86719,84124,2595,3.0
CN2710900000000,27,109,Olmsted County, MN,Apr-18(p),86126,83996,2130,2.5
CN0101500000000,01,015,Calhoun County, AL,Mar-17,46217,43670,2547,5.5
CN0101500000000,01,015,Calhoun County, AL,Apr-17,45804,43678,2126,4.6
CN0101500000000,01,015,Calhoun County, AL,May-17,45431,43374,2057,4.5
CN0101500000000,01,015,Calhoun County, AL,Jun-17,45736,43231,2505,5.5
CN0101500000000,01,015,Calhoun County, AL,Jul-17,45684,43349,2335,5.1
CN0101500000000,01,015,Calhoun County, AL,Aug-17,45386,43183,2203,4.9
CN0101500000000,01,015,Calhoun County, AL,Sep-17,45006,43126,1880,4.2
CN0101500000000,01,015,Calhoun County, AL,Oct-17,45383,43516,1867,4.1
CN0101500000000,01,015,Calhoun County, AL,Nov-17,45351,43587,1764,3.9
CN0101500000000,01,015,Calhoun County, AL,Dec-17,45160,43425,1735,3.8
CN0101500000000,01,015,Calhoun County, AL,Jan-18,45094,42983,2111,4.7
CN0101500000000,01,015,Calhoun County, AL,Feb-18,45700,43432,2268,5.0
CN0101500000000,01,015,Calhoun County, AL,Mar-18,45998,43919,2079,4.5
CN0101500000000,01,015,Calhoun County, AL,Apr-18(p),46217,44284,1933,4.2
CN3800100000000,38,001,Adams County, ND,Mar-17,1103,1069,34,3.1
CN3800100000000,38,001,Adams County, ND,Apr-17,1108,1078,30,2.7
CN3800100000000,38,001,Adams County, ND,May-17,1094,1073,21,1.9
CN3800100000000,38,001,Adams County, ND,Jun-17,1179,1148,31,2.6
CN3800100000000,38,001,Adams County, ND,Jul-17,1164,1141,23,2.0
CN3800100000000,38,001,Adams County, ND,Aug-17,1165,1142,23,2.0
CN3800100000000,38,001,Adams County, ND,Sep-17,1139,1116,23,2.0
CN3800100000000,38,001,Adams County, ND,Oct-17,1140,1119,21,1.8
CN3800100000000,38,001,Adams County, ND,Nov-17,1100,1077,23,2.1
CN3800100000000,38,001,Adams County, ND,Dec-17,1097,1067,30,2.7
CN3800100000000,38,001,Adams County, ND,Jan-18,1097,1061,36,3.3
CN3800100000000,38,001,Adams County, ND,Feb-18,1076,1049,27,2.5
CN3800100000000,38,001,Adams County, ND,Mar-18,1085,1060,25,2.3
CN3800100000000,38,001,Adams County, ND,Apr-18(p),1086,1064,22,2.0
CN2121700000000,21,217,Taylor County, KY,Mar-17,12179,11514,665,5.5
CN2121700000000,21,217,Taylor County, KY,Apr-17,12181,11620,561,4.6
CN2121700000000,21,217,Taylor County, KY,May-17,12142,11572,570,4.7
CN2121700000000,21,217,Taylor County, KY,Jun-17,12166,11504,662,5.4
CN2121700000000,21,217,Taylor County, KY,Jul-17,12036,11396,640,5.3
CN2121700000000,21,217,Taylor County, KY,Aug-17,12169,11630,539,4.4
CN2121700000000,21,217,Taylor County, KY,Sep-17,12217,11741,476,3.9
CN2121700000000,21,217,Taylor County, KY,Oct-17,12181,11754,427,3.5
CN2121700000000,21,217,Taylor County, KY,Nov-17,12542,12108,434,3.5
CN2121700000000,21,217,Taylor County, KY,Dec-17,12749,12326,423,3.3
CN2121700000000,21,217,Taylor County, KY,Jan-18,12176,11696,480,3.9
CN2121700000000,21,217,Taylor County, KY,Feb-18,12708,12154,554,4.4
CN2121700000000,21,217,Taylor County, KY,Mar-18,12870,12326,544,4.2
CN2121700000000,21,217,Taylor County, KY,Apr-18(p),12889,12424,465,3.6
CN3806100000000,38,061,Mountrail County, ND,Mar-17,7079,6911,168,2.4
CN3806100000000,38,061,Mountrail County, ND,Apr-17,6964,6818,146,2.1
CN3806100000000,38,061,Mountrail County, ND,May-17,7122,7001,121,1.7
CN3806100000000,38,061,Mountrail County, ND,Jun-17,7372,7215,157,2.1
CN3806100000000,38,061,Mountrail County, ND,Jul-17,7294,7155,139,1.9
CN3806100000000,38,061,Mountrail County, ND,Aug-17,7185,7056,129,1.8
CN3806100000000,38,061,Mountrail County, ND,Sep-17,7060,6947,113,1.6
CN3806100000000,38,061,Mountrail County, ND,Oct-17,7029,6912,117,1.7
CN3806100000000,38,061,Mountrail County, ND,Nov-17,6908,6777,131,1.9
CN3806100000000,38,061,Mountrail County, ND,Dec-17,6962,6839,123,1.8
CN3806100000000,38,061,Mountrail County, ND,Jan-18,6924,6777,147,2.1
CN3806100000000,38,061,Mountrail County, ND,Feb-18,6874,6727,147,2.1
CN3806100000000,38,061,Mountrail County, ND,Mar-18,6809,6669,140,2.1
CN3806100000000,38,061,Mountrail County, ND,Apr-18(p),6630,6512,118,1.8
CN3717100000000,37,171,Surry County, NC,Mar-17,33754,32301,1453,4.3
CN3717100000000,37,171,Surry County, NC,Apr-17,33749,32478,1271,3.8
CN3717100000000,37,171,Surry County, NC,May-17,33738,32404,1334,4.0
CN3717100000000,37,171,Surry County, NC,Jun-17,33760,32324,1436,4.3
CN3717100000000,37,171,Surry County, NC,Jul-17,33857,32348,1509,4.5
CN3717100000000,37,171,Surry County, NC,Aug-17,33289,31757,1532,4.6
CN3717100000000,37,171,Surry County, NC,Sep-17,33853,32510,1343,4.0
CN3717100000000,37,171,Surry County, NC,Oct-17,33948,32612,1336,3.9
CN3717100000000,37,171,Surry County, NC,Nov-17,33820,32422,1398,4.1
CN3717100000000,37,171,Surry County, NC,Dec-17,33577,32217,1360,4.1
CN3717100000000,37,171,Surry County, NC,Jan-18,33613,32168,1445,4.3
CN3717100000000,37,171,Surry County, NC,Feb-18,33486,32072,1414,4.2
CN3717100000000,37,171,Surry County, NC,Mar-18,33596,32222,1374,4.1
CN3717100000000,37,171,Surry County, NC,Apr-18(p),33561,32409,1152,3.4
CN0601700000000,06,017,El Dorado County, CA,Mar-17,89835,85418,4417,4.9
CN0601700000000,06,017,El Dorado County, CA,Apr-17,89251,85300,3951,4.4
CN0601700000000,06,017,El Dorado County, CA,May-17,89133,85478,3655,4.1
CN0601700000000,06,017,El Dorado County, CA,Jun-17,89588,85608,3980,4.4
CN0601700000000,06,017,El Dorado County, CA,Jul-17,90583,86444,4139,4.6
CN0601700000000,06,017,El Dorado County, CA,Aug-17,90288,86315,3973,4.4
CN0601700000000,06,017,El Dorado County, CA,Sep-17,90500,87048,3452,3.8
CN0601700000000,06,017,El Dorado County, CA,Oct-17,90112,86762,3350,3.7
CN0601700000000,06,017,El Dorado County, CA,Nov-17,90289,86974,3315,3.7
CN0601700000000,06,017,El Dorado County, CA,Dec-17,90023,86725,3298,3.7
CN0601700000000,06,017,El Dorado County, CA,Jan-18,90605,86963,3642,4.0
CN0601700000000,06,017,El Dorado County, CA,Feb-18,90862,87232,3630,4.0
CN0601700000000,06,017,El Dorado County, CA,Mar-18,90253,86808,3445,3.8
CN0601700000000,06,017,El Dorado County, CA,Apr-18(p),89390,86376,3014,3.4
CN3612100000000,36,121,Wyoming County, NY,Mar-17,18133,16842,1291,7.1
CN3612100000000,36,121,Wyoming County, NY,Apr-17,18049,17027,1022,5.7
CN3612100000000,36,121,Wyoming County, NY,May-17,17749,16917,832,4.7
CN3612100000000,36,121,Wyoming County, NY,Jun-17,18261,17441,820,4.5
CN3612100000000,36,121,Wyoming County, NY,Jul-17,18347,17467,880,4.8
CN3612100000000,36,121,Wyoming County, NY,Aug-17,18200,17326,874,4.8
CN3612100000000,36,121,Wyoming County, NY,Sep-17,17935,17118,817,4.6
CN3612100000000,36,121,Wyoming County, NY,Oct-17,17757,16950,807,4.5
CN3612100000000,36,121,Wyoming County, NY,Nov-17,18183,17169,1014,5.6
CN3612100000000,36,121,Wyoming County, NY,Dec-17,18004,16896,1108,6.2
CN3612100000000,36,121,Wyoming County, NY,Jan-18,18504,17098,1406,7.6
CN3612100000000,36,121,Wyoming County, NY,Feb-18,18193,16777,1416,7.8
CN3612100000000,36,121,Wyoming County, NY,Mar-18,17685,16413,1272,7.2
CN3612100000000,36,121,Wyoming County, NY,Apr-18(p),17638,16657,981,5.6
CN1814500000000,18,145,Shelby County, IN,Mar-17,22867,22077,790,3.5
CN1814500000000,18,145,Shelby County, IN,Apr-17,23005,22345,660,2.9
CN1814500000000,18,145,Shelby County, IN,May-17,23188,22473,715,3.1
CN1814500000000,18,145,Shelby County, IN,Jun-17,23385,22649,736,3.1
CN1814500000000,18,145,Shelby County, IN,Jul-17,23386,22611,775,3.3
CN1814500000000,18,145,Shelby County, IN,Aug-17,23215,22347,868,3.7
CN1814500000000,18,145,Shelby County, IN,Sep-17,23045,22314,731,3.2
CN1814500000000,18,145,Shelby County, IN,Oct-17,22904,22233,671,2.9
CN1814500000000,18,145,Shelby County, IN,Nov-17,22955,22289,666,2.9
CN1814500000000,18,145,Shelby County, IN,Dec-17,22733,22106,627,2.8
CN1814500000000,18,145,Shelby County, IN,Jan-18,22761,22009,752,3.3
CN1814500000000,18,145,Shelby County, IN,Feb-18,23085,22293,792,3.4
CN1814500000000,18,145,Shelby County, IN,Mar-18,23306,22605,701,3.0
CN1814500000000,18,145,Shelby County, IN,Apr-18(p),23339,22721,618,2.6
CN3701100000000,37,011,Avery County, NC,Mar-17,7404,7044,360,4.9
CN3701100000000,37,011,Avery County, NC,Apr-17,7482,7172,310,4.1
CN3701100000000,37,011,Avery County, NC,May-17,7827,7511,316,4.0
CN3701100000000,37,011,Avery County, NC,Jun-17,8027,7695,332,4.1
CN3701100000000,37,011,Avery County, NC,Jul-17,8157,7815,342,4.2
CN3701100000000,37,011,Avery County, NC,Aug-17,7940,7601,339,4.3
CN3701100000000,37,011,Avery County, NC,Sep-17,7937,7634,303,3.8
CN3701100000000,37,011,Avery County, NC,Oct-17,7883,7590,293,3.7
CN3701100000000,37,011,Avery County, NC,Nov-17,7539,7227,312,4.1
CN3701100000000,37,011,Avery County, NC,Dec-17,7410,7102,308,4.2
CN3701100000000,37,011,Avery County, NC,Jan-18,7495,7139,356,4.7
CN3701100000000,37,011,Avery County, NC,Feb-18,7540,7178,362,4.8
CN3701100000000,37,011,Avery County, NC,Mar-18,7387,7049,338,4.6
CN3701100000000,37,011,Avery County, NC,Apr-18(p),7428,7156,272,3.7
CN4613500000000,46,135,Yankton County, SD,Mar-17,11459,11083,376,3.3
CN4613500000000,46,135,Yankton County, SD,Apr-17,11543,11197,346,3.0
CN4613500000000,46,135,Yankton County, SD,May-17,11590,11261,329,2.8
CN4613500000000,46,135,Yankton County, SD,Jun-17,11720,11395,325,2.8
CN4613500000000,46,135,Yankton County, SD,Jul-17,11721,11412,309,2.6
CN4613500000000,46,135,Yankton County, SD,Aug-17,11594,11256,338,2.9
CN4613500000000,46,135,Yankton County, SD,Sep-17,11450,11133,317,2.8
CN4613500000000,46,135,Yankton County, SD,Oct-17,11548,11237,311,2.7
CN4613500000000,46,135,Yankton County, SD,Nov-17,11579,11242,337,2.9
CN4613500000000,46,135,Yankton County, SD,Dec-17,11467,11117,350,3.1
CN4613500000000,46,135,Yankton County, SD,Jan-18,11502,11109,393,3.4
CN4613500000000,46,135,Yankton County, SD,Feb-18,11648,11235,413,3.5
CN4613500000000,46,135,Yankton County, SD,Mar-18,11631,11263,368,3.2
CN4613500000000,46,135,Yankton County, SD,Apr-18(p),11763,11398,365,3.1
CN4702500000000,47,025,Claiborne County, TN,Mar-17,12869,12176,693,5.4
CN4702500000000,47,025,Claiborne County, TN,Apr-17,12776,12220,556,4.4
CN4702500000000,47,025,Claiborne County, TN,May-17,12780,12271,509,4.0
CN4702500000000,47,025,Claiborne County, TN,Jun-17,12842,12169,673,5.2
CN4702500000000,47,025,Claiborne County, TN,Jul-17,12807,12172,635,5.0
CN4702500000000,47,025,Claiborne County, TN,Aug-17,12665,12097,568,4.5
CN4702500000000,47,025,Claiborne County, TN,Sep-17,12724,12221,503,4.0
CN4702500000000,47,025,Claiborne County, TN,Oct-17,12655,12180,475,3.8
CN4702500000000,47,025,Claiborne County, TN,Nov-17,12595,12098,497,3.9
CN4702500000000,47,025,Claiborne County, TN,Dec-17,12623,12131,492,3.9
CN4702500000000,47,025,Claiborne County, TN,Jan-18,12597,12008,589,4.7
CN4702500000000,47,025,Claiborne County, TN,Feb-18,12806,12212,594,4.6
CN4702500000000,47,025,Claiborne County, TN,Mar-18,12844,12277,567,4.4
CN4702500000000,47,025,Claiborne County, TN,Apr-18(p),12831,12374,457,3.6
CN3708900000000,37,089,Henderson County, NC,Mar-17,53088,51062,2026,3.8
CN3708900000000,37,089,Henderson County, NC,Apr-17,52914,51137,1777,3.4
CN3708900000000,37,089,Henderson County, NC,May-17,53145,51219,1926,3.6
CN3708900000000,37,089,Henderson County, NC,Jun-17,53156,51120,2036,3.8
CN3708900000000,37,089,Henderson County, NC,Jul-17,53819,51630,2189,4.1
CN3708900000000,37,089,Henderson County, NC,Aug-17,53108,50888,2220,4.2
CN3708900000000,37,089,Henderson County, NC,Sep-17,53954,51985,1969,3.6
CN3708900000000,37,089,Henderson County, NC,Oct-17,53873,51921,1952,3.6
CN3708900000000,37,089,Henderson County, NC,Nov-17,53815,51750,2065,3.8
CN3708900000000,37,089,Henderson County, NC,Dec-17,53389,51404,1985,3.7
CN3708900000000,37,089,Henderson County, NC,Jan-18,53461,51393,2068,3.9
CN3708900000000,37,089,Henderson County, NC,Feb-18,53767,51751,2016,3.7
CN3708900000000,37,089,Henderson County, NC,Mar-18,53787,51835,1952,3.6
CN3708900000000,37,089,Henderson County, NC,Apr-18(p),53859,52197,1662,3.1
CN4602900000000,46,029,Codington County, SD,Mar-17,15116,14487,629,4.2
CN4602900000000,46,029,Codington County, SD,Apr-17,15107,14613,494,3.3
CN4602900000000,46,029,Codington County, SD,May-17,15164,14685,479,3.2
CN4602900000000,46,029,Codington County, SD,Jun-17,15386,14916,470,3.1
CN4602900000000,46,029,Codington County, SD,Jul-17,15388,14948,440,2.9
CN4602900000000,46,029,Codington County, SD,Aug-17,15289,14830,459,3.0
CN4602900000000,46,029,Codington County, SD,Sep-17,15177,14745,432,2.8
CN4602900000000,46,029,Codington County, SD,Oct-17,15192,14783,409,2.7
CN4602900000000,46,029,Codington County, SD,Nov-17,15238,14755,483,3.2
CN4602900000000,46,029,Codington County, SD,Dec-17,15139,14589,550,3.6
CN4602900000000,46,029,Codington County, SD,Jan-18,15185,14535,650,4.3
CN4602900000000,46,029,Codington County, SD,Feb-18,15157,14519,638,4.2
CN4602900000000,46,029,Codington County, SD,Mar-18,15156,14572,584,3.9
CN4602900000000,46,029,Codington County, SD,Apr-18(p),15209,14644,565,3.7
CN4826700000000,48,267,Kimble County, TX,Mar-17,1946,1873,73,3.8
CN4826700000000,48,267,Kimble County, TX,Apr-17,1903,1839,64,3.4
CN4826700000000,48,267,Kimble County, TX,May-17,1922,1853,69,3.6
CN4826700000000,48,267,Kimble County, TX,Jun-17,1941,1870,71,3.7
CN4826700000000,48,267,Kimble County, TX,Jul-17,1893,1821,72,3.8
CN4826700000000,48,267,Kimble County, TX,Aug-17,1907,1837,70,3.7
CN4826700000000,48,267,Kimble County, TX,Sep-17,1866,1799,67,3.6
CN4826700000000,48,267,Kimble County, TX,Oct-17,1925,1866,59,3.1
CN4826700000000,48,267,Kimble County, TX,Nov-17,1886,1825,61,3.2
CN4826700000000,48,267,Kimble County, TX,Dec-17,1901,1847,54,2.8
CN4826700000000,48,267,Kimble County, TX,Jan-18,1820,1761,59,3.2
CN4826700000000,48,267,Kimble County, TX,Feb-18,1838,1776,62,3.4
CN4826700000000,48,267,Kimble County, TX,Mar-18,1928,1866,62,3.2
CN4826700000000,48,267,Kimble County, TX,Apr-18(p),1876,1825,51,2.7
CN4837300000000,48,373,Polk County, TX,Mar-17,17797,16653,1144,6.4
CN4837300000000,48,373,Polk County, TX,Apr-17,17430,16379,1051,6.0
CN4837300000000,48,373,Polk County, TX,May-17,17379,16398,981,5.6
CN4837300000000,48,373,Polk County, TX,Jun-17,17478,16420,1058,6.1
CN4837300000000,48,373,Polk County, TX,Jul-17,17381,16329,1052,6.1
CN4837300000000,48,373,Polk County, TX,Aug-17,17248,16190,1058,6.1
CN4837300000000,48,373,Polk County, TX,Sep-17,17295,16315,980,5.7
CN4837300000000,48,373,Polk County, TX,Oct-17,17241,16345,896,5.2
CN4837300000000,48,373,Polk County, TX,Nov-17,17330,16413,917,5.3
CN4837300000000,48,373,Polk County, TX,Dec-17,17352,16445,907,5.2
CN4837300000000,48,373,Polk County, TX,Jan-18,17417,16366,1051,6.0
CN4837300000000,48,373,Polk County, TX,Feb-18,17671,16657,1014,5.7
CN4837300000000,48,373,Polk County, TX,Mar-18,17812,16821,991,5.6
CN4837300000000,48,373,Polk County, TX,Apr-18(p),17466,16590,876,5.0
CN4013700000000,40,137,Stephens County, OK,Mar-17,18302,17070,1232,6.7
CN4013700000000,40,137,Stephens County, OK,Apr-17,18198,17068,1130,6.2
CN4013700000000,40,137,Stephens County, OK,May-17,18318,17143,1175,6.4
CN4013700000000,40,137,Stephens County, OK,Jun-17,18569,17402,1167,6.3
CN4013700000000,40,137,Stephens County, OK,Jul-17,17750,16664,1086,6.1
CN4013700000000,40,137,Stephens County, OK,Aug-17,17927,16839,1088,6.1
CN4013700000000,40,137,Stephens County, OK,Sep-17,18370,17374,996,5.4
CN4013700000000,40,137,Stephens County, OK,Oct-17,18416,17424,992,5.4
CN4013700000000,40,137,Stephens County, OK,Nov-17,18426,17482,944,5.1
CN4013700000000,40,137,Stephens County, OK,Dec-17,18323,17378,945,5.2
CN4013700000000,40,137,Stephens County, OK,Jan-18,18290,17329,961,5.3
CN4013700000000,40,137,Stephens County, OK,Feb-18,18248,17369,879,4.8
CN4013700000000,40,137,Stephens County, OK,Mar-18,18293,17442,851,4.7
CN4013700000000,40,137,Stephens County, OK,Apr-18(p),17994,17166,828,4.6
CN4503900000000,45,039,Fairfield County, SC,Mar-17,9860,9328,532,5.4
CN4503900000000,45,039,Fairfield County, SC,Apr-17,9869,9365,504,5.1
CN4503900000000,45,039,Fairfield County, SC,May-17,9880,9365,515,5.2
CN4503900000000,45,039,Fairfield County, SC,Jun-17,10000,9405,595,6.0
CN4503900000000,45,039,Fairfield County, SC,Jul-17,10065,9436,629,6.2
CN4503900000000,45,039,Fairfield County, SC,Aug-17,10221,9254,967,9.5
CN4503900000000,45,039,Fairfield County, SC,Sep-17,10171,9268,903,8.9
CN4503900000000,45,039,Fairfield County, SC,Oct-17,10303,9260,1043,10.1
CN4503900000000,45,039,Fairfield County, SC,Nov-17,10145,9208,937,9.2
CN4503900000000,45,039,Fairfield County, SC,Dec-17,10157,9210,947,9.3
CN4503900000000,45,039,Fairfield County, SC,Jan-18,10196,9171,1025,10.1
CN4503900000000,45,039,Fairfield County, SC,Feb-18,10235,9268,967,9.4
CN4503900000000,45,039,Fairfield County, SC,Mar-18,10073,9271,802,8.0
CN4503900000000,45,039,Fairfield County, SC,Apr-18(p),9861,9279,582,5.9
CN1914100000000,19,141,O'Brien County, IA,Mar-17,7967,7736,231,2.9
CN1914100000000,19,141,O'Brien County, IA,Apr-17,8082,7899,183,2.3
CN1914100000000,19,141,O'Brien County, IA,May-17,8088,7907,181,2.2
CN1914100000000,19,141,O'Brien County, IA,Jun-17,8224,8031,193,2.3
CN1914100000000,19,141,O'Brien County, IA,Jul-17,8160,7976,184,2.3
CN1914100000000,19,141,O'Brien County, IA,Aug-17,8074,7880,194,2.4
CN1914100000000,19,141,O'Brien County, IA,Sep-17,7953,7794,159,2.0
CN1914100000000,19,141,O'Brien County, IA,Oct-17,8012,7878,134,1.7
CN1914100000000,19,141,O'Brien County, IA,Nov-17,7924,7783,141,1.8
CN1914100000000,19,141,O'Brien County, IA,Dec-17,7963,7770,193,2.4
CN1914100000000,19,141,O'Brien County, IA,Jan-18,7891,7654,237,3.0
CN1914100000000,19,141,O'Brien County, IA,Feb-18,7931,7696,235,3.0
CN1914100000000,19,141,O'Brien County, IA,Mar-18,7871,7656,215,2.7
CN1914100000000,19,141,O'Brien County, IA,Apr-18(p),7950,7758,192,2.4
CN4703100000000,47,031,Coffee County, TN,Mar-17,24838,23838,1000,4.0
CN4703100000000,47,031,Coffee County, TN,Apr-17,24783,23948,835,3.4
CN4703100000000,47,031,Coffee County, TN,May-17,24913,24062,851,3.4
CN4703100000000,47,031,Coffee County, TN,Jun-17,25231,24232,999,4.0
CN4703100000000,47,031,Coffee County, TN,Jul-17,25334,24361,973,3.8
CN4703100000000,47,031,Coffee County, TN,Aug-17,25192,24298,894,3.5
CN4703100000000,47,031,Coffee County, TN,Sep-17,25292,24486,806,3.2
CN4703100000000,47,031,Coffee County, TN,Oct-17,25112,24340,772,3.1
CN4703100000000,47,031,Coffee County, TN,Nov-17,25046,24272,774,3.1
CN4703100000000,47,031,Coffee County, TN,Dec-17,25041,24282,759,3.0
CN4703100000000,47,031,Coffee County, TN,Jan-18,25191,24292,899,3.6
CN4703100000000,47,031,Coffee County, TN,Feb-18,25336,24440,896,3.5
CN4703100000000,47,031,Coffee County, TN,Mar-18,25343,24469,874,3.4
CN4703100000000,47,031,Coffee County, TN,Apr-18(p),25518,24784,734,2.9
CN0602300000000,06,023,Humboldt County, CA,Mar-17,63310,60386,2924,4.6
CN0602300000000,06,023,Humboldt County, CA,Apr-17,63262,60616,2646,4.2
CN0602300000000,06,023,Humboldt County, CA,May-17,63297,60924,2373,3.7
CN0602300000000,06,023,Humboldt County, CA,Jun-17,63163,60414,2749,4.4
CN0602300000000,06,023,Humboldt County, CA,Jul-17,62172,59252,2920,4.7
CN0602300000000,06,023,Humboldt County, CA,Aug-17,62402,59589,2813,4.5
CN0602300000000,06,023,Humboldt County, CA,Sep-17,63676,61395,2281,3.6
CN0602300000000,06,023,Humboldt County, CA,Oct-17,63531,61299,2232,3.5
CN0602300000000,06,023,Humboldt County, CA,Nov-17,63144,60925,2219,3.5
CN0602300000000,06,023,Humboldt County, CA,Dec-17,62661,60459,2202,3.5
CN0602300000000,06,023,Humboldt County, CA,Jan-18,62557,60014,2543,4.1
CN0602300000000,06,023,Humboldt County, CA,Feb-18,63566,61068,2498,3.9
CN0602300000000,06,023,Humboldt County, CA,Mar-18,63134,60788,2346,3.7
CN0602300000000,06,023,Humboldt County, CA,Apr-18(p),63052,60960,2092,3.3
CN5102300000000,51,023,Botetourt County, VA,Mar-17,17403,16756,647,3.7
CN5102300000000,51,023,Botetourt County, VA,Apr-17,17388,16824,564,3.2
CN5102300000000,51,023,Botetourt County, VA,May-17,17428,16804,624,3.6
CN5102300000000,51,023,Botetourt County, VA,Jun-17,17400,16741,659,3.8
CN5102300000000,51,023,Botetourt County, VA,Jul-17,17482,16816,666,3.8
CN5102300000000,51,023,Botetourt County, VA,Aug-17,17342,16659,683,3.9
CN5102300000000,51,023,Botetourt County, VA,Sep-17,17427,16831,596,3.4
CN5102300000000,51,023,Botetourt County, VA,Oct-17,17295,16739,556,3.2
CN5102300000000,51,023,Botetourt County, VA,Nov-17,17192,16642,550,3.2
CN5102300000000,51,023,Botetourt County, VA,Dec-17,17120,16587,533,3.1
CN5102300000000,51,023,Botetourt County, VA,Jan-18,17095,16510,585,3.4
CN5102300000000,51,023,Botetourt County, VA,Feb-18,17260,16729,531,3.1
CN5102300000000,51,023,Botetourt County, VA,Mar-18,17336,16817,519,3.0
CN5102300000000,51,023,Botetourt County, VA,Apr-18(p),17400,16963,437,2.5
CN7206900000000,72,069,Humacao Municipio, PR,Mar-17,17813,15235,2578,14.5
CN7206900000000,72,069,Humacao Municipio, PR,Apr-17,17825,15113,2712,15.2
CN7206900000000,72,069,Humacao Municipio, PR,May-17,17447,15009,2438,14.0
CN7206900000000,72,069,Humacao Municipio, PR,Jun-17,17051,14924,2127,12.5
CN7206900000000,72,069,Humacao Municipio, PR,Jul-17,17218,14864,2354,13.7
CN7206900000000,72,069,Humacao Municipio, PR,Aug-17,17273,14678,2595,15.0
CN7206900000000,72,069,Humacao Municipio, PR,Sep-17(y),17115,14860,2255,13.2
CN7206900000000,72,069,Humacao Municipio, PR,Oct-17,16642,14228,2414,14.5
CN7206900000000,72,069,Humacao Municipio, PR,Nov-17,17321,15129,2192,12.7
CN7206900000000,72,069,Humacao Municipio, PR,Dec-17,17390,15270,2120,12.2
CN7206900000000,72,069,Humacao Municipio, PR,Jan-18,17380,14963,2417,13.9
CN7206900000000,72,069,Humacao Municipio, PR,Feb-18,17228,14983,2245,13.0
CN7206900000000,72,069,Humacao Municipio, PR,Mar-18,17233,15003,2230,12.9
CN7206900000000,72,069,Humacao Municipio, PR,Apr-18(p),17236,15143,2093,12.1
CN2020300000000,20,203,Wichita County, KS,Mar-17,1133,1104,29,2.6
CN2020300000000,20,203,Wichita County, KS,Apr-17,1109,1079,30,2.7
CN2020300000000,20,203,Wichita County, KS,May-17,1120,1091,29,2.6
CN2020300000000,20,203,Wichita County, KS,Jun-17,1191,1159,32,2.7
CN2020300000000,20,203,Wichita County, KS,Jul-17,1179,1141,38,3.2
CN2020300000000,20,203,Wichita County, KS,Aug-17,1184,1150,34,2.9
CN2020300000000,20,203,Wichita County, KS,Sep-17,1206,1184,22,1.8
CN2020300000000,20,203,Wichita County, KS,Oct-17,1240,1219,21,1.7
CN2020300000000,20,203,Wichita County, KS,Nov-17,1198,1173,25,2.1
CN2020300000000,20,203,Wichita County, KS,Dec-17,1179,1154,25,2.1
CN2020300000000,20,203,Wichita County, KS,Jan-18,1148,1123,25,2.2
CN2020300000000,20,203,Wichita County, KS,Feb-18,1147,1119,28,2.4
CN2020300000000,20,203,Wichita County, KS,Mar-18,1104,1078,26,2.4
CN2020300000000,20,203,Wichita County, KS,Apr-18(p),999,972,27,2.7
CN4708500000000,47,085,Humphreys County, TN,Mar-17,8822,8413,409,4.6
CN4708500000000,47,085,Humphreys County, TN,Apr-17,8877,8556,321,3.6
CN4708500000000,47,085,Humphreys County, TN,May-17,8835,8519,316,3.6
CN4708500000000,47,085,Humphreys County, TN,Jun-17,8731,8333,398,4.6
CN4708500000000,47,085,Humphreys County, TN,Jul-17,8733,8349,384,4.4
CN4708500000000,47,085,Humphreys County, TN,Aug-17,8856,8499,357,4.0
CN4708500000000,47,085,Humphreys County, TN,Sep-17,8943,8626,317,3.5
CN4708500000000,47,085,Humphreys County, TN,Oct-17,8940,8617,323,3.6
CN4708500000000,47,085,Humphreys County, TN,Nov-17,8871,8540,331,3.7
CN4708500000000,47,085,Humphreys County, TN,Dec-17,8858,8510,348,3.9
CN4708500000000,47,085,Humphreys County, TN,Jan-18,8985,8527,458,5.1
CN4708500000000,47,085,Humphreys County, TN,Feb-18,8979,8538,441,4.9
CN4708500000000,47,085,Humphreys County, TN,Mar-18,8959,8573,386,4.3
CN4708500000000,47,085,Humphreys County, TN,Apr-18(p),9039,8697,342,3.8
CN0112100000000,01,121,Talladega County, AL,Mar-17,34734,32786,1948,5.6
CN0112100000000,01,121,Talladega County, AL,Apr-17,34611,33006,1605,4.6
CN0112100000000,01,121,Talladega County, AL,May-17,34497,32947,1550,4.5
CN0112100000000,01,121,Talladega County, AL,Jun-17,34615,32796,1819,5.3
CN0112100000000,01,121,Talladega County, AL,Jul-17,34448,32666,1782,5.2
CN0112100000000,01,121,Talladega County, AL,Aug-17,34265,32663,1602,4.7
CN0112100000000,01,121,Talladega County, AL,Sep-17,34454,33046,1408,4.1
CN0112100000000,01,121,Talladega County, AL,Oct-17,34526,33107,1419,4.1
CN0112100000000,01,121,Talladega County, AL,Nov-17,34312,32976,1336,3.9
CN0112100000000,01,121,Talladega County, AL,Dec-17,34250,32955,1295,3.8
CN0112100000000,01,121,Talladega County, AL,Jan-18,34144,32561,1583,4.6
CN0112100000000,01,121,Talladega County, AL,Feb-18,33983,32343,1640,4.8
CN0112100000000,01,121,Talladega County, AL,Mar-18,34052,32596,1456,4.3
CN0112100000000,01,121,Talladega County, AL,Apr-18(p),34227,32881,1346,3.9
CN1816900000000,18,169,Wabash County, IN,Mar-17,15394,14856,538,3.5
CN1816900000000,18,169,Wabash County, IN,Apr-17,15290,14875,415,2.7
CN1816900000000,18,169,Wabash County, IN,May-17,15511,15048,463,3.0
CN1816900000000,18,169,Wabash County, IN,Jun-17,15318,14795,523,3.4
CN1816900000000,18,169,Wabash County, IN,Jul-17,14948,14391,557,3.7
CN1816900000000,18,169,Wabash County, IN,Aug-17,14801,14197,604,4.1
CN1816900000000,18,169,Wabash County, IN,Sep-17,14998,14486,512,3.4
CN1816900000000,18,169,Wabash County, IN,Oct-17,15119,14625,494,3.3
CN1816900000000,18,169,Wabash County, IN,Nov-17,15196,14677,519,3.4
CN1816900000000,18,169,Wabash County, IN,Dec-17,14860,14382,478,3.2
CN1816900000000,18,169,Wabash County, IN,Jan-18,14507,13955,552,3.8
CN1816900000000,18,169,Wabash County, IN,Feb-18,14913,14361,552,3.7
CN1816900000000,18,169,Wabash County, IN,Mar-18,15145,14630,515,3.4
CN1816900000000,18,169,Wabash County, IN,Apr-18(p),15141,14706,435,2.9
CN3700500000000,37,005,Alleghany County, NC,Mar-17,4400,4159,241,5.5
CN3700500000000,37,005,Alleghany County, NC,Apr-17,4392,4186,206,4.7
CN3700500000000,37,005,Alleghany County, NC,May-17,4349,4145,204,4.7
CN3700500000000,37,005,Alleghany County, NC,Jun-17,4294,4084,210,4.9
CN3700500000000,37,005,Alleghany County, NC,Jul-17,4467,4244,223,5.0
CN3700500000000,37,005,Alleghany County, NC,Aug-17,4471,4253,218,4.9
CN3700500000000,37,005,Alleghany County, NC,Sep-17,4461,4268,193,4.3
CN3700500000000,37,005,Alleghany County, NC,Oct-17,4227,4035,192,4.5
CN3700500000000,37,005,Alleghany County, NC,Nov-17,4150,3952,198,4.8
CN3700500000000,37,005,Alleghany County, NC,Dec-17,4098,3885,213,5.2
CN3700500000000,37,005,Alleghany County, NC,Jan-18,4060,3806,254,6.3
CN3700500000000,37,005,Alleghany County, NC,Feb-18,4362,4108,254,5.8
CN3700500000000,37,005,Alleghany County, NC,Mar-18,4343,4107,236,5.4
CN3700500000000,37,005,Alleghany County, NC,Apr-18(p),4367,4177,190,4.4
CN1604300000000,16,043,Fremont County, ID,Mar-17,7529,7269,260,3.5
CN1604300000000,16,043,Fremont County, ID,Apr-17,7483,7273,210,2.8
CN1604300000000,16,043,Fremont County, ID,May-17,7717,7544,173,2.2
CN1604300000000,16,043,Fremont County, ID,Jun-17,7777,7606,171,2.2
CN1604300000000,16,043,Fremont County, ID,Jul-17,7675,7517,158,2.1
CN1604300000000,16,043,Fremont County, ID,Aug-17,7066,6908,158,2.2
CN1604300000000,16,043,Fremont County, ID,Sep-17,7578,7432,146,1.9
CN1604300000000,16,043,Fremont County, ID,Oct-17,8395,8257,138,1.6
CN1604300000000,16,043,Fremont County, ID,Nov-17,7733,7541,192,2.5
CN1604300000000,16,043,Fremont County, ID,Dec-17,7616,7396,220,2.9
CN1604300000000,16,043,Fremont County, ID,Jan-18,7297,7015,282,3.9
CN1604300000000,16,043,Fremont County, ID,Feb-18,7512,7257,255,3.4
CN1604300000000,16,043,Fremont County, ID,Mar-18,7568,7341,227,3.0
CN1604300000000,16,043,Fremont County, ID,Apr-18(p),7787,7591,196,2.5
CN3718900000000,37,189,Watauga County, NC,Mar-17,27797,26541,1256,4.5
CN3718900000000,37,189,Watauga County, NC,Apr-17,27873,26849,1024,3.7
CN3718900000000,37,189,Watauga County, NC,May-17,28338,27223,1115,3.9
CN3718900000000,37,189,Watauga County, NC,Jun-17,28814,27581,1233,4.3
CN3718900000000,37,189,Watauga County, NC,Jul-17,29441,28111,1330,4.5
CN3718900000000,37,189,Watauga County, NC,Aug-17,29362,28044,1318,4.5
CN3718900000000,37,189,Watauga County, NC,Sep-17,29147,28083,1064,3.7
CN3718900000000,37,189,Watauga County, NC,Oct-17,29091,28069,1022,3.5
CN3718900000000,37,189,Watauga County, NC,Nov-17,28767,27686,1081,3.8
CN3718900000000,37,189,Watauga County, NC,Dec-17,28880,27819,1061,3.7
CN3718900000000,37,189,Watauga County, NC,Jan-18,28269,27128,1141,4.0
CN3718900000000,37,189,Watauga County, NC,Feb-18,28533,27332,1201,4.2
CN3718900000000,37,189,Watauga County, NC,Mar-18,28142,27003,1139,4.0
CN3718900000000,37,189,Watauga County, NC,Apr-18(p),28319,27370,949,3.4
CN3611500000000,36,115,Washington County, NY,Mar-17,28053,26590,1463,5.2
CN3611500000000,36,115,Washington County, NY,Apr-17,27896,26627,1269,4.5
CN3611500000000,36,115,Washington County, NY,May-17,28158,26981,1177,4.2
CN3611500000000,36,115,Washington County, NY,Jun-17,29673,28469,1204,4.1
CN3611500000000,36,115,Washington County, NY,Jul-17,30004,28746,1258,4.2
CN3611500000000,36,115,Washington County, NY,Aug-17,29658,28400,1258,4.2
CN3611500000000,36,115,Washington County, NY,Sep-17,28536,27277,1259,4.4
CN3611500000000,36,115,Washington County, NY,Oct-17,28230,27080,1150,4.1
CN3611500000000,36,115,Washington County, NY,Nov-17,27971,26702,1269,4.5
CN3611500000000,36,115,Washington County, NY,Dec-17,27700,26318,1382,5.0
CN3611500000000,36,115,Washington County, NY,Jan-18,28316,26556,1760,6.2
CN3611500000000,36,115,Washington County, NY,Feb-18,28035,26244,1791,6.4
CN3611500000000,36,115,Washington County, NY,Mar-18,27488,25903,1585,5.8
CN3611500000000,36,115,Washington County, NY,Apr-18(p),27530,26236,1294,4.7
CN1209100000000,12,091,Okaloosa County, FL,Mar-17,94453,91179,3274,3.5
CN1209100000000,12,091,Okaloosa County, FL,Apr-17,95053,91991,3062,3.2
CN1209100000000,12,091,Okaloosa County, FL,May-17,96216,93124,3092,3.2
CN1209100000000,12,091,Okaloosa County, FL,Jun-17,98927,95553,3374,3.4
CN1209100000000,12,091,Okaloosa County, FL,Jul-17,99351,95914,3437,3.5
CN1209100000000,12,091,Okaloosa County, FL,Aug-17,97745,94406,3339,3.4
CN1209100000000,12,091,Okaloosa County, FL,Sep-17,98098,95038,3060,3.1
CN1209100000000,12,091,Okaloosa County, FL,Oct-17,96496,93594,2902,3.0
CN1209100000000,12,091,Okaloosa County, FL,Nov-17,95962,93002,2960,3.1
CN1209100000000,12,091,Okaloosa County, FL,Dec-17,95108,92298,2810,3.0
CN1209100000000,12,091,Okaloosa County, FL,Jan-18,95575,92192,3383,3.5
CN1209100000000,12,091,Okaloosa County, FL,Feb-18,96604,93536,3068,3.2
CN1209100000000,12,091,Okaloosa County, FL,Mar-18,98751,95793,2958,3.0
CN1209100000000,12,091,Okaloosa County, FL,Apr-18(p),98970,96275,2695,2.7
CN4847300000000,48,473,Waller County, TX,Mar-17,22291,21148,1143,5.1
CN4847300000000,48,473,Waller County, TX,Apr-17,22239,21210,1029,4.6
CN4847300000000,48,473,Waller County, TX,May-17,22206,21182,1024,4.6
CN4847300000000,48,473,Waller County, TX,Jun-17,22325,21138,1187,5.3
CN4847300000000,48,473,Waller County, TX,Jul-17,22259,21114,1145,5.1
CN4847300000000,48,473,Waller County, TX,Aug-17,22203,21045,1158,5.2
CN4847300000000,48,473,Waller County, TX,Sep-17,22180,21158,1022,4.6
CN4847300000000,48,473,Waller County, TX,Oct-17,22135,21198,937,4.2
CN4847300000000,48,473,Waller County, TX,Nov-17,22220,21263,957,4.3
CN4847300000000,48,473,Waller County, TX,Dec-17,22226,21316,910,4.1
CN4847300000000,48,473,Waller County, TX,Jan-18,22209,21203,1006,4.5
CN4847300000000,48,473,Waller County, TX,Feb-18,22585,21545,1040,4.6
CN4847300000000,48,473,Waller County, TX,Mar-18,22691,21684,1007,4.4
CN4847300000000,48,473,Waller County, TX,Apr-18(p),22698,21776,922,4.1
CN3807900000000,38,079,Rolette County, ND,Mar-17,4931,4438,493,10.0
CN3807900000000,38,079,Rolette County, ND,Apr-17,4866,4430,436,9.0
CN3807900000000,38,079,Rolette County, ND,May-17,4820,4448,372,7.7
CN3807900000000,38,079,Rolette County, ND,Jun-17,5278,4532,746,14.1
CN3807900000000,38,079,Rolette County, ND,Jul-17,4861,4168,693,14.3
CN3807900000000,38,079,Rolette County, ND,Aug-17,5158,4464,694,13.5
CN3807900000000,38,079,Rolette County, ND,Sep-17,4705,4389,316,6.7
CN3807900000000,38,079,Rolette County, ND,Oct-17,4729,4383,346,7.3
CN3807900000000,38,079,Rolette County, ND,Nov-17,4683,4307,376,8.0
CN3807900000000,38,079,Rolette County, ND,Dec-17,4758,4325,433,9.1
CN3807900000000,38,079,Rolette County, ND,Jan-18,4792,4279,513,10.7
CN3807900000000,38,079,Rolette County, ND,Feb-18,4826,4286,540,11.2
CN3807900000000,38,079,Rolette County, ND,Mar-18,4822,4327,495,10.3
CN3807900000000,38,079,Rolette County, ND,Apr-18(p),4724,4298,426,9.0
CN2611900000000,26,119,Montmorency County, MI,Mar-17,2980,2591,389,13.1
CN2611900000000,26,119,Montmorency County, MI,Apr-17,2965,2654,311,10.5
CN2611900000000,26,119,Montmorency County, MI,May-17,3039,2757,282,9.3
CN2611900000000,26,119,Montmorency County, MI,Jun-17,3118,2830,288,9.2
CN2611900000000,26,119,Montmorency County, MI,Jul-17,3138,2821,317,10.1
CN2611900000000,26,119,Montmorency County, MI,Aug-17,3099,2799,300,9.7
CN2611900000000,26,119,Montmorency County, MI,Sep-17,3006,2757,249,8.3
CN2611900000000,26,119,Montmorency County, MI,Oct-17,2972,2729,243,8.2
CN2611900000000,26,119,Montmorency County, MI,Nov-17,2987,2691,296,9.9
CN2611900000000,26,119,Montmorency County, MI,Dec-17,3034,2646,388,12.8
CN2611900000000,26,119,Montmorency County, MI,Jan-18,2999,2604,395,13.2
CN2611900000000,26,119,Montmorency County, MI,Feb-18,3031,2607,424,14.0
CN2611900000000,26,119,Montmorency County, MI,Mar-18,2966,2595,371,12.5
CN2611900000000,26,119,Montmorency County, MI,Apr-18(p),2986,2658,328,11.0
CN0809300000000,08,093,Park County, CO,Mar-17,10022,9777,245,2.4
CN0809300000000,08,093,Park County, CO,Apr-17,10054,9834,220,2.2
CN0809300000000,08,093,Park County, CO,May-17,10080,9865,215,2.1
CN0809300000000,08,093,Park County, CO,Jun-17,10224,9972,252,2.5
CN0809300000000,08,093,Park County, CO,Jul-17,10261,10031,230,2.2
CN0809300000000,08,093,Park County, CO,Aug-17,10243,10008,235,2.3
CN0809300000000,08,093,Park County, CO,Sep-17,10293,10047,246,2.4
CN0809300000000,08,093,Park County, CO,Oct-17,10286,10041,245,2.4
CN0809300000000,08,093,Park County, CO,Nov-17,10287,10037,250,2.4
CN0809300000000,08,093,Park County, CO,Dec-17,10243,9987,256,2.5
CN0809300000000,08,093,Park County, CO,Jan-18,10264,9939,325,3.2
CN0809300000000,08,093,Park County, CO,Feb-18,10351,10040,311,3.0
CN0809300000000,08,093,Park County, CO,Mar-18,10383,10121,262,2.5
CN0809300000000,08,093,Park County, CO,Apr-18(p),10447,10204,243,2.3
CN2700900000000,27,009,Benton County, MN,Mar-17,22289,21104,1185,5.3
CN2700900000000,27,009,Benton County, MN,Apr-17,22219,21317,902,4.1
CN2700900000000,27,009,Benton County, MN,May-17,22026,21298,728,3.3
CN2700900000000,27,009,Benton County, MN,Jun-17,21921,21147,774,3.5
CN2700900000000,27,009,Benton County, MN,Jul-17,22002,21238,764,3.5
CN2700900000000,27,009,Benton County, MN,Aug-17,21914,21162,752,3.4
CN2700900000000,27,009,Benton County, MN,Sep-17,21886,21264,622,2.8
CN2700900000000,27,009,Benton County, MN,Oct-17,22025,21448,577,2.6
CN2700900000000,27,009,Benton County, MN,Nov-17,22114,21416,698,3.2
CN2700900000000,27,009,Benton County, MN,Dec-17,22233,21248,985,4.4
CN2700900000000,27,009,Benton County, MN,Jan-18,22512,21238,1274,5.7
CN2700900000000,27,009,Benton County, MN,Feb-18,22674,21477,1197,5.3
CN2700900000000,27,009,Benton County, MN,Mar-18,22648,21514,1134,5.0
CN2700900000000,27,009,Benton County, MN,Apr-18(p),22552,21656,896,4.0
CN4100300000000,41,003,Benton County, OR,Mar-17,48260,46658,1602,3.3
CN4100300000000,41,003,Benton County, OR,Apr-17,48290,46970,1320,2.7
CN4100300000000,41,003,Benton County, OR,May-17,48566,47211,1355,2.8
CN4100300000000,41,003,Benton County, OR,Jun-17,49250,47421,1829,3.7
CN4100300000000,41,003,Benton County, OR,Jul-17,46625,44707,1918,4.1
CN4100300000000,41,003,Benton County, OR,Aug-17,46735,44905,1830,3.9
CN4100300000000,41,003,Benton County, OR,Sep-17,47937,46319,1618,3.4
CN4100300000000,41,003,Benton County, OR,Oct-17,48972,47483,1489,3.0
CN4100300000000,41,003,Benton County, OR,Nov-17,49087,47664,1423,2.9
CN4100300000000,41,003,Benton County, OR,Dec-17,48595,47253,1342,2.8
CN4100300000000,41,003,Benton County, OR,Jan-18,48256,46874,1382,2.9
CN4100300000000,41,003,Benton County, OR,Feb-18,49150,47582,1568,3.2
CN4100300000000,41,003,Benton County, OR,Mar-18,49029,47504,1525,3.1
CN4100300000000,41,003,Benton County, OR,Apr-18(p),48545,47260,1285,2.6
CN4011300000000,40,113,Osage County, OK,Mar-17,21004,19887,1117,5.3
CN4011300000000,40,113,Osage County, OK,Apr-17,20902,19876,1026,4.9
CN4011300000000,40,113,Osage County, OK,May-17,20927,19835,1092,5.2
CN4011300000000,40,113,Osage County, OK,Jun-17,21228,20095,1133,5.3
CN4011300000000,40,113,Osage County, OK,Jul-17,21260,20224,1036,4.9
CN4011300000000,40,113,Osage County, OK,Aug-17,21027,19993,1034,4.9
CN4011300000000,40,113,Osage County, OK,Sep-17,21135,20122,1013,4.8
CN4011300000000,40,113,Osage County, OK,Oct-17,21346,20317,1029,4.8
CN4011300000000,40,113,Osage County, OK,Nov-17,21488,20481,1007,4.7
CN4011300000000,40,113,Osage County, OK,Dec-17,21395,20346,1049,4.9
CN4011300000000,40,113,Osage County, OK,Jan-18,21238,20082,1156,5.4
CN4011300000000,40,113,Osage County, OK,Feb-18,21305,20221,1084,5.1
CN4011300000000,40,113,Osage County, OK,Mar-18,21375,20324,1051,4.9
CN4011300000000,40,113,Osage County, OK,Apr-18(p),21377,20352,1025,4.8
CN4836700000000,48,367,Parker County, TX,Mar-17,62033,59722,2311,3.7
CN4836700000000,48,367,Parker County, TX,Apr-17,62101,60022,2079,3.3
CN4836700000000,48,367,Parker County, TX,May-17,62045,59927,2118,3.4
CN4836700000000,48,367,Parker County, TX,Jun-17,62289,60034,2255,3.6
CN4836700000000,48,367,Parker County, TX,Jul-17,62553,60264,2289,3.7
CN4836700000000,48,367,Parker County, TX,Aug-17,62453,60216,2237,3.6
CN4836700000000,48,367,Parker County, TX,Sep-17,62891,60908,1983,3.2
CN4836700000000,48,367,Parker County, TX,Oct-17,62488,60675,1813,2.9
CN4836700000000,48,367,Parker County, TX,Nov-17,62750,60843,1907,3.0
CN4836700000000,48,367,Parker County, TX,Dec-17,62668,60868,1800,2.9
CN4836700000000,48,367,Parker County, TX,Jan-18,62542,60501,2041,3.3
CN4836700000000,48,367,Parker County, TX,Feb-18,63377,61282,2095,3.3
CN4836700000000,48,367,Parker County, TX,Mar-18,63625,61494,2131,3.3
CN4836700000000,48,367,Parker County, TX,Apr-18(p),63851,61952,1899,3.0
CN5505900000000,55,059,Kenosha County, WI,Mar-17,88209,84472,3737,4.2
CN5505900000000,55,059,Kenosha County, WI,Apr-17,88859,85518,3341,3.8
CN5505900000000,55,059,Kenosha County, WI,May-17,89536,86282,3254,3.6
CN5505900000000,55,059,Kenosha County, WI,Jun-17,92320,88336,3984,4.3
CN5505900000000,55,059,Kenosha County, WI,Jul-17,92515,88751,3764,4.1
CN5505900000000,55,059,Kenosha County, WI,Aug-17,91975,88078,3897,4.2
CN5505900000000,55,059,Kenosha County, WI,Sep-17,91168,87940,3228,3.5
CN5505900000000,55,059,Kenosha County, WI,Oct-17,89986,87019,2967,3.3
CN5505900000000,55,059,Kenosha County, WI,Nov-17,89688,86696,2992,3.3
CN5505900000000,55,059,Kenosha County, WI,Dec-17,88662,85949,2713,3.1
CN5505900000000,55,059,Kenosha County, WI,Jan-18,88257,85135,3122,3.5
CN5505900000000,55,059,Kenosha County, WI,Feb-18,89844,86357,3487,3.9
CN5505900000000,55,059,Kenosha County, WI,Mar-18,90121,86854,3267,3.6
CN5505900000000,55,059,Kenosha County, WI,Apr-18(p),90202,87461,2741,3.0
CN2109100000000,21,091,Hancock County, KY,Mar-17,4098,3872,226,5.5
CN2109100000000,21,091,Hancock County, KY,Apr-17,4088,3890,198,4.8
CN2109100000000,21,091,Hancock County, KY,May-17,4091,3895,196,4.8
CN2109100000000,21,091,Hancock County, KY,Jun-17,4135,3910,225,5.4
CN2109100000000,21,091,Hancock County, KY,Jul-17,4151,3926,225,5.4
CN2109100000000,21,091,Hancock County, KY,Aug-17,4090,3890,200,4.9
CN2109100000000,21,091,Hancock County, KY,Sep-17,4090,3909,181,4.4
CN2109100000000,21,091,Hancock County, KY,Oct-17,4042,3863,179,4.4
CN2109100000000,21,091,Hancock County, KY,Nov-17,4066,3890,176,4.3
CN2109100000000,21,091,Hancock County, KY,Dec-17,4065,3885,180,4.4
CN2109100000000,21,091,Hancock County, KY,Jan-18,4065,3891,174,4.3
CN2109100000000,21,091,Hancock County, KY,Feb-18,4100,3908,192,4.7
CN2109100000000,21,091,Hancock County, KY,Mar-18,4112,3932,180,4.4
CN2109100000000,21,091,Hancock County, KY,Apr-18(p),4091,3943,148,3.6
CN2711500000000,27,115,Pine County, MN,Mar-17,15187,13949,1238,8.2
CN2711500000000,27,115,Pine County, MN,Apr-17,15013,14075,938,6.2
CN2711500000000,27,115,Pine County, MN,May-17,14967,14300,667,4.5
CN2711500000000,27,115,Pine County, MN,Jun-17,15078,14418,660,4.4
CN2711500000000,27,115,Pine County, MN,Jul-17,14996,14369,627,4.2
CN2711500000000,27,115,Pine County, MN,Aug-17,14911,14274,637,4.3
CN2711500000000,27,115,Pine County, MN,Sep-17,14795,14256,539,3.6
CN2711500000000,27,115,Pine County, MN,Oct-17,14841,14345,496,3.3
CN2711500000000,27,115,Pine County, MN,Nov-17,15026,14304,722,4.8
CN2711500000000,27,115,Pine County, MN,Dec-17,15220,14229,991,6.5
CN2711500000000,27,115,Pine County, MN,Jan-18,15389,14131,1258,8.2
CN2711500000000,27,115,Pine County, MN,Feb-18,15308,14144,1164,7.6
CN2711500000000,27,115,Pine County, MN,Mar-18,15314,14163,1151,7.5
CN2711500000000,27,115,Pine County, MN,Apr-18(p),15290,14394,896,5.9
CN0106900000000,01,069,Houston County, AL,Mar-17,44660,42511,2149,4.8
CN0106900000000,01,069,Houston County, AL,Apr-17,44434,42671,1763,4.0
CN0106900000000,01,069,Houston County, AL,May-17,44334,42584,1750,3.9
CN0106900000000,01,069,Houston County, AL,Jun-17,44580,42479,2101,4.7
CN0106900000000,01,069,Houston County, AL,Jul-17,44648,42691,1957,4.4
CN0106900000000,01,069,Houston County, AL,Aug-17,44418,42533,1885,4.2
CN0106900000000,01,069,Houston County, AL,Sep-17,44340,42692,1648,3.7
CN0106900000000,01,069,Houston County, AL,Oct-17,44409,42784,1625,3.7
CN0106900000000,01,069,Houston County, AL,Nov-17,44183,42615,1568,3.5
CN0106900000000,01,069,Houston County, AL,Dec-17,43943,42406,1537,3.5
CN0106900000000,01,069,Houston County, AL,Jan-18,43605,41751,1854,4.3
CN0106900000000,01,069,Houston County, AL,Feb-18,44208,42305,1903,4.3
CN0106900000000,01,069,Houston County, AL,Mar-18,44504,42775,1729,3.9
CN0106900000000,01,069,Houston County, AL,Apr-18(p),44944,43342,1602,3.6
CN3100700000000,31,007,Banner County, NE,Mar-17,401,387,14,3.5
CN3100700000000,31,007,Banner County, NE,Apr-17,406,391,15,3.7
CN3100700000000,31,007,Banner County, NE,May-17,413,397,16,3.9
CN3100700000000,31,007,Banner County, NE,Jun-17,429,413,16,3.7
CN3100700000000,31,007,Banner County, NE,Jul-17,403,386,17,4.2
CN3100700000000,31,007,Banner County, NE,Aug-17,387,372,15,3.9
CN3100700000000,31,007,Banner County, NE,Sep-17,373,361,12,3.2
CN3100700000000,31,007,Banner County, NE,Oct-17,382,371,11,2.9
CN3100700000000,31,007,Banner County, NE,Nov-17,395,377,18,4.6
CN3100700000000,31,007,Banner County, NE,Dec-17,392,376,16,4.1
CN3100700000000,31,007,Banner County, NE,Jan-18,398,384,14,3.5
CN3100700000000,31,007,Banner County, NE,Feb-18,390,375,15,3.8
CN3100700000000,31,007,Banner County, NE,Mar-18,400,383,17,4.3
CN3100700000000,31,007,Banner County, NE,Apr-18(p),391,375,16,4.1
CN1313700000000,13,137,Habersham County, GA,Mar-17,19441,18507,934,4.8
CN1313700000000,13,137,Habersham County, GA,Apr-17,19376,18392,984,5.1
CN1313700000000,13,137,Habersham County, GA,May-17,19304,18455,849,4.4
CN1313700000000,13,137,Habersham County, GA,Jun-17,19387,18473,914,4.7
CN1313700000000,13,137,Habersham County, GA,Jul-17,19397,18405,992,5.1
CN1313700000000,13,137,Habersham County, GA,Aug-17,19246,18369,877,4.6
CN1313700000000,13,137,Habersham County, GA,Sep-17,19476,18674,802,4.1
CN1313700000000,13,137,Habersham County, GA,Oct-17,19409,18623,786,4.0
CN1313700000000,13,137,Habersham County, GA,Nov-17,19402,18658,744,3.8
CN1313700000000,13,137,Habersham County, GA,Dec-17,19448,18695,753,3.9
CN1313700000000,13,137,Habersham County, GA,Jan-18,19438,18605,833,4.3
CN1313700000000,13,137,Habersham County, GA,Feb-18,19254,18415,839,4.4
CN1313700000000,13,137,Habersham County, GA,Mar-18,19222,18472,750,3.9
CN1313700000000,13,137,Habersham County, GA,Apr-18(p),19174,18515,659,3.4
CN1324300000000,13,243,Randolph County, GA,Mar-17,2533,2361,172,6.8
CN1324300000000,13,243,Randolph County, GA,Apr-17,2500,2336,164,6.6
CN1324300000000,13,243,Randolph County, GA,May-17,2509,2344,165,6.6
CN1324300000000,13,243,Randolph County, GA,Jun-17,2539,2361,178,7.0
CN1324300000000,13,243,Randolph County, GA,Jul-17,2470,2291,179,7.2
CN1324300000000,13,243,Randolph County, GA,Aug-17,2479,2304,175,7.1
CN1324300000000,13,243,Randolph County, GA,Sep-17,2467,2313,154,6.2
CN1324300000000,13,243,Randolph County, GA,Oct-17,2511,2365,146,5.8
CN1324300000000,13,243,Randolph County, GA,Nov-17,2497,2354,143,5.7
CN1324300000000,13,243,Randolph County, GA,Dec-17,2496,2358,138,5.5
CN1324300000000,13,243,Randolph County, GA,Jan-18,2548,2396,152,6.0
CN1324300000000,13,243,Randolph County, GA,Feb-18,2549,2395,154,6.0
CN1324300000000,13,243,Randolph County, GA,Mar-18,2531,2400,131,5.2
CN1324300000000,13,243,Randolph County, GA,Apr-18(p),2517,2387,130,5.2
CN2905500000000,29,055,Crawford County, MO,Mar-17,10731,10145,586,5.5
CN2905500000000,29,055,Crawford County, MO,Apr-17,10703,10221,482,4.5
CN2905500000000,29,055,Crawford County, MO,May-17,10727,10232,495,4.6
CN2905500000000,29,055,Crawford County, MO,Jun-17,10873,10381,492,4.5
CN2905500000000,29,055,Crawford County, MO,Jul-17,10786,10281,505,4.7
CN2905500000000,29,055,Crawford County, MO,Aug-17,10624,10111,513,4.8
CN2905500000000,29,055,Crawford County, MO,Sep-17,10586,10192,394,3.7
CN2905500000000,29,055,Crawford County, MO,Oct-17,10493,10106,387,3.7
CN2905500000000,29,055,Crawford County, MO,Nov-17,10409,10006,403,3.9
CN2905500000000,29,055,Crawford County, MO,Dec-17,10395,9932,463,4.5
CN2905500000000,29,055,Crawford County, MO,Jan-18,10401,9825,576,5.5
CN2905500000000,29,055,Crawford County, MO,Feb-18,10514,9937,577,5.5
CN2905500000000,29,055,Crawford County, MO,Mar-18,10527,9986,541,5.1
CN2905500000000,29,055,Crawford County, MO,Apr-18(p),10583,10131,452,4.3
CN2916100000000,29,161,Phelps County, MO,Mar-17,19546,18754,792,4.1
CN2916100000000,29,161,Phelps County, MO,Apr-17,19404,18695,709,3.7
CN2916100000000,29,161,Phelps County, MO,May-17,19395,18670,725,3.7
CN2916100000000,29,161,Phelps County, MO,Jun-17,19248,18462,786,4.1
CN2916100000000,29,161,Phelps County, MO,Jul-17,19076,18262,814,4.3
CN2916100000000,29,161,Phelps County, MO,Aug-17,19505,18686,819,4.2
CN2916100000000,29,161,Phelps County, MO,Sep-17,19436,18809,627,3.2
CN2916100000000,29,161,Phelps County, MO,Oct-17,19072,18603,469,2.5
CN2916100000000,29,161,Phelps County, MO,Nov-17,19158,18536,622,3.2
CN2916100000000,29,161,Phelps County, MO,Dec-17,19089,18455,634,3.3
CN2916100000000,29,161,Phelps County, MO,Jan-18,18945,18153,792,4.2
CN2916100000000,29,161,Phelps County, MO,Feb-18,19247,18513,734,3.8
CN2916100000000,29,161,Phelps County, MO,Mar-18,19346,18602,744,3.8
CN2916100000000,29,161,Phelps County, MO,Apr-18(p),19361,18720,641,3.3
CN3111300000000,31,113,Logan County, NE,Mar-17,477,463,14,2.9
CN3111300000000,31,113,Logan County, NE,Apr-17,488,473,15,3.1
CN3111300000000,31,113,Logan County, NE,May-17,478,462,16,3.3
CN3111300000000,31,113,Logan County, NE,Jun-17,494,481,13,2.6
CN3111300000000,31,113,Logan County, NE,Jul-17,478,466,12,2.5
CN3111300000000,31,113,Logan County, NE,Aug-17,469,457,12,2.6
CN3111300000000,31,113,Logan County, NE,Sep-17,452,441,11,2.4
CN3111300000000,31,113,Logan County, NE,Oct-17,455,446,9,2.0
CN3111300000000,31,113,Logan County, NE,Nov-17,460,449,11,2.4
CN3111300000000,31,113,Logan County, NE,Dec-17,459,448,11,2.4
CN3111300000000,31,113,Logan County, NE,Jan-18,470,460,10,2.1
CN3111300000000,31,113,Logan County, NE,Feb-18,460,446,14,3.0
CN3111300000000,31,113,Logan County, NE,Mar-18,469,455,14,3.0
CN3111300000000,31,113,Logan County, NE,Apr-18(p),470,459,11,2.3
CN4207700000000,42,077,Lehigh County, PA,Mar-17,189039,179044,9995,5.3
CN4207700000000,42,077,Lehigh County, PA,Apr-17,188386,179599,8787,4.7
CN4207700000000,42,077,Lehigh County, PA,May-17,189437,179877,9560,5.0
CN4207700000000,42,077,Lehigh County, PA,Jun-17,190600,180936,9664,5.1
CN4207700000000,42,077,Lehigh County, PA,Jul-17,190472,180130,10342,5.4
CN4207700000000,42,077,Lehigh County, PA,Aug-17,188766,178207,10559,5.6
CN4207700000000,42,077,Lehigh County, PA,Sep-17,188903,180166,8737,4.6
CN4207700000000,42,077,Lehigh County, PA,Oct-17,187859,179413,8446,4.5
CN4207700000000,42,077,Lehigh County, PA,Nov-17,188264,179716,8548,4.5
CN4207700000000,42,077,Lehigh County, PA,Dec-17,186283,178089,8194,4.4
CN4207700000000,42,077,Lehigh County, PA,Jan-18,187025,177067,9958,5.3
CN4207700000000,42,077,Lehigh County, PA,Feb-18,187678,177542,10136,5.4
CN4207700000000,42,077,Lehigh County, PA,Mar-18,185870,176723,9147,4.9
CN4207700000000,42,077,Lehigh County, PA,Apr-18(p),186627,178530,8097,4.3
CN2004100000000,20,041,Dickinson County, KS,Mar-17,9121,8748,373,4.1
CN2004100000000,20,041,Dickinson County, KS,Apr-17,9171,8832,339,3.7
CN2004100000000,20,041,Dickinson County, KS,May-17,9192,8854,338,3.7
CN2004100000000,20,041,Dickinson County, KS,Jun-17,9368,8935,433,4.6
CN2004100000000,20,041,Dickinson County, KS,Jul-17,9454,9080,374,4.0
CN2004100000000,20,041,Dickinson County, KS,Aug-17,9347,9002,345,3.7
CN2004100000000,20,041,Dickinson County, KS,Sep-17,9344,9035,309,3.3
CN2004100000000,20,041,Dickinson County, KS,Oct-17,9429,9136,293,3.1
CN2004100000000,20,041,Dickinson County, KS,Nov-17,9330,9042,288,3.1
CN2004100000000,20,041,Dickinson County, KS,Dec-17,9273,8988,285,3.1
CN2004100000000,20,041,Dickinson County, KS,Jan-18,9179,8832,347,3.8
CN2004100000000,20,041,Dickinson County, KS,Feb-18,9170,8817,353,3.8
CN2004100000000,20,041,Dickinson County, KS,Mar-18,9163,8797,366,4.0
CN2004100000000,20,041,Dickinson County, KS,Apr-18(p),9050,8743,307,3.4
CN1709300000000,17,093,Kendall County, IL,Mar-17,67722,64817,2905,4.3
CN1709300000000,17,093,Kendall County, IL,Apr-17,67366,64592,2774,4.1
CN1709300000000,17,093,Kendall County, IL,May-17,67529,64890,2639,3.9
CN1709300000000,17,093,Kendall County, IL,Jun-17,68984,65600,3384,4.9
CN1709300000000,17,093,Kendall County, IL,Jul-17,68830,65574,3256,4.7
CN1709300000000,17,093,Kendall County, IL,Aug-17,67974,64640,3334,4.9
CN1709300000000,17,093,Kendall County, IL,Sep-17,67818,65003,2815,4.2
CN1709300000000,17,093,Kendall County, IL,Oct-17,67752,64909,2843,4.2
CN1709300000000,17,093,Kendall County, IL,Nov-17,67859,65071,2788,4.1
CN1709300000000,17,093,Kendall County, IL,Dec-17,67592,64665,2927,4.3
CN1709300000000,17,093,Kendall County, IL,Jan-18,67050,63514,3536,5.3
CN1709300000000,17,093,Kendall County, IL,Feb-18,68045,64626,3419,5.0
CN1709300000000,17,093,Kendall County, IL,Mar-18,67276,64718,2558,3.8
CN1709300000000,17,093,Kendall County, IL,Apr-18(p),66470,64367,2103,3.2
CN4000700000000,40,007,Beaver County, OK,Mar-17,2982,2898,84,2.8
CN4000700000000,40,007,Beaver County, OK,Apr-17,2875,2803,72,2.5
CN4000700000000,40,007,Beaver County, OK,May-17,2912,2827,85,2.9
CN4000700000000,40,007,Beaver County, OK,Jun-17,3047,2958,89,2.9
CN4000700000000,40,007,Beaver County, OK,Jul-17,3037,2957,80,2.6
CN4000700000000,40,007,Beaver County, OK,Aug-17,3161,3079,82,2.6
CN4000700000000,40,007,Beaver County, OK,Sep-17,3176,3095,81,2.6
CN4000700000000,40,007,Beaver County, OK,Oct-17,3134,3062,72,2.3
CN4000700000000,40,007,Beaver County, OK,Nov-17,3151,3078,73,2.3
CN4000700000000,40,007,Beaver County, OK,Dec-17,3085,3016,69,2.2
CN4000700000000,40,007,Beaver County, OK,Jan-18,3050,2971,79,2.6
CN4000700000000,40,007,Beaver County, OK,Feb-18,3181,3099,82,2.6
CN4000700000000,40,007,Beaver County, OK,Mar-18,3139,3063,76,2.4
CN4000700000000,40,007,Beaver County, OK,Apr-18(p),3072,3006,66,2.1
CN5603100000000,56,031,Platte County, WY,Mar-17,4561,4350,211,4.6
CN5603100000000,56,031,Platte County, WY,Apr-17,4767,4597,170,3.6
CN5603100000000,56,031,Platte County, WY,May-17,4906,4745,161,3.3
CN5603100000000,56,031,Platte County, WY,Jun-17,5031,4856,175,3.5
CN5603100000000,56,031,Platte County, WY,Jul-17,4895,4728,167,3.4
CN5603100000000,56,031,Platte County, WY,Aug-17,4879,4706,173,3.5
CN5603100000000,56,031,Platte County, WY,Sep-17,4847,4695,152,3.1
CN5603100000000,56,031,Platte County, WY,Oct-17,4805,4647,158,3.3
CN5603100000000,56,031,Platte County, WY,Nov-17,4793,4631,162,3.4
CN5603100000000,56,031,Platte County, WY,Dec-17,4683,4519,164,3.5
CN5603100000000,56,031,Platte County, WY,Jan-18,4727,4518,209,4.4
CN5603100000000,56,031,Platte County, WY,Feb-18,4712,4506,206,4.4
CN5603100000000,56,031,Platte County, WY,Mar-18,4758,4556,202,4.2
CN5603100000000,56,031,Platte County, WY,Apr-18(p),4780,4617,163,3.4
CN1327700000000,13,277,Tift County, GA,Mar-17,19118,18218,900,4.7
CN1327700000000,13,277,Tift County, GA,Apr-17,19130,18271,859,4.5
CN1327700000000,13,277,Tift County, GA,May-17,19232,18372,860,4.5
CN1327700000000,13,277,Tift County, GA,Jun-17,19330,18346,984,5.1
CN1327700000000,13,277,Tift County, GA,Jul-17,19258,18273,985,5.1
CN1327700000000,13,277,Tift County, GA,Aug-17,19215,18243,972,5.1
CN1327700000000,13,277,Tift County, GA,Sep-17,19329,18434,895,4.6
CN1327700000000,13,277,Tift County, GA,Oct-17,19325,18466,859,4.4
CN1327700000000,13,277,Tift County, GA,Nov-17,19318,18499,819,4.2
CN1327700000000,13,277,Tift County, GA,Dec-17,19286,18477,809,4.2
CN1327700000000,13,277,Tift County, GA,Jan-18,19492,18585,907,4.7
CN1327700000000,13,277,Tift County, GA,Feb-18,19237,18337,900,4.7
CN1327700000000,13,277,Tift County, GA,Mar-18,19220,18399,821,4.3
CN1327700000000,13,277,Tift County, GA,Apr-18(p),19152,18399,753,3.9
CN4820900000000,48,209,Hays County, TX,Mar-17,107342,103843,3499,3.3
CN4820900000000,48,209,Hays County, TX,Apr-17,107680,104569,3111,2.9
CN4820900000000,48,209,Hays County, TX,May-17,107739,104487,3252,3.0
CN4820900000000,48,209,Hays County, TX,Jun-17,108138,104497,3641,3.4
CN4820900000000,48,209,Hays County, TX,Jul-17,108556,104929,3627,3.3
CN4820900000000,48,209,Hays County, TX,Aug-17,107905,104319,3586,3.3
CN4820900000000,48,209,Hays County, TX,Sep-17,108792,105588,3204,2.9
CN4820900000000,48,209,Hays County, TX,Oct-17,108264,105261,3003,2.8
CN4820900000000,48,209,Hays County, TX,Nov-17,109312,106167,3145,2.9
CN4820900000000,48,209,Hays County, TX,Dec-17,109109,106111,2998,2.7
CN4820900000000,48,209,Hays County, TX,Jan-18,109624,106280,3344,3.1
CN4820900000000,48,209,Hays County, TX,Feb-18,111405,107988,3417,3.1
CN4820900000000,48,209,Hays County, TX,Mar-18,111504,108064,3440,3.1
CN4820900000000,48,209,Hays County, TX,Apr-18(p),111529,108491,3038,2.7
CN1915900000000,19,159,Ringgold County, IA,Mar-17,2518,2422,96,3.8
CN1915900000000,19,159,Ringgold County, IA,Apr-17,2529,2447,82,3.2
CN1915900000000,19,159,Ringgold County, IA,May-17,2554,2486,68,2.7
CN1915900000000,19,159,Ringgold County, IA,Jun-17,2615,2546,69,2.6
CN1915900000000,19,159,Ringgold County, IA,Jul-17,2683,2610,73,2.7
CN1915900000000,19,159,Ringgold County, IA,Aug-17,2633,2560,73,2.8
CN1915900000000,19,159,Ringgold County, IA,Sep-17,2562,2500,62,2.4
CN1915900000000,19,159,Ringgold County, IA,Oct-17,2597,2541,56,2.2
CN1915900000000,19,159,Ringgold County, IA,Nov-17,2550,2489,61,2.4
CN1915900000000,19,159,Ringgold County, IA,Dec-17,2559,2487,72,2.8
CN1915900000000,19,159,Ringgold County, IA,Jan-18,2530,2422,108,4.3
CN1915900000000,19,159,Ringgold County, IA,Feb-18,2548,2444,104,4.1
CN1915900000000,19,159,Ringgold County, IA,Mar-18,2485,2397,88,3.5
CN1915900000000,19,159,Ringgold County, IA,Apr-18(p),2488,2412,76,3.1
CN1719900000000,17,199,Williamson County, IL,Mar-17,32212,30498,1714,5.3
CN1719900000000,17,199,Williamson County, IL,Apr-17,32003,30565,1438,4.5
CN1719900000000,17,199,Williamson County, IL,May-17,30899,29470,1429,4.6
CN1719900000000,17,199,Williamson County, IL,Jun-17,30239,28657,1582,5.2
CN1719900000000,17,199,Williamson County, IL,Jul-17,31439,29770,1669,5.3
CN1719900000000,17,199,Williamson County, IL,Aug-17,31095,29411,1684,5.4
CN1719900000000,17,199,Williamson County, IL,Sep-17,31644,30172,1472,4.7
CN1719900000000,17,199,Williamson County, IL,Oct-17,31680,30312,1368,4.3
CN1719900000000,17,199,Williamson County, IL,Nov-17,31831,30407,1424,4.5
CN1719900000000,17,199,Williamson County, IL,Dec-17,31292,29863,1429,4.6
CN1719900000000,17,199,Williamson County, IL,Jan-18,30590,29038,1552,5.1
CN1719900000000,17,199,Williamson County, IL,Feb-18,30870,29400,1470,4.8
CN1719900000000,17,199,Williamson County, IL,Mar-18,31817,30209,1608,5.1
CN1719900000000,17,199,Williamson County, IL,Apr-18(p),31908,30595,1313,4.1
CN3808500000000,38,085,Sioux County, ND,Mar-17,1323,1273,50,3.8
CN3808500000000,38,085,Sioux County, ND,Apr-17,1335,1295,40,3.0
CN3808500000000,38,085,Sioux County, ND,May-17,1334,1302,32,2.4
CN3808500000000,38,085,Sioux County, ND,Jun-17,1385,1322,63,4.5
CN3808500000000,38,085,Sioux County, ND,Jul-17,1377,1319,58,4.2
CN3808500000000,38,085,Sioux County, ND,Aug-17,1361,1299,62,4.6
CN3808500000000,38,085,Sioux County, ND,Sep-17,1325,1279,46,3.5
CN3808500000000,38,085,Sioux County, ND,Oct-17,1333,1292,41,3.1
CN3808500000000,38,085,Sioux County, ND,Nov-17,1314,1266,48,3.7
CN3808500000000,38,085,Sioux County, ND,Dec-17,1298,1260,38,2.9
CN3808500000000,38,085,Sioux County, ND,Jan-18,1288,1243,45,3.5
CN3808500000000,38,085,Sioux County, ND,Feb-18,1294,1244,50,3.9
CN3808500000000,38,085,Sioux County, ND,Mar-18,1292,1246,46,3.6
CN3808500000000,38,085,Sioux County, ND,Apr-18(p),1293,1249,44,3.4
CN2909700000000,29,097,Jasper County, MO,Mar-17,57029,55022,2007,3.5
CN2909700000000,29,097,Jasper County, MO,Apr-17,57109,55231,1878,3.3
CN2909700000000,29,097,Jasper County, MO,May-17,56768,54806,1962,3.5
CN2909700000000,29,097,Jasper County, MO,Jun-17,57009,54931,2078,3.6
CN2909700000000,29,097,Jasper County, MO,Jul-17,56927,54775,2152,3.8
CN2909700000000,29,097,Jasper County, MO,Aug-17,55910,53779,2131,3.8
CN2909700000000,29,097,Jasper County, MO,Sep-17,56718,55012,1706,3.0
CN2909700000000,29,097,Jasper County, MO,Oct-17,56257,54988,1269,2.3
CN2909700000000,29,097,Jasper County, MO,Nov-17,56663,55080,1583,2.8
CN2909700000000,29,097,Jasper County, MO,Dec-17,56679,55078,1601,2.8
CN2909700000000,29,097,Jasper County, MO,Jan-18,56190,54370,1820,3.2
CN2909700000000,29,097,Jasper County, MO,Feb-18,56789,55002,1787,3.1
CN2909700000000,29,097,Jasper County, MO,Mar-18,56632,54862,1770,3.1
CN2909700000000,29,097,Jasper County, MO,Apr-18(p),56619,54992,1627,2.9
CN4606100000000,46,061,Hanson County, SD,Mar-17,1742,1655,87,5.0
CN4606100000000,46,061,Hanson County, SD,Apr-17,1750,1677,73,4.2
CN4606100000000,46,061,Hanson County, SD,May-17,1754,1690,64,3.6
CN4606100000000,46,061,Hanson County, SD,Jun-17,1791,1729,62,3.5
CN4606100000000,46,061,Hanson County, SD,Jul-17,1773,1713,60,3.4
CN4606100000000,46,061,Hanson County, SD,Aug-17,1733,1670,63,3.6
CN4606100000000,46,061,Hanson County, SD,Sep-17,1724,1670,54,3.1
CN4606100000000,46,061,Hanson County, SD,Oct-17,1709,1659,50,2.9
CN4606100000000,46,061,Hanson County, SD,Nov-17,1712,1645,67,3.9
CN4606100000000,46,061,Hanson County, SD,Dec-17,1740,1654,86,4.9
CN4606100000000,46,061,Hanson County, SD,Jan-18,1763,1652,111,6.3
CN4606100000000,46,061,Hanson County, SD,Feb-18,1766,1645,121,6.9
CN4606100000000,46,061,Hanson County, SD,Mar-18,1775,1663,112,6.3
CN4606100000000,46,061,Hanson County, SD,Apr-18(p),1722,1643,79,4.6
CN5109900000000,51,099,King George County, VA,Mar-17,12449,11916,533,4.3
CN5109900000000,51,099,King George County, VA,Apr-17,12403,11932,471,3.8
CN5109900000000,51,099,King George County, VA,May-17,12348,11863,485,3.9
CN5109900000000,51,099,King George County, VA,Jun-17,12423,11933,490,3.9
CN5109900000000,51,099,King George County, VA,Jul-17,12556,12056,500,4.0
CN5109900000000,51,099,King George County, VA,Aug-17,12395,11893,502,4.1
CN5109900000000,51,099,King George County, VA,Sep-17,12357,11890,467,3.8
CN5109900000000,51,099,King George County, VA,Oct-17,12273,11834,439,3.6
CN5109900000000,51,099,King George County, VA,Nov-17,12223,11780,443,3.6
CN5109900000000,51,099,King George County, VA,Dec-17,12168,11746,422,3.5
CN5109900000000,51,099,King George County, VA,Jan-18,12339,11849,490,4.0
CN5109900000000,51,099,King George County, VA,Feb-18,12367,11925,442,3.6
CN5109900000000,51,099,King George County, VA,Mar-18,12415,11976,439,3.5
CN5109900000000,51,099,King George County, VA,Apr-18(p),12411,12028,383,3.1
CN3707300000000,37,073,Gates County, NC,Mar-17,5270,5021,249,4.7
CN3707300000000,37,073,Gates County, NC,Apr-17,5245,5044,201,3.8
CN3707300000000,37,073,Gates County, NC,May-17,5236,5007,229,4.4
CN3707300000000,37,073,Gates County, NC,Jun-17,5270,5038,232,4.4
CN3707300000000,37,073,Gates County, NC,Jul-17,5401,5153,248,4.6
CN3707300000000,37,073,Gates County, NC,Aug-17,5257,5012,245,4.7
CN3707300000000,37,073,Gates County, NC,Sep-17,5279,5062,217,4.1
CN3707300000000,37,073,Gates County, NC,Oct-17,5220,5010,210,4.0
CN3707300000000,37,073,Gates County, NC,Nov-17,5180,4949,231,4.5
CN3707300000000,37,073,Gates County, NC,Dec-17,5148,4927,221,4.3
CN3707300000000,37,073,Gates County, NC,Jan-18,5132,4899,233,4.5
CN3707300000000,37,073,Gates County, NC,Feb-18,5239,4990,249,4.8
CN3707300000000,37,073,Gates County, NC,Mar-18,5235,5002,233,4.5
CN3707300000000,37,073,Gates County, NC,Apr-18(p),5231,5035,196,3.7
CN0808500000000,08,085,Montrose County, CO,Mar-17,20292,19516,776,3.8
CN0808500000000,08,085,Montrose County, CO,Apr-17,20705,20027,678,3.3
CN0808500000000,08,085,Montrose County, CO,May-17,20890,20289,601,2.9
CN0808500000000,08,085,Montrose County, CO,Jun-17,20946,20267,679,3.2
CN0808500000000,08,085,Montrose County, CO,Jul-17,21342,20699,643,3.0
CN0808500000000,08,085,Montrose County, CO,Aug-17,21210,20591,619,2.9
CN0808500000000,08,085,Montrose County, CO,Sep-17,21200,20624,576,2.7
CN0808500000000,08,085,Montrose County, CO,Oct-17,21621,21026,595,2.8
CN0808500000000,08,085,Montrose County, CO,Nov-17,21440,20794,646,3.0
CN0808500000000,08,085,Montrose County, CO,Dec-17,21087,20365,722,3.4
CN0808500000000,08,085,Montrose County, CO,Jan-18,20982,20101,881,4.2
CN0808500000000,08,085,Montrose County, CO,Feb-18,21081,20154,927,4.4
CN0808500000000,08,085,Montrose County, CO,Mar-18,21210,20370,840,4.0
CN0808500000000,08,085,Montrose County, CO,Apr-18(p),21536,20856,680,3.2
CN1903300000000,19,033,Cerro Gordo County, IA,Mar-17,23143,22297,846,3.7
CN1903300000000,19,033,Cerro Gordo County, IA,Apr-17,23118,22431,687,3.0
CN1903300000000,19,033,Cerro Gordo County, IA,May-17,23274,22617,657,2.8
CN1903300000000,19,033,Cerro Gordo County, IA,Jun-17,23704,22965,739,3.1
CN1903300000000,19,033,Cerro Gordo County, IA,Jul-17,23612,22904,708,3.0
CN1903300000000,19,033,Cerro Gordo County, IA,Aug-17,23330,22583,747,3.2
CN1903300000000,19,033,Cerro Gordo County, IA,Sep-17,23095,22457,638,2.8
CN1903300000000,19,033,Cerro Gordo County, IA,Oct-17,23060,22529,531,2.3
CN1903300000000,19,033,Cerro Gordo County, IA,Nov-17,23092,22506,586,2.5
CN1903300000000,19,033,Cerro Gordo County, IA,Dec-17,22982,22323,659,2.9
CN1903300000000,19,033,Cerro Gordo County, IA,Jan-18,22964,22193,771,3.4
CN1903300000000,19,033,Cerro Gordo County, IA,Feb-18,23088,22346,742,3.2
CN1903300000000,19,033,Cerro Gordo County, IA,Mar-18,23185,22467,718,3.1
CN1903300000000,19,033,Cerro Gordo County, IA,Apr-18(p),23224,22608,616,2.7
CN1606100000000,16,061,Lewis County, ID,Mar-17,1568,1437,131,8.4
CN1606100000000,16,061,Lewis County, ID,Apr-17,1619,1512,107,6.6
CN1606100000000,16,061,Lewis County, ID,May-17,1637,1557,80,4.9
CN1606100000000,16,061,Lewis County, ID,Jun-17,1669,1585,84,5.0
CN1606100000000,16,061,Lewis County, ID,Jul-17,1695,1599,96,5.7
CN1606100000000,16,061,Lewis County, ID,Aug-17,1686,1595,91,5.4
CN1606100000000,16,061,Lewis County, ID,Sep-17,1633,1553,80,4.9
CN1606100000000,16,061,Lewis County, ID,Oct-17,1593,1523,70,4.4
CN1606100000000,16,061,Lewis County, ID,Nov-17,1555,1477,78,5.0
CN1606100000000,16,061,Lewis County, ID,Dec-17,1519,1442,77,5.1
CN1606100000000,16,061,Lewis County, ID,Jan-18,1538,1432,106,6.9
CN1606100000000,16,061,Lewis County, ID,Feb-18,1551,1447,104,6.7
CN1606100000000,16,061,Lewis County, ID,Mar-18,1575,1469,106,6.7
CN1606100000000,16,061,Lewis County, ID,Apr-18(p),1638,1541,97,5.9
CN4836500000000,48,365,Panola County, TX,Mar-17,10669,10031,638,6.0
CN4836500000000,48,365,Panola County, TX,Apr-17,10341,9779,562,5.4
CN4836500000000,48,365,Panola County, TX,May-17,10284,9735,549,5.3
CN4836500000000,48,365,Panola County, TX,Jun-17,10306,9702,604,5.9
CN4836500000000,48,365,Panola County, TX,Jul-17,10315,9735,580,5.6
CN4836500000000,48,365,Panola County, TX,Aug-17,10485,9899,586,5.6
CN4836500000000,48,365,Panola County, TX,Sep-17,10504,10026,478,4.6
CN4836500000000,48,365,Panola County, TX,Oct-17,10184,9744,440,4.3
CN4836500000000,48,365,Panola County, TX,Nov-17,10072,9617,455,4.5
CN4836500000000,48,365,Panola County, TX,Dec-17,10056,9610,446,4.4
CN4836500000000,48,365,Panola County, TX,Jan-18,10068,9555,513,5.1
CN4836500000000,48,365,Panola County, TX,Feb-18,10223,9722,501,4.9
CN4836500000000,48,365,Panola County, TX,Mar-18,10298,9797,501,4.9
CN4836500000000,48,365,Panola County, TX,Apr-18(p),10486,10019,467,4.5
CN5158000000000,51,580,Covington city, VA,Mar-17,2429,2267,162,6.7
CN5158000000000,51,580,Covington city, VA,Apr-17,2398,2262,136,5.7
CN5158000000000,51,580,Covington city, VA,May-17,2403,2270,133,5.5
CN5158000000000,51,580,Covington city, VA,Jun-17,2385,2250,135,5.7
CN5158000000000,51,580,Covington city, VA,Jul-17,2346,2191,155,6.6
CN5158000000000,51,580,Covington city, VA,Aug-17,2356,2206,150,6.4
CN5158000000000,51,580,Covington city, VA,Sep-17,2382,2252,130,5.5
CN5158000000000,51,580,Covington city, VA,Oct-17,2344,2230,114,4.9
CN5158000000000,51,580,Covington city, VA,Nov-17,2334,2207,127,5.4
CN5158000000000,51,580,Covington city, VA,Dec-17,2354,2200,154,6.5
CN5158000000000,51,580,Covington city, VA,Jan-18,2357,2188,169,7.2
CN5158000000000,51,580,Covington city, VA,Feb-18,2359,2202,157,6.7
CN5158000000000,51,580,Covington city, VA,Mar-18,2369,2234,135,5.7
CN5158000000000,51,580,Covington city, VA,Apr-18(p),2368,2266,102,4.3
CN1310100000000,13,101,Echols County, GA,Mar-17,1924,1852,72,3.7
CN1310100000000,13,101,Echols County, GA,Apr-17,1913,1846,67,3.5
CN1310100000000,13,101,Echols County, GA,May-17,1941,1867,74,3.8
CN1310100000000,13,101,Echols County, GA,Jun-17,1966,1888,78,4.0
CN1310100000000,13,101,Echols County, GA,Jul-17,1911,1833,78,4.1
CN1310100000000,13,101,Echols County, GA,Aug-17,1907,1836,71,3.7
CN1310100000000,13,101,Echols County, GA,Sep-17,1896,1826,70,3.7
CN1310100000000,13,101,Echols County, GA,Oct-17,1945,1873,72,3.7
CN1310100000000,13,101,Echols County, GA,Nov-17,1958,1891,67,3.4
CN1310100000000,13,101,Echols County, GA,Dec-17,1957,1893,64,3.3
CN1310100000000,13,101,Echols County, GA,Jan-18,1995,1929,66,3.3
CN1310100000000,13,101,Echols County, GA,Feb-18,1915,1847,68,3.6
CN1310100000000,13,101,Echols County, GA,Mar-18,1917,1854,63,3.3
CN1310100000000,13,101,Echols County, GA,Apr-18(p),1910,1859,51,2.7
CN1702300000000,17,023,Clark County, IL,Mar-17,7918,7524,394,5.0
CN1702300000000,17,023,Clark County, IL,Apr-17,7910,7593,317,4.0
CN1702300000000,17,023,Clark County, IL,May-17,7969,7656,313,3.9
CN1702300000000,17,023,Clark County, IL,Jun-17,7956,7607,349,4.4
CN1702300000000,17,023,Clark County, IL,Jul-17,7909,7529,380,4.8
CN1702300000000,17,023,Clark County, IL,Aug-17,7853,7475,378,4.8
CN1702300000000,17,023,Clark County, IL,Sep-17,7759,7435,324,4.2
CN1702300000000,17,023,Clark County, IL,Oct-17,7726,7400,326,4.2
CN1702300000000,17,023,Clark County, IL,Nov-17,7690,7323,367,4.8
CN1702300000000,17,023,Clark County, IL,Dec-17,7641,7281,360,4.7
CN1702300000000,17,023,Clark County, IL,Jan-18,7652,7239,413,5.4
CN1702300000000,17,023,Clark County, IL,Feb-18,7667,7273,394,5.1
CN1702300000000,17,023,Clark County, IL,Mar-18,7827,7443,384,4.9
CN1702300000000,17,023,Clark County, IL,Apr-18(p),7889,7580,309,3.9
CN2104900000000,21,049,Clark County, KY,Mar-17,17261,16371,890,5.2
CN2104900000000,21,049,Clark County, KY,Apr-17,17342,16559,783,4.5
CN2104900000000,21,049,Clark County, KY,May-17,17301,16493,808,4.7
CN2104900000000,21,049,Clark County, KY,Jun-17,17439,16552,887,5.1
CN2104900000000,21,049,Clark County, KY,Jul-17,17284,16425,859,5.0
CN2104900000000,21,049,Clark County, KY,Aug-17,17124,16331,793,4.6
CN2104900000000,21,049,Clark County, KY,Sep-17,17235,16509,726,4.2
CN2104900000000,21,049,Clark County, KY,Oct-17,17215,16547,668,3.9
CN2104900000000,21,049,Clark County, KY,Nov-17,17273,16638,635,3.7
CN2104900000000,21,049,Clark County, KY,Dec-17,17251,16607,644,3.7
CN2104900000000,21,049,Clark County, KY,Jan-18,17135,16441,694,4.1
CN2104900000000,21,049,Clark County, KY,Feb-18,17178,16391,787,4.6
CN2104900000000,21,049,Clark County, KY,Mar-18,17267,16528,739,4.3
CN2104900000000,21,049,Clark County, KY,Apr-18(p),17409,16765,644,3.7
CN0501900000000,05,019,Clark County, AR,Mar-17,9492,9151,341,3.6
CN0501900000000,05,019,Clark County, AR,Apr-17,9497,9173,324,3.4
CN0501900000000,05,019,Clark County, AR,May-17,9508,9139,369,3.9
CN0501900000000,05,019,Clark County, AR,Jun-17,9322,8884,438,4.7
CN0501900000000,05,019,Clark County, AR,Jul-17,9335,8880,455,4.9
CN0501900000000,05,019,Clark County, AR,Aug-17,9327,8933,394,4.2
CN0501900000000,05,019,Clark County, AR,Sep-17,9541,9191,350,3.7
CN0501900000000,05,019,Clark County, AR,Oct-17,9722,9377,345,3.5
CN0501900000000,05,019,Clark County, AR,Nov-17,9663,9340,323,3.3
CN0501900000000,05,019,Clark County, AR,Dec-17,9611,9271,340,3.5
CN0501900000000,05,019,Clark County, AR,Jan-18,9339,8925,414,4.4
CN0501900000000,05,019,Clark County, AR,Feb-18,9498,9096,402,4.2
CN0501900000000,05,019,Clark County, AR,Mar-18,9549,9175,374,3.9
CN0501900000000,05,019,Clark County, AR,Apr-18(p),9489,9180,309,3.3
CN4002300000000,40,023,Choctaw County, OK,Mar-17,5732,5372,360,6.3
CN4002300000000,40,023,Choctaw County, OK,Apr-17,5692,5389,303,5.3
CN4002300000000,40,023,Choctaw County, OK,May-17,5684,5344,340,6.0
CN4002300000000,40,023,Choctaw County, OK,Jun-17,5678,5306,372,6.6
CN4002300000000,40,023,Choctaw County, OK,Jul-17,5666,5323,343,6.1
CN4002300000000,40,023,Choctaw County, OK,Aug-17,5689,5354,335,5.9
CN4002300000000,40,023,Choctaw County, OK,Sep-17,5693,5392,301,5.3
CN4002300000000,40,023,Choctaw County, OK,Oct-17,5751,5441,310,5.4
CN4002300000000,40,023,Choctaw County, OK,Nov-17,5799,5473,326,5.6
CN4002300000000,40,023,Choctaw County, OK,Dec-17,5793,5421,372,6.4
CN4002300000000,40,023,Choctaw County, OK,Jan-18,5789,5396,393,6.8
CN4002300000000,40,023,Choctaw County, OK,Feb-18,5727,5384,343,6.0
CN4002300000000,40,023,Choctaw County, OK,Mar-18,5720,5394,326,5.7
CN4002300000000,40,023,Choctaw County, OK,Apr-18(p),5638,5326,312,5.5
CN3300900000000,33,009,Grafton County, NH,Mar-17,48791,47591,1200,2.5
CN3300900000000,33,009,Grafton County, NH,Apr-17,47329,46313,1016,2.1
CN3300900000000,33,009,Grafton County, NH,May-17,47408,46363,1045,2.2
CN3300900000000,33,009,Grafton County, NH,Jun-17,48306,47284,1022,2.1
CN3300900000000,33,009,Grafton County, NH,Jul-17,50023,48961,1062,2.1
CN3300900000000,33,009,Grafton County, NH,Aug-17,49687,48665,1022,2.1
CN3300900000000,33,009,Grafton County, NH,Sep-17,48819,47807,1012,2.1
CN3300900000000,33,009,Grafton County, NH,Oct-17,48270,47378,892,1.8
CN3300900000000,33,009,Grafton County, NH,Nov-17,47674,46687,987,2.1
CN3300900000000,33,009,Grafton County, NH,Dec-17,48067,47194,873,1.8
CN3300900000000,33,009,Grafton County, NH,Jan-18,48313,47158,1155,2.4
CN3300900000000,33,009,Grafton County, NH,Feb-18,49179,48004,1175,2.4
CN3300900000000,33,009,Grafton County, NH,Mar-18,49404,48217,1187,2.4
CN3300900000000,33,009,Grafton County, NH,Apr-18(p),48090,47008,1082,2.2
CN3803500000000,38,035,Grand Forks County, ND,Mar-17,39575,38519,1056,2.7
CN3803500000000,38,035,Grand Forks County, ND,Apr-17,39181,38315,866,2.2
CN3803500000000,38,035,Grand Forks County, ND,May-17,39226,38512,714,1.8
CN3803500000000,38,035,Grand Forks County, ND,Jun-17,39671,38662,1009,2.5
CN3803500000000,38,035,Grand Forks County, ND,Jul-17,38884,38034,850,2.2
CN3803500000000,38,035,Grand Forks County, ND,Aug-17,38859,38016,843,2.2
CN3803500000000,38,035,Grand Forks County, ND,Sep-17,39171,38478,693,1.8
CN3803500000000,38,035,Grand Forks County, ND,Oct-17,38798,38233,565,1.5
CN3803500000000,38,035,Grand Forks County, ND,Nov-17,38979,38224,755,1.9
CN3803500000000,38,035,Grand Forks County, ND,Dec-17,38939,38108,831,2.1
CN3803500000000,38,035,Grand Forks County, ND,Jan-18,39301,38237,1064,2.7
CN3803500000000,38,035,Grand Forks County, ND,Feb-18,39492,38452,1040,2.6
CN3803500000000,38,035,Grand Forks County, ND,Mar-18,39405,38398,1007,2.6
CN3803500000000,38,035,Grand Forks County, ND,Apr-18(p),39072,38159,913,2.3
CN4702300000000,47,023,Chester County, TN,Mar-17,8519,8182,337,4.0
CN4702300000000,47,023,Chester County, TN,Apr-17,8409,8110,299,3.6
CN4702300000000,47,023,Chester County, TN,May-17,8370,8078,292,3.5
CN4702300000000,47,023,Chester County, TN,Jun-17,8604,8196,408,4.7
CN4702300000000,47,023,Chester County, TN,Jul-17,8708,8324,384,4.4
CN4702300000000,47,023,Chester County, TN,Aug-17,8607,8245,362,4.2
CN4702300000000,47,023,Chester County, TN,Sep-17,8580,8279,301,3.5
CN4702300000000,47,023,Chester County, TN,Oct-17,8506,8224,282,3.3
CN4702300000000,47,023,Chester County, TN,Nov-17,8512,8220,292,3.4
CN4702300000000,47,023,Chester County, TN,Dec-17,8523,8243,280,3.3
CN4702300000000,47,023,Chester County, TN,Jan-18,8449,8094,355,4.2
CN4702300000000,47,023,Chester County, TN,Feb-18,8589,8263,326,3.8
CN4702300000000,47,023,Chester County, TN,Mar-18,8579,8262,317,3.7
CN4702300000000,47,023,Chester County, TN,Apr-18(p),8640,8373,267,3.1
CN3003700000000,30,037,Golden Valley County, MT,Mar-17,379,356,23,6.1
CN3003700000000,30,037,Golden Valley County, MT,Apr-17,387,366,21,5.4
CN3003700000000,30,037,Golden Valley County, MT,May-17,385,370,15,3.9
CN3003700000000,30,037,Golden Valley County, MT,Jun-17,384,365,19,4.9
CN3003700000000,30,037,Golden Valley County, MT,Jul-17,386,372,14,3.6
CN3003700000000,30,037,Golden Valley County, MT,Aug-17,381,366,15,3.9
CN3003700000000,30,037,Golden Valley County, MT,Sep-17,372,358,14,3.8
CN3003700000000,30,037,Golden Valley County, MT,Oct-17,375,359,16,4.3
CN3003700000000,30,037,Golden Valley County, MT,Nov-17,373,355,18,4.8
CN3003700000000,30,037,Golden Valley County, MT,Dec-17,375,351,24,6.4
CN3003700000000,30,037,Golden Valley County, MT,Jan-18,375,351,24,6.4
CN3003700000000,30,037,Golden Valley County, MT,Feb-18,378,351,27,7.1
CN3003700000000,30,037,Golden Valley County, MT,Mar-18,370,349,21,5.7
CN3003700000000,30,037,Golden Valley County, MT,Apr-18(p),367,353,14,3.8
CN0512500000000,05,125,Saline County, AR,Mar-17,57230,55582,1648,2.9
CN0512500000000,05,125,Saline County, AR,Apr-17,57456,55945,1511,2.6
CN0512500000000,05,125,Saline County, AR,May-17,57699,56011,1688,2.9
CN0512500000000,05,125,Saline County, AR,Jun-17,58386,56536,1850,3.2
CN0512500000000,05,125,Saline County, AR,Jul-17,59349,57377,1972,3.3
CN0512500000000,05,125,Saline County, AR,Aug-17,58462,56692,1770,3.0
CN0512500000000,05,125,Saline County, AR,Sep-17,58293,56570,1723,3.0
CN0512500000000,05,125,Saline County, AR,Oct-17,57898,56358,1540,2.7
CN0512500000000,05,125,Saline County, AR,Nov-17,57740,56179,1561,2.7
CN0512500000000,05,125,Saline County, AR,Dec-17,57334,55642,1692,3.0
CN0512500000000,05,125,Saline County, AR,Jan-18,56696,54697,1999,3.5
CN0512500000000,05,125,Saline County, AR,Feb-18,57357,55345,2012,3.5
CN0512500000000,05,125,Saline County, AR,Mar-18,57774,55902,1872,3.2
CN0512500000000,05,125,Saline County, AR,Apr-18(p),57465,55779,1686,2.9
CN3607500000000,36,075,Oswego County, NY,Mar-17,53539,49855,3684,6.9
CN3607500000000,36,075,Oswego County, NY,Apr-17,53444,50119,3325,6.2
CN3607500000000,36,075,Oswego County, NY,May-17,52988,49760,3228,6.1
CN3607500000000,36,075,Oswego County, NY,Jun-17,53742,50383,3359,6.3
CN3607500000000,36,075,Oswego County, NY,Jul-17,53665,50371,3294,6.1
CN3607500000000,36,075,Oswego County, NY,Aug-17,53160,49934,3226,6.1
CN3607500000000,36,075,Oswego County, NY,Sep-17,53356,50120,3236,6.1
CN3607500000000,36,075,Oswego County, NY,Oct-17,52996,49944,3052,5.8
CN3607500000000,36,075,Oswego County, NY,Nov-17,53178,49825,3353,6.3
CN3607500000000,36,075,Oswego County, NY,Dec-17,52745,49109,3636,6.9
CN3607500000000,36,075,Oswego County, NY,Jan-18,53279,48938,4341,8.1
CN3607500000000,36,075,Oswego County, NY,Feb-18,53020,48658,4362,8.2
CN3607500000000,36,075,Oswego County, NY,Mar-18,52549,48656,3893,7.4
CN3607500000000,36,075,Oswego County, NY,Apr-18(p),52720,49477,3243,6.2
CN2109900000000,21,099,Hart County, KY,Mar-17,8407,7984,423,5.0
CN2109900000000,21,099,Hart County, KY,Apr-17,8417,8049,368,4.4
CN2109900000000,21,099,Hart County, KY,May-17,8402,8042,360,4.3
CN2109900000000,21,099,Hart County, KY,Jun-17,8498,8098,400,4.7
CN2109900000000,21,099,Hart County, KY,Jul-17,8181,7783,398,4.9
CN2109900000000,21,099,Hart County, KY,Aug-17,8155,7807,348,4.3
CN2109900000000,21,099,Hart County, KY,Sep-17,8149,7837,312,3.8
CN2109900000000,21,099,Hart County, KY,Oct-17,8190,7902,288,3.5
CN2109900000000,21,099,Hart County, KY,Nov-17,8129,7845,284,3.5
CN2109900000000,21,099,Hart County, KY,Dec-17,8179,7891,288,3.5
CN2109900000000,21,099,Hart County, KY,Jan-18,8294,7964,330,4.0
CN2109900000000,21,099,Hart County, KY,Feb-18,8260,7903,357,4.3
CN2109900000000,21,099,Hart County, KY,Mar-18,8410,8082,328,3.9
CN2109900000000,21,099,Hart County, KY,Apr-18(p),8412,8122,290,3.4
CN4802100000000,48,021,Bastrop County, TX,Mar-17,40068,38516,1552,3.9
CN4802100000000,48,021,Bastrop County, TX,Apr-17,40022,38753,1269,3.2
CN4802100000000,48,021,Bastrop County, TX,May-17,40052,38738,1314,3.3
CN4802100000000,48,021,Bastrop County, TX,Jun-17,40264,38712,1552,3.9
CN4802100000000,48,021,Bastrop County, TX,Jul-17,40334,38751,1583,3.9
CN4802100000000,48,021,Bastrop County, TX,Aug-17,40179,38578,1601,4.0
CN4802100000000,48,021,Bastrop County, TX,Sep-17,40302,38981,1321,3.3
CN4802100000000,48,021,Bastrop County, TX,Oct-17,40158,38935,1223,3.0
CN4802100000000,48,021,Bastrop County, TX,Nov-17,40483,39211,1272,3.1
CN4802100000000,48,021,Bastrop County, TX,Dec-17,40430,39225,1205,3.0
CN4802100000000,48,021,Bastrop County, TX,Jan-18,40614,39252,1362,3.4
CN4802100000000,48,021,Bastrop County, TX,Feb-18,41299,39902,1397,3.4
CN4802100000000,48,021,Bastrop County, TX,Mar-18,41597,40048,1549,3.7
CN4802100000000,48,021,Bastrop County, TX,Apr-18(p),41419,40141,1278,3.1
CN2613700000000,26,137,Otsego County, MI,Mar-17,11379,10600,779,6.8
CN2613700000000,26,137,Otsego County, MI,Apr-17,11395,10715,680,6.0
CN2613700000000,26,137,Otsego County, MI,May-17,11740,11127,613,5.2
CN2613700000000,26,137,Otsego County, MI,Jun-17,12166,11475,691,5.7
CN2613700000000,26,137,Otsego County, MI,Jul-17,12232,11413,819,6.7
CN2613700000000,26,137,Otsego County, MI,Aug-17,12108,11375,733,6.1
CN2613700000000,26,137,Otsego County, MI,Sep-17,11748,11131,617,5.3
CN2613700000000,26,137,Otsego County, MI,Oct-17,11505,10919,586,5.1
CN2613700000000,26,137,Otsego County, MI,Nov-17,11339,10686,653,5.8
CN2613700000000,26,137,Otsego County, MI,Dec-17,11519,10739,780,6.8
CN2613700000000,26,137,Otsego County, MI,Jan-18,11553,10710,843,7.3
CN2613700000000,26,137,Otsego County, MI,Feb-18,11538,10681,857,7.4
CN2613700000000,26,137,Otsego County, MI,Mar-18,11452,10697,755,6.6
CN2613700000000,26,137,Otsego County, MI,Apr-18(p),11492,10776,716,6.2
CN4714900000000,47,149,Rutherford County, TN,Mar-17,168355,163116,5239,3.1
CN4714900000000,47,149,Rutherford County, TN,Apr-17,168560,164093,4467,2.7
CN4714900000000,47,149,Rutherford County, TN,May-17,169212,164705,4507,2.7
CN4714900000000,47,149,Rutherford County, TN,Jun-17,172078,166418,5660,3.3
CN4714900000000,47,149,Rutherford County, TN,Jul-17,172719,167364,5355,3.1
CN4714900000000,47,149,Rutherford County, TN,Aug-17,170347,165332,5015,2.9
CN4714900000000,47,149,Rutherford County, TN,Sep-17,171899,167512,4387,2.6
CN4714900000000,47,149,Rutherford County, TN,Oct-17,171469,167318,4151,2.4
CN4714900000000,47,149,Rutherford County, TN,Nov-17,171115,166868,4247,2.5
CN4714900000000,47,149,Rutherford County, TN,Dec-17,170577,166639,3938,2.3
CN4714900000000,47,149,Rutherford County, TN,Jan-18,170111,165440,4671,2.7
CN4714900000000,47,149,Rutherford County, TN,Feb-18,172123,167547,4576,2.7
CN4714900000000,47,149,Rutherford County, TN,Mar-18,172686,168170,4516,2.6
CN4714900000000,47,149,Rutherford County, TN,Apr-18(p),173735,169944,3791,2.2
CN5305900000000,53,059,Skamania County, WA,Mar-17,5212,4875,337,6.5
CN5305900000000,53,059,Skamania County, WA,Apr-17,5183,4885,298,5.7
CN5305900000000,53,059,Skamania County, WA,May-17,5151,4865,286,5.6
CN5305900000000,53,059,Skamania County, WA,Jun-17,5174,4887,287,5.5
CN5305900000000,53,059,Skamania County, WA,Jul-17,5164,4873,291,5.6
CN5305900000000,53,059,Skamania County, WA,Aug-17,5185,4879,306,5.9
CN5305900000000,53,059,Skamania County, WA,Sep-17,5195,4912,283,5.4
CN5305900000000,53,059,Skamania County, WA,Oct-17,5231,4964,267,5.1
CN5305900000000,53,059,Skamania County, WA,Nov-17,5280,4981,299,5.7
CN5305900000000,53,059,Skamania County, WA,Dec-17,5317,4975,342,6.4
CN5305900000000,53,059,Skamania County, WA,Jan-18,5227,4860,367,7.0
CN5305900000000,53,059,Skamania County, WA,Feb-18,5240,4853,387,7.4
CN5305900000000,53,059,Skamania County, WA,Mar-18,5231,4898,333,6.4
CN5305900000000,53,059,Skamania County, WA,Apr-18(p),5173,4873,300,5.8
CN2014900000000,20,149,Pottawatomie County, KS,Mar-17,12424,12045,379,3.1
CN2014900000000,20,149,Pottawatomie County, KS,Apr-17,12479,12124,355,2.8
CN2014900000000,20,149,Pottawatomie County, KS,May-17,12181,11807,374,3.1
CN2014900000000,20,149,Pottawatomie County, KS,Jun-17,11911,11507,404,3.4
CN2014900000000,20,149,Pottawatomie County, KS,Jul-17,11695,11265,430,3.7
CN2014900000000,20,149,Pottawatomie County, KS,Aug-17,11523,11136,387,3.4
CN2014900000000,20,149,Pottawatomie County, KS,Sep-17,12398,12061,337,2.7
CN2014900000000,20,149,Pottawatomie County, KS,Oct-17,12520,12224,296,2.4
CN2014900000000,20,149,Pottawatomie County, KS,Nov-17,12463,12151,312,2.5
CN2014900000000,20,149,Pottawatomie County, KS,Dec-17,12246,11931,315,2.6
CN2014900000000,20,149,Pottawatomie County, KS,Jan-18,11455,11108,347,3.0
CN2014900000000,20,149,Pottawatomie County, KS,Feb-18,12461,12101,360,2.9
CN2014900000000,20,149,Pottawatomie County, KS,Mar-18,12376,12042,334,2.7
CN2014900000000,20,149,Pottawatomie County, KS,Apr-18(p),12433,12118,315,2.5
CN2210900000000,22,109,Terrebonne Parish, LA,Mar-17,47072,44107,2965,6.3
CN2210900000000,22,109,Terrebonne Parish, LA,Apr-17,46930,44184,2746,5.9
CN2210900000000,22,109,Terrebonne Parish, LA,May-17,47186,44441,2745,5.8
CN2210900000000,22,109,Terrebonne Parish, LA,Jun-17,47832,44872,2960,6.2
CN2210900000000,22,109,Terrebonne Parish, LA,Jul-17,47972,45190,2782,5.8
CN2210900000000,22,109,Terrebonne Parish, LA,Aug-17,47289,44532,2757,5.8
CN2210900000000,22,109,Terrebonne Parish, LA,Sep-17,47211,44680,2531,5.4
CN2210900000000,22,109,Terrebonne Parish, LA,Oct-17,46954,44777,2177,4.6
CN2210900000000,22,109,Terrebonne Parish, LA,Nov-17,46829,44724,2105,4.5
CN2210900000000,22,109,Terrebonne Parish, LA,Dec-17,46532,44525,2007,4.3
CN2210900000000,22,109,Terrebonne Parish, LA,Jan-18,46725,44517,2208,4.7
CN2210900000000,22,109,Terrebonne Parish, LA,Feb-18,47247,45235,2012,4.3
CN2210900000000,22,109,Terrebonne Parish, LA,Mar-18,47285,45145,2140,4.5
CN2210900000000,22,109,Terrebonne Parish, LA,Apr-18(p),47166,45008,2158,4.6
CN4903300000000,49,033,Rich County, UT,Mar-17,1015,970,45,4.4
CN4903300000000,49,033,Rich County, UT,Apr-17,1021,979,42,4.1
CN4903300000000,49,033,Rich County, UT,May-17,1089,1053,36,3.3
CN4903300000000,49,033,Rich County, UT,Jun-17,1321,1283,38,2.9
CN4903300000000,49,033,Rich County, UT,Jul-17,1540,1506,34,2.2
CN4903300000000,49,033,Rich County, UT,Aug-17,1478,1444,34,2.3
CN4903300000000,49,033,Rich County, UT,Sep-17,1301,1272,29,2.2
CN4903300000000,49,033,Rich County, UT,Oct-17,1128,1100,28,2.5
CN4903300000000,49,033,Rich County, UT,Nov-17,1050,1016,34,3.2
CN4903300000000,49,033,Rich County, UT,Dec-17,1028,991,37,3.6
CN4903300000000,49,033,Rich County, UT,Jan-18,1011,960,51,5.0
CN4903300000000,49,033,Rich County, UT,Feb-18,997,947,50,5.0
CN4903300000000,49,033,Rich County, UT,Mar-18,1045,1002,43,4.1
CN4903300000000,49,033,Rich County, UT,Apr-18(p),1034,1001,33,3.2
CN4809900000000,48,099,Coryell County, TX,Mar-17,24683,23543,1140,4.6
CN4809900000000,48,099,Coryell County, TX,Apr-17,24723,23710,1013,4.1
CN4809900000000,48,099,Coryell County, TX,May-17,24748,23729,1019,4.1
CN4809900000000,48,099,Coryell County, TX,Jun-17,24673,23596,1077,4.4
CN4809900000000,48,099,Coryell County, TX,Jul-17,24706,23627,1079,4.4
CN4809900000000,48,099,Coryell County, TX,Aug-17,24675,23590,1085,4.4
CN4809900000000,48,099,Coryell County, TX,Sep-17,24782,23786,996,4.0
CN4809900000000,48,099,Coryell County, TX,Oct-17,24613,23687,926,3.8
CN4809900000000,48,099,Coryell County, TX,Nov-17,24738,23760,978,4.0
CN4809900000000,48,099,Coryell County, TX,Dec-17,24606,23692,914,3.7
CN4809900000000,48,099,Coryell County, TX,Jan-18,24703,23658,1045,4.2
CN4809900000000,48,099,Coryell County, TX,Feb-18,25023,23987,1036,4.1
CN4809900000000,48,099,Coryell County, TX,Mar-18,25078,24033,1045,4.2
CN4809900000000,48,099,Coryell County, TX,Apr-18(p),25107,24154,953,3.8
CN3908300000000,39,083,Knox County, OH,Mar-17,31519,30069,1450,4.6
CN3908300000000,39,083,Knox County, OH,Apr-17,31396,30184,1212,3.9
CN3908300000000,39,083,Knox County, OH,May-17,31347,30149,1198,3.8
CN3908300000000,39,083,Knox County, OH,Jun-17,31436,29983,1453,4.6
CN3908300000000,39,083,Knox County, OH,Jul-17,31148,29636,1512,4.9
CN3908300000000,39,083,Knox County, OH,Aug-17,31449,30018,1431,4.6
CN3908300000000,39,083,Knox County, OH,Sep-17,31468,30190,1278,4.1
CN3908300000000,39,083,Knox County, OH,Oct-17,31447,30175,1272,4.0
CN3908300000000,39,083,Knox County, OH,Nov-17,31369,30040,1329,4.2
CN3908300000000,39,083,Knox County, OH,Dec-17,30952,29593,1359,4.4
CN3908300000000,39,083,Knox County, OH,Jan-18,30228,28690,1538,5.1
CN3908300000000,39,083,Knox County, OH,Feb-18,31150,29774,1376,4.4
CN3908300000000,39,083,Knox County, OH,Mar-18,31516,30183,1333,4.2
CN3908300000000,39,083,Knox County, OH,Apr-18(p),31423,30232,1191,3.8
CN4807100000000,48,071,Chambers County, TX,Mar-17,18486,17238,1248,6.8
CN4807100000000,48,071,Chambers County, TX,Apr-17,18490,17314,1176,6.4
CN4807100000000,48,071,Chambers County, TX,May-17,18414,17275,1139,6.2
CN4807100000000,48,071,Chambers County, TX,Jun-17,18508,17273,1235,6.7
CN4807100000000,48,071,Chambers County, TX,Jul-17,18591,17361,1230,6.6
CN4807100000000,48,071,Chambers County, TX,Aug-17,18510,17255,1255,6.8
CN4807100000000,48,071,Chambers County, TX,Sep-17,18612,17406,1206,6.5
CN4807100000000,48,071,Chambers County, TX,Oct-17,18423,17372,1051,5.7
CN4807100000000,48,071,Chambers County, TX,Nov-17,18558,17482,1076,5.8
CN4807100000000,48,071,Chambers County, TX,Dec-17,18598,17500,1098,5.9
CN4807100000000,48,071,Chambers County, TX,Jan-18,18660,17439,1221,6.5
CN4807100000000,48,071,Chambers County, TX,Feb-18,18881,17696,1185,6.3
CN4807100000000,48,071,Chambers County, TX,Mar-18,18810,17706,1104,5.9
CN4807100000000,48,071,Chambers County, TX,Apr-18(p),18884,17844,1040,5.5
CN3400700000000,34,007,Camden County, NJ,Mar-17,257319,244569,12750,5.0
CN3400700000000,34,007,Camden County, NJ,Apr-17,256648,244909,11739,4.6
CN3400700000000,34,007,Camden County, NJ,May-17,256073,243719,12354,4.8
CN3400700000000,34,007,Camden County, NJ,Jun-17,258084,244793,13291,5.1
CN3400700000000,34,007,Camden County, NJ,Jul-17,257781,242998,14783,5.7
CN3400700000000,34,007,Camden County, NJ,Aug-17,256386,242028,14358,5.6
CN3400700000000,34,007,Camden County, NJ,Sep-17,256926,243497,13429,5.2
CN3400700000000,34,007,Camden County, NJ,Oct-17,256635,244010,12625,4.9
CN3400700000000,34,007,Camden County, NJ,Nov-17,257478,245116,12362,4.8
CN3400700000000,34,007,Camden County, NJ,Dec-17,255935,244139,11796,4.6
CN3400700000000,34,007,Camden County, NJ,Jan-18,254685,241460,13225,5.2
CN3400700000000,34,007,Camden County, NJ,Feb-18,256751,243247,13504,5.3
CN3400700000000,34,007,Camden County, NJ,Mar-18,256691,243752,12939,5.0
CN3400700000000,34,007,Camden County, NJ,Apr-18(p),255302,243952,11350,4.4
CN2814700000000,28,147,Walthall County, MS,Mar-17,5047,4683,364,7.2
CN2814700000000,28,147,Walthall County, MS,Apr-17,5043,4706,337,6.7
CN2814700000000,28,147,Walthall County, MS,May-17,5041,4686,355,7.0
CN2814700000000,28,147,Walthall County, MS,Jun-17,5085,4673,412,8.1
CN2814700000000,28,147,Walthall County, MS,Jul-17,5018,4610,408,8.1
CN2814700000000,28,147,Walthall County, MS,Aug-17,5005,4667,338,6.8
CN2814700000000,28,147,Walthall County, MS,Sep-17,4991,4704,287,5.8
CN2814700000000,28,147,Walthall County, MS,Oct-17,4928,4668,260,5.3
CN2814700000000,28,147,Walthall County, MS,Nov-17,4936,4670,266,5.4
CN2814700000000,28,147,Walthall County, MS,Dec-17,4964,4687,277,5.6
CN2814700000000,28,147,Walthall County, MS,Jan-18,4874,4596,278,5.7
CN2814700000000,28,147,Walthall County, MS,Feb-18,4886,4608,278,5.7
CN2814700000000,28,147,Walthall County, MS,Mar-18,4929,4644,285,5.8
CN2814700000000,28,147,Walthall County, MS,Apr-18(p),4945,4662,283,5.7
CN2910900000000,29,109,Lawrence County, MO,Mar-17,17654,16980,674,3.8
CN2910900000000,29,109,Lawrence County, MO,Apr-17,17951,17364,587,3.3
CN2910900000000,29,109,Lawrence County, MO,May-17,17697,17094,603,3.4
CN2910900000000,29,109,Lawrence County, MO,Jun-17,17800,17138,662,3.7
CN2910900000000,29,109,Lawrence County, MO,Jul-17,17236,16518,718,4.2
CN2910900000000,29,109,Lawrence County, MO,Aug-17,17077,16348,729,4.3
CN2910900000000,29,109,Lawrence County, MO,Sep-17,17587,17020,567,3.2
CN2910900000000,29,109,Lawrence County, MO,Oct-17,17499,17082,417,2.4
CN2910900000000,29,109,Lawrence County, MO,Nov-17,17509,16978,531,3.0
CN2910900000000,29,109,Lawrence County, MO,Dec-17,17368,16805,563,3.2
CN2910900000000,29,109,Lawrence County, MO,Jan-18,17423,16713,710,4.1
CN2910900000000,29,109,Lawrence County, MO,Feb-18,17799,17004,795,4.5
CN2910900000000,29,109,Lawrence County, MO,Mar-18,17707,16994,713,4.0
CN2910900000000,29,109,Lawrence County, MO,Apr-18(p),17803,17228,575,3.2
CN3501900000000,35,019,Guadalupe County, NM,Mar-17,1612,1511,101,6.3
CN3501900000000,35,019,Guadalupe County, NM,Apr-17,1602,1508,94,5.9
CN3501900000000,35,019,Guadalupe County, NM,May-17,1583,1492,91,5.7
CN3501900000000,35,019,Guadalupe County, NM,Jun-17,1684,1567,117,6.9
CN3501900000000,35,019,Guadalupe County, NM,Jul-17,1681,1566,115,6.8
CN3501900000000,35,019,Guadalupe County, NM,Aug-17,1664,1559,105,6.3
CN3501900000000,35,019,Guadalupe County, NM,Sep-17,1641,1538,103,6.3
CN3501900000000,35,019,Guadalupe County, NM,Oct-17,1634,1539,95,5.8
CN3501900000000,35,019,Guadalupe County, NM,Nov-17,1631,1532,99,6.1
CN3501900000000,35,019,Guadalupe County, NM,Dec-17,1635,1538,97,5.9
CN3501900000000,35,019,Guadalupe County, NM,Jan-18,1624,1526,98,6.0
CN3501900000000,35,019,Guadalupe County, NM,Feb-18,1585,1491,94,5.9
CN3501900000000,35,019,Guadalupe County, NM,Mar-18,1572,1485,87,5.5
CN3501900000000,35,019,Guadalupe County, NM,Apr-18(p),1568,1492,76,4.8
CN3612300000000,36,123,Yates County, NY,Mar-17,11777,11193,584,5.0
CN3612300000000,36,123,Yates County, NY,Apr-17,11794,11292,502,4.3
CN3612300000000,36,123,Yates County, NY,May-17,11447,10999,448,3.9
CN3612300000000,36,123,Yates County, NY,Jun-17,11720,11227,493,4.2
CN3612300000000,36,123,Yates County, NY,Jul-17,11617,11136,481,4.1
CN3612300000000,36,123,Yates County, NY,Aug-17,11503,11037,466,4.1
CN3612300000000,36,123,Yates County, NY,Sep-17,11598,11121,477,4.1
CN3612300000000,36,123,Yates County, NY,Oct-17,11614,11170,444,3.8
CN3612300000000,36,123,Yates County, NY,Nov-17,11954,11431,523,4.4
CN3612300000000,36,123,Yates County, NY,Dec-17,11799,11235,564,4.8
CN3612300000000,36,123,Yates County, NY,Jan-18,12072,11391,681,5.6
CN3612300000000,36,123,Yates County, NY,Feb-18,11962,11270,692,5.8
CN3612300000000,36,123,Yates County, NY,Mar-18,11610,10982,628,5.4
CN3612300000000,36,123,Yates County, NY,Apr-18(p),11651,11135,516,4.4
CN5104900000000,51,049,Cumberland County, VA,Mar-17,4582,4382,200,4.4
CN5104900000000,51,049,Cumberland County, VA,Apr-17,4676,4487,189,4.0
CN5104900000000,51,049,Cumberland County, VA,May-17,4659,4474,185,4.0
CN5104900000000,51,049,Cumberland County, VA,Jun-17,4651,4458,193,4.1
CN5104900000000,51,049,Cumberland County, VA,Jul-17,4708,4508,200,4.2
CN5104900000000,51,049,Cumberland County, VA,Aug-17,4675,4476,199,4.3
CN5104900000000,51,049,Cumberland County, VA,Sep-17,4750,4569,181,3.8
CN5104900000000,51,049,Cumberland County, VA,Oct-17,4616,4445,171,3.7
CN5104900000000,51,049,Cumberland County, VA,Nov-17,4601,4425,176,3.8
CN5104900000000,51,049,Cumberland County, VA,Dec-17,4582,4407,175,3.8
CN5104900000000,51,049,Cumberland County, VA,Jan-18,4569,4362,207,4.5
CN5104900000000,51,049,Cumberland County, VA,Feb-18,4680,4493,187,4.0
CN5104900000000,51,049,Cumberland County, VA,Mar-18,4684,4507,177,3.8
CN5104900000000,51,049,Cumberland County, VA,Apr-18(p),4728,4580,148,3.1
CN5114700000000,51,147,Prince Edward County, VA,Mar-17,10321,9782,539,5.2
CN5114700000000,51,147,Prince Edward County, VA,Apr-17,10477,10014,463,4.4
CN5114700000000,51,147,Prince Edward County, VA,May-17,10259,9787,472,4.6
CN5114700000000,51,147,Prince Edward County, VA,Jun-17,10299,9708,591,5.7
CN5114700000000,51,147,Prince Edward County, VA,Jul-17,10322,9748,574,5.6
CN5114700000000,51,147,Prince Edward County, VA,Aug-17,10332,9783,549,5.3
CN5114700000000,51,147,Prince Edward County, VA,Sep-17,10573,10078,495,4.7
CN5114700000000,51,147,Prince Edward County, VA,Oct-17,10339,9901,438,4.2
CN5114700000000,51,147,Prince Edward County, VA,Nov-17,10332,9861,471,4.6
CN5114700000000,51,147,Prince Edward County, VA,Dec-17,10173,9741,432,4.2
CN5114700000000,51,147,Prince Edward County, VA,Jan-18,10159,9646,513,5.0
CN5114700000000,51,147,Prince Edward County, VA,Feb-18,10303,9857,446,4.3
CN5114700000000,51,147,Prince Edward County, VA,Mar-18,10305,9875,430,4.2
CN5114700000000,51,147,Prince Edward County, VA,Apr-18(p),10429,10069,360,3.5
CN1807100000000,18,071,Jackson County, IN,Mar-17,22306,21632,674,3.0
CN1807100000000,18,071,Jackson County, IN,Apr-17,22119,21582,537,2.4
CN1807100000000,18,071,Jackson County, IN,May-17,22488,21872,616,2.7
CN1807100000000,18,071,Jackson County, IN,Jun-17,22827,22144,683,3.0
CN1807100000000,18,071,Jackson County, IN,Jul-17,22782,22082,700,3.1
CN1807100000000,18,071,Jackson County, IN,Aug-17,22679,21921,758,3.3
CN1807100000000,18,071,Jackson County, IN,Sep-17,22356,21728,628,2.8
CN1807100000000,18,071,Jackson County, IN,Oct-17,22133,21525,608,2.7
CN1807100000000,18,071,Jackson County, IN,Nov-17,22166,21560,606,2.7
CN1807100000000,18,071,Jackson County, IN,Dec-17,22008,21439,569,2.6
CN1807100000000,18,071,Jackson County, IN,Jan-18,21930,21279,651,3.0
CN1807100000000,18,071,Jackson County, IN,Feb-18,22236,21565,671,3.0
CN1807100000000,18,071,Jackson County, IN,Mar-18,22453,21875,578,2.6
CN1807100000000,18,071,Jackson County, IN,Apr-18(p),22556,22017,539,2.4
CN4831500000000,48,315,Marion County, TX,Mar-17,4245,3976,269,6.3
CN4831500000000,48,315,Marion County, TX,Apr-17,4283,4029,254,5.9
CN4831500000000,48,315,Marion County, TX,May-17,4283,4038,245,5.7
CN4831500000000,48,315,Marion County, TX,Jun-17,4299,4046,253,5.9
CN4831500000000,48,315,Marion County, TX,Jul-17,4387,4137,250,5.7
CN4831500000000,48,315,Marion County, TX,Aug-17,4417,4166,251,5.7
CN4831500000000,48,315,Marion County, TX,Sep-17,4443,4221,222,5.0
CN4831500000000,48,315,Marion County, TX,Oct-17,4421,4217,204,4.6
CN4831500000000,48,315,Marion County, TX,Nov-17,4415,4210,205,4.6
CN4831500000000,48,315,Marion County, TX,Dec-17,4398,4197,201,4.6
CN4831500000000,48,315,Marion County, TX,Jan-18,4461,4243,218,4.9
CN4831500000000,48,315,Marion County, TX,Feb-18,4475,4255,220,4.9
CN4831500000000,48,315,Marion County, TX,Mar-18,4461,4244,217,4.9
CN4831500000000,48,315,Marion County, TX,Apr-18(p),4413,4221,192,4.4
CN5506900000000,55,069,Lincoln County, WI,Mar-17,15541,14856,685,4.4
CN5506900000000,55,069,Lincoln County, WI,Apr-17,15439,14863,576,3.7
CN5506900000000,55,069,Lincoln County, WI,May-17,15465,14986,479,3.1
CN5506900000000,55,069,Lincoln County, WI,Jun-17,15947,15377,570,3.6
CN5506900000000,55,069,Lincoln County, WI,Jul-17,15697,15126,571,3.6
CN5506900000000,55,069,Lincoln County, WI,Aug-17,15733,15145,588,3.7
CN5506900000000,55,069,Lincoln County, WI,Sep-17,15632,15173,459,2.9
CN5506900000000,55,069,Lincoln County, WI,Oct-17,15651,15236,415,2.7
CN5506900000000,55,069,Lincoln County, WI,Nov-17,15614,15208,406,2.6
CN5506900000000,55,069,Lincoln County, WI,Dec-17,15567,15126,441,2.8
CN5506900000000,55,069,Lincoln County, WI,Jan-18,15602,15088,514,3.3
CN5506900000000,55,069,Lincoln County, WI,Feb-18,15744,15160,584,3.7
CN5506900000000,55,069,Lincoln County, WI,Mar-18,15833,15255,578,3.7
CN5506900000000,55,069,Lincoln County, WI,Apr-18(p),15754,15214,540,3.4
CN4712100000000,47,121,Meigs County, TN,Mar-17,5037,4678,359,7.1
CN4712100000000,47,121,Meigs County, TN,Apr-17,4947,4723,224,4.5
CN4712100000000,47,121,Meigs County, TN,May-17,4992,4766,226,4.5
CN4712100000000,47,121,Meigs County, TN,Jun-17,4988,4714,274,5.5
CN4712100000000,47,121,Meigs County, TN,Jul-17,5040,4772,268,5.3
CN4712100000000,47,121,Meigs County, TN,Aug-17,5049,4793,256,5.1
CN4712100000000,47,121,Meigs County, TN,Sep-17,5053,4829,224,4.4
CN4712100000000,47,121,Meigs County, TN,Oct-17,5050,4829,221,4.4
CN4712100000000,47,121,Meigs County, TN,Nov-17,5012,4816,196,3.9
CN4712100000000,47,121,Meigs County, TN,Dec-17,5043,4832,211,4.2
CN4712100000000,47,121,Meigs County, TN,Jan-18,5034,4777,257,5.1
CN4712100000000,47,121,Meigs County, TN,Feb-18,5061,4820,241,4.8
CN4712100000000,47,121,Meigs County, TN,Mar-18,5078,4850,228,4.5
CN4712100000000,47,121,Meigs County, TN,Apr-18(p),5110,4934,176,3.4
CN7203300000000,72,033,Catano Municipio, PR,Mar-17,8012,7242,770,9.6
CN7203300000000,72,033,Catano Municipio, PR,Apr-17,7994,7195,799,10.0
CN7203300000000,72,033,Catano Municipio, PR,May-17,7828,7129,699,8.9
CN7203300000000,72,033,Catano Municipio, PR,Jun-17,7676,7083,593,7.7
CN7203300000000,72,033,Catano Municipio, PR,Jul-17,7686,7044,642,8.4
CN7203300000000,72,033,Catano Municipio, PR,Aug-17,7725,6951,774,10.0
CN7203300000000,72,033,Catano Municipio, PR,Sep-17(y),7813,7050,763,9.8
CN7203300000000,72,033,Catano Municipio, PR,Oct-17,7405,6759,646,8.7
CN7203300000000,72,033,Catano Municipio, PR,Nov-17,7838,7177,661,8.4
CN7203300000000,72,033,Catano Municipio, PR,Dec-17,7891,7245,646,8.2
CN7203300000000,72,033,Catano Municipio, PR,Jan-18,7824,7109,715,9.1
CN7203300000000,72,033,Catano Municipio, PR,Feb-18,7788,7126,662,8.5
CN7203300000000,72,033,Catano Municipio, PR,Mar-18,7779,7130,649,8.3
CN7203300000000,72,033,Catano Municipio, PR,Apr-18(p),7827,7196,631,8.1
CN2708700000000,27,087,Mahnomen County, MN,Mar-17,2404,2257,147,6.1
CN2708700000000,27,087,Mahnomen County, MN,Apr-17,2403,2280,123,5.1
CN2708700000000,27,087,Mahnomen County, MN,May-17,2412,2311,101,4.2
CN2708700000000,27,087,Mahnomen County, MN,Jun-17,2399,2274,125,5.2
CN2708700000000,27,087,Mahnomen County, MN,Jul-17,2326,2203,123,5.3
CN2708700000000,27,087,Mahnomen County, MN,Aug-17,2285,2175,110,4.8
CN2708700000000,27,087,Mahnomen County, MN,Sep-17,2318,2245,73,3.1
CN2708700000000,27,087,Mahnomen County, MN,Oct-17,2342,2279,63,2.7
CN2708700000000,27,087,Mahnomen County, MN,Nov-17,2353,2270,83,3.5
CN2708700000000,27,087,Mahnomen County, MN,Dec-17,2376,2261,115,4.8
CN2708700000000,27,087,Mahnomen County, MN,Jan-18,2399,2243,156,6.5
CN2708700000000,27,087,Mahnomen County, MN,Feb-18,2404,2256,148,6.2
CN2708700000000,27,087,Mahnomen County, MN,Mar-18,2432,2275,157,6.5
CN2708700000000,27,087,Mahnomen County, MN,Apr-18(p),2430,2303,127,5.2
CN0602500000000,06,025,Imperial County, CA,Mar-17,74548,60827,13721,18.4
CN0602500000000,06,025,Imperial County, CA,Apr-17,72817,59932,12885,17.7
CN0602500000000,06,025,Imperial County, CA,May-17,73838,60743,13095,17.7
CN0602500000000,06,025,Imperial County, CA,Jun-17,74341,60389,13952,18.8
CN0602500000000,06,025,Imperial County, CA,Jul-17,72263,57232,15031,20.8
CN0602500000000,06,025,Imperial County, CA,Aug-17,74218,57876,16342,22.0
CN0602500000000,06,025,Imperial County, CA,Sep-17,74003,59046,14957,20.2
CN0602500000000,06,025,Imperial County, CA,Oct-17,73265,59050,14215,19.4
CN0602500000000,06,025,Imperial County, CA,Nov-17,73729,60179,13550,18.4
CN0602500000000,06,025,Imperial County, CA,Dec-17,72581,60253,12328,17.0
CN0602500000000,06,025,Imperial County, CA,Jan-18,72662,60642,12020,16.5
CN0602500000000,06,025,Imperial County, CA,Feb-18,72590,61034,11556,15.9
CN0602500000000,06,025,Imperial County, CA,Mar-18,71621,60554,11067,15.5
CN0602500000000,06,025,Imperial County, CA,Apr-18(p),69961,59885,10076,14.4
CN0607500000000,06,075,San Francisco County/city, CA,Mar-17,568195,550964,17231,3.0
CN0607500000000,06,075,San Francisco County/city, CA,Apr-17,565311,549495,15816,2.8
CN0607500000000,06,075,San Francisco County/city, CA,May-17,563480,548077,15403,2.7
CN0607500000000,06,075,San Francisco County/city, CA,Jun-17,566236,548875,17361,3.1
CN0607500000000,06,075,San Francisco County/city, CA,Jul-17,573054,554623,18431,3.2
CN0607500000000,06,075,San Francisco County/city, CA,Aug-17,571361,553201,18160,3.2
CN0607500000000,06,075,San Francisco County/city, CA,Sep-17,572922,557574,15348,2.7
CN0607500000000,06,075,San Francisco County/city, CA,Oct-17,569888,554818,15070,2.6
CN0607500000000,06,075,San Francisco County/city, CA,Nov-17,571230,556904,14326,2.5
CN0607500000000,06,075,San Francisco County/city, CA,Dec-17,571462,557616,13846,2.4
CN0607500000000,06,075,San Francisco County/city, CA,Jan-18,569425,554124,15301,2.7
CN0607500000000,06,075,San Francisco County/city, CA,Feb-18,571273,556711,14562,2.5
CN0607500000000,06,075,San Francisco County/city, CA,Mar-18,569093,555568,13525,2.4
CN0607500000000,06,075,San Francisco County/city, CA,Apr-18(p),564290,552379,11911,2.1
CN4501300000000,45,013,Beaufort County, SC,Mar-17,73256,70460,2796,3.8
CN4501300000000,45,013,Beaufort County, SC,Apr-17,74186,71614,2572,3.5
CN4501300000000,45,013,Beaufort County, SC,May-17,74951,72299,2652,3.5
CN4501300000000,45,013,Beaufort County, SC,Jun-17,76711,73519,3192,4.2
CN4501300000000,45,013,Beaufort County, SC,Jul-17,76997,73851,3146,4.1
CN4501300000000,45,013,Beaufort County, SC,Aug-17,76131,72793,3338,4.4
CN4501300000000,45,013,Beaufort County, SC,Sep-17,73547,70535,3012,4.1
CN4501300000000,45,013,Beaufort County, SC,Oct-17,73367,70417,2950,4.0
CN4501300000000,45,013,Beaufort County, SC,Nov-17,73005,70226,2779,3.8
CN4501300000000,45,013,Beaufort County, SC,Dec-17,72606,69766,2840,3.9
CN4501300000000,45,013,Beaufort County, SC,Jan-18,72985,69472,3513,4.8
CN4501300000000,45,013,Beaufort County, SC,Feb-18,73485,70225,3260,4.4
CN4501300000000,45,013,Beaufort County, SC,Mar-18,74155,71280,2875,3.9
CN4501300000000,45,013,Beaufort County, SC,Apr-18(p),74289,72406,1883,2.5
CN3602500000000,36,025,Delaware County, NY,Mar-17,19057,17893,1164,6.1
CN3602500000000,36,025,Delaware County, NY,Apr-17,19095,18051,1044,5.5
CN3602500000000,36,025,Delaware County, NY,May-17,18912,17946,966,5.1
CN3602500000000,36,025,Delaware County, NY,Jun-17,19323,18278,1045,5.4
CN3602500000000,36,025,Delaware County, NY,Jul-17,19826,18767,1059,5.3
CN3602500000000,36,025,Delaware County, NY,Aug-17,19622,18577,1045,5.3
CN3602500000000,36,025,Delaware County, NY,Sep-17,18949,17978,971,5.1
CN3602500000000,36,025,Delaware County, NY,Oct-17,18822,17896,926,4.9
CN3602500000000,36,025,Delaware County, NY,Nov-17,18876,17898,978,5.2
CN3602500000000,36,025,Delaware County, NY,Dec-17,18555,17472,1083,5.8
CN3602500000000,36,025,Delaware County, NY,Jan-18,19136,17733,1403,7.3
CN3602500000000,36,025,Delaware County, NY,Feb-18,19229,17815,1414,7.4
CN3602500000000,36,025,Delaware County, NY,Mar-18,18629,17379,1250,6.7
CN3602500000000,36,025,Delaware County, NY,Apr-18(p),18764,17647,1117,6.0
CN4825900000000,48,259,Kendall County, TX,Mar-17,20747,20070,677,3.3
CN4825900000000,48,259,Kendall County, TX,Apr-17,20699,20117,582,2.8
CN4825900000000,48,259,Kendall County, TX,May-17,20700,20083,617,3.0
CN4825900000000,48,259,Kendall County, TX,Jun-17,20796,20114,682,3.3
CN4825900000000,48,259,Kendall County, TX,Jul-17,20745,20048,697,3.4
CN4825900000000,48,259,Kendall County, TX,Aug-17,20698,20025,673,3.3
CN4825900000000,48,259,Kendall County, TX,Sep-17,20805,20205,600,2.9
CN4825900000000,48,259,Kendall County, TX,Oct-17,20752,20185,567,2.7
CN4825900000000,48,259,Kendall County, TX,Nov-17,20734,20152,582,2.8
CN4825900000000,48,259,Kendall County, TX,Dec-17,20824,20278,546,2.6
CN4825900000000,48,259,Kendall County, TX,Jan-18,20771,20153,618,3.0
CN4825900000000,48,259,Kendall County, TX,Feb-18,21103,20460,643,3.0
CN4825900000000,48,259,Kendall County, TX,Mar-18,21264,20613,651,3.1
CN4825900000000,48,259,Kendall County, TX,Apr-18(p),21173,20600,573,2.7
CN4830700000000,48,307,McCulloch County, TX,Mar-17,3788,3650,138,3.6
CN4830700000000,48,307,McCulloch County, TX,Apr-17,3695,3577,118,3.2
CN4830700000000,48,307,McCulloch County, TX,May-17,3723,3585,138,3.7
CN4830700000000,48,307,McCulloch County, TX,Jun-17,3736,3592,144,3.9
CN4830700000000,48,307,McCulloch County, TX,Jul-17,3666,3523,143,3.9
CN4830700000000,48,307,McCulloch County, TX,Aug-17,3700,3563,137,3.7
CN4830700000000,48,307,McCulloch County, TX,Sep-17,3719,3593,126,3.4
CN4830700000000,48,307,McCulloch County, TX,Oct-17,3721,3608,113,3.0
CN4830700000000,48,307,McCulloch County, TX,Nov-17,3694,3574,120,3.2
CN4830700000000,48,307,McCulloch County, TX,Dec-17,3742,3631,111,3.0
CN4830700000000,48,307,McCulloch County, TX,Jan-18,3717,3589,128,3.4
CN4830700000000,48,307,McCulloch County, TX,Feb-18,3754,3630,124,3.3
CN4830700000000,48,307,McCulloch County, TX,Mar-18,3843,3715,128,3.3
CN4830700000000,48,307,McCulloch County, TX,Apr-18(p),3737,3622,115,3.1
CN4841300000000,48,413,Schleicher County, TX,Mar-17,1363,1310,53,3.9
CN4841300000000,48,413,Schleicher County, TX,Apr-17,1402,1354,48,3.4
CN4841300000000,48,413,Schleicher County, TX,May-17,1406,1357,49,3.5
CN4841300000000,48,413,Schleicher County, TX,Jun-17,1392,1341,51,3.7
CN4841300000000,48,413,Schleicher County, TX,Jul-17,1344,1294,50,3.7
CN4841300000000,48,413,Schleicher County, TX,Aug-17,1318,1267,51,3.9
CN4841300000000,48,413,Schleicher County, TX,Sep-17,1287,1239,48,3.7
CN4841300000000,48,413,Schleicher County, TX,Oct-17,1293,1253,40,3.1
CN4841300000000,48,413,Schleicher County, TX,Nov-17,1282,1243,39,3.0
CN4841300000000,48,413,Schleicher County, TX,Dec-17,1279,1244,35,2.7
CN4841300000000,48,413,Schleicher County, TX,Jan-18,1280,1243,37,2.9
CN4841300000000,48,413,Schleicher County, TX,Feb-18,1304,1262,42,3.2
CN4841300000000,48,413,Schleicher County, TX,Mar-18,1325,1279,46,3.5
CN4841300000000,48,413,Schleicher County, TX,Apr-18(p),1355,1316,39,2.9
CN0109300000000,01,093,Marion County, AL,Mar-17,12520,11844,676,5.4
CN0109300000000,01,093,Marion County, AL,Apr-17,12470,11903,567,4.5
CN0109300000000,01,093,Marion County, AL,May-17,12465,11923,542,4.3
CN0109300000000,01,093,Marion County, AL,Jun-17,12565,11902,663,5.3
CN0109300000000,01,093,Marion County, AL,Jul-17,12476,11879,597,4.8
CN0109300000000,01,093,Marion County, AL,Aug-17,12493,11909,584,4.7
CN0109300000000,01,093,Marion County, AL,Sep-17,12726,12219,507,4.0
CN0109300000000,01,093,Marion County, AL,Oct-17,12624,12126,498,3.9
CN0109300000000,01,093,Marion County, AL,Nov-17,12546,12079,467,3.7
CN0109300000000,01,093,Marion County, AL,Dec-17,12444,11996,448,3.6
CN0109300000000,01,093,Marion County, AL,Jan-18,12280,11756,524,4.3
CN0109300000000,01,093,Marion County, AL,Feb-18,12444,11893,551,4.4
CN0109300000000,01,093,Marion County, AL,Mar-18,12508,11996,512,4.1
CN0109300000000,01,093,Marion County, AL,Apr-18(p),12524,12082,442,3.5
CN4846300000000,48,463,Uvalde County, TX,Mar-17,11891,11317,574,4.8
CN4846300000000,48,463,Uvalde County, TX,Apr-17,11871,11353,518,4.4
CN4846300000000,48,463,Uvalde County, TX,May-17,11921,11401,520,4.4
CN4846300000000,48,463,Uvalde County, TX,Jun-17,12078,11495,583,4.8
CN4846300000000,48,463,Uvalde County, TX,Jul-17,11911,11329,582,4.9
CN4846300000000,48,463,Uvalde County, TX,Aug-17,11893,11310,583,4.9
CN4846300000000,48,463,Uvalde County, TX,Sep-17,11558,11064,494,4.3
CN4846300000000,48,463,Uvalde County, TX,Oct-17,11415,10959,456,4.0
CN4846300000000,48,463,Uvalde County, TX,Nov-17,11357,10877,480,4.2
CN4846300000000,48,463,Uvalde County, TX,Dec-17,11351,10887,464,4.1
CN4846300000000,48,463,Uvalde County, TX,Jan-18,11390,10874,516,4.5
CN4846300000000,48,463,Uvalde County, TX,Feb-18,11601,11063,538,4.6
CN4846300000000,48,463,Uvalde County, TX,Mar-18,11823,11303,520,4.4
CN4846300000000,48,463,Uvalde County, TX,Apr-18(p),11662,11192,470,4.0
CN0802700000000,08,027,Custer County, CO,Mar-17,1938,1879,59,3.0
CN0802700000000,08,027,Custer County, CO,Apr-17,1989,1935,54,2.7
CN0802700000000,08,027,Custer County, CO,May-17,2008,1951,57,2.8
CN0802700000000,08,027,Custer County, CO,Jun-17,2077,2016,61,2.9
CN0802700000000,08,027,Custer County, CO,Jul-17,2072,2016,56,2.7
CN0802700000000,08,027,Custer County, CO,Aug-17,2056,1997,59,2.9
CN0802700000000,08,027,Custer County, CO,Sep-17,2068,2010,58,2.8
CN0802700000000,08,027,Custer County, CO,Oct-17,2063,2004,59,2.9
CN0802700000000,08,027,Custer County, CO,Nov-17,2064,1998,66,3.2
CN0802700000000,08,027,Custer County, CO,Dec-17,2017,1953,64,3.2
CN0802700000000,08,027,Custer County, CO,Jan-18,1928,1850,78,4.0
CN0802700000000,08,027,Custer County, CO,Feb-18,1926,1841,85,4.4
CN0802700000000,08,027,Custer County, CO,Mar-18,1944,1876,68,3.5
CN0802700000000,08,027,Custer County, CO,Apr-18(p),2014,1948,66,3.3
CN1701500000000,17,015,Carroll County, IL,Mar-17,7563,7167,396,5.2
CN1701500000000,17,015,Carroll County, IL,Apr-17,7695,7387,308,4.0
CN1701500000000,17,015,Carroll County, IL,May-17,7728,7440,288,3.7
CN1701500000000,17,015,Carroll County, IL,Jun-17,7969,7646,323,4.1
CN1701500000000,17,015,Carroll County, IL,Jul-17,7783,7459,324,4.2
CN1701500000000,17,015,Carroll County, IL,Aug-17,7656,7317,339,4.4
CN1701500000000,17,015,Carroll County, IL,Sep-17,7582,7289,293,3.9
CN1701500000000,17,015,Carroll County, IL,Oct-17,7513,7237,276,3.7
CN1701500000000,17,015,Carroll County, IL,Nov-17,7496,7203,293,3.9
CN1701500000000,17,015,Carroll County, IL,Dec-17,7302,7006,296,4.1
CN1701500000000,17,015,Carroll County, IL,Jan-18,7237,6882,355,4.9
CN1701500000000,17,015,Carroll County, IL,Feb-18,7229,6903,326,4.5
CN1701500000000,17,015,Carroll County, IL,Mar-18,7399,7072,327,4.4
CN1701500000000,17,015,Carroll County, IL,Apr-18(p),7504,7246,258,3.4
CN4012100000000,40,121,Pittsburg County, OK,Mar-17,17353,16373,980,5.6
CN4012100000000,40,121,Pittsburg County, OK,Apr-17,17760,16870,890,5.0
CN4012100000000,40,121,Pittsburg County, OK,May-17,17866,16902,964,5.4
CN4012100000000,40,121,Pittsburg County, OK,Jun-17,17768,16752,1016,5.7
CN4012100000000,40,121,Pittsburg County, OK,Jul-17,17531,16590,941,5.4
CN4012100000000,40,121,Pittsburg County, OK,Aug-17,17781,16864,917,5.2
CN4012100000000,40,121,Pittsburg County, OK,Sep-17,18096,17201,895,4.9
CN4012100000000,40,121,Pittsburg County, OK,Oct-17,17562,16648,914,5.2
CN4012100000000,40,121,Pittsburg County, OK,Nov-17,17585,16737,848,4.8
CN4012100000000,40,121,Pittsburg County, OK,Dec-17,17403,16565,838,4.8
CN4012100000000,40,121,Pittsburg County, OK,Jan-18,17352,16472,880,5.1
CN4012100000000,40,121,Pittsburg County, OK,Feb-18,17901,17066,835,4.7
CN4012100000000,40,121,Pittsburg County, OK,Mar-18,17860,17036,824,4.6
CN4012100000000,40,121,Pittsburg County, OK,Apr-18(p),17811,17004,807,4.5
CN5303100000000,53,031,Jefferson County, WA,Mar-17,11689,10953,736,6.3
CN5303100000000,53,031,Jefferson County, WA,Apr-17,11824,11097,727,6.1
CN5303100000000,53,031,Jefferson County, WA,May-17,11896,11198,698,5.9
CN5303100000000,53,031,Jefferson County, WA,Jun-17,12164,11491,673,5.5
CN5303100000000,53,031,Jefferson County, WA,Jul-17,12231,11518,713,5.8
CN5303100000000,53,031,Jefferson County, WA,Aug-17,12139,11434,705,5.8
CN5303100000000,53,031,Jefferson County, WA,Sep-17,12150,11435,715,5.9
CN5303100000000,53,031,Jefferson County, WA,Oct-17,12189,11493,696,5.7
CN5303100000000,53,031,Jefferson County, WA,Nov-17,12243,11536,707,5.8
CN5303100000000,53,031,Jefferson County, WA,Dec-17,12121,11359,762,6.3
CN5303100000000,53,031,Jefferson County, WA,Jan-18,11945,11099,846,7.1
CN5303100000000,53,031,Jefferson County, WA,Feb-18,11874,10983,891,7.5
CN5303100000000,53,031,Jefferson County, WA,Mar-18,11968,11148,820,6.9
CN5303100000000,53,031,Jefferson County, WA,Apr-18(p),11958,11193,765,6.4
CN0606700000000,06,067,Sacramento County, CA,Mar-17,700569,665091,35478,5.1
CN0606700000000,06,067,Sacramento County, CA,Apr-17,696700,664489,32211,4.6
CN0606700000000,06,067,Sacramento County, CA,May-17,695957,665965,29992,4.3
CN0606700000000,06,067,Sacramento County, CA,Jun-17,700841,667338,33503,4.8
CN0606700000000,06,067,Sacramento County, CA,Jul-17,709308,673817,35491,5.0
CN0606700000000,06,067,Sacramento County, CA,Aug-17,706530,672260,34270,4.9
CN0606700000000,06,067,Sacramento County, CA,Sep-17,707258,677396,29862,4.2
CN0606700000000,06,067,Sacramento County, CA,Oct-17,703539,674594,28945,4.1
CN0606700000000,06,067,Sacramento County, CA,Nov-17,705040,676869,28171,4.0
CN0606700000000,06,067,Sacramento County, CA,Dec-17,702889,675604,27285,3.9
CN0606700000000,06,067,Sacramento County, CA,Jan-18,705669,675553,30116,4.3
CN0606700000000,06,067,Sacramento County, CA,Feb-18,706743,677556,29187,4.1
CN0606700000000,06,067,Sacramento County, CA,Mar-18,701421,674212,27209,3.9
CN0606700000000,06,067,Sacramento County, CA,Apr-18(p),695431,671100,24331,3.5
CN4107100000000,41,071,Yamhill County, OR,Mar-17,54031,51939,2092,3.9
CN4107100000000,41,071,Yamhill County, OR,Apr-17,54018,52188,1830,3.4
CN4107100000000,41,071,Yamhill County, OR,May-17,54153,52349,1804,3.3
CN4107100000000,41,071,Yamhill County, OR,Jun-17,54692,52467,2225,4.1
CN4107100000000,41,071,Yamhill County, OR,Jul-17,55641,53317,2324,4.2
CN4107100000000,41,071,Yamhill County, OR,Aug-17,55489,53196,2293,4.1
CN4107100000000,41,071,Yamhill County, OR,Sep-17,55315,53288,2027,3.7
CN4107100000000,41,071,Yamhill County, OR,Oct-17,54987,53010,1977,3.6
CN4107100000000,41,071,Yamhill County, OR,Nov-17,54912,52927,1985,3.6
CN4107100000000,41,071,Yamhill County, OR,Dec-17,54572,52713,1859,3.4
CN4107100000000,41,071,Yamhill County, OR,Jan-18,54724,52767,1957,3.6
CN4107100000000,41,071,Yamhill County, OR,Feb-18,55194,53025,2169,3.9
CN4107100000000,41,071,Yamhill County, OR,Mar-18,55015,52894,2121,3.9
CN4107100000000,41,071,Yamhill County, OR,Apr-18(p),54345,52500,1845,3.4
CN4003100000000,40,031,Comanche County, OK,Mar-17,49470,47334,2136,4.3
CN4003100000000,40,031,Comanche County, OK,Apr-17,49367,47379,1988,4.0
CN4003100000000,40,031,Comanche County, OK,May-17,49228,47005,2223,4.5
CN4003100000000,40,031,Comanche County, OK,Jun-17,49799,47456,2343,4.7
CN4003100000000,40,031,Comanche County, OK,Jul-17,49415,47230,2185,4.4
CN4003100000000,40,031,Comanche County, OK,Aug-17,48938,46685,2253,4.6
CN4003100000000,40,031,Comanche County, OK,Sep-17,48995,46806,2189,4.5
CN4003100000000,40,031,Comanche County, OK,Oct-17,49057,46902,2155,4.4
CN4003100000000,40,031,Comanche County, OK,Nov-17,49305,47204,2101,4.3
CN4003100000000,40,031,Comanche County, OK,Dec-17,48956,46894,2062,4.2
CN4003100000000,40,031,Comanche County, OK,Jan-18,49084,46829,2255,4.6
CN4003100000000,40,031,Comanche County, OK,Feb-18,49387,47287,2100,4.3
CN4003100000000,40,031,Comanche County, OK,Mar-18,49687,47606,2081,4.2
CN4003100000000,40,031,Comanche County, OK,Apr-18(p),49651,47551,2100,4.2
CN0401500000000,04,015,Mohave County, AZ,Mar-17,81545,76630,4915,6.0
CN0401500000000,04,015,Mohave County, AZ,Apr-17,82007,77318,4689,5.7
CN0401500000000,04,015,Mohave County, AZ,May-17,82210,77687,4523,5.5
CN0401500000000,04,015,Mohave County, AZ,Jun-17,82934,78039,4895,5.9
CN0401500000000,04,015,Mohave County, AZ,Jul-17,83458,78605,4853,5.8
CN0401500000000,04,015,Mohave County, AZ,Aug-17,83271,78318,4953,5.9
CN0401500000000,04,015,Mohave County, AZ,Sep-17,83096,78335,4761,5.7
CN0401500000000,04,015,Mohave County, AZ,Oct-17,82514,78026,4488,5.4
CN0401500000000,04,015,Mohave County, AZ,Nov-17,82878,78360,4518,5.5
CN0401500000000,04,015,Mohave County, AZ,Dec-17,82613,77809,4804,5.8
CN0401500000000,04,015,Mohave County, AZ,Jan-18,83328,77974,5354,6.4
CN0401500000000,04,015,Mohave County, AZ,Feb-18,84394,79277,5117,6.1
CN0401500000000,04,015,Mohave County, AZ,Mar-18,84038,79306,4732,5.6
CN0401500000000,04,015,Mohave County, AZ,Apr-18(p),84669,80235,4434,5.2
CN1300300000000,13,003,Atkinson County, GA,Mar-17,4095,3903,192,4.7
CN1300300000000,13,003,Atkinson County, GA,Apr-17,4083,3903,180,4.4
CN1300300000000,13,003,Atkinson County, GA,May-17,4160,3980,180,4.3
CN1300300000000,13,003,Atkinson County, GA,Jun-17,4288,4065,223,5.2
CN1300300000000,13,003,Atkinson County, GA,Jul-17,4171,3980,191,4.6
CN1300300000000,13,003,Atkinson County, GA,Aug-17,4151,3985,166,4.0
CN1300300000000,13,003,Atkinson County, GA,Sep-17,4155,3991,164,3.9
CN1300300000000,13,003,Atkinson County, GA,Oct-17,4191,4031,160,3.8
CN1300300000000,13,003,Atkinson County, GA,Nov-17,4192,4030,162,3.9
CN1300300000000,13,003,Atkinson County, GA,Dec-17,4182,4009,173,4.1
CN1300300000000,13,003,Atkinson County, GA,Jan-18,4342,4126,216,5.0
CN1300300000000,13,003,Atkinson County, GA,Feb-18,4262,4072,190,4.5
CN1300300000000,13,003,Atkinson County, GA,Mar-18,4260,4091,169,4.0
CN1300300000000,13,003,Atkinson County, GA,Apr-18(p),4271,4113,158,3.7
CN2603900000000,26,039,Crawford County, MI,Mar-17,5338,4919,419,7.8
CN2603900000000,26,039,Crawford County, MI,Apr-17,5337,4983,354,6.6
CN2603900000000,26,039,Crawford County, MI,May-17,5466,5118,348,6.4
CN2603900000000,26,039,Crawford County, MI,Jun-17,5651,5284,367,6.5
CN2603900000000,26,039,Crawford County, MI,Jul-17,5657,5236,421,7.4
CN2603900000000,26,039,Crawford County, MI,Aug-17,5602,5235,367,6.6
CN2603900000000,26,039,Crawford County, MI,Sep-17,5477,5167,310,5.7
CN2603900000000,26,039,Crawford County, MI,Oct-17,5390,5095,295,5.5
CN2603900000000,26,039,Crawford County, MI,Nov-17,5390,5049,341,6.3
CN2603900000000,26,039,Crawford County, MI,Dec-17,5421,5005,416,7.7
CN2603900000000,26,039,Crawford County, MI,Jan-18,5453,5000,453,8.3
CN2603900000000,26,039,Crawford County, MI,Feb-18,5493,5010,483,8.8
CN2603900000000,26,039,Crawford County, MI,Mar-18,5498,5043,455,8.3
CN2603900000000,26,039,Crawford County, MI,Apr-18(p),5496,5105,391,7.1
CN2211700000000,22,117,Washington Parish, LA,Mar-17,17285,16282,1003,5.8
CN2211700000000,22,117,Washington Parish, LA,Apr-17,17075,16104,971,5.7
CN2211700000000,22,117,Washington Parish, LA,May-17,16829,15883,946,5.6
CN2211700000000,22,117,Washington Parish, LA,Jun-17,17252,16117,1135,6.6
CN2211700000000,22,117,Washington Parish, LA,Jul-17,16909,15769,1140,6.7
CN2211700000000,22,117,Washington Parish, LA,Aug-17,16731,15642,1089,6.5
CN2211700000000,22,117,Washington Parish, LA,Sep-17,16749,15777,972,5.8
CN2211700000000,22,117,Washington Parish, LA,Oct-17,17007,16182,825,4.9
CN2211700000000,22,117,Washington Parish, LA,Nov-17,17092,16285,807,4.7
CN2211700000000,22,117,Washington Parish, LA,Dec-17,16993,16234,759,4.5
CN2211700000000,22,117,Washington Parish, LA,Jan-18,17138,16301,837,4.9
CN2211700000000,22,117,Washington Parish, LA,Feb-18,17026,16256,770,4.5
CN2211700000000,22,117,Washington Parish, LA,Mar-18,17198,16344,854,5.0
CN2211700000000,22,117,Washington Parish, LA,Apr-18(p),17119,16275,844,4.9
CN3110500000000,31,105,Kimball County, NE,Mar-17,1919,1859,60,3.1
CN3110500000000,31,105,Kimball County, NE,Apr-17,1919,1856,63,3.3
CN3110500000000,31,105,Kimball County, NE,May-17,1949,1891,58,3.0
CN3110500000000,31,105,Kimball County, NE,Jun-17,2017,1957,60,3.0
CN3110500000000,31,105,Kimball County, NE,Jul-17,2035,1974,61,3.0
CN3110500000000,31,105,Kimball County, NE,Aug-17,2033,1982,51,2.5
CN3110500000000,31,105,Kimball County, NE,Sep-17,1943,1897,46,2.4
CN3110500000000,31,105,Kimball County, NE,Oct-17,1966,1920,46,2.3
CN3110500000000,31,105,Kimball County, NE,Nov-17,1959,1913,46,2.3
CN3110500000000,31,105,Kimball County, NE,Dec-17,1965,1912,53,2.7
CN3110500000000,31,105,Kimball County, NE,Jan-18,1989,1939,50,2.5
CN3110500000000,31,105,Kimball County, NE,Feb-18,1989,1946,43,2.2
CN3110500000000,31,105,Kimball County, NE,Mar-18,2003,1951,52,2.6
CN3110500000000,31,105,Kimball County, NE,Apr-18(p),1977,1929,48,2.4
CN2015700000000,20,157,Republic County, KS,Mar-17,2433,2359,74,3.0
CN2015700000000,20,157,Republic County, KS,Apr-17,2401,2337,64,2.7
CN2015700000000,20,157,Republic County, KS,May-17,2402,2331,71,3.0
CN2015700000000,20,157,Republic County, KS,Jun-17,2489,2417,72,2.9
CN2015700000000,20,157,Republic County, KS,Jul-17,2484,2399,85,3.4
CN2015700000000,20,157,Republic County, KS,Aug-17,2464,2385,79,3.2
CN2015700000000,20,157,Republic County, KS,Sep-17,2509,2445,64,2.6
CN2015700000000,20,157,Republic County, KS,Oct-17,2533,2475,58,2.3
CN2015700000000,20,157,Republic County, KS,Nov-17,2493,2433,60,2.4
CN2015700000000,20,157,Republic County, KS,Dec-17,2472,2419,53,2.1
CN2015700000000,20,157,Republic County, KS,Jan-18,2369,2314,55,2.3
CN2015700000000,20,157,Republic County, KS,Feb-18,2359,2300,59,2.5
CN2015700000000,20,157,Republic County, KS,Mar-18,2340,2274,66,2.8
CN2015700000000,20,157,Republic County, KS,Apr-18(p),2252,2182,70,3.1
CN2119700000000,21,197,Powell County, KY,Mar-17,5143,4760,383,7.4
CN2119700000000,21,197,Powell County, KY,Apr-17,5086,4765,321,6.3
CN2119700000000,21,197,Powell County, KY,May-17,5133,4811,322,6.3
CN2119700000000,21,197,Powell County, KY,Jun-17,5219,4859,360,6.9
CN2119700000000,21,197,Powell County, KY,Jul-17,5199,4855,344,6.6
CN2119700000000,21,197,Powell County, KY,Aug-17,5133,4802,331,6.4
CN2119700000000,21,197,Powell County, KY,Sep-17,5116,4816,300,5.9
CN2119700000000,21,197,Powell County, KY,Oct-17,5084,4814,270,5.3
CN2119700000000,21,197,Powell County, KY,Nov-17,5074,4813,261,5.1
CN2119700000000,21,197,Powell County, KY,Dec-17,5053,4781,272,5.4
CN2119700000000,21,197,Powell County, KY,Jan-18,5059,4752,307,6.1
CN2119700000000,21,197,Powell County, KY,Feb-18,5151,4796,355,6.9
CN2119700000000,21,197,Powell County, KY,Mar-18,5205,4873,332,6.4
CN2119700000000,21,197,Powell County, KY,Apr-18(p),5202,4914,288,5.5
CN5306700000000,53,067,Thurston County, WA,Mar-17,134911,127993,6918,5.1
CN5306700000000,53,067,Thurston County, WA,Apr-17,133321,126944,6377,4.8
CN5306700000000,53,067,Thurston County, WA,May-17,133135,126749,6386,4.8
CN5306700000000,53,067,Thurston County, WA,Jun-17,133227,126822,6405,4.8
CN5306700000000,53,067,Thurston County, WA,Jul-17,133048,126469,6579,4.9
CN5306700000000,53,067,Thurston County, WA,Aug-17,133301,126726,6575,4.9
CN5306700000000,53,067,Thurston County, WA,Sep-17,135308,128995,6313,4.7
CN5306700000000,53,067,Thurston County, WA,Oct-17,136595,130388,6207,4.5
CN5306700000000,53,067,Thurston County, WA,Nov-17,137948,131594,6354,4.6
CN5306700000000,53,067,Thurston County, WA,Dec-17,138027,131089,6938,5.0
CN5306700000000,53,067,Thurston County, WA,Jan-18,136710,129265,7445,5.4
CN5306700000000,53,067,Thurston County, WA,Feb-18,135895,128245,7650,5.6
CN5306700000000,53,067,Thurston County, WA,Mar-18,136386,129175,7211,5.3
CN5306700000000,53,067,Thurston County, WA,Apr-18(p),135166,128474,6692,5.0
CN2612900000000,26,129,Ogemaw County, MI,Mar-17,8093,7321,772,9.5
CN2612900000000,26,129,Ogemaw County, MI,Apr-17,8180,7560,620,7.6
CN2612900000000,26,129,Ogemaw County, MI,May-17,8312,7766,546,6.6
CN2612900000000,26,129,Ogemaw County, MI,Jun-17,8411,7844,567,6.7
CN2612900000000,26,129,Ogemaw County, MI,Jul-17,8445,7784,661,7.8
CN2612900000000,26,129,Ogemaw County, MI,Aug-17,8296,7708,588,7.1
CN2612900000000,26,129,Ogemaw County, MI,Sep-17,8261,7762,499,6.0
CN2612900000000,26,129,Ogemaw County, MI,Oct-17,8180,7709,471,5.8
CN2612900000000,26,129,Ogemaw County, MI,Nov-17,8204,7676,528,6.4
CN2612900000000,26,129,Ogemaw County, MI,Dec-17,8305,7554,751,9.0
CN2612900000000,26,129,Ogemaw County, MI,Jan-18,8194,7319,875,10.7
CN2612900000000,26,129,Ogemaw County, MI,Feb-18,8238,7328,910,11.0
CN2612900000000,26,129,Ogemaw County, MI,Mar-18,8205,7402,803,9.8
CN2612900000000,26,129,Ogemaw County, MI,Apr-18(p),8258,7604,654,7.9
CN3910300000000,39,103,Medina County, OH,Mar-17,95217,90330,4887,5.1
CN3910300000000,39,103,Medina County, OH,Apr-17,96437,92265,4172,4.3
CN3910300000000,39,103,Medina County, OH,May-17,95463,91119,4344,4.6
CN3910300000000,39,103,Medina County, OH,Jun-17,96752,91841,4911,5.1
CN3910300000000,39,103,Medina County, OH,Jul-17,97660,92760,4900,5.0
CN3910300000000,39,103,Medina County, OH,Aug-17,96300,91615,4685,4.9
CN3910300000000,39,103,Medina County, OH,Sep-17,96279,92130,4149,4.3
CN3910300000000,39,103,Medina County, OH,Oct-17,94855,91169,3686,3.9
CN3910300000000,39,103,Medina County, OH,Nov-17,94776,91202,3574,3.8
CN3910300000000,39,103,Medina County, OH,Dec-17,93209,89449,3760,4.0
CN3910300000000,39,103,Medina County, OH,Jan-18,93621,89098,4523,4.8
CN3910300000000,39,103,Medina County, OH,Feb-18,95160,90510,4650,4.9
CN3910300000000,39,103,Medina County, OH,Mar-18,94812,90965,3847,4.1
CN3910300000000,39,103,Medina County, OH,Apr-18(p),96228,92610,3618,3.8
CN2815500000000,28,155,Webster County, MS,Mar-17,3968,3776,192,4.8
CN2815500000000,28,155,Webster County, MS,Apr-17,3968,3793,175,4.4
CN2815500000000,28,155,Webster County, MS,May-17,4006,3792,214,5.3
CN2815500000000,28,155,Webster County, MS,Jun-17,3850,3609,241,6.3
CN2815500000000,28,155,Webster County, MS,Jul-17,3867,3624,243,6.3
CN2815500000000,28,155,Webster County, MS,Aug-17,3783,3591,192,5.1
CN2815500000000,28,155,Webster County, MS,Sep-17,3934,3743,191,4.9
CN2815500000000,28,155,Webster County, MS,Oct-17,3951,3764,187,4.7
CN2815500000000,28,155,Webster County, MS,Nov-17,3914,3735,179,4.6
CN2815500000000,28,155,Webster County, MS,Dec-17,3903,3715,188,4.8
CN2815500000000,28,155,Webster County, MS,Jan-18,3706,3519,187,5.0
CN2815500000000,28,155,Webster County, MS,Feb-18,3894,3699,195,5.0
CN2815500000000,28,155,Webster County, MS,Mar-18,3900,3722,178,4.6
CN2815500000000,28,155,Webster County, MS,Apr-18(p),3942,3759,183,4.6
CN7204100000000,72,041,Cidra Municipio, PR,Mar-17,15556,14227,1329,8.5
CN7204100000000,72,041,Cidra Municipio, PR,Apr-17,15513,14100,1413,9.1
CN7204100000000,72,041,Cidra Municipio, PR,May-17,15229,14015,1214,8.0
CN7204100000000,72,041,Cidra Municipio, PR,Jun-17,15034,13926,1108,7.4
CN7204100000000,72,041,Cidra Municipio, PR,Jul-17,15106,13874,1232,8.2
CN7204100000000,72,041,Cidra Municipio, PR,Aug-17,15077,13692,1385,9.2
CN7204100000000,72,041,Cidra Municipio, PR,Sep-17(y),15140,13854,1286,8.5
CN7204100000000,72,041,Cidra Municipio, PR,Oct-17,14546,13291,1255,8.6
CN7204100000000,72,041,Cidra Municipio, PR,Nov-17,15316,14073,1243,8.1
CN7204100000000,72,041,Cidra Municipio, PR,Dec-17,15344,14187,1157,7.5
CN7204100000000,72,041,Cidra Municipio, PR,Jan-18,15204,13922,1282,8.4
CN7204100000000,72,041,Cidra Municipio, PR,Feb-18,15150,13962,1188,7.8
CN7204100000000,72,041,Cidra Municipio, PR,Mar-18,15110,13979,1131,7.5
CN7204100000000,72,041,Cidra Municipio, PR,Apr-18(p),15172,14077,1095,7.2
CN2115500000000,21,155,Marion County, KY,Mar-17,9567,9109,458,4.8
CN2115500000000,21,155,Marion County, KY,Apr-17,9630,9231,399,4.1
CN2115500000000,21,155,Marion County, KY,May-17,9648,9237,411,4.3
CN2115500000000,21,155,Marion County, KY,Jun-17,9787,9338,449,4.6
CN2115500000000,21,155,Marion County, KY,Jul-17,9698,9260,438,4.5
CN2115500000000,21,155,Marion County, KY,Aug-17,9601,9203,398,4.1
CN2115500000000,21,155,Marion County, KY,Sep-17,9641,9306,335,3.5
CN2115500000000,21,155,Marion County, KY,Oct-17,9503,9204,299,3.1
CN2115500000000,21,155,Marion County, KY,Nov-17,9495,9202,293,3.1
CN2115500000000,21,155,Marion County, KY,Dec-17,9440,9160,280,3.0
CN2115500000000,21,155,Marion County, KY,Jan-18,9550,9239,311,3.3
CN2115500000000,21,155,Marion County, KY,Feb-18,9444,9082,362,3.8
CN2115500000000,21,155,Marion County, KY,Mar-18,9439,9104,335,3.5
CN2115500000000,21,155,Marion County, KY,Apr-18(p),9474,9179,295,3.1
CN2908900000000,29,089,Howard County, MO,Mar-17,5087,4865,222,4.4
CN2908900000000,29,089,Howard County, MO,Apr-17,5130,4931,199,3.9
CN2908900000000,29,089,Howard County, MO,May-17,5013,4827,186,3.7
CN2908900000000,29,089,Howard County, MO,Jun-17,4966,4764,202,4.1
CN2908900000000,29,089,Howard County, MO,Jul-17,4815,4603,212,4.4
CN2908900000000,29,089,Howard County, MO,Aug-17,4771,4572,199,4.2
CN2908900000000,29,089,Howard County, MO,Sep-17,4997,4837,160,3.2
CN2908900000000,29,089,Howard County, MO,Oct-17,4986,4865,121,2.4
CN2908900000000,29,089,Howard County, MO,Nov-17,5000,4850,150,3.0
CN2908900000000,29,089,Howard County, MO,Dec-17,4974,4816,158,3.2
CN2908900000000,29,089,Howard County, MO,Jan-18,4941,4733,208,4.2
CN2908900000000,29,089,Howard County, MO,Feb-18,5050,4842,208,4.1
CN2908900000000,29,089,Howard County, MO,Mar-18,5019,4860,159,3.2
CN2908900000000,29,089,Howard County, MO,Apr-18(p),5060,4918,142,2.8
CN2020500000000,20,205,Wilson County, KS,Mar-17,3982,3786,196,4.9
CN2020500000000,20,205,Wilson County, KS,Apr-17,3937,3755,182,4.6
CN2020500000000,20,205,Wilson County, KS,May-17,3952,3772,180,4.6
CN2020500000000,20,205,Wilson County, KS,Jun-17,4073,3887,186,4.6
CN2020500000000,20,205,Wilson County, KS,Jul-17,3990,3792,198,5.0
CN2020500000000,20,205,Wilson County, KS,Aug-17,4013,3822,191,4.8
CN2020500000000,20,205,Wilson County, KS,Sep-17,4022,3846,176,4.4
CN2020500000000,20,205,Wilson County, KS,Oct-17,4030,3878,152,3.8
CN2020500000000,20,205,Wilson County, KS,Nov-17,4020,3853,167,4.2
CN2020500000000,20,205,Wilson County, KS,Dec-17,3977,3821,156,3.9
CN2020500000000,20,205,Wilson County, KS,Jan-18,3976,3801,175,4.4
CN2020500000000,20,205,Wilson County, KS,Feb-18,4015,3817,198,4.9
CN2020500000000,20,205,Wilson County, KS,Mar-18,4002,3800,202,5.0
CN2020500000000,20,205,Wilson County, KS,Apr-18(p),3893,3724,169,4.3
CN2804900000000,28,049,Hinds County, MS,Mar-17,110556,105318,5238,4.7
CN2804900000000,28,049,Hinds County, MS,Apr-17,110282,105510,4772,4.3
CN2804900000000,28,049,Hinds County, MS,May-17,110760,105027,5733,5.2
CN2804900000000,28,049,Hinds County, MS,Jun-17,112050,105414,6636,5.9
CN2804900000000,28,049,Hinds County, MS,Jul-17,112103,105748,6355,5.7
CN2804900000000,28,049,Hinds County, MS,Aug-17,109636,104410,5226,4.8
CN2804900000000,28,049,Hinds County, MS,Sep-17,110130,105081,5049,4.6
CN2804900000000,28,049,Hinds County, MS,Oct-17,110808,106028,4780,4.3
CN2804900000000,28,049,Hinds County, MS,Nov-17,111189,106650,4539,4.1
CN2804900000000,28,049,Hinds County, MS,Dec-17,111336,106751,4585,4.1
CN2804900000000,28,049,Hinds County, MS,Jan-18,110116,105476,4640,4.2
CN2804900000000,28,049,Hinds County, MS,Feb-18,110760,106158,4602,4.2
CN2804900000000,28,049,Hinds County, MS,Mar-18,110879,106239,4640,4.2
CN2804900000000,28,049,Hinds County, MS,Apr-18(p),110980,106428,4552,4.1
CN4821700000000,48,217,Hill County, TX,Mar-17,16130,15441,689,4.3
CN4821700000000,48,217,Hill County, TX,Apr-17,16113,15541,572,3.5
CN4821700000000,48,217,Hill County, TX,May-17,16066,15469,597,3.7
CN4821700000000,48,217,Hill County, TX,Jun-17,16059,15383,676,4.2
CN4821700000000,48,217,Hill County, TX,Jul-17,16173,15480,693,4.3
CN4821700000000,48,217,Hill County, TX,Aug-17,16158,15514,644,4.0
CN4821700000000,48,217,Hill County, TX,Sep-17,16369,15797,572,3.5
CN4821700000000,48,217,Hill County, TX,Oct-17,16232,15713,519,3.2
CN4821700000000,48,217,Hill County, TX,Nov-17,16313,15761,552,3.4
CN4821700000000,48,217,Hill County, TX,Dec-17,16343,15800,543,3.3
CN4821700000000,48,217,Hill County, TX,Jan-18,16303,15695,608,3.7
CN4821700000000,48,217,Hill County, TX,Feb-18,16571,15960,611,3.7
CN4821700000000,48,217,Hill County, TX,Mar-18,16730,16115,615,3.7
CN4821700000000,48,217,Hill County, TX,Apr-18(p),16623,16059,564,3.4
CN4847100000000,48,471,Walker County, TX,Mar-17,23964,22841,1123,4.7
CN4847100000000,48,471,Walker County, TX,Apr-17,23825,22810,1015,4.3
CN4847100000000,48,471,Walker County, TX,May-17,23681,22643,1038,4.4
CN4847100000000,48,471,Walker County, TX,Jun-17,23577,22371,1206,5.1
CN4847100000000,48,471,Walker County, TX,Jul-17,23285,22080,1205,5.2
CN4847100000000,48,471,Walker County, TX,Aug-17,23377,22217,1160,5.0
CN4847100000000,48,471,Walker County, TX,Sep-17,23665,22645,1020,4.3
CN4847100000000,48,471,Walker County, TX,Oct-17,23501,22586,915,3.9
CN4847100000000,48,471,Walker County, TX,Nov-17,23558,22602,956,4.1
CN4847100000000,48,471,Walker County, TX,Dec-17,23363,22447,916,3.9
CN4847100000000,48,471,Walker County, TX,Jan-18,23544,22462,1082,4.6
CN4847100000000,48,471,Walker County, TX,Feb-18,23895,22818,1077,4.5
CN4847100000000,48,471,Walker County, TX,Mar-18,23903,22826,1077,4.5
CN4847100000000,48,471,Walker County, TX,Apr-18(p),23903,22931,972,4.1
CN2919500000000,29,195,Saline County, MO,Mar-17,10499,10095,404,3.8
CN2919500000000,29,195,Saline County, MO,Apr-17,10768,10403,365,3.4
CN2919500000000,29,195,Saline County, MO,May-17,10584,10214,370,3.5
CN2919500000000,29,195,Saline County, MO,Jun-17,10752,10333,419,3.9
CN2919500000000,29,195,Saline County, MO,Jul-17,10229,9784,445,4.4
CN2919500000000,29,195,Saline County, MO,Aug-17,10197,9763,434,4.3
CN2919500000000,29,195,Saline County, MO,Sep-17,10424,10094,330,3.2
CN2919500000000,29,195,Saline County, MO,Oct-17,10360,10126,234,2.3
CN2919500000000,29,195,Saline County, MO,Nov-17,10397,10092,305,2.9
CN2919500000000,29,195,Saline County, MO,Dec-17,10275,9942,333,3.2
CN2919500000000,29,195,Saline County, MO,Jan-18,10285,9882,403,3.9
CN2919500000000,29,195,Saline County, MO,Feb-18,10480,10089,391,3.7
CN2919500000000,29,195,Saline County, MO,Mar-18,10538,10113,425,4.0
CN2919500000000,29,195,Saline County, MO,Apr-18(p),10645,10295,350,3.3
CN1605300000000,16,053,Jerome County, ID,Mar-17,11635,11248,387,3.3
CN1605300000000,16,053,Jerome County, ID,Apr-17,11793,11473,320,2.7
CN1605300000000,16,053,Jerome County, ID,May-17,11775,11497,278,2.4
CN1605300000000,16,053,Jerome County, ID,Jun-17,11826,11536,290,2.5
CN1605300000000,16,053,Jerome County, ID,Jul-17,11809,11511,298,2.5
CN1605300000000,16,053,Jerome County, ID,Aug-17,11826,11546,280,2.4
CN1605300000000,16,053,Jerome County, ID,Sep-17,11880,11604,276,2.3
CN1605300000000,16,053,Jerome County, ID,Oct-17,11874,11613,261,2.2
CN1605300000000,16,053,Jerome County, ID,Nov-17,11845,11549,296,2.5
CN1605300000000,16,053,Jerome County, ID,Dec-17,11776,11466,310,2.6
CN1605300000000,16,053,Jerome County, ID,Jan-18,11685,11292,393,3.4
CN1605300000000,16,053,Jerome County, ID,Feb-18,11761,11382,379,3.2
CN1605300000000,16,053,Jerome County, ID,Mar-18,11875,11524,351,3.0
CN1605300000000,16,053,Jerome County, ID,Apr-18(p),12008,11726,282,2.3
CN5102100000000,51,021,Bland County, VA,Mar-17,2766,2619,147,5.3
CN5102100000000,51,021,Bland County, VA,Apr-17,2744,2631,113,4.1
CN5102100000000,51,021,Bland County, VA,May-17,2752,2632,120,4.4
CN5102100000000,51,021,Bland County, VA,Jun-17,2743,2614,129,4.7
CN5102100000000,51,021,Bland County, VA,Jul-17,2734,2613,121,4.4
CN5102100000000,51,021,Bland County, VA,Aug-17,2719,2599,120,4.4
CN5102100000000,51,021,Bland County, VA,Sep-17,2736,2631,105,3.8
CN5102100000000,51,021,Bland County, VA,Oct-17,2709,2614,95,3.5
CN5102100000000,51,021,Bland County, VA,Nov-17,2709,2606,103,3.8
CN5102100000000,51,021,Bland County, VA,Dec-17,2699,2600,99,3.7
CN5102100000000,51,021,Bland County, VA,Jan-18,2691,2582,109,4.1
CN5102100000000,51,021,Bland County, VA,Feb-18,2727,2622,105,3.9
CN5102100000000,51,021,Bland County, VA,Mar-18,2747,2641,106,3.9
CN5102100000000,51,021,Bland County, VA,Apr-18(p),2745,2655,90,3.3
CN4500500000000,45,005,Allendale County, SC,Mar-17,2691,2511,180,6.7
CN4500500000000,45,005,Allendale County, SC,Apr-17,2696,2529,167,6.2
CN4500500000000,45,005,Allendale County, SC,May-17,2692,2521,171,6.4
CN4500500000000,45,005,Allendale County, SC,Jun-17,2783,2592,191,6.9
CN4500500000000,45,005,Allendale County, SC,Jul-17,2794,2605,189,6.8
CN4500500000000,45,005,Allendale County, SC,Aug-17,2768,2565,203,7.3
CN4500500000000,45,005,Allendale County, SC,Sep-17,2752,2557,195,7.1
CN4500500000000,45,005,Allendale County, SC,Oct-17,2734,2558,176,6.4
CN4500500000000,45,005,Allendale County, SC,Nov-17,2732,2569,163,6.0
CN4500500000000,45,005,Allendale County, SC,Dec-17,2809,2622,187,6.7
CN4500500000000,45,005,Allendale County, SC,Jan-18,2846,2609,237,8.3
CN4500500000000,45,005,Allendale County, SC,Feb-18,2842,2617,225,7.9
CN4500500000000,45,005,Allendale County, SC,Mar-18,2768,2573,195,7.0
CN4500500000000,45,005,Allendale County, SC,Apr-18(p),2723,2586,137,5.0
CN1913100000000,19,131,Mitchell County, IA,Mar-17,5620,5472,148,2.6
CN1913100000000,19,131,Mitchell County, IA,Apr-17,5791,5661,130,2.2
CN1913100000000,19,131,Mitchell County, IA,May-17,5808,5694,114,2.0
CN1913100000000,19,131,Mitchell County, IA,Jun-17,5971,5842,129,2.2
CN1913100000000,19,131,Mitchell County, IA,Jul-17,6133,6007,126,2.1
CN1913100000000,19,131,Mitchell County, IA,Aug-17,6001,5872,129,2.1
CN1913100000000,19,131,Mitchell County, IA,Sep-17,5714,5600,114,2.0
CN1913100000000,19,131,Mitchell County, IA,Oct-17,5700,5608,92,1.6
CN1913100000000,19,131,Mitchell County, IA,Nov-17,5608,5515,93,1.7
CN1913100000000,19,131,Mitchell County, IA,Dec-17,5611,5506,105,1.9
CN1913100000000,19,131,Mitchell County, IA,Jan-18,5538,5389,149,2.7
CN1913100000000,19,131,Mitchell County, IA,Feb-18,5674,5526,148,2.6
CN1913100000000,19,131,Mitchell County, IA,Mar-18,5580,5451,129,2.3
CN1913100000000,19,131,Mitchell County, IA,Apr-18(p),5689,5583,106,1.9
CN3601700000000,36,017,Chenango County, NY,Mar-17,22709,21352,1357,6.0
CN3601700000000,36,017,Chenango County, NY,Apr-17,22550,21389,1161,5.1
CN3601700000000,36,017,Chenango County, NY,May-17,22446,21355,1091,4.9
CN3601700000000,36,017,Chenango County, NY,Jun-17,23030,21912,1118,4.9
CN3601700000000,36,017,Chenango County, NY,Jul-17,23089,21960,1129,4.9
CN3601700000000,36,017,Chenango County, NY,Aug-17,22895,21778,1117,4.9
CN3601700000000,36,017,Chenango County, NY,Sep-17,22356,21276,1080,4.8
CN3601700000000,36,017,Chenango County, NY,Oct-17,22126,21056,1070,4.8
CN3601700000000,36,017,Chenango County, NY,Nov-17,22244,21051,1193,5.4
CN3601700000000,36,017,Chenango County, NY,Dec-17,22212,20890,1322,6.0
CN3601700000000,36,017,Chenango County, NY,Jan-18,22846,21216,1630,7.1
CN3601700000000,36,017,Chenango County, NY,Feb-18,22607,20969,1638,7.2
CN3601700000000,36,017,Chenango County, NY,Mar-18,22265,20770,1495,6.7
CN3601700000000,36,017,Chenango County, NY,Apr-18(p),22147,20910,1237,5.6
CN3108500000000,31,085,Hayes County, NE,Mar-17,563,551,12,2.1
CN3108500000000,31,085,Hayes County, NE,Apr-17,573,562,11,1.9
CN3108500000000,31,085,Hayes County, NE,May-17,591,579,12,2.0
CN3108500000000,31,085,Hayes County, NE,Jun-17,597,583,14,2.3
CN3108500000000,31,085,Hayes County, NE,Jul-17,583,569,14,2.4
CN3108500000000,31,085,Hayes County, NE,Aug-17,569,554,15,2.6
CN3108500000000,31,085,Hayes County, NE,Sep-17,552,540,12,2.2
CN3108500000000,31,085,Hayes County, NE,Oct-17,561,548,13,2.3
CN3108500000000,31,085,Hayes County, NE,Nov-17,569,554,15,2.6
CN3108500000000,31,085,Hayes County, NE,Dec-17,561,547,14,2.5
CN3108500000000,31,085,Hayes County, NE,Jan-18,576,562,14,2.4
CN3108500000000,31,085,Hayes County, NE,Feb-18,553,539,14,2.5
CN3108500000000,31,085,Hayes County, NE,Mar-18,569,556,13,2.3
CN3108500000000,31,085,Hayes County, NE,Apr-18(p),575,562,13,2.3
CN4007300000000,40,073,Kingfisher County, OK,Mar-17,8580,8337,243,2.8
CN4007300000000,40,073,Kingfisher County, OK,Apr-17,8523,8304,219,2.6
CN4007300000000,40,073,Kingfisher County, OK,May-17,8545,8294,251,2.9
CN4007300000000,40,073,Kingfisher County, OK,Jun-17,8706,8426,280,3.2
CN4007300000000,40,073,Kingfisher County, OK,Jul-17,8642,8379,263,3.0
CN4007300000000,40,073,Kingfisher County, OK,Aug-17,8788,8534,254,2.9
CN4007300000000,40,073,Kingfisher County, OK,Sep-17,8824,8588,236,2.7
CN4007300000000,40,073,Kingfisher County, OK,Oct-17,8760,8539,221,2.5
CN4007300000000,40,073,Kingfisher County, OK,Nov-17,8813,8608,205,2.3
CN4007300000000,40,073,Kingfisher County, OK,Dec-17,8691,8485,206,2.4
CN4007300000000,40,073,Kingfisher County, OK,Jan-18,8620,8395,225,2.6
CN4007300000000,40,073,Kingfisher County, OK,Feb-18,8894,8672,222,2.5
CN4007300000000,40,073,Kingfisher County, OK,Mar-18,8878,8659,219,2.5
CN4007300000000,40,073,Kingfisher County, OK,Apr-18(p),8768,8559,209,2.4
CN4203300000000,42,033,Clearfield County, PA,Mar-17,36409,33833,2576,7.1
CN4203300000000,42,033,Clearfield County, PA,Apr-17,35949,33970,1979,5.5
CN4203300000000,42,033,Clearfield County, PA,May-17,35514,33546,1968,5.5
CN4203300000000,42,033,Clearfield County, PA,Jun-17,36060,34018,2042,5.7
CN4203300000000,42,033,Clearfield County, PA,Jul-17,36056,33984,2072,5.7
CN4203300000000,42,033,Clearfield County, PA,Aug-17,35780,33715,2065,5.8
CN4203300000000,42,033,Clearfield County, PA,Sep-17,35423,33755,1668,4.7
CN4203300000000,42,033,Clearfield County, PA,Oct-17,35237,33611,1626,4.6
CN4203300000000,42,033,Clearfield County, PA,Nov-17,35490,33653,1837,5.2
CN4203300000000,42,033,Clearfield County, PA,Dec-17,35575,33485,2090,5.9
CN4203300000000,42,033,Clearfield County, PA,Jan-18,35596,33099,2497,7.0
CN4203300000000,42,033,Clearfield County, PA,Feb-18,35562,33164,2398,6.7
CN4203300000000,42,033,Clearfield County, PA,Mar-18,35074,33030,2044,5.8
CN4203300000000,42,033,Clearfield County, PA,Apr-18(p),34868,33223,1645,4.7
CN1208300000000,12,083,Marion County, FL,Mar-17,133573,126838,6735,5.0
CN1208300000000,12,083,Marion County, FL,Apr-17,133971,127633,6338,4.7
CN1208300000000,12,083,Marion County, FL,May-17,134210,127750,6460,4.8
CN1208300000000,12,083,Marion County, FL,Jun-17,134835,127965,6870,5.1
CN1208300000000,12,083,Marion County, FL,Jul-17,134690,127754,6936,5.1
CN1208300000000,12,083,Marion County, FL,Aug-17,133670,126860,6810,5.1
CN1208300000000,12,083,Marion County, FL,Sep-17,135340,129043,6297,4.7
CN1208300000000,12,083,Marion County, FL,Oct-17,133139,127172,5967,4.5
CN1208300000000,12,083,Marion County, FL,Nov-17,132840,126745,6095,4.6
CN1208300000000,12,083,Marion County, FL,Dec-17,131914,126100,5814,4.4
CN1208300000000,12,083,Marion County, FL,Jan-18,132971,126330,6641,5.0
CN1208300000000,12,083,Marion County, FL,Feb-18,134361,128246,6115,4.6
CN1208300000000,12,083,Marion County, FL,Mar-18,134983,128973,6010,4.5
CN1208300000000,12,083,Marion County, FL,Apr-18(p),134980,129511,5469,4.1
CN1712100000000,17,121,Marion County, IL,Mar-17,17546,16576,970,5.5
CN1712100000000,17,121,Marion County, IL,Apr-17,17715,16887,828,4.7
CN1712100000000,17,121,Marion County, IL,May-17,17537,16716,821,4.7
CN1712100000000,17,121,Marion County, IL,Jun-17,17755,16854,901,5.1
CN1712100000000,17,121,Marion County, IL,Jul-17,17736,16784,952,5.4
CN1712100000000,17,121,Marion County, IL,Aug-17,17546,16622,924,5.3
CN1712100000000,17,121,Marion County, IL,Sep-17,17610,16797,813,4.6
CN1712100000000,17,121,Marion County, IL,Oct-17,17615,16850,765,4.3
CN1712100000000,17,121,Marion County, IL,Nov-17,17639,16842,797,4.5
CN1712100000000,17,121,Marion County, IL,Dec-17,17606,16802,804,4.6
CN1712100000000,17,121,Marion County, IL,Jan-18,17527,16643,884,5.0
CN1712100000000,17,121,Marion County, IL,Feb-18,17582,16800,782,4.4
CN1712100000000,17,121,Marion County, IL,Mar-18,17900,17081,819,4.6
CN1712100000000,17,121,Marion County, IL,Apr-18(p),17931,17254,677,3.8
CN4001500000000,40,015,Caddo County, OK,Mar-17,12317,11773,544,4.4
CN4001500000000,40,015,Caddo County, OK,Apr-17,12282,11771,511,4.2
CN4001500000000,40,015,Caddo County, OK,May-17,12304,11735,569,4.6
CN4001500000000,40,015,Caddo County, OK,Jun-17,12168,11551,617,5.1
CN4001500000000,40,015,Caddo County, OK,Jul-17,11910,11317,593,5.0
CN4001500000000,40,015,Caddo County, OK,Aug-17,12571,11989,582,4.6
CN4001500000000,40,015,Caddo County, OK,Sep-17,12568,12025,543,4.3
CN4001500000000,40,015,Caddo County, OK,Oct-17,12554,12036,518,4.1
CN4001500000000,40,015,Caddo County, OK,Nov-17,12609,12105,504,4.0
CN4001500000000,40,015,Caddo County, OK,Dec-17,12370,11878,492,4.0
CN4001500000000,40,015,Caddo County, OK,Jan-18,12404,11878,526,4.2
CN4001500000000,40,015,Caddo County, OK,Feb-18,12654,12147,507,4.0
CN4001500000000,40,015,Caddo County, OK,Mar-18,12603,12100,503,4.0
CN4001500000000,40,015,Caddo County, OK,Apr-18(p),12478,11986,492,3.9
CN1902500000000,19,025,Calhoun County, IA,Mar-17,4232,4079,153,3.6
CN1902500000000,19,025,Calhoun County, IA,Apr-17,4335,4207,128,3.0
CN1902500000000,19,025,Calhoun County, IA,May-17,4369,4241,128,2.9
CN1902500000000,19,025,Calhoun County, IA,Jun-17,4437,4305,132,3.0
CN1902500000000,19,025,Calhoun County, IA,Jul-17,4382,4248,134,3.1
CN1902500000000,19,025,Calhoun County, IA,Aug-17,4310,4175,135,3.1
CN1902500000000,19,025,Calhoun County, IA,Sep-17,4297,4168,129,3.0
CN1902500000000,19,025,Calhoun County, IA,Oct-17,4339,4233,106,2.4
CN1902500000000,19,025,Calhoun County, IA,Nov-17,4274,4170,104,2.4
CN1902500000000,19,025,Calhoun County, IA,Dec-17,4203,4094,109,2.6
CN1902500000000,19,025,Calhoun County, IA,Jan-18,4127,3988,139,3.4
CN1902500000000,19,025,Calhoun County, IA,Feb-18,4166,4017,149,3.6
CN1902500000000,19,025,Calhoun County, IA,Mar-18,4086,3968,118,2.9
CN1902500000000,19,025,Calhoun County, IA,Apr-18(p),4131,4031,100,2.4
CN2614500000000,26,145,Saginaw County, MI,Mar-17,87963,82958,5005,5.7
CN2614500000000,26,145,Saginaw County, MI,Apr-17,87142,82923,4219,4.8
CN2614500000000,26,145,Saginaw County, MI,May-17,87012,82673,4339,5.0
CN2614500000000,26,145,Saginaw County, MI,Jun-17,88488,83687,4801,5.4
CN2614500000000,26,145,Saginaw County, MI,Jul-17,88399,82697,5702,6.5
CN2614500000000,26,145,Saginaw County, MI,Aug-17,87828,82618,5210,5.9
CN2614500000000,26,145,Saginaw County, MI,Sep-17,87431,82986,4445,5.1
CN2614500000000,26,145,Saginaw County, MI,Oct-17,86953,82843,4110,4.7
CN2614500000000,26,145,Saginaw County, MI,Nov-17,87792,83499,4293,4.9
CN2614500000000,26,145,Saginaw County, MI,Dec-17,87276,82628,4648,5.3
CN2614500000000,26,145,Saginaw County, MI,Jan-18,86578,80865,5713,6.6
CN2614500000000,26,145,Saginaw County, MI,Feb-18,87585,81859,5726,6.5
CN2614500000000,26,145,Saginaw County, MI,Mar-18,87745,82672,5073,5.8
CN2614500000000,26,145,Saginaw County, MI,Apr-18(p),87010,82681,4329,5.0
CN1204100000000,12,041,Gilchrist County, FL,Mar-17,6875,6581,294,4.3
CN1204100000000,12,041,Gilchrist County, FL,Apr-17,6873,6601,272,4.0
CN1204100000000,12,041,Gilchrist County, FL,May-17,6755,6483,272,4.0
CN1204100000000,12,041,Gilchrist County, FL,Jun-17,6758,6454,304,4.5
CN1204100000000,12,041,Gilchrist County, FL,Jul-17,6806,6508,298,4.4
CN1204100000000,12,041,Gilchrist County, FL,Aug-17,6711,6421,290,4.3
CN1204100000000,12,041,Gilchrist County, FL,Sep-17,7021,6751,270,3.8
CN1204100000000,12,041,Gilchrist County, FL,Oct-17,6941,6675,266,3.8
CN1204100000000,12,041,Gilchrist County, FL,Nov-17,6863,6593,270,3.9
CN1204100000000,12,041,Gilchrist County, FL,Dec-17,6794,6545,249,3.7
CN1204100000000,12,041,Gilchrist County, FL,Jan-18,6865,6564,301,4.4
CN1204100000000,12,041,Gilchrist County, FL,Feb-18,6925,6663,262,3.8
CN1204100000000,12,041,Gilchrist County, FL,Mar-18,6910,6650,260,3.8
CN1204100000000,12,041,Gilchrist County, FL,Apr-18(p),6928,6697,231,3.3
CN1715700000000,17,157,Randolph County, IL,Mar-17,14278,13656,622,4.4
CN1715700000000,17,157,Randolph County, IL,Apr-17,14291,13771,520,3.6
CN1715700000000,17,157,Randolph County, IL,May-17,14111,13564,547,3.9
CN1715700000000,17,157,Randolph County, IL,Jun-17,14145,13525,620,4.4
CN1715700000000,17,157,Randolph County, IL,Jul-17,14139,13468,671,4.7
CN1715700000000,17,157,Randolph County, IL,Aug-17,14312,13662,650,4.5
CN1715700000000,17,157,Randolph County, IL,Sep-17,13938,13373,565,4.1
CN1715700000000,17,157,Randolph County, IL,Oct-17,13936,13419,517,3.7
CN1715700000000,17,157,Randolph County, IL,Nov-17,13940,13379,561,4.0
CN1715700000000,17,157,Randolph County, IL,Dec-17,13832,13271,561,4.1
CN1715700000000,17,157,Randolph County, IL,Jan-18,13862,13209,653,4.7
CN1715700000000,17,157,Randolph County, IL,Feb-18,13992,13418,574,4.1
CN1715700000000,17,157,Randolph County, IL,Mar-18,14231,13654,577,4.1
CN1715700000000,17,157,Randolph County, IL,Apr-18(p),14309,13864,445,3.1
CN2920700000000,29,207,Stoddard County, MO,Mar-17,13091,12371,720,5.5
CN2920700000000,29,207,Stoddard County, MO,Apr-17,13409,12764,645,4.8
CN2920700000000,29,207,Stoddard County, MO,May-17,13251,12601,650,4.9
CN2920700000000,29,207,Stoddard County, MO,Jun-17,13099,12388,711,5.4
CN2920700000000,29,207,Stoddard County, MO,Jul-17,12886,12150,736,5.7
CN2920700000000,29,207,Stoddard County, MO,Aug-17,12872,12188,684,5.3
CN2920700000000,29,207,Stoddard County, MO,Sep-17,12809,12272,537,4.2
CN2920700000000,29,207,Stoddard County, MO,Oct-17,12842,12390,452,3.5
CN2920700000000,29,207,Stoddard County, MO,Nov-17,12856,12319,537,4.2
CN2920700000000,29,207,Stoddard County, MO,Dec-17,12708,12101,607,4.8
CN2920700000000,29,207,Stoddard County, MO,Jan-18,12796,12032,764,6.0
CN2920700000000,29,207,Stoddard County, MO,Feb-18,13041,12295,746,5.7
CN2920700000000,29,207,Stoddard County, MO,Mar-18,12974,12288,686,5.3
CN2920700000000,29,207,Stoddard County, MO,Apr-18(p),13162,12553,609,4.6
CN2813900000000,28,139,Tippah County, MS,Mar-17,9504,9075,429,4.5
CN2813900000000,28,139,Tippah County, MS,Apr-17,9423,9047,376,4.0
CN2813900000000,28,139,Tippah County, MS,May-17,9552,9097,455,4.8
CN2813900000000,28,139,Tippah County, MS,Jun-17,9621,9102,519,5.4
CN2813900000000,28,139,Tippah County, MS,Jul-17,9554,9080,474,5.0
CN2813900000000,28,139,Tippah County, MS,Aug-17,9461,9050,411,4.3
CN2813900000000,28,139,Tippah County, MS,Sep-17,9455,9068,387,4.1
CN2813900000000,28,139,Tippah County, MS,Oct-17,9394,9035,359,3.8
CN2813900000000,28,139,Tippah County, MS,Nov-17,9413,9044,369,3.9
CN2813900000000,28,139,Tippah County, MS,Dec-17,9458,9086,372,3.9
CN2813900000000,28,139,Tippah County, MS,Jan-18,9474,9073,401,4.2
CN2813900000000,28,139,Tippah County, MS,Feb-18,9488,9100,388,4.1
CN2813900000000,28,139,Tippah County, MS,Mar-18,9463,9098,365,3.9
CN2813900000000,28,139,Tippah County, MS,Apr-18(p),9484,9118,366,3.9
CN3712700000000,37,127,Nash County, NC,Mar-17,44177,41607,2570,5.8
CN3712700000000,37,127,Nash County, NC,Apr-17,43712,41096,2616,6.0
CN3712700000000,37,127,Nash County, NC,May-17,43610,40935,2675,6.1
CN3712700000000,37,127,Nash County, NC,Jun-17,43375,40605,2770,6.4
CN3712700000000,37,127,Nash County, NC,Jul-17,43574,40719,2855,6.6
CN3712700000000,37,127,Nash County, NC,Aug-17,42688,39877,2811,6.6
CN3712700000000,37,127,Nash County, NC,Sep-17,43554,41071,2483,5.7
CN3712700000000,37,127,Nash County, NC,Oct-17,43516,41019,2497,5.7
CN3712700000000,37,127,Nash County, NC,Nov-17,43744,41167,2577,5.9
CN3712700000000,37,127,Nash County, NC,Dec-17,43185,40760,2425,5.6
CN3712700000000,37,127,Nash County, NC,Jan-18,42761,40150,2611,6.1
CN3712700000000,37,127,Nash County, NC,Feb-18,43450,40854,2596,6.0
CN3712700000000,37,127,Nash County, NC,Mar-18,43255,40822,2433,5.6
CN3712700000000,37,127,Nash County, NC,Apr-18(p),42967,40754,2213,5.2
CN5105700000000,51,057,Essex County, VA,Mar-17,5556,5233,323,5.8
CN5105700000000,51,057,Essex County, VA,Apr-17,5452,5178,274,5.0
CN5105700000000,51,057,Essex County, VA,May-17,5466,5203,263,4.8
CN5105700000000,51,057,Essex County, VA,Jun-17,5544,5283,261,4.7
CN5105700000000,51,057,Essex County, VA,Jul-17,5552,5293,259,4.7
CN5105700000000,51,057,Essex County, VA,Aug-17,5466,5188,278,5.1
CN5105700000000,51,057,Essex County, VA,Sep-17,5418,5177,241,4.4
CN5105700000000,51,057,Essex County, VA,Oct-17,5394,5158,236,4.4
CN5105700000000,51,057,Essex County, VA,Nov-17,5375,5144,231,4.3
CN5105700000000,51,057,Essex County, VA,Dec-17,5410,5164,246,4.5
CN5105700000000,51,057,Essex County, VA,Jan-18,5365,5092,273,5.1
CN5105700000000,51,057,Essex County, VA,Feb-18,5391,5122,269,5.0
CN5105700000000,51,057,Essex County, VA,Mar-18,5428,5172,256,4.7
CN5105700000000,51,057,Essex County, VA,Apr-18(p),5402,5183,219,4.1
CN2120900000000,21,209,Scott County, KY,Mar-17,28261,27099,1162,4.1
CN2120900000000,21,209,Scott County, KY,Apr-17,28517,27452,1065,3.7
CN2120900000000,21,209,Scott County, KY,May-17,28444,27357,1087,3.8
CN2120900000000,21,209,Scott County, KY,Jun-17,28767,27503,1264,4.4
CN2120900000000,21,209,Scott County, KY,Jul-17,28524,27353,1171,4.1
CN2120900000000,21,209,Scott County, KY,Aug-17,28261,27215,1046,3.7
CN2120900000000,21,209,Scott County, KY,Sep-17,28416,27487,929,3.3
CN2120900000000,21,209,Scott County, KY,Oct-17,28371,27492,879,3.1
CN2120900000000,21,209,Scott County, KY,Nov-17,28546,27694,852,3.0
CN2120900000000,21,209,Scott County, KY,Dec-17,28412,27587,825,2.9
CN2120900000000,21,209,Scott County, KY,Jan-18,28187,27289,898,3.2
CN2120900000000,21,209,Scott County, KY,Feb-18,28231,27189,1042,3.7
CN2120900000000,21,209,Scott County, KY,Mar-18,28329,27345,984,3.5
CN2120900000000,21,209,Scott County, KY,Apr-18(p),28619,27756,863,3.0
CN5167000000000,51,670,Hopewell city, VA,Mar-17,9952,9317,635,6.4
CN5167000000000,51,670,Hopewell city, VA,Apr-17,9971,9350,621,6.2
CN5167000000000,51,670,Hopewell city, VA,May-17,9917,9356,561,5.7
CN5167000000000,51,670,Hopewell city, VA,Jun-17,9974,9375,599,6.0
CN5167000000000,51,670,Hopewell city, VA,Jul-17,10075,9455,620,6.2
CN5167000000000,51,670,Hopewell city, VA,Aug-17,9973,9360,613,6.1
CN5167000000000,51,670,Hopewell city, VA,Sep-17,9983,9409,574,5.7
CN5167000000000,51,670,Hopewell city, VA,Oct-17,9909,9385,524,5.3
CN5167000000000,51,670,Hopewell city, VA,Nov-17,9843,9296,547,5.6
CN5167000000000,51,670,Hopewell city, VA,Dec-17,9808,9249,559,5.7
CN5167000000000,51,670,Hopewell city, VA,Jan-18,9821,9257,564,5.7
CN5167000000000,51,670,Hopewell city, VA,Feb-18,9912,9381,531,5.4
CN5167000000000,51,670,Hopewell city, VA,Mar-18,9974,9440,534,5.4
CN5167000000000,51,670,Hopewell city, VA,Apr-18(p),9953,9482,471,4.7
CN2451000000000,24,510,Baltimore city, MD,Mar-17,291737,273588,18149,6.2
CN2451000000000,24,510,Baltimore city, MD,Apr-17,292426,274887,17539,6.0
CN2451000000000,24,510,Baltimore city, MD,May-17,293377,276574,16803,5.7
CN2451000000000,24,510,Baltimore city, MD,Jun-17,296974,278098,18876,6.4
CN2451000000000,24,510,Baltimore city, MD,Jul-17,299782,280789,18993,6.3
CN2451000000000,24,510,Baltimore city, MD,Aug-17,298154,278408,19746,6.6
CN2451000000000,24,510,Baltimore city, MD,Sep-17,294993,278234,16759,5.7
CN2451000000000,24,510,Baltimore city, MD,Oct-17,294146,277457,16689,5.7
CN2451000000000,24,510,Baltimore city, MD,Nov-17,294238,277516,16722,5.7
CN2451000000000,24,510,Baltimore city, MD,Dec-17,292410,275415,16995,5.8
CN2451000000000,24,510,Baltimore city, MD,Jan-18,292771,273571,19200,6.6
CN2451000000000,24,510,Baltimore city, MD,Feb-18,293094,274278,18816,6.4
CN2451000000000,24,510,Baltimore city, MD,Mar-18,294531,275768,18763,6.4
CN2451000000000,24,510,Baltimore city, MD,Apr-18(p),293236,276360,16876,5.8
CN0100700000000,01,007,Bibb County, AL,Mar-17,8539,8116,423,5.0
CN0100700000000,01,007,Bibb County, AL,Apr-17,8488,8142,346,4.1
CN0100700000000,01,007,Bibb County, AL,May-17,8476,8138,338,4.0
CN0100700000000,01,007,Bibb County, AL,Jun-17,8557,8139,418,4.9
CN0100700000000,01,007,Bibb County, AL,Jul-17,8579,8175,404,4.7
CN0100700000000,01,007,Bibb County, AL,Aug-17,8479,8118,361,4.3
CN0100700000000,01,007,Bibb County, AL,Sep-17,8506,8197,309,3.6
CN0100700000000,01,007,Bibb County, AL,Oct-17,8493,8195,298,3.5
CN0100700000000,01,007,Bibb County, AL,Nov-17,8455,8177,278,3.3
CN0100700000000,01,007,Bibb County, AL,Dec-17,8412,8143,269,3.2
CN0100700000000,01,007,Bibb County, AL,Jan-18,8411,8078,333,4.0
CN0100700000000,01,007,Bibb County, AL,Feb-18,8536,8187,349,4.1
CN0100700000000,01,007,Bibb County, AL,Mar-18,8539,8222,317,3.7
CN0100700000000,01,007,Bibb County, AL,Apr-18(p),8641,8339,302,3.5
CN0900500000000,09,005,Litchfield County, CT,Mar-17,106383,100932,5451,5.1
CN0900500000000,09,005,Litchfield County, CT,Apr-17,105700,101044,4656,4.4
CN0900500000000,09,005,Litchfield County, CT,May-17,106283,101939,4344,4.1
CN0900500000000,09,005,Litchfield County, CT,Jun-17,107114,102593,4521,4.2
CN0900500000000,09,005,Litchfield County, CT,Jul-17,107666,103052,4614,4.3
CN0900500000000,09,005,Litchfield County, CT,Aug-17,105837,101529,4308,4.1
CN0900500000000,09,005,Litchfield County, CT,Sep-17,104734,100927,3807,3.6
CN0900500000000,09,005,Litchfield County, CT,Oct-17,104315,100575,3740,3.6
CN0900500000000,09,005,Litchfield County, CT,Nov-17,104459,100748,3711,3.6
CN0900500000000,09,005,Litchfield County, CT,Dec-17,104486,100683,3803,3.6
CN0900500000000,09,005,Litchfield County, CT,Jan-18,104573,98976,5597,5.4
CN0900500000000,09,005,Litchfield County, CT,Feb-18,104028,98602,5426,5.2
CN0900500000000,09,005,Litchfield County, CT,Mar-18,104087,99187,4900,4.7
CN0900500000000,09,005,Litchfield County, CT,Apr-18(p),103037,98933,4104,4.0
CN0804300000000,08,043,Fremont County, CO,Mar-17,14677,14016,661,4.5
CN0804300000000,08,043,Fremont County, CO,Apr-17,14807,14234,573,3.9
CN0804300000000,08,043,Fremont County, CO,May-17,15085,14542,543,3.6
CN0804300000000,08,043,Fremont County, CO,Jun-17,15501,14849,652,4.2
CN0804300000000,08,043,Fremont County, CO,Jul-17,15616,14984,632,4.0
CN0804300000000,08,043,Fremont County, CO,Aug-17,15464,14834,630,4.1
CN0804300000000,08,043,Fremont County, CO,Sep-17,15314,14700,614,4.0
CN0804300000000,08,043,Fremont County, CO,Oct-17,15271,14645,626,4.1
CN0804300000000,08,043,Fremont County, CO,Nov-17,15323,14672,651,4.2
CN0804300000000,08,043,Fremont County, CO,Dec-17,15004,14291,713,4.8
CN0804300000000,08,043,Fremont County, CO,Jan-18,14823,14026,797,5.4
CN0804300000000,08,043,Fremont County, CO,Feb-18,15094,14286,808,5.4
CN0804300000000,08,043,Fremont County, CO,Mar-18,15156,14457,699,4.6
CN0804300000000,08,043,Fremont County, CO,Apr-18(p),15295,14686,609,4.0
CN1703100000000,17,031,Cook County, IL,Mar-17,2640740,2514583,126157,4.8
CN1703100000000,17,031,Cook County, IL,Apr-17,2627215,2500511,126704,4.8
CN1703100000000,17,031,Cook County, IL,May-17,2639920,2516486,123434,4.7
CN1703100000000,17,031,Cook County, IL,Jun-17,2692944,2543074,149870,5.6
CN1703100000000,17,031,Cook County, IL,Jul-17,2691384,2541927,149457,5.6
CN1703100000000,17,031,Cook County, IL,Aug-17,2665965,2508801,157164,5.9
CN1703100000000,17,031,Cook County, IL,Sep-17,2659377,2522922,136455,5.1
CN1703100000000,17,031,Cook County, IL,Oct-17,2652318,2517661,134657,5.1
CN1703100000000,17,031,Cook County, IL,Nov-17,2656315,2523723,132592,5.0
CN1703100000000,17,031,Cook County, IL,Dec-17,2646950,2512895,134055,5.1
CN1703100000000,17,031,Cook County, IL,Jan-18,2617298,2468135,149163,5.7
CN1703100000000,17,031,Cook County, IL,Feb-18,2653566,2508823,144743,5.5
CN1703100000000,17,031,Cook County, IL,Mar-18,2629566,2514591,114975,4.4
CN1703100000000,17,031,Cook County, IL,Apr-18(p),2592252,2496386,95866,3.7
CN2710700000000,27,107,Norman County, MN,Mar-17,3452,3240,212,6.1
CN2710700000000,27,107,Norman County, MN,Apr-17,3450,3286,164,4.8
CN2710700000000,27,107,Norman County, MN,May-17,3464,3331,133,3.8
CN2710700000000,27,107,Norman County, MN,Jun-17,3472,3317,155,4.5
CN2710700000000,27,107,Norman County, MN,Jul-17,3359,3206,153,4.6
CN2710700000000,27,107,Norman County, MN,Aug-17,3262,3121,141,4.3
CN2710700000000,27,107,Norman County, MN,Sep-17,3222,3115,107,3.3
CN2710700000000,27,107,Norman County, MN,Oct-17,3418,3327,91,2.7
CN2710700000000,27,107,Norman County, MN,Nov-17,3402,3263,139,4.1
CN2710700000000,27,107,Norman County, MN,Dec-17,3412,3232,180,5.3
CN2710700000000,27,107,Norman County, MN,Jan-18,3355,3130,225,6.7
CN2710700000000,27,107,Norman County, MN,Feb-18,3344,3141,203,6.1
CN2710700000000,27,107,Norman County, MN,Mar-18,3354,3156,198,5.9
CN2710700000000,27,107,Norman County, MN,Apr-18(p),3352,3191,161,4.8
CN2116300000000,21,163,Meade County, KY,Mar-17,12179,11468,711,5.8
CN2116300000000,21,163,Meade County, KY,Apr-17,12291,11664,627,5.1
CN2116300000000,21,163,Meade County, KY,May-17,12296,11645,651,5.3
CN2116300000000,21,163,Meade County, KY,Jun-17,12510,11793,717,5.7
CN2116300000000,21,163,Meade County, KY,Jul-17,12508,11798,710,5.7
CN2116300000000,21,163,Meade County, KY,Aug-17,12262,11664,598,4.9
CN2116300000000,21,163,Meade County, KY,Sep-17,12171,11624,547,4.5
CN2116300000000,21,163,Meade County, KY,Oct-17,12037,11519,518,4.3
CN2116300000000,21,163,Meade County, KY,Nov-17,12086,11591,495,4.1
CN2116300000000,21,163,Meade County, KY,Dec-17,11992,11506,486,4.1
CN2116300000000,21,163,Meade County, KY,Jan-18,12016,11464,552,4.6
CN2116300000000,21,163,Meade County, KY,Feb-18,12171,11578,593,4.9
CN2116300000000,21,163,Meade County, KY,Mar-18,12250,11680,570,4.7
CN2116300000000,21,163,Meade County, KY,Apr-18(p),12272,11757,515,4.2
CN1906900000000,19,069,Franklin County, IA,Mar-17,5649,5433,216,3.8
CN1906900000000,19,069,Franklin County, IA,Apr-17,5768,5602,166,2.9
CN1906900000000,19,069,Franklin County, IA,May-17,5847,5703,144,2.5
CN1906900000000,19,069,Franklin County, IA,Jun-17,5964,5819,145,2.4
CN1906900000000,19,069,Franklin County, IA,Jul-17,5980,5839,141,2.4
CN1906900000000,19,069,Franklin County, IA,Aug-17,5845,5702,143,2.4
CN1906900000000,19,069,Franklin County, IA,Sep-17,5795,5674,121,2.1
CN1906900000000,19,069,Franklin County, IA,Oct-17,5783,5680,103,1.8
CN1906900000000,19,069,Franklin County, IA,Nov-17,5698,5591,107,1.9
CN1906900000000,19,069,Franklin County, IA,Dec-17,5702,5555,147,2.6
CN1906900000000,19,069,Franklin County, IA,Jan-18,5558,5375,183,3.3
CN1906900000000,19,069,Franklin County, IA,Feb-18,5619,5434,185,3.3
CN1906900000000,19,069,Franklin County, IA,Mar-18,5563,5403,160,2.9
CN1906900000000,19,069,Franklin County, IA,Apr-18(p),5618,5475,143,2.5
CN2805700000000,28,057,Itawamba County, MS,Mar-17,10339,9893,446,4.3
CN2805700000000,28,057,Itawamba County, MS,Apr-17,10342,9944,398,3.8
CN2805700000000,28,057,Itawamba County, MS,May-17,10460,9949,511,4.9
CN2805700000000,28,057,Itawamba County, MS,Jun-17,10636,10071,565,5.3
CN2805700000000,28,057,Itawamba County, MS,Jul-17,10534,10029,505,4.8
CN2805700000000,28,057,Itawamba County, MS,Aug-17,10350,9910,440,4.3
CN2805700000000,28,057,Itawamba County, MS,Sep-17,10363,9964,399,3.9
CN2805700000000,28,057,Itawamba County, MS,Oct-17,10269,9886,383,3.7
CN2805700000000,28,057,Itawamba County, MS,Nov-17,10342,9968,374,3.6
CN2805700000000,28,057,Itawamba County, MS,Dec-17,10358,9991,367,3.5
CN2805700000000,28,057,Itawamba County, MS,Jan-18,10224,9870,354,3.5
CN2805700000000,28,057,Itawamba County, MS,Feb-18,10310,9937,373,3.6
CN2805700000000,28,057,Itawamba County, MS,Mar-18,10312,9938,374,3.6
CN2805700000000,28,057,Itawamba County, MS,Apr-18(p),10358,9975,383,3.7
CN3900500000000,39,005,Ashland County, OH,Mar-17,26884,25488,1396,5.2
CN3900500000000,39,005,Ashland County, OH,Apr-17,26487,25321,1166,4.4
CN3900500000000,39,005,Ashland County, OH,May-17,25914,24808,1106,4.3
CN3900500000000,39,005,Ashland County, OH,Jun-17,26247,24973,1274,4.9
CN3900500000000,39,005,Ashland County, OH,Jul-17,26367,25030,1337,5.1
CN3900500000000,39,005,Ashland County, OH,Aug-17,26672,25417,1255,4.7
CN3900500000000,39,005,Ashland County, OH,Sep-17,26586,25429,1157,4.4
CN3900500000000,39,005,Ashland County, OH,Oct-17,26607,25505,1102,4.1
CN3900500000000,39,005,Ashland County, OH,Nov-17,26488,25327,1161,4.4
CN3900500000000,39,005,Ashland County, OH,Dec-17,25767,24491,1276,5.0
CN3900500000000,39,005,Ashland County, OH,Jan-18,25621,24170,1451,5.7
CN3900500000000,39,005,Ashland County, OH,Feb-18,26330,25001,1329,5.0
CN3900500000000,39,005,Ashland County, OH,Mar-18,26744,25518,1226,4.6
CN3900500000000,39,005,Ashland County, OH,Apr-18(p),26299,25246,1053,4.0
CN0603300000000,06,033,Lake County, CA,Mar-17,29951,28034,1917,6.4
CN0603300000000,06,033,Lake County, CA,Apr-17,29559,27861,1698,5.7
CN0603300000000,06,033,Lake County, CA,May-17,29612,28082,1530,5.2
CN0603300000000,06,033,Lake County, CA,Jun-17,29606,27969,1637,5.5
CN0603300000000,06,033,Lake County, CA,Jul-17,29710,28002,1708,5.7
CN0603300000000,06,033,Lake County, CA,Aug-17,30391,28759,1632,5.4
CN0603300000000,06,033,Lake County, CA,Sep-17,30126,28690,1436,4.8
CN0603300000000,06,033,Lake County, CA,Oct-17,29678,28179,1499,5.1
CN0603300000000,06,033,Lake County, CA,Nov-17,29345,27797,1548,5.3
CN0603300000000,06,033,Lake County, CA,Dec-17,29463,27815,1648,5.6
CN0603300000000,06,033,Lake County, CA,Jan-18,29921,28110,1811,6.1
CN0603300000000,06,033,Lake County, CA,Feb-18,29895,28182,1713,5.7
CN0603300000000,06,033,Lake County, CA,Mar-18,29696,28063,1633,5.5
CN0603300000000,06,033,Lake County, CA,Apr-18(p),29601,28133,1468,5.0
CN2918700000000,29,187,St. Francois County, MO,Mar-17,26331,25036,1295,4.9
CN2918700000000,29,187,St. Francois County, MO,Apr-17,26421,25303,1118,4.2
CN2918700000000,29,187,St. Francois County, MO,May-17,26440,25287,1153,4.4
CN2918700000000,29,187,St. Francois County, MO,Jun-17,26758,25580,1178,4.4
CN2918700000000,29,187,St. Francois County, MO,Jul-17,26202,24937,1265,4.8
CN2918700000000,29,187,St. Francois County, MO,Aug-17,26220,24970,1250,4.8
CN2918700000000,29,187,St. Francois County, MO,Sep-17,26186,25160,1026,3.9
CN2918700000000,29,187,St. Francois County, MO,Oct-17,25881,25082,799,3.1
CN2918700000000,29,187,St. Francois County, MO,Nov-17,25991,25047,944,3.6
CN2918700000000,29,187,St. Francois County, MO,Dec-17,26080,25028,1052,4.0
CN2918700000000,29,187,St. Francois County, MO,Jan-18,25846,24570,1276,4.9
CN2918700000000,29,187,St. Francois County, MO,Feb-18,26012,24749,1263,4.9
CN2918700000000,29,187,St. Francois County, MO,Mar-18,26067,24924,1143,4.4
CN2918700000000,29,187,St. Francois County, MO,Apr-18(p),26269,25231,1038,4.0
CN5116300000000,51,163,Rockbridge County, VA,Mar-17,10595,10153,442,4.2
CN5116300000000,51,163,Rockbridge County, VA,Apr-17,10751,10346,405,3.8
CN5116300000000,51,163,Rockbridge County, VA,May-17,10486,10060,426,4.1
CN5116300000000,51,163,Rockbridge County, VA,Jun-17,10605,10132,473,4.5
CN5116300000000,51,163,Rockbridge County, VA,Jul-17,10776,10283,493,4.6
CN5116300000000,51,163,Rockbridge County, VA,Aug-17,10759,10282,477,4.4
CN5116300000000,51,163,Rockbridge County, VA,Sep-17,10870,10478,392,3.6
CN5116300000000,51,163,Rockbridge County, VA,Oct-17,10605,10241,364,3.4
CN5116300000000,51,163,Rockbridge County, VA,Nov-17,10545,10179,366,3.5
CN5116300000000,51,163,Rockbridge County, VA,Dec-17,10236,9878,358,3.5
CN5116300000000,51,163,Rockbridge County, VA,Jan-18,10416,9992,424,4.1
CN5116300000000,51,163,Rockbridge County, VA,Feb-18,10600,10250,350,3.3
CN5116300000000,51,163,Rockbridge County, VA,Mar-18,10746,10399,347,3.2
CN5116300000000,51,163,Rockbridge County, VA,Apr-18(p),10875,10589,286,2.6
CN1811900000000,18,119,Owen County, IN,Mar-17,9383,8939,444,4.7
CN1811900000000,18,119,Owen County, IN,Apr-17,9326,8979,347,3.7
CN1811900000000,18,119,Owen County, IN,May-17,9135,8772,363,4.0
CN1811900000000,18,119,Owen County, IN,Jun-17,9039,8672,367,4.1
CN1811900000000,18,119,Owen County, IN,Jul-17,8840,8450,390,4.4
CN1811900000000,18,119,Owen County, IN,Aug-17,8935,8505,430,4.8
CN1811900000000,18,119,Owen County, IN,Sep-17,9184,8825,359,3.9
CN1811900000000,18,119,Owen County, IN,Oct-17,9245,8895,350,3.8
CN1811900000000,18,119,Owen County, IN,Nov-17,9211,8860,351,3.8
CN1811900000000,18,119,Owen County, IN,Dec-17,9030,8684,346,3.8
CN1811900000000,18,119,Owen County, IN,Jan-18,8926,8479,447,5.0
CN1811900000000,18,119,Owen County, IN,Feb-18,9266,8797,469,5.1
CN1811900000000,18,119,Owen County, IN,Mar-18,9213,8802,411,4.5
CN1811900000000,18,119,Owen County, IN,Apr-18(p),9250,8917,333,3.6
CN5160000000000,51,600,Fairfax city, VA,Mar-17,13230,12833,397,3.0
CN5160000000000,51,600,Fairfax city, VA,Apr-17,13222,12851,371,2.8
CN5160000000000,51,600,Fairfax city, VA,May-17,13304,12904,400,3.0
CN5160000000000,51,600,Fairfax city, VA,Jun-17,13366,12966,400,3.0
CN5160000000000,51,600,Fairfax city, VA,Jul-17,13440,13032,408,3.0
CN5160000000000,51,600,Fairfax city, VA,Aug-17,13255,12842,413,3.1
CN5160000000000,51,600,Fairfax city, VA,Sep-17,13254,12884,370,2.8
CN5160000000000,51,600,Fairfax city, VA,Oct-17,13250,12883,367,2.8
CN5160000000000,51,600,Fairfax city, VA,Nov-17,13274,12908,366,2.8
CN5160000000000,51,600,Fairfax city, VA,Dec-17,13217,12883,334,2.5
CN5160000000000,51,600,Fairfax city, VA,Jan-18,13325,12953,372,2.8
CN5160000000000,51,600,Fairfax city, VA,Feb-18,13429,13102,327,2.4
CN5160000000000,51,600,Fairfax city, VA,Mar-18,13500,13150,350,2.6
CN5160000000000,51,600,Fairfax city, VA,Apr-18(p),13462,13162,300,2.2
CN0107700000000,01,077,Lauderdale County, AL,Mar-17,42484,40345,2139,5.0
CN0107700000000,01,077,Lauderdale County, AL,Apr-17,42227,40397,1830,4.3
CN0107700000000,01,077,Lauderdale County, AL,May-17,41930,40204,1726,4.1
CN0107700000000,01,077,Lauderdale County, AL,Jun-17,42063,39871,2192,5.2
CN0107700000000,01,077,Lauderdale County, AL,Jul-17,41713,39693,2020,4.8
CN0107700000000,01,077,Lauderdale County, AL,Aug-17,41544,39642,1902,4.6
CN0107700000000,01,077,Lauderdale County, AL,Sep-17,41698,40110,1588,3.8
CN0107700000000,01,077,Lauderdale County, AL,Oct-17,41768,40191,1577,3.8
CN0107700000000,01,077,Lauderdale County, AL,Nov-17,41588,40104,1484,3.6
CN0107700000000,01,077,Lauderdale County, AL,Dec-17,41056,39561,1495,3.6
CN0107700000000,01,077,Lauderdale County, AL,Jan-18,40854,39006,1848,4.5
CN0107700000000,01,077,Lauderdale County, AL,Feb-18,41398,39574,1824,4.4
CN0107700000000,01,077,Lauderdale County, AL,Mar-18,41731,40069,1662,4.0
CN0107700000000,01,077,Lauderdale County, AL,Apr-18(p),42089,40547,1542,3.7
CN4202500000000,42,025,Carbon County, PA,Mar-17,31660,29708,1952,6.2
CN4202500000000,42,025,Carbon County, PA,Apr-17,31462,29812,1650,5.2
CN4202500000000,42,025,Carbon County, PA,May-17,31569,29874,1695,5.4
CN4202500000000,42,025,Carbon County, PA,Jun-17,31819,30073,1746,5.5
CN4202500000000,42,025,Carbon County, PA,Jul-17,31788,29945,1843,5.8
CN4202500000000,42,025,Carbon County, PA,Aug-17,31461,29606,1855,5.9
CN4202500000000,42,025,Carbon County, PA,Sep-17,31395,29893,1502,4.8
CN4202500000000,42,025,Carbon County, PA,Oct-17,31213,29740,1473,4.7
CN4202500000000,42,025,Carbon County, PA,Nov-17,31297,29767,1530,4.9
CN4202500000000,42,025,Carbon County, PA,Dec-17,31103,29515,1588,5.1
CN4202500000000,42,025,Carbon County, PA,Jan-18,31257,29339,1918,6.1
CN4202500000000,42,025,Carbon County, PA,Feb-18,31353,29436,1917,6.1
CN4202500000000,42,025,Carbon County, PA,Mar-18,31038,29296,1742,5.6
CN4202500000000,42,025,Carbon County, PA,Apr-18(p),31105,29576,1529,4.9
CN5101300000000,51,013,Arlington County, VA,Mar-17,149347,145439,3908,2.6
CN5101300000000,51,013,Arlington County, VA,Apr-17,149343,145858,3485,2.3
CN5101300000000,51,013,Arlington County, VA,May-17,150281,146390,3891,2.6
CN5101300000000,51,013,Arlington County, VA,Jun-17,150793,146966,3827,2.5
CN5101300000000,51,013,Arlington County, VA,Jul-17,151805,147933,3872,2.6
CN5101300000000,51,013,Arlington County, VA,Aug-17,149600,145767,3833,2.6
CN5101300000000,51,013,Arlington County, VA,Sep-17,149871,146298,3573,2.4
CN5101300000000,51,013,Arlington County, VA,Oct-17,149805,146333,3472,2.3
CN5101300000000,51,013,Arlington County, VA,Nov-17,149692,146344,3348,2.2
CN5101300000000,51,013,Arlington County, VA,Dec-17,149155,145952,3203,2.1
CN5101300000000,51,013,Arlington County, VA,Jan-18,150363,146821,3542,2.4
CN5101300000000,51,013,Arlington County, VA,Feb-18,151562,148420,3142,2.1
CN5101300000000,51,013,Arlington County, VA,Mar-18,152180,148862,3318,2.2
CN5101300000000,51,013,Arlington County, VA,Apr-18(p),151976,149077,2899,1.9
CN4006500000000,40,065,Jackson County, OK,Mar-17,10983,10560,423,3.9
CN4006500000000,40,065,Jackson County, OK,Apr-17,10906,10519,387,3.5
CN4006500000000,40,065,Jackson County, OK,May-17,10933,10493,440,4.0
CN4006500000000,40,065,Jackson County, OK,Jun-17,11005,10548,457,4.2
CN4006500000000,40,065,Jackson County, OK,Jul-17,10439,10015,424,4.1
CN4006500000000,40,065,Jackson County, OK,Aug-17,10761,10347,414,3.8
CN4006500000000,40,065,Jackson County, OK,Sep-17,10827,10409,418,3.9
CN4006500000000,40,065,Jackson County, OK,Oct-17,10989,10605,384,3.5
CN4006500000000,40,065,Jackson County, OK,Nov-17,11025,10652,373,3.4
CN4006500000000,40,065,Jackson County, OK,Dec-17,10890,10533,357,3.3
CN4006500000000,40,065,Jackson County, OK,Jan-18,10826,10430,396,3.7
CN4006500000000,40,065,Jackson County, OK,Feb-18,10773,10390,383,3.6
CN4006500000000,40,065,Jackson County, OK,Mar-18,10829,10445,384,3.5
CN4006500000000,40,065,Jackson County, OK,Apr-18(p),10669,10294,375,3.5
CN3107700000000,31,077,Greeley County, NE,Mar-17,1183,1150,33,2.8
CN3107700000000,31,077,Greeley County, NE,Apr-17,1223,1190,33,2.7
CN3107700000000,31,077,Greeley County, NE,May-17,1278,1241,37,2.9
CN3107700000000,31,077,Greeley County, NE,Jun-17,1358,1320,38,2.8
CN3107700000000,31,077,Greeley County, NE,Jul-17,1301,1256,45,3.5
CN3107700000000,31,077,Greeley County, NE,Aug-17,1232,1193,39,3.2
CN3107700000000,31,077,Greeley County, NE,Sep-17,1166,1129,37,3.2
CN3107700000000,31,077,Greeley County, NE,Oct-17,1167,1132,35,3.0
CN3107700000000,31,077,Greeley County, NE,Nov-17,1184,1142,42,3.5
CN3107700000000,31,077,Greeley County, NE,Dec-17,1176,1141,35,3.0
CN3107700000000,31,077,Greeley County, NE,Jan-18,1205,1169,36,3.0
CN3107700000000,31,077,Greeley County, NE,Feb-18,1158,1129,29,2.5
CN3107700000000,31,077,Greeley County, NE,Mar-18,1191,1158,33,2.8
CN3107700000000,31,077,Greeley County, NE,Apr-18(p),1207,1173,34,2.8
CN2901100000000,29,011,Barton County, MO,Mar-17,5174,4938,236,4.6
CN2901100000000,29,011,Barton County, MO,Apr-17,5299,5088,211,4.0
CN2901100000000,29,011,Barton County, MO,May-17,5172,4955,217,4.2
CN2901100000000,29,011,Barton County, MO,Jun-17,5236,5013,223,4.3
CN2901100000000,29,011,Barton County, MO,Jul-17,5127,4890,237,4.6
CN2901100000000,29,011,Barton County, MO,Aug-17,5098,4849,249,4.9
CN2901100000000,29,011,Barton County, MO,Sep-17,5008,4831,177,3.5
CN2901100000000,29,011,Barton County, MO,Oct-17,5017,4887,130,2.6
CN2901100000000,29,011,Barton County, MO,Nov-17,4984,4824,160,3.2
CN2901100000000,29,011,Barton County, MO,Dec-17,4908,4754,154,3.1
CN2901100000000,29,011,Barton County, MO,Jan-18,4949,4766,183,3.7
CN2901100000000,29,011,Barton County, MO,Feb-18,5013,4836,177,3.5
CN2901100000000,29,011,Barton County, MO,Mar-18,5020,4836,184,3.7
CN2901100000000,29,011,Barton County, MO,Apr-18(p),5101,4938,163,3.2
CN4832300000000,48,323,Maverick County, TX,Mar-17,24539,21846,2693,11.0
CN4832300000000,48,323,Maverick County, TX,Apr-17,24530,21959,2571,10.5
CN4832300000000,48,323,Maverick County, TX,May-17,24062,21798,2264,9.4
CN4832300000000,48,323,Maverick County, TX,Jun-17,23901,21575,2326,9.7
CN4832300000000,48,323,Maverick County, TX,Jul-17,23149,21058,2091,9.0
CN4832300000000,48,323,Maverick County, TX,Aug-17,23069,21047,2022,8.8
CN4832300000000,48,323,Maverick County, TX,Sep-17,23181,21520,1661,7.2
CN4832300000000,48,323,Maverick County, TX,Oct-17,23130,21554,1576,6.8
CN4832300000000,48,323,Maverick County, TX,Nov-17,23532,21869,1663,7.1
CN4832300000000,48,323,Maverick County, TX,Dec-17,23780,21908,1872,7.9
CN4832300000000,48,323,Maverick County, TX,Jan-18,24214,21915,2299,9.5
CN4832300000000,48,323,Maverick County, TX,Feb-18,24459,22078,2381,9.7
CN4832300000000,48,323,Maverick County, TX,Mar-18,24492,22095,2397,9.8
CN4832300000000,48,323,Maverick County, TX,Apr-18(p),24271,22075,2196,9.0
CN2010700000000,20,107,Linn County, KS,Mar-17,4303,4041,262,6.1
CN2010700000000,20,107,Linn County, KS,Apr-17,4273,4044,229,5.4
CN2010700000000,20,107,Linn County, KS,May-17,4271,4037,234,5.5
CN2010700000000,20,107,Linn County, KS,Jun-17,4394,4130,264,6.0
CN2010700000000,20,107,Linn County, KS,Jul-17,4493,4212,281,6.3
CN2010700000000,20,107,Linn County, KS,Aug-17,4422,4154,268,6.1
CN2010700000000,20,107,Linn County, KS,Sep-17,4370,4138,232,5.3
CN2010700000000,20,107,Linn County, KS,Oct-17,4345,4140,205,4.7
CN2010700000000,20,107,Linn County, KS,Nov-17,4346,4141,205,4.7
CN2010700000000,20,107,Linn County, KS,Dec-17,4356,4126,230,5.3
CN2010700000000,20,107,Linn County, KS,Jan-18,4381,4092,289,6.6
CN2010700000000,20,107,Linn County, KS,Feb-18,4396,4089,307,7.0
CN2010700000000,20,107,Linn County, KS,Mar-18,4342,4086,256,5.9
CN2010700000000,20,107,Linn County, KS,Apr-18(p),4311,4072,239,5.5
CN4849900000000,48,499,Wood County, TX,Mar-17,17465,16604,861,4.9
CN4849900000000,48,499,Wood County, TX,Apr-17,17506,16729,777,4.4
CN4849900000000,48,499,Wood County, TX,May-17,17474,16685,789,4.5
CN4849900000000,48,499,Wood County, TX,Jun-17,17426,16587,839,4.8
CN4849900000000,48,499,Wood County, TX,Jul-17,17248,16400,848,4.9
CN4849900000000,48,499,Wood County, TX,Aug-17,17201,16378,823,4.8
CN4849900000000,48,499,Wood County, TX,Sep-17,17290,16544,746,4.3
CN4849900000000,48,499,Wood County, TX,Oct-17,17179,16471,708,4.1
CN4849900000000,48,499,Wood County, TX,Nov-17,17229,16502,727,4.2
CN4849900000000,48,499,Wood County, TX,Dec-17,17227,16542,685,4.0
CN4849900000000,48,499,Wood County, TX,Jan-18,17303,16536,767,4.4
CN4849900000000,48,499,Wood County, TX,Feb-18,17652,16862,790,4.5
CN4849900000000,48,499,Wood County, TX,Mar-18,17776,16980,796,4.5
CN4849900000000,48,499,Wood County, TX,Apr-18(p),17667,16962,705,4.0
CN7212300000000,72,123,Salinas Municipio, PR,Mar-17,7418,6003,1415,19.1
CN7212300000000,72,123,Salinas Municipio, PR,Apr-17,7487,5984,1503,20.1
CN7212300000000,72,123,Salinas Municipio, PR,May-17,7402,6009,1393,18.8
CN7212300000000,72,123,Salinas Municipio, PR,Jun-17,7249,5974,1275,17.6
CN7212300000000,72,123,Salinas Municipio, PR,Jul-17,7441,6048,1393,18.7
CN7212300000000,72,123,Salinas Municipio, PR,Aug-17,7649,5975,1674,21.9
CN7212300000000,72,123,Salinas Municipio, PR,Sep-17(y),7443,5957,1486,20.0
CN7212300000000,72,123,Salinas Municipio, PR,Oct-17,7065,5758,1307,18.5
CN7212300000000,72,123,Salinas Municipio, PR,Nov-17,7396,6066,1330,18.0
CN7212300000000,72,123,Salinas Municipio, PR,Dec-17,7374,6146,1228,16.7
CN7212300000000,72,123,Salinas Municipio, PR,Jan-18,7974,6758,1216,15.2
CN7212300000000,72,123,Salinas Municipio, PR,Feb-18,7610,6575,1035,13.6
CN7212300000000,72,123,Salinas Municipio, PR,Mar-18,7724,6678,1046,13.5
CN7212300000000,72,123,Salinas Municipio, PR,Apr-18(p),7721,6717,1004,13.0
CN3200500000000,32,005,Douglas County, NV,Mar-17,22540,21349,1191,5.3
CN3200500000000,32,005,Douglas County, NV,Apr-17,22444,21298,1146,5.1
CN3200500000000,32,005,Douglas County, NV,May-17,22719,21584,1135,5.0
CN3200500000000,32,005,Douglas County, NV,Jun-17,23403,22329,1074,4.6
CN3200500000000,32,005,Douglas County, NV,Jul-17,23439,22403,1036,4.4
CN3200500000000,32,005,Douglas County, NV,Aug-17,23237,22224,1013,4.4
CN3200500000000,32,005,Douglas County, NV,Sep-17,23067,22069,998,4.3
CN3200500000000,32,005,Douglas County, NV,Oct-17,22732,21753,979,4.3
CN3200500000000,32,005,Douglas County, NV,Nov-17,22611,21643,968,4.3
CN3200500000000,32,005,Douglas County, NV,Dec-17,22760,21768,992,4.4
CN3200500000000,32,005,Douglas County, NV,Jan-18,22698,21518,1180,5.2
CN3200500000000,32,005,Douglas County, NV,Feb-18,22975,21871,1104,4.8
CN3200500000000,32,005,Douglas County, NV,Mar-18,23083,21976,1107,4.8
CN3200500000000,32,005,Douglas County, NV,Apr-18(p),22760,21741,1019,4.5
CN4213100000000,42,131,Wyoming County, PA,Mar-17,14008,13120,888,6.3
CN4213100000000,42,131,Wyoming County, PA,Apr-17,13964,13246,718,5.1
CN4213100000000,42,131,Wyoming County, PA,May-17,13936,13243,693,5.0
CN4213100000000,42,131,Wyoming County, PA,Jun-17,14033,13334,699,5.0
CN4213100000000,42,131,Wyoming County, PA,Jul-17,14076,13349,727,5.2
CN4213100000000,42,131,Wyoming County, PA,Aug-17,13963,13211,752,5.4
CN4213100000000,42,131,Wyoming County, PA,Sep-17,13948,13325,623,4.5
CN4213100000000,42,131,Wyoming County, PA,Oct-17,13869,13266,603,4.3
CN4213100000000,42,131,Wyoming County, PA,Nov-17,13916,13302,614,4.4
CN4213100000000,42,131,Wyoming County, PA,Dec-17,13865,13236,629,4.5
CN4213100000000,42,131,Wyoming County, PA,Jan-18,13927,13076,851,6.1
CN4213100000000,42,131,Wyoming County, PA,Feb-18,13889,13093,796,5.7
CN4213100000000,42,131,Wyoming County, PA,Mar-18,13726,13021,705,5.1
CN4213100000000,42,131,Wyoming County, PA,Apr-18(p),13693,13133,560,4.1
CN0201300000000,02,013,Aleutians East Borough, AK,Mar-17,3494,3432,62,1.8
CN0201300000000,02,013,Aleutians East Borough, AK,Apr-17,2585,2518,67,2.6
CN0201300000000,02,013,Aleutians East Borough, AK,May-17,1468,1398,70,4.8
CN0201300000000,02,013,Aleutians East Borough, AK,Jun-17,2421,2355,66,2.7
CN0201300000000,02,013,Aleutians East Borough, AK,Jul-17,3555,3494,61,1.7
CN0201300000000,02,013,Aleutians East Borough, AK,Aug-17,3487,3431,56,1.6
CN0201300000000,02,013,Aleutians East Borough, AK,Sep-17,2875,2809,66,2.3
CN0201300000000,02,013,Aleutians East Borough, AK,Oct-17,2582,2519,63,2.4
CN0201300000000,02,013,Aleutians East Borough, AK,Nov-17,1763,1691,72,4.1
CN0201300000000,02,013,Aleutians East Borough, AK,Dec-17,1195,1130,65,5.4
CN0201300000000,02,013,Aleutians East Borough, AK,Jan-18,2095,2028,67,3.2
CN0201300000000,02,013,Aleutians East Borough, AK,Feb-18,3589,3520,69,1.9
CN0201300000000,02,013,Aleutians East Borough, AK,Mar-18,3525,3463,62,1.8
CN0201300000000,02,013,Aleutians East Borough, AK,Apr-18(p),2662,2590,72,2.7
CN1100100000000,11,001,District of, Columbia,Mar-17,399738,375962,23776,5.9
CN1100100000000,11,001,District of, Columbia,Apr-17,399234,376962,22272,5.6
CN1100100000000,11,001,District of, Columbia,May-17,398908,375793,23115,5.8
CN1100100000000,11,001,District of, Columbia,Jun-17,404318,377839,26479,6.5
CN1100100000000,11,001,District of, Columbia,Jul-17,407291,380358,26933,6.6
CN1100100000000,11,001,District of, Columbia,Aug-17,400601,375041,25560,6.4
CN1100100000000,11,001,District of, Columbia,Sep-17,399944,374855,25089,6.3
CN1100100000000,11,001,District of, Columbia,Oct-17,401245,377350,23895,6.0
CN1100100000000,11,001,District of, Columbia,Nov-17,401397,378755,22642,5.6
CN1100100000000,11,001,District of, Columbia,Dec-17,400171,378555,21616,5.4
CN1100100000000,11,001,District of, Columbia,Jan-18,401782,379548,22234,5.5
CN1100100000000,11,001,District of, Columbia,Feb-18,406350,383343,23007,5.7
CN1100100000000,11,001,District of, Columbia,Mar-18,406302,383271,23031,5.7
CN1100100000000,11,001,District of, Columbia,Apr-18(p),408712,388167,20545,5.0
CN3807700000000,38,077,Richland County, ND,Mar-17,8836,8577,259,2.9
CN3807700000000,38,077,Richland County, ND,Apr-17,8891,8696,195,2.2
CN3807700000000,38,077,Richland County, ND,May-17,8941,8784,157,1.8
CN3807700000000,38,077,Richland County, ND,Jun-17,9156,8932,224,2.4
CN3807700000000,38,077,Richland County, ND,Jul-17,9004,8815,189,2.1
CN3807700000000,38,077,Richland County, ND,Aug-17,8918,8721,197,2.2
CN3807700000000,38,077,Richland County, ND,Sep-17,8981,8822,159,1.8
CN3807700000000,38,077,Richland County, ND,Oct-17,9038,8889,149,1.6
CN3807700000000,38,077,Richland County, ND,Nov-17,8755,8565,190,2.2
CN3807700000000,38,077,Richland County, ND,Dec-17,8637,8414,223,2.6
CN3807700000000,38,077,Richland County, ND,Jan-18,8553,8261,292,3.4
CN3807700000000,38,077,Richland County, ND,Feb-18,8575,8291,284,3.3
CN3807700000000,38,077,Richland County, ND,Mar-18,8616,8350,266,3.1
CN3807700000000,38,077,Richland County, ND,Apr-18(p),8597,8342,255,3.0
CN4509100000000,45,091,York County, SC,Mar-17,132218,127351,4867,3.7
CN4509100000000,45,091,York County, SC,Apr-17,132319,127766,4553,3.4
CN4509100000000,45,091,York County, SC,May-17,133079,128331,4748,3.6
CN4509100000000,45,091,York County, SC,Jun-17,134319,128670,5649,4.2
CN4509100000000,45,091,York County, SC,Jul-17,133299,127754,5545,4.2
CN4509100000000,45,091,York County, SC,Aug-17,134175,128260,5915,4.4
CN4509100000000,45,091,York County, SC,Sep-17,134498,129169,5329,4.0
CN4509100000000,45,091,York County, SC,Oct-17,135208,129986,5222,3.9
CN4509100000000,45,091,York County, SC,Nov-17,134291,129157,5134,3.8
CN4509100000000,45,091,York County, SC,Dec-17,134294,129060,5234,3.9
CN4509100000000,45,091,York County, SC,Jan-18,134278,128008,6270,4.7
CN4509100000000,45,091,York County, SC,Feb-18,134599,128810,5789,4.3
CN4509100000000,45,091,York County, SC,Mar-18,134866,129665,5201,3.9
CN4509100000000,45,091,York County, SC,Apr-18(p),133338,129720,3618,2.7
CN1916700000000,19,167,Sioux County, IA,Mar-17,20172,19615,557,2.8
CN1916700000000,19,167,Sioux County, IA,Apr-17,20647,20277,370,1.8
CN1916700000000,19,167,Sioux County, IA,May-17,20231,19880,351,1.7
CN1916700000000,19,167,Sioux County, IA,Jun-17,20273,19847,426,2.1
CN1916700000000,19,167,Sioux County, IA,Jul-17,20522,20136,386,1.9
CN1916700000000,19,167,Sioux County, IA,Aug-17,20049,19664,385,1.9
CN1916700000000,19,167,Sioux County, IA,Sep-17,20522,20196,326,1.6
CN1916700000000,19,167,Sioux County, IA,Oct-17,20673,20421,252,1.2
CN1916700000000,19,167,Sioux County, IA,Nov-17,20319,20059,260,1.3
CN1916700000000,19,167,Sioux County, IA,Dec-17,20346,19984,362,1.8
CN1916700000000,19,167,Sioux County, IA,Jan-18,20085,19525,560,2.8
CN1916700000000,19,167,Sioux County, IA,Feb-18,20312,19756,556,2.7
CN1916700000000,19,167,Sioux County, IA,Mar-18,20065,19534,531,2.6
CN1916700000000,19,167,Sioux County, IA,Apr-18(p),20278,19825,453,2.2
CN5402900000000,54,029,Hancock County, WV,Mar-17,12451,11659,792,6.4
CN5402900000000,54,029,Hancock County, WV,Apr-17,12743,11972,771,6.1
CN5402900000000,54,029,Hancock County, WV,May-17,12706,12002,704,5.5
CN5402900000000,54,029,Hancock County, WV,Jun-17,12910,12102,808,6.3
CN5402900000000,54,029,Hancock County, WV,Jul-17,12915,12144,771,6.0
CN5402900000000,54,029,Hancock County, WV,Aug-17,12798,12023,775,6.1
CN5402900000000,54,029,Hancock County, WV,Sep-17,12796,12103,693,5.4
CN5402900000000,54,029,Hancock County, WV,Oct-17,12724,12033,691,5.4
CN5402900000000,54,029,Hancock County, WV,Nov-17,12593,11847,746,5.9
CN5402900000000,54,029,Hancock County, WV,Dec-17,12560,11772,788,6.3
CN5402900000000,54,029,Hancock County, WV,Jan-18,12539,11634,905,7.2
CN5402900000000,54,029,Hancock County, WV,Feb-18,12696,11754,942,7.4
CN5402900000000,54,029,Hancock County, WV,Mar-18,12551,11677,874,7.0
CN5402900000000,54,029,Hancock County, WV,Apr-18(p),12629,11850,779,6.2
CN2005100000000,20,051,Ellis County, KS,Mar-17,16984,16547,437,2.6
CN2005100000000,20,051,Ellis County, KS,Apr-17,16869,16452,417,2.5
CN2005100000000,20,051,Ellis County, KS,May-17,16804,16366,438,2.6
CN2005100000000,20,051,Ellis County, KS,Jun-17,17227,16754,473,2.7
CN2005100000000,20,051,Ellis County, KS,Jul-17,17013,16511,502,3.0
CN2005100000000,20,051,Ellis County, KS,Aug-17,16776,16317,459,2.7
CN2005100000000,20,051,Ellis County, KS,Sep-17,17006,16631,375,2.2
CN2005100000000,20,051,Ellis County, KS,Oct-17,17040,16697,343,2.0
CN2005100000000,20,051,Ellis County, KS,Nov-17,17077,16689,388,2.3
CN2005100000000,20,051,Ellis County, KS,Dec-17,16902,16540,362,2.1
CN2005100000000,20,051,Ellis County, KS,Jan-18,16735,16337,398,2.4
CN2005100000000,20,051,Ellis County, KS,Feb-18,16807,16378,429,2.6
CN2005100000000,20,051,Ellis County, KS,Mar-18,16881,16463,418,2.5
CN2005100000000,20,051,Ellis County, KS,Apr-18(p),16753,16348,405,2.4
CN1207500000000,12,075,Levy County, FL,Mar-17,17044,16296,748,4.4
CN1207500000000,12,075,Levy County, FL,Apr-17,17130,16426,704,4.1
CN1207500000000,12,075,Levy County, FL,May-17,17043,16313,730,4.3
CN1207500000000,12,075,Levy County, FL,Jun-17,16720,15956,764,4.6
CN1207500000000,12,075,Levy County, FL,Jul-17,16800,16026,774,4.6
CN1207500000000,12,075,Levy County, FL,Aug-17,16827,16071,756,4.5
CN1207500000000,12,075,Levy County, FL,Sep-17,17383,16686,697,4.0
CN1207500000000,12,075,Levy County, FL,Oct-17,17126,16462,664,3.9
CN1207500000000,12,075,Levy County, FL,Nov-17,16950,16280,670,4.0
CN1207500000000,12,075,Levy County, FL,Dec-17,16785,16139,646,3.8
CN1207500000000,12,075,Levy County, FL,Jan-18,16903,16150,753,4.5
CN1207500000000,12,075,Levy County, FL,Feb-18,17042,16369,673,3.9
CN1207500000000,12,075,Levy County, FL,Mar-18,17075,16404,671,3.9
CN1207500000000,12,075,Levy County, FL,Apr-18(p),17152,16553,599,3.5
CN7213100000000,72,131,San Sebastian Municipio, PR,Mar-17,10961,8819,2142,19.5
CN7213100000000,72,131,San Sebastian Municipio, PR,Apr-17,10810,8589,2221,20.5
CN7213100000000,72,131,San Sebastian Municipio, PR,May-17,10723,8817,1906,17.8
CN7213100000000,72,131,San Sebastian Municipio, PR,Jun-17,10453,8883,1570,15.0
CN7213100000000,72,131,San Sebastian Municipio, PR,Jul-17,10795,9049,1746,16.2
CN7213100000000,72,131,San Sebastian Municipio, PR,Aug-17,10869,8945,1924,17.7
CN7213100000000,72,131,San Sebastian Municipio, PR,Sep-17(y),10427,8772,1655,15.9
CN7213100000000,72,131,San Sebastian Municipio, PR,Oct-17,10089,8345,1744,17.3
CN7213100000000,72,131,San Sebastian Municipio, PR,Nov-17,10704,8976,1728,16.1
CN7213100000000,72,131,San Sebastian Municipio, PR,Dec-17,10762,9046,1716,15.9
CN7213100000000,72,131,San Sebastian Municipio, PR,Jan-18,10735,8849,1886,17.6
CN7213100000000,72,131,San Sebastian Municipio, PR,Feb-18,10389,8624,1765,17.0
CN7213100000000,72,131,San Sebastian Municipio, PR,Mar-18,10468,8721,1747,16.7
CN7213100000000,72,131,San Sebastian Municipio, PR,Apr-18(p),10490,8818,1672,15.9
CN7202500000000,72,025,Caguas Municipio, PR,Mar-17,48285,44026,4259,8.8
CN7202500000000,72,025,Caguas Municipio, PR,Apr-17,48133,43644,4489,9.3
CN7202500000000,72,025,Caguas Municipio, PR,May-17,47282,43353,3929,8.3
CN7202500000000,72,025,Caguas Municipio, PR,Jun-17,46854,43081,3773,8.1
CN7202500000000,72,025,Caguas Municipio, PR,Jul-17,47061,42888,4173,8.9
CN7202500000000,72,025,Caguas Municipio, PR,Aug-17,46753,42316,4437,9.5
CN7202500000000,72,025,Caguas Municipio, PR,Sep-17(y),47048,42841,4207,8.9
CN7202500000000,72,025,Caguas Municipio, PR,Oct-17,45828,41113,4715,10.3
CN7202500000000,72,025,Caguas Municipio, PR,Nov-17,47980,43523,4457,9.3
CN7202500000000,72,025,Caguas Municipio, PR,Dec-17,48087,43875,4212,8.8
CN7202500000000,72,025,Caguas Municipio, PR,Jan-18,47390,43055,4335,9.1
CN7202500000000,72,025,Caguas Municipio, PR,Feb-18,47193,43203,3990,8.5
CN7202500000000,72,025,Caguas Municipio, PR,Mar-18,47111,43252,3859,8.2
CN7202500000000,72,025,Caguas Municipio, PR,Apr-18(p),47294,43577,3717,7.9
CN1604500000000,16,045,Gem County, ID,Mar-17,7838,7473,365,4.7
CN1604500000000,16,045,Gem County, ID,Apr-17,7825,7517,308,3.9
CN1604500000000,16,045,Gem County, ID,May-17,7860,7589,271,3.4
CN1604500000000,16,045,Gem County, ID,Jun-17,7976,7683,293,3.7
CN1604500000000,16,045,Gem County, ID,Jul-17,8020,7720,300,3.7
CN1604500000000,16,045,Gem County, ID,Aug-17,7977,7707,270,3.4
CN1604500000000,16,045,Gem County, ID,Sep-17,7994,7729,265,3.3
CN1604500000000,16,045,Gem County, ID,Oct-17,8011,7753,258,3.2
CN1604500000000,16,045,Gem County, ID,Nov-17,8075,7798,277,3.4
CN1604500000000,16,045,Gem County, ID,Dec-17,8019,7746,273,3.4
CN1604500000000,16,045,Gem County, ID,Jan-18,8086,7708,378,4.7
CN1604500000000,16,045,Gem County, ID,Feb-18,8068,7748,320,4.0
CN1604500000000,16,045,Gem County, ID,Mar-18,8097,7781,316,3.9
CN1604500000000,16,045,Gem County, ID,Apr-18(p),8087,7793,294,3.6
CN1324100000000,13,241,Rabun County, GA,Mar-17,6778,6403,375,5.5
CN1324100000000,13,241,Rabun County, GA,Apr-17,6826,6499,327,4.8
CN1324100000000,13,241,Rabun County, GA,May-17,6981,6652,329,4.7
CN1324100000000,13,241,Rabun County, GA,Jun-17,7183,6837,346,4.8
CN1324100000000,13,241,Rabun County, GA,Jul-17,7291,6948,343,4.7
CN1324100000000,13,241,Rabun County, GA,Aug-17,7073,6738,335,4.7
CN1324100000000,13,241,Rabun County, GA,Sep-17,7066,6758,308,4.4
CN1324100000000,13,241,Rabun County, GA,Oct-17,6917,6609,308,4.5
CN1324100000000,13,241,Rabun County, GA,Nov-17,6812,6511,301,4.4
CN1324100000000,13,241,Rabun County, GA,Dec-17,6699,6376,323,4.8
CN1324100000000,13,241,Rabun County, GA,Jan-18,6740,6380,360,5.3
CN1324100000000,13,241,Rabun County, GA,Feb-18,6754,6407,347,5.1
CN1324100000000,13,241,Rabun County, GA,Mar-18,6791,6478,313,4.6
CN1324100000000,13,241,Rabun County, GA,Apr-18(p),6958,6673,285,4.1
CN2403700000000,24,037,St. Mary's County, MD,Mar-17,55289,53157,2132,3.9
CN2403700000000,24,037,St. Mary's County, MD,Apr-17,55153,53233,1920,3.5
CN2403700000000,24,037,St. Mary's County, MD,May-17,55048,53035,2013,3.7
CN2403700000000,24,037,St. Mary's County, MD,Jun-17,56046,53532,2514,4.5
CN2403700000000,24,037,St. Mary's County, MD,Jul-17,56160,53632,2528,4.5
CN2403700000000,24,037,St. Mary's County, MD,Aug-17,55392,52990,2402,4.3
CN2403700000000,24,037,St. Mary's County, MD,Sep-17,55245,53231,2014,3.6
CN2403700000000,24,037,St. Mary's County, MD,Oct-17,55318,53216,2102,3.8
CN2403700000000,24,037,St. Mary's County, MD,Nov-17,55036,52904,2132,3.9
CN2403700000000,24,037,St. Mary's County, MD,Dec-17,54858,52864,1994,3.6
CN2403700000000,24,037,St. Mary's County, MD,Jan-18,55306,52781,2525,4.6
CN2403700000000,24,037,St. Mary's County, MD,Feb-18,55468,52958,2510,4.5
CN2403700000000,24,037,St. Mary's County, MD,Mar-18,55644,53185,2459,4.4
CN2403700000000,24,037,St. Mary's County, MD,Apr-18(p),55064,53007,2057,3.7
CN4100100000000,41,001,Baker County, OR,Mar-17,6918,6454,464,6.7
CN4100100000000,41,001,Baker County, OR,Apr-17,6974,6599,375,5.4
CN4100100000000,41,001,Baker County, OR,May-17,7001,6685,316,4.5
CN4100100000000,41,001,Baker County, OR,Jun-17,7214,6867,347,4.8
CN4100100000000,41,001,Baker County, OR,Jul-17,7152,6801,351,4.9
CN4100100000000,41,001,Baker County, OR,Aug-17,7253,6897,356,4.9
CN4100100000000,41,001,Baker County, OR,Sep-17,7182,6854,328,4.6
CN4100100000000,41,001,Baker County, OR,Oct-17,7258,6908,350,4.8
CN4100100000000,41,001,Baker County, OR,Nov-17,7081,6706,375,5.3
CN4100100000000,41,001,Baker County, OR,Dec-17,7053,6646,407,5.8
CN4100100000000,41,001,Baker County, OR,Jan-18,7012,6530,482,6.9
CN4100100000000,41,001,Baker County, OR,Feb-18,7075,6596,479,6.8
CN4100100000000,41,001,Baker County, OR,Mar-18,6987,6518,469,6.7
CN4100100000000,41,001,Baker County, OR,Apr-18(p),6945,6553,392,5.6
CN1326900000000,13,269,Taylor County, GA,Mar-17,2826,2576,250,8.8
CN1326900000000,13,269,Taylor County, GA,Apr-17,2811,2567,244,8.7
CN1326900000000,13,269,Taylor County, GA,May-17,2844,2608,236,8.3
CN1326900000000,13,269,Taylor County, GA,Jun-17,2854,2614,240,8.4
CN1326900000000,13,269,Taylor County, GA,Jul-17,2833,2604,229,8.1
CN1326900000000,13,269,Taylor County, GA,Aug-17,2821,2594,227,8.0
CN1326900000000,13,269,Taylor County, GA,Sep-17,2830,2619,211,7.5
CN1326900000000,13,269,Taylor County, GA,Oct-17,2876,2608,268,9.3
CN1326900000000,13,269,Taylor County, GA,Nov-17,2799,2605,194,6.9
CN1326900000000,13,269,Taylor County, GA,Dec-17,2808,2600,208,7.4
CN1326900000000,13,269,Taylor County, GA,Jan-18,2894,2629,265,9.2
CN1326900000000,13,269,Taylor County, GA,Feb-18,2776,2568,208,7.5
CN1326900000000,13,269,Taylor County, GA,Mar-18,2770,2584,186,6.7
CN1326900000000,13,269,Taylor County, GA,Apr-18(p),2744,2585,159,5.8
CN3201300000000,32,013,Humboldt County, NV,Mar-17,9119,8734,385,4.2
CN3201300000000,32,013,Humboldt County, NV,Apr-17,8559,8218,341,4.0
CN3201300000000,32,013,Humboldt County, NV,May-17,8596,8264,332,3.9
CN3201300000000,32,013,Humboldt County, NV,Jun-17,8771,8415,356,4.1
CN3201300000000,32,013,Humboldt County, NV,Jul-17,8324,7947,377,4.5
CN3201300000000,32,013,Humboldt County, NV,Aug-17,8190,7851,339,4.1
CN3201300000000,32,013,Humboldt County, NV,Sep-17,8090,7768,322,4.0
CN3201300000000,32,013,Humboldt County, NV,Oct-17,7881,7572,309,3.9
CN3201300000000,32,013,Humboldt County, NV,Nov-17,7935,7636,299,3.8
CN3201300000000,32,013,Humboldt County, NV,Dec-17,8076,7776,300,3.7
CN3201300000000,32,013,Humboldt County, NV,Jan-18,7936,7589,347,4.4
CN3201300000000,32,013,Humboldt County, NV,Feb-18,8276,7949,327,4.0
CN3201300000000,32,013,Humboldt County, NV,Mar-18,8682,8358,324,3.7
CN3201300000000,32,013,Humboldt County, NV,Apr-18(p),8062,7778,284,3.5
CN4207500000000,42,075,Lebanon County, PA,Mar-17,70434,67431,3003,4.3
CN4207500000000,42,075,Lebanon County, PA,Apr-17,70676,68123,2553,3.6
CN4207500000000,42,075,Lebanon County, PA,May-17,70833,67990,2843,4.0
CN4207500000000,42,075,Lebanon County, PA,Jun-17,71976,68920,3056,4.2
CN4207500000000,42,075,Lebanon County, PA,Jul-17,72123,68876,3247,4.5
CN4207500000000,42,075,Lebanon County, PA,Aug-17,71344,68061,3283,4.6
CN4207500000000,42,075,Lebanon County, PA,Sep-17,70558,67927,2631,3.7
CN4207500000000,42,075,Lebanon County, PA,Oct-17,69587,67067,2520,3.6
CN4207500000000,42,075,Lebanon County, PA,Nov-17,69844,67105,2739,3.9
CN4207500000000,42,075,Lebanon County, PA,Dec-17,69766,67129,2637,3.8
CN4207500000000,42,075,Lebanon County, PA,Jan-18,69293,66117,3176,4.6
CN4207500000000,42,075,Lebanon County, PA,Feb-18,69854,66677,3177,4.5
CN4207500000000,42,075,Lebanon County, PA,Mar-18,68995,66298,2697,3.9
CN4207500000000,42,075,Lebanon County, PA,Apr-18(p),68944,66562,2382,3.5
CN4604500000000,46,045,Edmunds County, SD,Mar-17,2131,2071,60,2.8
CN4604500000000,46,045,Edmunds County, SD,Apr-17,2169,2109,60,2.8
CN4604500000000,46,045,Edmunds County, SD,May-17,2177,2121,56,2.6
CN4604500000000,46,045,Edmunds County, SD,Jun-17,2218,2160,58,2.6
CN4604500000000,46,045,Edmunds County, SD,Jul-17,2171,2112,59,2.7
CN4604500000000,46,045,Edmunds County, SD,Aug-17,2104,2042,62,2.9
CN4604500000000,46,045,Edmunds County, SD,Sep-17,2115,2058,57,2.7
CN4604500000000,46,045,Edmunds County, SD,Oct-17,2088,2035,53,2.5
CN4604500000000,46,045,Edmunds County, SD,Nov-17,2083,2023,60,2.9
CN4604500000000,46,045,Edmunds County, SD,Dec-17,2120,2053,67,3.2
CN4604500000000,46,045,Edmunds County, SD,Jan-18,2119,2050,69,3.3
CN4604500000000,46,045,Edmunds County, SD,Feb-18,2136,2067,69,3.2
CN4604500000000,46,045,Edmunds County, SD,Mar-18,2167,2096,71,3.3
CN4604500000000,46,045,Edmunds County, SD,Apr-18(p),2130,2062,68,3.2
CN5503300000000,55,033,Dunn County, WI,Mar-17,24152,23162,990,4.1
CN5503300000000,55,033,Dunn County, WI,Apr-17,25135,24367,768,3.1
CN5503300000000,55,033,Dunn County, WI,May-17,24723,23974,749,3.0
CN5503300000000,55,033,Dunn County, WI,Jun-17,23912,23034,878,3.7
CN5503300000000,55,033,Dunn County, WI,Jul-17,23904,23099,805,3.4
CN5503300000000,55,033,Dunn County, WI,Aug-17,23541,22814,727,3.1
CN5503300000000,55,033,Dunn County, WI,Sep-17,24821,24175,646,2.6
CN5503300000000,55,033,Dunn County, WI,Oct-17,25251,24633,618,2.4
CN5503300000000,55,033,Dunn County, WI,Nov-17,25419,24781,638,2.5
CN5503300000000,55,033,Dunn County, WI,Dec-17,24895,24217,678,2.7
CN5503300000000,55,033,Dunn County, WI,Jan-18,24443,23641,802,3.3
CN5503300000000,55,033,Dunn County, WI,Feb-18,25449,24507,942,3.7
CN5503300000000,55,033,Dunn County, WI,Mar-18,24597,23719,878,3.6
CN5503300000000,55,033,Dunn County, WI,Apr-18(p),25372,24631,741,2.9
CN2800700000000,28,007,Attala County, MS,Mar-17,7044,6607,437,6.2
CN2800700000000,28,007,Attala County, MS,Apr-17,7045,6648,397,5.6
CN2800700000000,28,007,Attala County, MS,May-17,6980,6550,430,6.2
CN2800700000000,28,007,Attala County, MS,Jun-17,7089,6620,469,6.6
CN2800700000000,28,007,Attala County, MS,Jul-17,6899,6449,450,6.5
CN2800700000000,28,007,Attala County, MS,Aug-17,6906,6536,370,5.4
CN2800700000000,28,007,Attala County, MS,Sep-17,6927,6509,418,6.0
CN2800700000000,28,007,Attala County, MS,Oct-17,6817,6412,405,5.9
CN2800700000000,28,007,Attala County, MS,Nov-17,6713,6318,395,5.9
CN2800700000000,28,007,Attala County, MS,Dec-17,6757,6358,399,5.9
CN2800700000000,28,007,Attala County, MS,Jan-18,6689,6270,419,6.3
CN2800700000000,28,007,Attala County, MS,Feb-18,6751,6357,394,5.8
CN2800700000000,28,007,Attala County, MS,Mar-18,6851,6464,387,5.6
CN2800700000000,28,007,Attala County, MS,Apr-18(p),6823,6461,362,5.3
CN2811300000000,28,113,Pike County, MS,Mar-17,14770,13931,839,5.7
CN2811300000000,28,113,Pike County, MS,Apr-17,14747,13955,792,5.4
CN2811300000000,28,113,Pike County, MS,May-17,14816,13911,905,6.1
CN2811300000000,28,113,Pike County, MS,Jun-17,14930,13833,1097,7.3
CN2811300000000,28,113,Pike County, MS,Jul-17,14670,13625,1045,7.1
CN2811300000000,28,113,Pike County, MS,Aug-17,14697,13822,875,6.0
CN2811300000000,28,113,Pike County, MS,Sep-17,14733,13924,809,5.5
CN2811300000000,28,113,Pike County, MS,Oct-17,14504,13745,759,5.2
CN2811300000000,28,113,Pike County, MS,Nov-17,14548,13797,751,5.2
CN2811300000000,28,113,Pike County, MS,Dec-17,14619,13849,770,5.3
CN2811300000000,28,113,Pike County, MS,Jan-18,14393,13605,788,5.5
CN2811300000000,28,113,Pike County, MS,Feb-18,14474,13713,761,5.3
CN2811300000000,28,113,Pike County, MS,Mar-18,14583,13856,727,5.0
CN2811300000000,28,113,Pike County, MS,Apr-18(p),14547,13841,706,4.9
CN3710100000000,37,101,Johnston County, NC,Mar-17,93611,89772,3839,4.1
CN3710100000000,37,101,Johnston County, NC,Apr-17,93268,89797,3471,3.7
CN3710100000000,37,101,Johnston County, NC,May-17,93634,89947,3687,3.9
CN3710100000000,37,101,Johnston County, NC,Jun-17,93938,89962,3976,4.2
CN3710100000000,37,101,Johnston County, NC,Jul-17,95895,91661,4234,4.4
CN3710100000000,37,101,Johnston County, NC,Aug-17,94548,90289,4259,4.5
CN3710100000000,37,101,Johnston County, NC,Sep-17,94986,91229,3757,4.0
CN3710100000000,37,101,Johnston County, NC,Oct-17,94808,91067,3741,3.9
CN3710100000000,37,101,Johnston County, NC,Nov-17,94639,90752,3887,4.1
CN3710100000000,37,101,Johnston County, NC,Dec-17,93790,90071,3719,4.0
CN3710100000000,37,101,Johnston County, NC,Jan-18,94211,90270,3941,4.2
CN3710100000000,37,101,Johnston County, NC,Feb-18,95355,91443,3912,4.1
CN3710100000000,37,101,Johnston County, NC,Mar-18,95542,91796,3746,3.9
CN3710100000000,37,101,Johnston County, NC,Apr-18(p),95471,92234,3237,3.4
CN1313500000000,13,135,Gwinnett County, GA,Mar-17,480449,459747,20702,4.3
CN1313500000000,13,135,Gwinnett County, GA,Apr-17,480810,461181,19629,4.1
CN1313500000000,13,135,Gwinnett County, GA,May-17,481767,461844,19923,4.1
CN1313500000000,13,135,Gwinnett County, GA,Jun-17,483232,461360,21872,4.5
CN1313500000000,13,135,Gwinnett County, GA,Jul-17,486511,464685,21826,4.5
CN1313500000000,13,135,Gwinnett County, GA,Aug-17,483434,462142,21292,4.4
CN1313500000000,13,135,Gwinnett County, GA,Sep-17,488008,468609,19399,4.0
CN1313500000000,13,135,Gwinnett County, GA,Oct-17,485641,466526,19115,3.9
CN1313500000000,13,135,Gwinnett County, GA,Nov-17,486475,467896,18579,3.8
CN1313500000000,13,135,Gwinnett County, GA,Dec-17,486197,467688,18509,3.8
CN1313500000000,13,135,Gwinnett County, GA,Jan-18,486240,467039,19201,3.9
CN1313500000000,13,135,Gwinnett County, GA,Feb-18,494464,474877,19587,4.0
CN1313500000000,13,135,Gwinnett County, GA,Mar-18,494516,476381,18135,3.7
CN1313500000000,13,135,Gwinnett County, GA,Apr-18(p),491815,475578,16237,3.3
CN3806900000000,38,069,Pierce County, ND,Mar-17,1908,1829,79,4.1
CN3806900000000,38,069,Pierce County, ND,Apr-17,1926,1860,66,3.4
CN3806900000000,38,069,Pierce County, ND,May-17,1925,1875,50,2.6
CN3806900000000,38,069,Pierce County, ND,Jun-17,2010,1949,61,3.0
CN3806900000000,38,069,Pierce County, ND,Jul-17,1971,1924,47,2.4
CN3806900000000,38,069,Pierce County, ND,Aug-17,1969,1923,46,2.3
CN3806900000000,38,069,Pierce County, ND,Sep-17,1909,1866,43,2.3
CN3806900000000,38,069,Pierce County, ND,Oct-17,1928,1892,36,1.9
CN3806900000000,38,069,Pierce County, ND,Nov-17,1875,1830,45,2.4
CN3806900000000,38,069,Pierce County, ND,Dec-17,1864,1803,61,3.3
CN3806900000000,38,069,Pierce County, ND,Jan-18,1864,1787,77,4.1
CN3806900000000,38,069,Pierce County, ND,Feb-18,1871,1785,86,4.6
CN3806900000000,38,069,Pierce County, ND,Mar-18,1869,1786,83,4.4
CN3806900000000,38,069,Pierce County, ND,Apr-18(p),1866,1798,68,3.6
CN4504900000000,45,049,Hampton County, SC,Mar-17,8014,7674,340,4.2
CN4504900000000,45,049,Hampton County, SC,Apr-17,8097,7787,310,3.8
CN4504900000000,45,049,Hampton County, SC,May-17,8165,7847,318,3.9
CN4504900000000,45,049,Hampton County, SC,Jun-17,8453,8049,404,4.8
CN4504900000000,45,049,Hampton County, SC,Jul-17,8484,8088,396,4.7
CN4504900000000,45,049,Hampton County, SC,Aug-17,8367,7962,405,4.8
CN4504900000000,45,049,Hampton County, SC,Sep-17,8210,7845,365,4.4
CN4504900000000,45,049,Hampton County, SC,Oct-17,8185,7834,351,4.3
CN4504900000000,45,049,Hampton County, SC,Nov-17,8194,7850,344,4.2
CN4504900000000,45,049,Hampton County, SC,Dec-17,8299,7945,354,4.3
CN4504900000000,45,049,Hampton County, SC,Jan-18,8338,7920,418,5.0
CN4504900000000,45,049,Hampton County, SC,Feb-18,8348,7953,395,4.7
CN4504900000000,45,049,Hampton County, SC,Mar-18,8251,7896,355,4.3
CN4504900000000,45,049,Hampton County, SC,Apr-18(p),8215,7976,239,2.9
CN1917500000000,19,175,Union County, IA,Mar-17,6440,6220,220,3.4
CN1917500000000,19,175,Union County, IA,Apr-17,6368,6180,188,3.0
CN1917500000000,19,175,Union County, IA,May-17,6394,6206,188,2.9
CN1917500000000,19,175,Union County, IA,Jun-17,6467,6258,209,3.2
CN1917500000000,19,175,Union County, IA,Jul-17,6519,6319,200,3.1
CN1917500000000,19,175,Union County, IA,Aug-17,6429,6221,208,3.2
CN1917500000000,19,175,Union County, IA,Sep-17,6402,6225,177,2.8
CN1917500000000,19,175,Union County, IA,Oct-17,6421,6279,142,2.2
CN1917500000000,19,175,Union County, IA,Nov-17,6416,6261,155,2.4
CN1917500000000,19,175,Union County, IA,Dec-17,6406,6233,173,2.7
CN1917500000000,19,175,Union County, IA,Jan-18,6469,6135,334,5.2
CN1917500000000,19,175,Union County, IA,Feb-18,6509,6191,318,4.9
CN1917500000000,19,175,Union County, IA,Mar-18,6447,6176,271,4.2
CN1917500000000,19,175,Union County, IA,Apr-18(p),6363,6128,235,3.7
CN2816300000000,28,163,Yazoo County, MS,Mar-17,9279,8738,541,5.8
CN2816300000000,28,163,Yazoo County, MS,Apr-17,9262,8763,499,5.4
CN2816300000000,28,163,Yazoo County, MS,May-17,9230,8668,562,6.1
CN2816300000000,28,163,Yazoo County, MS,Jun-17,9360,8681,679,7.3
CN2816300000000,28,163,Yazoo County, MS,Jul-17,9375,8677,698,7.4
CN2816300000000,28,163,Yazoo County, MS,Aug-17,9172,8589,583,6.4
CN2816300000000,28,163,Yazoo County, MS,Sep-17,9186,8678,508,5.5
CN2816300000000,28,163,Yazoo County, MS,Oct-17,9174,8704,470,5.1
CN2816300000000,28,163,Yazoo County, MS,Nov-17,9094,8646,448,4.9
CN2816300000000,28,163,Yazoo County, MS,Dec-17,9123,8672,451,4.9
CN2816300000000,28,163,Yazoo County, MS,Jan-18,9037,8553,484,5.4
CN2816300000000,28,163,Yazoo County, MS,Feb-18,9130,8665,465,5.1
CN2816300000000,28,163,Yazoo County, MS,Mar-18,9252,8783,469,5.1
CN2816300000000,28,163,Yazoo County, MS,Apr-18(p),9222,8775,447,4.8
CN4835700000000,48,357,Ochiltree County, TX,Mar-17,4585,4392,193,4.2
CN4835700000000,48,357,Ochiltree County, TX,Apr-17,4579,4406,173,3.8
CN4835700000000,48,357,Ochiltree County, TX,May-17,4556,4394,162,3.6
CN4835700000000,48,357,Ochiltree County, TX,Jun-17,4562,4395,167,3.7
CN4835700000000,48,357,Ochiltree County, TX,Jul-17,4603,4436,167,3.6
CN4835700000000,48,357,Ochiltree County, TX,Aug-17,4548,4382,166,3.6
CN4835700000000,48,357,Ochiltree County, TX,Sep-17,4508,4364,144,3.2
CN4835700000000,48,357,Ochiltree County, TX,Oct-17,4462,4332,130,2.9
CN4835700000000,48,357,Ochiltree County, TX,Nov-17,4400,4264,136,3.1
CN4835700000000,48,357,Ochiltree County, TX,Dec-17,4339,4210,129,3.0
CN4835700000000,48,357,Ochiltree County, TX,Jan-18,4353,4215,138,3.2
CN4835700000000,48,357,Ochiltree County, TX,Feb-18,4399,4257,142,3.2
CN4835700000000,48,357,Ochiltree County, TX,Mar-18,4414,4272,142,3.2
CN4835700000000,48,357,Ochiltree County, TX,Apr-18(p),4551,4427,124,2.7
CN5403700000000,54,037,Jefferson County, WV,Mar-17,28176,27268,908,3.2
CN5403700000000,54,037,Jefferson County, WV,Apr-17,28790,27991,799,2.8
CN5403700000000,54,037,Jefferson County, WV,May-17,28752,27956,796,2.8
CN5403700000000,54,037,Jefferson County, WV,Jun-17,29540,28552,988,3.3
CN5403700000000,54,037,Jefferson County, WV,Jul-17,29190,28279,911,3.1
CN5403700000000,54,037,Jefferson County, WV,Aug-17,28901,27912,989,3.4
CN5403700000000,54,037,Jefferson County, WV,Sep-17,28903,28028,875,3.0
CN5403700000000,54,037,Jefferson County, WV,Oct-17,28825,27975,850,2.9
CN5403700000000,54,037,Jefferson County, WV,Nov-17,28481,27608,873,3.1
CN5403700000000,54,037,Jefferson County, WV,Dec-17,28241,27391,850,3.0
CN5403700000000,54,037,Jefferson County, WV,Jan-18,28342,27412,930,3.3
CN5403700000000,54,037,Jefferson County, WV,Feb-18,28788,27632,1156,4.0
CN5403700000000,54,037,Jefferson County, WV,Mar-18,28586,27533,1053,3.7
CN5403700000000,54,037,Jefferson County, WV,Apr-18(p),28890,27897,993,3.4
CN4842100000000,48,421,Sherman County, TX,Mar-17,1345,1305,40,3.0
CN4842100000000,48,421,Sherman County, TX,Apr-17,1307,1272,35,2.7
CN4842100000000,48,421,Sherman County, TX,May-17,1337,1297,40,3.0
CN4842100000000,48,421,Sherman County, TX,Jun-17,1317,1269,48,3.6
CN4842100000000,48,421,Sherman County, TX,Jul-17,1257,1212,45,3.6
CN4842100000000,48,421,Sherman County, TX,Aug-17,1276,1235,41,3.2
CN4842100000000,48,421,Sherman County, TX,Sep-17,1273,1237,36,2.8
CN4842100000000,48,421,Sherman County, TX,Oct-17,1301,1267,34,2.6
CN4842100000000,48,421,Sherman County, TX,Nov-17,1268,1232,36,2.8
CN4842100000000,48,421,Sherman County, TX,Dec-17,1278,1243,35,2.7
CN4842100000000,48,421,Sherman County, TX,Jan-18,1249,1213,36,2.9
CN4842100000000,48,421,Sherman County, TX,Feb-18,1285,1246,39,3.0
CN4842100000000,48,421,Sherman County, TX,Mar-18,1360,1322,38,2.8
CN4842100000000,48,421,Sherman County, TX,Apr-18(p),1287,1255,32,2.5
CN0110500000000,01,105,Perry County, AL,Mar-17,3428,3140,288,8.4
CN0110500000000,01,105,Perry County, AL,Apr-17,3393,3146,247,7.3
CN0110500000000,01,105,Perry County, AL,May-17,3342,3111,231,6.9
CN0110500000000,01,105,Perry County, AL,Jun-17,3406,3073,333,9.8
CN0110500000000,01,105,Perry County, AL,Jul-17,3477,3111,366,10.5
CN0110500000000,01,105,Perry County, AL,Aug-17,3408,3135,273,8.0
CN0110500000000,01,105,Perry County, AL,Sep-17,3454,3232,222,6.4
CN0110500000000,01,105,Perry County, AL,Oct-17,3395,3192,203,6.0
CN0110500000000,01,105,Perry County, AL,Nov-17,3355,3147,208,6.2
CN0110500000000,01,105,Perry County, AL,Dec-17,3251,3058,193,5.9
CN0110500000000,01,105,Perry County, AL,Jan-18,3251,3035,216,6.6
CN0110500000000,01,105,Perry County, AL,Feb-18,3341,3127,214,6.4
CN0110500000000,01,105,Perry County, AL,Mar-18,3331,3123,208,6.2
CN0110500000000,01,105,Perry County, AL,Apr-18(p),3352,3164,188,5.6
CN1805500000000,18,055,Greene County, IN,Mar-17,13653,12953,700,5.1
CN1805500000000,18,055,Greene County, IN,Apr-17,13607,13051,556,4.1
CN1805500000000,18,055,Greene County, IN,May-17,13634,13052,582,4.3
CN1805500000000,18,055,Greene County, IN,Jun-17,13598,12966,632,4.6
CN1805500000000,18,055,Greene County, IN,Jul-17,13337,12681,656,4.9
CN1805500000000,18,055,Greene County, IN,Aug-17,13366,12700,666,5.0
CN1805500000000,18,055,Greene County, IN,Sep-17,13511,12949,562,4.2
CN1805500000000,18,055,Greene County, IN,Oct-17,13345,12827,518,3.9
CN1805500000000,18,055,Greene County, IN,Nov-17,13346,12801,545,4.1
CN1805500000000,18,055,Greene County, IN,Dec-17,13176,12656,520,3.9
CN1805500000000,18,055,Greene County, IN,Jan-18,13018,12355,663,5.1
CN1805500000000,18,055,Greene County, IN,Feb-18,13456,12769,687,5.1
CN1805500000000,18,055,Greene County, IN,Mar-18,13463,12864,599,4.4
CN1805500000000,18,055,Greene County, IN,Apr-18(p),13531,13026,505,3.7
CN2704300000000,27,043,Faribault County, MN,Mar-17,7146,6744,402,5.6
CN2704300000000,27,043,Faribault County, MN,Apr-17,7131,6822,309,4.3
CN2704300000000,27,043,Faribault County, MN,May-17,7131,6868,263,3.7
CN2704300000000,27,043,Faribault County, MN,Jun-17,7316,7036,280,3.8
CN2704300000000,27,043,Faribault County, MN,Jul-17,7231,6969,262,3.6
CN2704300000000,27,043,Faribault County, MN,Aug-17,7243,6964,279,3.9
CN2704300000000,27,043,Faribault County, MN,Sep-17,7129,6899,230,3.2
CN2704300000000,27,043,Faribault County, MN,Oct-17,7384,7190,194,2.6
CN2704300000000,27,043,Faribault County, MN,Nov-17,7330,7097,233,3.2
CN2704300000000,27,043,Faribault County, MN,Dec-17,7357,7051,306,4.2
CN2704300000000,27,043,Faribault County, MN,Jan-18,7335,6940,395,5.4
CN2704300000000,27,043,Faribault County, MN,Feb-18,7284,6912,372,5.1
CN2704300000000,27,043,Faribault County, MN,Mar-18,7300,6947,353,4.8
CN2704300000000,27,043,Faribault County, MN,Apr-18(p),7295,7004,291,4.0
CN1716500000000,17,165,Saline County, IL,Mar-17,9825,9222,603,6.1
CN1716500000000,17,165,Saline County, IL,Apr-17,9821,9298,523,5.3
CN1716500000000,17,165,Saline County, IL,May-17,9693,9118,575,5.9
CN1716500000000,17,165,Saline County, IL,Jun-17,9635,9022,613,6.4
CN1716500000000,17,165,Saline County, IL,Jul-17,9662,9026,636,6.6
CN1716500000000,17,165,Saline County, IL,Aug-17,9621,8957,664,6.9
CN1716500000000,17,165,Saline County, IL,Sep-17,9635,9034,601,6.2
CN1716500000000,17,165,Saline County, IL,Oct-17,9626,9068,558,5.8
CN1716500000000,17,165,Saline County, IL,Nov-17,9615,9044,571,5.9
CN1716500000000,17,165,Saline County, IL,Dec-17,9511,8942,569,6.0
CN1716500000000,17,165,Saline County, IL,Jan-18,9401,8811,590,6.3
CN1716500000000,17,165,Saline County, IL,Feb-18,9457,8893,564,6.0
CN1716500000000,17,165,Saline County, IL,Mar-18,9664,9076,588,6.1
CN1716500000000,17,165,Saline County, IL,Apr-18(p),9685,9173,512,5.3
CN2707900000000,27,079,Le Sueur County, MN,Mar-17,15966,14885,1081,6.8
CN2707900000000,27,079,Le Sueur County, MN,Apr-17,15817,15015,802,5.1
CN2707900000000,27,079,Le Sueur County, MN,May-17,15605,15063,542,3.5
CN2707900000000,27,079,Le Sueur County, MN,Jun-17,15660,15103,557,3.6
CN2707900000000,27,079,Le Sueur County, MN,Jul-17,15827,15275,552,3.5
CN2707900000000,27,079,Le Sueur County, MN,Aug-17,15703,15153,550,3.5
CN2707900000000,27,079,Le Sueur County, MN,Sep-17,15597,15142,455,2.9
CN2707900000000,27,079,Le Sueur County, MN,Oct-17,15668,15259,409,2.6
CN2707900000000,27,079,Le Sueur County, MN,Nov-17,15779,15182,597,3.8
CN2707900000000,27,079,Le Sueur County, MN,Dec-17,15986,15057,929,5.8
CN2707900000000,27,079,Le Sueur County, MN,Jan-18,16358,15106,1252,7.7
CN2707900000000,27,079,Le Sueur County, MN,Feb-18,16300,15199,1101,6.8
CN2707900000000,27,079,Le Sueur County, MN,Mar-18,16235,15173,1062,6.5
CN2707900000000,27,079,Le Sueur County, MN,Apr-18(p),16153,15286,867,5.4
CN4701500000000,47,015,Cannon County, TN,Mar-17,6175,5942,233,3.8
CN4701500000000,47,015,Cannon County, TN,Apr-17,6173,5977,196,3.2
CN4701500000000,47,015,Cannon County, TN,May-17,6216,5981,235,3.8
CN4701500000000,47,015,Cannon County, TN,Jun-17,6297,6044,253,4.0
CN4701500000000,47,015,Cannon County, TN,Jul-17,6331,6082,249,3.9
CN4701500000000,47,015,Cannon County, TN,Aug-17,6269,6043,226,3.6
CN4701500000000,47,015,Cannon County, TN,Sep-17,6310,6117,193,3.1
CN4701500000000,47,015,Cannon County, TN,Oct-17,6281,6100,181,2.9
CN4701500000000,47,015,Cannon County, TN,Nov-17,6265,6082,183,2.9
CN4701500000000,47,015,Cannon County, TN,Dec-17,6251,6076,175,2.8
CN4701500000000,47,015,Cannon County, TN,Jan-18,6231,6022,209,3.4
CN4701500000000,47,015,Cannon County, TN,Feb-18,6292,6107,185,2.9
CN4701500000000,47,015,Cannon County, TN,Mar-18,6311,6115,196,3.1
CN4701500000000,47,015,Cannon County, TN,Apr-18(p),6344,6184,160,2.5
CN3912900000000,39,129,Pickaway County, OH,Mar-17,26606,25305,1301,4.9
CN3912900000000,39,129,Pickaway County, OH,Apr-17,26483,25382,1101,4.2
CN3912900000000,39,129,Pickaway County, OH,May-17,26539,25472,1067,4.0
CN3912900000000,39,129,Pickaway County, OH,Jun-17,26814,25570,1244,4.6
CN3912900000000,39,129,Pickaway County, OH,Jul-17,26900,25659,1241,4.6
CN3912900000000,39,129,Pickaway County, OH,Aug-17,27010,25760,1250,4.6
CN3912900000000,39,129,Pickaway County, OH,Sep-17,26649,25538,1111,4.2
CN3912900000000,39,129,Pickaway County, OH,Oct-17,26581,25520,1061,4.0
CN3912900000000,39,129,Pickaway County, OH,Nov-17,26600,25529,1071,4.0
CN3912900000000,39,129,Pickaway County, OH,Dec-17,26550,25431,1119,4.2
CN3912900000000,39,129,Pickaway County, OH,Jan-18,26230,24938,1292,4.9
CN3912900000000,39,129,Pickaway County, OH,Feb-18,26635,25421,1214,4.6
CN3912900000000,39,129,Pickaway County, OH,Mar-18,26961,25837,1124,4.2
CN3912900000000,39,129,Pickaway County, OH,Apr-18(p),26767,25734,1033,3.9
CN3606700000000,36,067,Onondaga County, NY,Mar-17,221557,211172,10385,4.7
CN3606700000000,36,067,Onondaga County, NY,Apr-17,222036,212301,9735,4.4
CN3606700000000,36,067,Onondaga County, NY,May-17,221095,211194,9901,4.5
CN3606700000000,36,067,Onondaga County, NY,Jun-17,224187,213620,10567,4.7
CN3606700000000,36,067,Onondaga County, NY,Jul-17,224423,213646,10777,4.8
CN3606700000000,36,067,Onondaga County, NY,Aug-17,222352,211826,10526,4.7
CN3606700000000,36,067,Onondaga County, NY,Sep-17,223000,212534,10466,4.7
CN3606700000000,36,067,Onondaga County, NY,Oct-17,221580,211656,9924,4.5
CN3606700000000,36,067,Onondaga County, NY,Nov-17,220760,210528,10232,4.6
CN3606700000000,36,067,Onondaga County, NY,Dec-17,217999,207736,10263,4.7
CN3606700000000,36,067,Onondaga County, NY,Jan-18,218325,206699,11626,5.3
CN3606700000000,36,067,Onondaga County, NY,Feb-18,217754,205662,12092,5.6
CN3606700000000,36,067,Onondaga County, NY,Mar-18,217040,206133,10907,5.0
CN3606700000000,36,067,Onondaga County, NY,Apr-18(p),219304,209582,9722,4.4
CN3802700000000,38,027,Eddy County, ND,Mar-17,1302,1209,93,7.1
CN3802700000000,38,027,Eddy County, ND,Apr-17,1284,1215,69,5.4
CN3802700000000,38,027,Eddy County, ND,May-17,1277,1226,51,4.0
CN3802700000000,38,027,Eddy County, ND,Jun-17,1383,1326,57,4.1
CN3802700000000,38,027,Eddy County, ND,Jul-17,1307,1261,46,3.5
CN3802700000000,38,027,Eddy County, ND,Aug-17,1291,1247,44,3.4
CN3802700000000,38,027,Eddy County, ND,Sep-17,1316,1282,34,2.6
CN3802700000000,38,027,Eddy County, ND,Oct-17,1334,1298,36,2.7
CN3802700000000,38,027,Eddy County, ND,Nov-17,1300,1252,48,3.7
CN3802700000000,38,027,Eddy County, ND,Dec-17,1312,1260,52,4.0
CN3802700000000,38,027,Eddy County, ND,Jan-18,1263,1187,76,6.0
CN3802700000000,38,027,Eddy County, ND,Feb-18,1272,1177,95,7.5
CN3802700000000,38,027,Eddy County, ND,Mar-18,1290,1204,86,6.7
CN3802700000000,38,027,Eddy County, ND,Apr-18(p),1271,1195,76,6.0
CN0511700000000,05,117,Prairie County, AR,Mar-17,3710,3568,142,3.8
CN0511700000000,05,117,Prairie County, AR,Apr-17,3797,3669,128,3.4
CN0511700000000,05,117,Prairie County, AR,May-17,3825,3682,143,3.7
CN0511700000000,05,117,Prairie County, AR,Jun-17,3858,3703,155,4.0
CN0511700000000,05,117,Prairie County, AR,Jul-17,3686,3525,161,4.4
CN0511700000000,05,117,Prairie County, AR,Aug-17,3719,3568,151,4.1
CN0511700000000,05,117,Prairie County, AR,Sep-17,3665,3519,146,4.0
CN0511700000000,05,117,Prairie County, AR,Oct-17,3748,3619,129,3.4
CN0511700000000,05,117,Prairie County, AR,Nov-17,3719,3581,138,3.7
CN0511700000000,05,117,Prairie County, AR,Dec-17,3734,3554,180,4.8
CN0511700000000,05,117,Prairie County, AR,Jan-18,3607,3437,170,4.7
CN0511700000000,05,117,Prairie County, AR,Feb-18,3566,3404,162,4.5
CN0511700000000,05,117,Prairie County, AR,Mar-18,3585,3426,159,4.4
CN0511700000000,05,117,Prairie County, AR,Apr-18(p),3590,3461,129,3.6
CN3000300000000,30,003,Big Horn County, MT,Mar-17,5536,4740,796,14.4
CN3000300000000,30,003,Big Horn County, MT,Apr-17,5439,4656,783,14.4
CN3000300000000,30,003,Big Horn County, MT,May-17,5392,4655,737,13.7
CN3000300000000,30,003,Big Horn County, MT,Jun-17,5472,4623,849,15.5
CN3000300000000,30,003,Big Horn County, MT,Jul-17,5481,4731,750,13.7
CN3000300000000,30,003,Big Horn County, MT,Aug-17,5578,4787,791,14.2
CN3000300000000,30,003,Big Horn County, MT,Sep-17,5642,4940,702,12.4
CN3000300000000,30,003,Big Horn County, MT,Oct-17,5669,4934,735,13.0
CN3000300000000,30,003,Big Horn County, MT,Nov-17,5624,4902,722,12.8
CN3000300000000,30,003,Big Horn County, MT,Dec-17,5432,4816,616,11.3
CN3000300000000,30,003,Big Horn County, MT,Jan-18,5391,4753,638,11.8
CN3000300000000,30,003,Big Horn County, MT,Feb-18,5346,4700,646,12.1
CN3000300000000,30,003,Big Horn County, MT,Mar-18,5248,4647,601,11.5
CN3000300000000,30,003,Big Horn County, MT,Apr-18(p),5097,4613,484,9.5
CN3909100000000,39,091,Logan County, OH,Mar-17,23803,22806,997,4.2
CN3909100000000,39,091,Logan County, OH,Apr-17,23563,22692,871,3.7
CN3909100000000,39,091,Logan County, OH,May-17,23555,22676,879,3.7
CN3909100000000,39,091,Logan County, OH,Jun-17,23836,22811,1025,4.3
CN3909100000000,39,091,Logan County, OH,Jul-17,23580,22535,1045,4.4
CN3909100000000,39,091,Logan County, OH,Aug-17,23860,22862,998,4.2
CN3909100000000,39,091,Logan County, OH,Sep-17,23419,22513,906,3.9
CN3909100000000,39,091,Logan County, OH,Oct-17,23360,22513,847,3.6
CN3909100000000,39,091,Logan County, OH,Nov-17,23391,22535,856,3.7
CN3909100000000,39,091,Logan County, OH,Dec-17,23153,22247,906,3.9
CN3909100000000,39,091,Logan County, OH,Jan-18,22992,22061,931,4.0
CN3909100000000,39,091,Logan County, OH,Feb-18,23333,22455,878,3.8
CN3909100000000,39,091,Logan County, OH,Mar-18,23502,22715,787,3.3
CN3909100000000,39,091,Logan County, OH,Apr-18(p),23261,22502,759,3.3
CN5119700000000,51,197,Wythe County, VA,Mar-17,13807,12838,969,7.0
CN5119700000000,51,197,Wythe County, VA,Apr-17,13812,13190,622,4.5
CN5119700000000,51,197,Wythe County, VA,May-17,13687,13067,620,4.5
CN5119700000000,51,197,Wythe County, VA,Jun-17,13822,13140,682,4.9
CN5119700000000,51,197,Wythe County, VA,Jul-17,13663,12963,700,5.1
CN5119700000000,51,197,Wythe County, VA,Aug-17,13434,12730,704,5.2
CN5119700000000,51,197,Wythe County, VA,Sep-17,13632,13025,607,4.5
CN5119700000000,51,197,Wythe County, VA,Oct-17,13576,13022,554,4.1
CN5119700000000,51,197,Wythe County, VA,Nov-17,13531,12946,585,4.3
CN5119700000000,51,197,Wythe County, VA,Dec-17,13599,13037,562,4.1
CN5119700000000,51,197,Wythe County, VA,Jan-18,13371,12718,653,4.9
CN5119700000000,51,197,Wythe County, VA,Feb-18,13307,12724,583,4.4
CN5119700000000,51,197,Wythe County, VA,Mar-18,13322,12740,582,4.4
CN5119700000000,51,197,Wythe County, VA,Apr-18(p),13499,13021,478,3.5
CN3401500000000,34,015,Gloucester County, NJ,Mar-17,151756,144827,6929,4.6
CN3401500000000,34,015,Gloucester County, NJ,Apr-17,151275,144991,6284,4.2
CN3401500000000,34,015,Gloucester County, NJ,May-17,151079,144338,6741,4.5
CN3401500000000,34,015,Gloucester County, NJ,Jun-17,152191,144926,7265,4.8
CN3401500000000,34,015,Gloucester County, NJ,Jul-17,152020,143861,8159,5.4
CN3401500000000,34,015,Gloucester County, NJ,Aug-17,151156,143299,7857,5.2
CN3401500000000,34,015,Gloucester County, NJ,Sep-17,151446,144238,7208,4.8
CN3401500000000,34,015,Gloucester County, NJ,Oct-17,151455,144566,6889,4.5
CN3401500000000,34,015,Gloucester County, NJ,Nov-17,152009,145255,6754,4.4
CN3401500000000,34,015,Gloucester County, NJ,Dec-17,151009,144652,6357,4.2
CN3401500000000,34,015,Gloucester County, NJ,Jan-18,150504,143017,7487,5.0
CN3401500000000,34,015,Gloucester County, NJ,Feb-18,151515,144023,7492,4.9
CN3401500000000,34,015,Gloucester County, NJ,Mar-18,151288,144314,6974,4.6
CN3401500000000,34,015,Gloucester County, NJ,Apr-18(p),150494,144468,6026,4.0
CN0901300000000,09,013,Tolland County, CT,Mar-17,87099,83198,3901,4.5
CN0901300000000,09,013,Tolland County, CT,Apr-17,86558,83176,3382,3.9
CN0901300000000,09,013,Tolland County, CT,May-17,86911,83504,3407,3.9
CN0901300000000,09,013,Tolland County, CT,Jun-17,87374,83659,3715,4.3
CN0901300000000,09,013,Tolland County, CT,Jul-17,87426,83778,3648,4.2
CN0901300000000,09,013,Tolland County, CT,Aug-17,86051,82721,3330,3.9
CN0901300000000,09,013,Tolland County, CT,Sep-17,85959,82981,2978,3.5
CN0901300000000,09,013,Tolland County, CT,Oct-17,86196,83312,2884,3.3
CN0901300000000,09,013,Tolland County, CT,Nov-17,86157,83192,2965,3.4
CN0901300000000,09,013,Tolland County, CT,Dec-17,86102,83132,2970,3.4
CN0901300000000,09,013,Tolland County, CT,Jan-18,86226,82063,4163,4.8
CN0901300000000,09,013,Tolland County, CT,Feb-18,86351,82319,4032,4.7
CN0901300000000,09,013,Tolland County, CT,Mar-18,86510,82806,3704,4.3
CN0901300000000,09,013,Tolland County, CT,Apr-18(p),85446,82343,3103,3.6
CN5115500000000,51,155,Pulaski County, VA,Mar-17,16993,15648,1345,7.9
CN5115500000000,51,155,Pulaski County, VA,Apr-17,16454,15752,702,4.3
CN5115500000000,51,155,Pulaski County, VA,May-17,16180,15437,743,4.6
CN5115500000000,51,155,Pulaski County, VA,Jun-17,15866,15077,789,5.0
CN5115500000000,51,155,Pulaski County, VA,Jul-17,15914,15107,807,5.1
CN5115500000000,51,155,Pulaski County, VA,Aug-17,16192,15318,874,5.4
CN5115500000000,51,155,Pulaski County, VA,Sep-17,16352,15646,706,4.3
CN5115500000000,51,155,Pulaski County, VA,Oct-17,16139,15481,658,4.1
CN5115500000000,51,155,Pulaski County, VA,Nov-17,16067,15427,640,4.0
CN5115500000000,51,155,Pulaski County, VA,Dec-17,16025,15369,656,4.1
CN5115500000000,51,155,Pulaski County, VA,Jan-18,15510,14785,725,4.7
CN5115500000000,51,155,Pulaski County, VA,Feb-18,16239,15616,623,3.8
CN5115500000000,51,155,Pulaski County, VA,Mar-18,16312,15697,615,3.8
CN5115500000000,51,155,Pulaski County, VA,Apr-18(p),16343,15832,511,3.1
CN5603900000000,56,039,Teton County, WY,Mar-17,14666,14259,407,2.8
CN5603900000000,56,039,Teton County, WY,Apr-17,13905,13230,675,4.9
CN5603900000000,56,039,Teton County, WY,May-17,14681,14141,540,3.7
CN5603900000000,56,039,Teton County, WY,Jun-17,16935,16566,369,2.2
CN5603900000000,56,039,Teton County, WY,Jul-17,17884,17588,296,1.7
CN5603900000000,56,039,Teton County, WY,Aug-17,17660,17365,295,1.7
CN5603900000000,56,039,Teton County, WY,Sep-17,16235,15924,311,1.9
CN5603900000000,56,039,Teton County, WY,Oct-17,15182,14729,453,3.0
CN5603900000000,56,039,Teton County, WY,Nov-17,13842,13036,806,5.8
CN5603900000000,56,039,Teton County, WY,Dec-17,14928,14412,516,3.5
CN5603900000000,56,039,Teton County, WY,Jan-18,14926,14554,372,2.5
CN5603900000000,56,039,Teton County, WY,Feb-18,14872,14517,355,2.4
CN5603900000000,56,039,Teton County, WY,Mar-18,14759,14391,368,2.5
CN5603900000000,56,039,Teton County, WY,Apr-18(p),13944,13231,713,5.1
CN0807700000000,08,077,Mesa County, CO,Mar-17,72706,69589,3117,4.3
CN0807700000000,08,077,Mesa County, CO,Apr-17,72811,70110,2701,3.7
CN0807700000000,08,077,Mesa County, CO,May-17,73500,71025,2475,3.4
CN0807700000000,08,077,Mesa County, CO,Jun-17,73596,70679,2917,4.0
CN0807700000000,08,077,Mesa County, CO,Jul-17,74042,71148,2894,3.9
CN0807700000000,08,077,Mesa County, CO,Aug-17,74442,71676,2766,3.7
CN0807700000000,08,077,Mesa County, CO,Sep-17,75625,72998,2627,3.5
CN0807700000000,08,077,Mesa County, CO,Oct-17,75467,72893,2574,3.4
CN0807700000000,08,077,Mesa County, CO,Nov-17,75316,72612,2704,3.6
CN0807700000000,08,077,Mesa County, CO,Dec-17,74943,71891,3052,4.1
CN0807700000000,08,077,Mesa County, CO,Jan-18,73781,70236,3545,4.8
CN0807700000000,08,077,Mesa County, CO,Feb-18,74935,71453,3482,4.6
CN0807700000000,08,077,Mesa County, CO,Mar-18,74917,71935,2982,4.0
CN0807700000000,08,077,Mesa County, CO,Apr-18(p),75093,72606,2487,3.3
CN2921500000000,29,215,Texas County, MO,Mar-17,9420,8905,515,5.5
CN2921500000000,29,215,Texas County, MO,Apr-17,9610,9169,441,4.6
CN2921500000000,29,215,Texas County, MO,May-17,9481,9005,476,5.0
CN2921500000000,29,215,Texas County, MO,Jun-17,9490,9022,468,4.9
CN2921500000000,29,215,Texas County, MO,Jul-17,8813,8318,495,5.6
CN2921500000000,29,215,Texas County, MO,Aug-17,8811,8312,499,5.7
CN2921500000000,29,215,Texas County, MO,Sep-17,8981,8572,409,4.6
CN2921500000000,29,215,Texas County, MO,Oct-17,9254,8944,310,3.3
CN2921500000000,29,215,Texas County, MO,Nov-17,9184,8793,391,4.3
CN2921500000000,29,215,Texas County, MO,Dec-17,9097,8677,420,4.6
CN2921500000000,29,215,Texas County, MO,Jan-18,9162,8695,467,5.1
CN2921500000000,29,215,Texas County, MO,Feb-18,9125,8668,457,5.0
CN2921500000000,29,215,Texas County, MO,Mar-18,9102,8674,428,4.7
CN2921500000000,29,215,Texas County, MO,Apr-18(p),9221,8837,384,4.2
CN0108500000000,01,085,Lowndes County, AL,Mar-17,3765,3443,322,8.6
CN0108500000000,01,085,Lowndes County, AL,Apr-17,3730,3449,281,7.5
CN0108500000000,01,085,Lowndes County, AL,May-17,3707,3447,260,7.0
CN0108500000000,01,085,Lowndes County, AL,Jun-17,3766,3448,318,8.4
CN0108500000000,01,085,Lowndes County, AL,Jul-17,3808,3450,358,9.4
CN0108500000000,01,085,Lowndes County, AL,Aug-17,3726,3446,280,7.5
CN0108500000000,01,085,Lowndes County, AL,Sep-17,3740,3490,250,6.7
CN0108500000000,01,085,Lowndes County, AL,Oct-17,3746,3501,245,6.5
CN0108500000000,01,085,Lowndes County, AL,Nov-17,3717,3487,230,6.2
CN0108500000000,01,085,Lowndes County, AL,Dec-17,3683,3445,238,6.5
CN0108500000000,01,085,Lowndes County, AL,Jan-18,3672,3397,275,7.5
CN0108500000000,01,085,Lowndes County, AL,Feb-18,3711,3438,273,7.4
CN0108500000000,01,085,Lowndes County, AL,Mar-18,3696,3442,254,6.9
CN0108500000000,01,085,Lowndes County, AL,Apr-18(p),3707,3464,243,6.6
CN1203300000000,12,033,Escambia County, FL,Mar-17,143698,137705,5993,4.2
CN1203300000000,12,033,Escambia County, FL,Apr-17,144229,138565,5664,3.9
CN1203300000000,12,033,Escambia County, FL,May-17,145020,139264,5756,4.0
CN1203300000000,12,033,Escambia County, FL,Jun-17,146309,139918,6391,4.4
CN1203300000000,12,033,Escambia County, FL,Jul-17,146017,139697,6320,4.3
CN1203300000000,12,033,Escambia County, FL,Aug-17,145594,139487,6107,4.2
CN1203300000000,12,033,Escambia County, FL,Sep-17,149066,143407,5659,3.8
CN1203300000000,12,033,Escambia County, FL,Oct-17,146034,140562,5472,3.7
CN1203300000000,12,033,Escambia County, FL,Nov-17,144723,139155,5568,3.8
CN1203300000000,12,033,Escambia County, FL,Dec-17,143218,138000,5218,3.6
CN1203300000000,12,033,Escambia County, FL,Jan-18,144218,137855,6363,4.4
CN1203300000000,12,033,Escambia County, FL,Feb-18,144481,138915,5566,3.9
CN1203300000000,12,033,Escambia County, FL,Mar-18,145504,140025,5479,3.8
CN1203300000000,12,033,Escambia County, FL,Apr-18(p),145184,140259,4925,3.4
CN2102100000000,21,021,Boyle County, KY,Mar-17,12874,12144,730,5.7
CN2102100000000,21,021,Boyle County, KY,Apr-17,12905,12264,641,5.0
CN2102100000000,21,021,Boyle County, KY,May-17,12790,12138,652,5.1
CN2102100000000,21,021,Boyle County, KY,Jun-17,12981,12216,765,5.9
CN2102100000000,21,021,Boyle County, KY,Jul-17,12656,11943,713,5.6
CN2102100000000,21,021,Boyle County, KY,Aug-17,12601,11970,631,5.0
CN2102100000000,21,021,Boyle County, KY,Sep-17,12664,12115,549,4.3
CN2102100000000,21,021,Boyle County, KY,Oct-17,12600,12087,513,4.1
CN2102100000000,21,021,Boyle County, KY,Nov-17,12576,12080,496,3.9
CN2102100000000,21,021,Boyle County, KY,Dec-17,12558,12069,489,3.9
CN2102100000000,21,021,Boyle County, KY,Jan-18,12553,12024,529,4.2
CN2102100000000,21,021,Boyle County, KY,Feb-18,12568,11958,610,4.9
CN2102100000000,21,021,Boyle County, KY,Mar-18,12799,12217,582,4.5
CN2102100000000,21,021,Boyle County, KY,Apr-18(p),12786,12305,481,3.8
CN2303100000000,23,031,York County, ME,Mar-17,111057,107185,3872,3.5
CN2303100000000,23,031,York County, ME,Apr-17,111521,108243,3278,2.9
CN2303100000000,23,031,York County, ME,May-17,113002,109773,3229,2.9
CN2303100000000,23,031,York County, ME,Jun-17,115534,112201,3333,2.9
CN2303100000000,23,031,York County, ME,Jul-17,116965,113700,3265,2.8
CN2303100000000,23,031,York County, ME,Aug-17,116818,113999,2819,2.4
CN2303100000000,23,031,York County, ME,Sep-17,114210,111469,2741,2.4
CN2303100000000,23,031,York County, ME,Oct-17,113927,111173,2754,2.4
CN2303100000000,23,031,York County, ME,Nov-17,113241,110156,3085,2.7
CN2303100000000,23,031,York County, ME,Dec-17,112581,109868,2713,2.4
CN2303100000000,23,031,York County, ME,Jan-18,111821,108198,3623,3.2
CN2303100000000,23,031,York County, ME,Feb-18,111533,107981,3552,3.2
CN2303100000000,23,031,York County, ME,Mar-18,112202,108896,3306,2.9
CN2303100000000,23,031,York County, ME,Apr-18(p),113069,110055,3014,2.7
CN2105700000000,21,057,Cumberland County, KY,Mar-17,2951,2772,179,6.1
CN2105700000000,21,057,Cumberland County, KY,Apr-17,2969,2824,145,4.9
CN2105700000000,21,057,Cumberland County, KY,May-17,3013,2864,149,4.9
CN2105700000000,21,057,Cumberland County, KY,Jun-17,3093,2934,159,5.1
CN2105700000000,21,057,Cumberland County, KY,Jul-17,2994,2844,150,5.0
CN2105700000000,21,057,Cumberland County, KY,Aug-17,2878,2735,143,5.0
CN2105700000000,21,057,Cumberland County, KY,Sep-17,2975,2826,149,5.0
CN2105700000000,21,057,Cumberland County, KY,Oct-17,2929,2799,130,4.4
CN2105700000000,21,057,Cumberland County, KY,Nov-17,2897,2779,118,4.1
CN2105700000000,21,057,Cumberland County, KY,Dec-17,2916,2772,144,4.9
CN2105700000000,21,057,Cumberland County, KY,Jan-18,2945,2763,182,6.2
CN2105700000000,21,057,Cumberland County, KY,Feb-18,2949,2779,170,5.8
CN2105700000000,21,057,Cumberland County, KY,Mar-18,2985,2846,139,4.7
CN2105700000000,21,057,Cumberland County, KY,Apr-18(p),3007,2890,117,3.9
CN3004500000000,30,045,Judith Basin County, MT,Mar-17,929,892,37,4.0
CN3004500000000,30,045,Judith Basin County, MT,Apr-17,943,910,33,3.5
CN3004500000000,30,045,Judith Basin County, MT,May-17,963,934,29,3.0
CN3004500000000,30,045,Judith Basin County, MT,Jun-17,927,894,33,3.6
CN3004500000000,30,045,Judith Basin County, MT,Jul-17,926,895,31,3.3
CN3004500000000,30,045,Judith Basin County, MT,Aug-17,877,845,32,3.6
CN3004500000000,30,045,Judith Basin County, MT,Sep-17,918,888,30,3.3
CN3004500000000,30,045,Judith Basin County, MT,Oct-17,942,914,28,3.0
CN3004500000000,30,045,Judith Basin County, MT,Nov-17,954,917,37,3.9
CN3004500000000,30,045,Judith Basin County, MT,Dec-17,921,885,36,3.9
CN3004500000000,30,045,Judith Basin County, MT,Jan-18,919,866,53,5.8
CN3004500000000,30,045,Judith Basin County, MT,Feb-18,924,873,51,5.5
CN3004500000000,30,045,Judith Basin County, MT,Mar-18,900,859,41,4.6
CN3004500000000,30,045,Judith Basin County, MT,Apr-18(p),883,855,28,3.2
CN2700100000000,27,001,Aitkin County, MN,Mar-17,7251,6609,642,8.9
CN2700100000000,27,001,Aitkin County, MN,Apr-17,7124,6623,501,7.0
CN2700100000000,27,001,Aitkin County, MN,May-17,7161,6805,356,5.0
CN2700100000000,27,001,Aitkin County, MN,Jun-17,7233,6887,346,4.8
CN2700100000000,27,001,Aitkin County, MN,Jul-17,7167,6847,320,4.5
CN2700100000000,27,001,Aitkin County, MN,Aug-17,7123,6814,309,4.3
CN2700100000000,27,001,Aitkin County, MN,Sep-17,7087,6819,268,3.8
CN2700100000000,27,001,Aitkin County, MN,Oct-17,7066,6833,233,3.3
CN2700100000000,27,001,Aitkin County, MN,Nov-17,7261,6817,444,6.1
CN2700100000000,27,001,Aitkin County, MN,Dec-17,7377,6800,577,7.8
CN2700100000000,27,001,Aitkin County, MN,Jan-18,7445,6752,693,9.3
CN2700100000000,27,001,Aitkin County, MN,Feb-18,7442,6802,640,8.6
CN2700100000000,27,001,Aitkin County, MN,Mar-18,7406,6794,612,8.3
CN2700100000000,27,001,Aitkin County, MN,Apr-18(p),7383,6884,499,6.8
CN1816100000000,18,161,Union County, IN,Mar-17,3606,3493,113,3.1
CN1816100000000,18,161,Union County, IN,Apr-17,3620,3530,90,2.5
CN1816100000000,18,161,Union County, IN,May-17,3697,3596,101,2.7
CN1816100000000,18,161,Union County, IN,Jun-17,3722,3603,119,3.2
CN1816100000000,18,161,Union County, IN,Jul-17,3716,3593,123,3.3
CN1816100000000,18,161,Union County, IN,Aug-17,3657,3528,129,3.5
CN1816100000000,18,161,Union County, IN,Sep-17,3592,3493,99,2.8
CN1816100000000,18,161,Union County, IN,Oct-17,3588,3492,96,2.7
CN1816100000000,18,161,Union County, IN,Nov-17,3595,3495,100,2.8
CN1816100000000,18,161,Union County, IN,Dec-17,3548,3449,99,2.8
CN1816100000000,18,161,Union County, IN,Jan-18,3523,3405,118,3.3
CN1816100000000,18,161,Union County, IN,Feb-18,3595,3471,124,3.4
CN1816100000000,18,161,Union County, IN,Mar-18,3630,3523,107,2.9
CN1816100000000,18,161,Union County, IN,Apr-18(p),3648,3551,97,2.7
CN0509700000000,05,097,Montgomery County, AR,Mar-17,3083,2938,145,4.7
CN0509700000000,05,097,Montgomery County, AR,Apr-17,3127,3000,127,4.1
CN0509700000000,05,097,Montgomery County, AR,May-17,3166,3036,130,4.1
CN0509700000000,05,097,Montgomery County, AR,Jun-17,3328,3169,159,4.8
CN0509700000000,05,097,Montgomery County, AR,Jul-17,3111,2943,168,5.4
CN0509700000000,05,097,Montgomery County, AR,Aug-17,3111,2964,147,4.7
CN0509700000000,05,097,Montgomery County, AR,Sep-17,3068,2928,140,4.6
CN0509700000000,05,097,Montgomery County, AR,Oct-17,2992,2859,133,4.4
CN0509700000000,05,097,Montgomery County, AR,Nov-17,2949,2819,130,4.4
CN0509700000000,05,097,Montgomery County, AR,Dec-17,2925,2776,149,5.1
CN0509700000000,05,097,Montgomery County, AR,Jan-18,2830,2649,181,6.4
CN0509700000000,05,097,Montgomery County, AR,Feb-18,2973,2801,172,5.8
CN0509700000000,05,097,Montgomery County, AR,Mar-18,3005,2851,154,5.1
CN0509700000000,05,097,Montgomery County, AR,Apr-18(p),3046,2911,135,4.4
CN5509300000000,55,093,Pierce County, WI,Mar-17,24948,23959,989,4.0
CN5509300000000,55,093,Pierce County, WI,Apr-17,24977,24181,796,3.2
CN5509300000000,55,093,Pierce County, WI,May-17,25109,24328,781,3.1
CN5509300000000,55,093,Pierce County, WI,Jun-17,25568,24652,916,3.6
CN5509300000000,55,093,Pierce County, WI,Jul-17,25508,24706,802,3.1
CN5509300000000,55,093,Pierce County, WI,Aug-17,25289,24506,783,3.1
CN5509300000000,55,093,Pierce County, WI,Sep-17,25244,24553,691,2.7
CN5509300000000,55,093,Pierce County, WI,Oct-17,25256,24612,644,2.5
CN5509300000000,55,093,Pierce County, WI,Nov-17,25234,24547,687,2.7
CN5509300000000,55,093,Pierce County, WI,Dec-17,25126,24424,702,2.8
CN5509300000000,55,093,Pierce County, WI,Jan-18,25286,24412,874,3.5
CN5509300000000,55,093,Pierce County, WI,Feb-18,25455,24445,1010,4.0
CN5509300000000,55,093,Pierce County, WI,Mar-18,25457,24540,917,3.6
CN5509300000000,55,093,Pierce County, WI,Apr-18(p),25369,24626,743,2.9
CN4902500000000,49,025,Kane County, UT,Mar-17,3583,3438,145,4.0
CN4902500000000,49,025,Kane County, UT,Apr-17,3705,3583,122,3.3
CN4902500000000,49,025,Kane County, UT,May-17,3868,3758,110,2.8
CN4902500000000,49,025,Kane County, UT,Jun-17,4073,3940,133,3.3
CN4902500000000,49,025,Kane County, UT,Jul-17,4133,4015,118,2.9
CN4902500000000,49,025,Kane County, UT,Aug-17,4114,3998,116,2.8
CN4902500000000,49,025,Kane County, UT,Sep-17,3962,3865,97,2.4
CN4902500000000,49,025,Kane County, UT,Oct-17,3804,3706,98,2.6
CN4902500000000,49,025,Kane County, UT,Nov-17,3612,3498,114,3.2
CN4902500000000,49,025,Kane County, UT,Dec-17,3524,3389,135,3.8
CN4902500000000,49,025,Kane County, UT,Jan-18,3448,3280,168,4.9
CN4902500000000,49,025,Kane County, UT,Feb-18,3503,3348,155,4.4
CN4902500000000,49,025,Kane County, UT,Mar-18,3636,3490,146,4.0
CN4902500000000,49,025,Kane County, UT,Apr-18(p),3752,3636,116,3.1
CN3118300000000,31,183,Wheeler County, NE,Mar-17,550,540,10,1.8
CN3118300000000,31,183,Wheeler County, NE,Apr-17,588,575,13,2.2
CN3118300000000,31,183,Wheeler County, NE,May-17,611,597,14,2.3
CN3118300000000,31,183,Wheeler County, NE,Jun-17,626,610,16,2.6
CN3118300000000,31,183,Wheeler County, NE,Jul-17,589,573,16,2.7
CN3118300000000,31,183,Wheeler County, NE,Aug-17,556,544,12,2.2
CN3118300000000,31,183,Wheeler County, NE,Sep-17,533,521,12,2.3
CN3118300000000,31,183,Wheeler County, NE,Oct-17,544,533,11,2.0
CN3118300000000,31,183,Wheeler County, NE,Nov-17,552,541,11,2.0
CN3118300000000,31,183,Wheeler County, NE,Dec-17,546,535,11,2.0
CN3118300000000,31,183,Wheeler County, NE,Jan-18,574,558,16,2.8
CN3118300000000,31,183,Wheeler County, NE,Feb-18,525,515,10,1.9
CN3118300000000,31,183,Wheeler County, NE,Mar-18,551,537,14,2.5
CN3118300000000,31,183,Wheeler County, NE,Apr-18(p),571,558,13,2.3
CN4715700000000,47,157,Shelby County, TN,Mar-17,437482,416802,20680,4.7
CN4715700000000,47,157,Shelby County, TN,Apr-17,436444,418642,17802,4.1
CN4715700000000,47,157,Shelby County, TN,May-17,436274,419441,16833,3.9
CN4715700000000,47,157,Shelby County, TN,Jun-17,444348,423305,21043,4.7
CN4715700000000,47,157,Shelby County, TN,Jul-17,445188,425055,20133,4.5
CN4715700000000,47,157,Shelby County, TN,Aug-17,437874,419089,18785,4.3
CN4715700000000,47,157,Shelby County, TN,Sep-17,439726,422838,16888,3.8
CN4715700000000,47,157,Shelby County, TN,Oct-17,440467,423582,16885,3.8
CN4715700000000,47,157,Shelby County, TN,Nov-17,443382,426851,16531,3.7
CN4715700000000,47,157,Shelby County, TN,Dec-17,442449,426353,16096,3.6
CN4715700000000,47,157,Shelby County, TN,Jan-18,438937,420325,18612,4.2
CN4715700000000,47,157,Shelby County, TN,Feb-18,444828,426365,18463,4.2
CN4715700000000,47,157,Shelby County, TN,Mar-18,446328,428489,17839,4.0
CN4715700000000,47,157,Shelby County, TN,Apr-18(p),445850,430341,15509,3.5
CN0803500000000,08,035,Douglas County, CO,Mar-17,180326,176215,4111,2.3
CN0803500000000,08,035,Douglas County, CO,Apr-17,180686,176802,3884,2.1
CN0803500000000,08,035,Douglas County, CO,May-17,181970,178046,3924,2.2
CN0803500000000,08,035,Douglas County, CO,Jun-17,184460,179799,4661,2.5
CN0803500000000,08,035,Douglas County, CO,Jul-17,185187,180716,4471,2.4
CN0803500000000,08,035,Douglas County, CO,Aug-17,185094,180707,4387,2.4
CN0803500000000,08,035,Douglas County, CO,Sep-17,186078,181719,4359,2.3
CN0803500000000,08,035,Douglas County, CO,Oct-17,185673,181185,4488,2.4
CN0803500000000,08,035,Douglas County, CO,Nov-17,185833,181283,4550,2.4
CN0803500000000,08,035,Douglas County, CO,Dec-17,185186,180549,4637,2.5
CN0803500000000,08,035,Douglas County, CO,Jan-18,184389,179282,5107,2.8
CN0803500000000,08,035,Douglas County, CO,Feb-18,187270,182052,5218,2.8
CN0803500000000,08,035,Douglas County, CO,Mar-18,187345,182704,4641,2.5
CN0803500000000,08,035,Douglas County, CO,Apr-18(p),187173,182948,4225,2.3
CN5184000000000,51,840,Winchester city, VA,Mar-17,14444,13879,565,3.9
CN5184000000000,51,840,Winchester city, VA,Apr-17,14616,14111,505,3.5
CN5184000000000,51,840,Winchester city, VA,May-17,14622,14102,520,3.6
CN5184000000000,51,840,Winchester city, VA,Jun-17,14726,14172,554,3.8
CN5184000000000,51,840,Winchester city, VA,Jul-17,14826,14258,568,3.8
CN5184000000000,51,840,Winchester city, VA,Aug-17,14605,14056,549,3.8
CN5184000000000,51,840,Winchester city, VA,Sep-17,14648,14153,495,3.4
CN5184000000000,51,840,Winchester city, VA,Oct-17,14607,14157,450,3.1
CN5184000000000,51,840,Winchester city, VA,Nov-17,14621,14160,461,3.2
CN5184000000000,51,840,Winchester city, VA,Dec-17,14514,14082,432,3.0
CN5184000000000,51,840,Winchester city, VA,Jan-18,14495,14008,487,3.4
CN5184000000000,51,840,Winchester city, VA,Feb-18,14794,14293,501,3.4
CN5184000000000,51,840,Winchester city, VA,Mar-18,14789,14319,470,3.2
CN5184000000000,51,840,Winchester city, VA,Apr-18(p),14910,14516,394,2.6
CN1308900000000,13,089,DeKalb County, GA,Mar-17,392978,373592,19386,4.9
CN1308900000000,13,089,DeKalb County, GA,Apr-17,392604,374473,18131,4.6
CN1308900000000,13,089,DeKalb County, GA,May-17,393576,375093,18483,4.7
CN1308900000000,13,089,DeKalb County, GA,Jun-17,394122,374643,19479,4.9
CN1308900000000,13,089,DeKalb County, GA,Jul-17,397296,377410,19886,5.0
CN1308900000000,13,089,DeKalb County, GA,Aug-17,395383,375543,19840,5.0
CN1308900000000,13,089,DeKalb County, GA,Sep-17,398501,380730,17771,4.5
CN1308900000000,13,089,DeKalb County, GA,Oct-17,396690,379067,17623,4.4
CN1308900000000,13,089,DeKalb County, GA,Nov-17,397612,380360,17252,4.3
CN1308900000000,13,089,DeKalb County, GA,Dec-17,397790,380157,17633,4.4
CN1308900000000,13,089,DeKalb County, GA,Jan-18,397968,379385,18583,4.7
CN1308900000000,13,089,DeKalb County, GA,Feb-18,404277,385989,18288,4.5
CN1308900000000,13,089,DeKalb County, GA,Mar-18,404497,387339,17158,4.2
CN1308900000000,13,089,DeKalb County, GA,Apr-18(p),401440,386265,15175,3.8
CN1319500000000,13,195,Madison County, GA,Mar-17,13464,12879,585,4.3
CN1319500000000,13,195,Madison County, GA,Apr-17,13689,13126,563,4.1
CN1319500000000,13,195,Madison County, GA,May-17,13568,13014,554,4.1
CN1319500000000,13,195,Madison County, GA,Jun-17,13705,13092,613,4.5
CN1319500000000,13,195,Madison County, GA,Jul-17,13634,13010,624,4.6
CN1319500000000,13,195,Madison County, GA,Aug-17,13561,12950,611,4.5
CN1319500000000,13,195,Madison County, GA,Sep-17,13770,13225,545,4.0
CN1319500000000,13,195,Madison County, GA,Oct-17,13761,13211,550,4.0
CN1319500000000,13,195,Madison County, GA,Nov-17,13782,13257,525,3.8
CN1319500000000,13,195,Madison County, GA,Dec-17,13596,13071,525,3.9
CN1319500000000,13,195,Madison County, GA,Jan-18,13783,13229,554,4.0
CN1319500000000,13,195,Madison County, GA,Feb-18,14009,13462,547,3.9
CN1319500000000,13,195,Madison County, GA,Mar-18,13996,13471,525,3.8
CN1319500000000,13,195,Madison County, GA,Apr-18(p),14001,13544,457,3.3
CN0402300000000,04,023,Santa Cruz County, AZ,Mar-17,19250,17699,1551,8.1
CN0402300000000,04,023,Santa Cruz County, AZ,Apr-17,19066,17697,1369,7.2
CN0402300000000,04,023,Santa Cruz County, AZ,May-17,19144,17819,1325,6.9
CN0402300000000,04,023,Santa Cruz County, AZ,Jun-17,19408,17721,1687,8.7
CN0402300000000,04,023,Santa Cruz County, AZ,Jul-17,18082,15922,2160,11.9
CN0402300000000,04,023,Santa Cruz County, AZ,Aug-17,18763,16414,2349,12.5
CN0402300000000,04,023,Santa Cruz County, AZ,Sep-17,18853,16554,2299,12.2
CN0402300000000,04,023,Santa Cruz County, AZ,Oct-17,18923,16769,2154,11.4
CN0402300000000,04,023,Santa Cruz County, AZ,Nov-17,18972,17226,1746,9.2
CN0402300000000,04,023,Santa Cruz County, AZ,Dec-17,19295,17496,1799,9.3
CN0402300000000,04,023,Santa Cruz County, AZ,Jan-18,19210,17397,1813,9.4
CN0402300000000,04,023,Santa Cruz County, AZ,Feb-18,19205,17522,1683,8.8
CN0402300000000,04,023,Santa Cruz County, AZ,Mar-18,19289,17656,1633,8.5
CN0402300000000,04,023,Santa Cruz County, AZ,Apr-18(p),18951,17565,1386,7.3
CN1301100000000,13,011,Banks County, GA,Mar-17,9170,8789,381,4.2
CN1301100000000,13,011,Banks County, GA,Apr-17,9104,8741,363,4.0
CN1301100000000,13,011,Banks County, GA,May-17,9174,8828,346,3.8
CN1301100000000,13,011,Banks County, GA,Jun-17,9298,8919,379,4.1
CN1301100000000,13,011,Banks County, GA,Jul-17,9233,8829,404,4.4
CN1301100000000,13,011,Banks County, GA,Aug-17,9197,8823,374,4.1
CN1301100000000,13,011,Banks County, GA,Sep-17,9267,8918,349,3.8
CN1301100000000,13,011,Banks County, GA,Oct-17,9344,8999,345,3.7
CN1301100000000,13,011,Banks County, GA,Nov-17,9385,9063,322,3.4
CN1301100000000,13,011,Banks County, GA,Dec-17,9414,9091,323,3.4
CN1301100000000,13,011,Banks County, GA,Jan-18,9501,9168,333,3.5
CN1301100000000,13,011,Banks County, GA,Feb-18,9372,9012,360,3.8
CN1301100000000,13,011,Banks County, GA,Mar-18,9382,9059,323,3.4
CN1301100000000,13,011,Banks County, GA,Apr-18(p),9345,9067,278,3.0
CN3708100000000,37,081,Guilford County, NC,Mar-17,260004,247657,12347,4.7
CN3708100000000,37,081,Guilford County, NC,Apr-17,260220,248852,11368,4.4
CN3708100000000,37,081,Guilford County, NC,May-17,260539,248516,12023,4.6
CN3708100000000,37,081,Guilford County, NC,Jun-17,260403,247513,12890,5.0
CN3708100000000,37,081,Guilford County, NC,Jul-17,260794,247254,13540,5.2
CN3708100000000,37,081,Guilford County, NC,Aug-17,259434,245917,13517,5.2
CN3708100000000,37,081,Guilford County, NC,Sep-17,262218,250390,11828,4.5
CN3708100000000,37,081,Guilford County, NC,Oct-17,260986,249197,11789,4.5
CN3708100000000,37,081,Guilford County, NC,Nov-17,261656,249279,12377,4.7
CN3708100000000,37,081,Guilford County, NC,Dec-17,259064,247211,11853,4.6
CN3708100000000,37,081,Guilford County, NC,Jan-18,259477,246637,12840,4.9
CN3708100000000,37,081,Guilford County, NC,Feb-18,262317,249744,12573,4.8
CN3708100000000,37,081,Guilford County, NC,Mar-18,262539,250636,11903,4.5
CN3708100000000,37,081,Guilford County, NC,Apr-18(p),262017,251708,10309,3.9
CN5302300000000,53,023,Garfield County, WA,Mar-17,874,821,53,6.1
CN5302300000000,53,023,Garfield County, WA,Apr-17,884,840,44,5.0
CN5302300000000,53,023,Garfield County, WA,May-17,900,860,40,4.4
CN5302300000000,53,023,Garfield County, WA,Jun-17,941,901,40,4.3
CN5302300000000,53,023,Garfield County, WA,Jul-17,1006,967,39,3.9
CN5302300000000,53,023,Garfield County, WA,Aug-17,967,920,47,4.9
CN5302300000000,53,023,Garfield County, WA,Sep-17,969,925,44,4.5
CN5302300000000,53,023,Garfield County, WA,Oct-17,919,868,51,5.5
CN5302300000000,53,023,Garfield County, WA,Nov-17,909,854,55,6.1
CN5302300000000,53,023,Garfield County, WA,Dec-17,897,832,65,7.2
CN5302300000000,53,023,Garfield County, WA,Jan-18,870,804,66,7.6
CN5302300000000,53,023,Garfield County, WA,Feb-18,867,802,65,7.5
CN5302300000000,53,023,Garfield County, WA,Mar-18,877,814,63,7.2
CN5302300000000,53,023,Garfield County, WA,Apr-18(p),876,831,45,5.1
CN2604700000000,26,047,Emmet County, MI,Mar-17,16839,15283,1556,9.2
CN2604700000000,26,047,Emmet County, MI,Apr-17,16736,15512,1224,7.3
CN2604700000000,26,047,Emmet County, MI,May-17,17574,16622,952,5.4
CN2604700000000,26,047,Emmet County, MI,Jun-17,18875,17918,957,5.1
CN2604700000000,26,047,Emmet County, MI,Jul-17,19325,18307,1018,5.3
CN2604700000000,26,047,Emmet County, MI,Aug-17,18985,18028,957,5.0
CN2604700000000,26,047,Emmet County, MI,Sep-17,17832,17037,795,4.5
CN2604700000000,26,047,Emmet County, MI,Oct-17,17271,16502,769,4.5
CN2604700000000,26,047,Emmet County, MI,Nov-17,17040,15965,1075,6.3
CN2604700000000,26,047,Emmet County, MI,Dec-17,17352,15910,1442,8.3
CN2604700000000,26,047,Emmet County, MI,Jan-18,17248,15667,1581,9.2
CN2604700000000,26,047,Emmet County, MI,Feb-18,17209,15468,1741,10.1
CN2604700000000,26,047,Emmet County, MI,Mar-18,17044,15461,1583,9.3
CN2604700000000,26,047,Emmet County, MI,Apr-18(p),17105,15675,1430,8.4
CN2615300000000,26,153,Schoolcraft County, MI,Mar-17,3385,2995,390,11.5
CN2615300000000,26,153,Schoolcraft County, MI,Apr-17,3359,3073,286,8.5
CN2615300000000,26,153,Schoolcraft County, MI,May-17,3377,3143,234,6.9
CN2615300000000,26,153,Schoolcraft County, MI,Jun-17,3408,3160,248,7.3
CN2615300000000,26,153,Schoolcraft County, MI,Jul-17,3483,3216,267,7.7
CN2615300000000,26,153,Schoolcraft County, MI,Aug-17,3450,3202,248,7.2
CN2615300000000,26,153,Schoolcraft County, MI,Sep-17,3353,3150,203,6.1
CN2615300000000,26,153,Schoolcraft County, MI,Oct-17,3287,3082,205,6.2
CN2615300000000,26,153,Schoolcraft County, MI,Nov-17,3287,3056,231,7.0
CN2615300000000,26,153,Schoolcraft County, MI,Dec-17,3322,2996,326,9.8
CN2615300000000,26,153,Schoolcraft County, MI,Jan-18,3340,2961,379,11.3
CN2615300000000,26,153,Schoolcraft County, MI,Feb-18,3348,2969,379,11.3
CN2615300000000,26,153,Schoolcraft County, MI,Mar-18,3360,3012,348,10.4
CN2615300000000,26,153,Schoolcraft County, MI,Apr-18(p),3381,3085,296,8.8
CN3711900000000,37,119,Mecklenburg County, NC,Mar-17,596947,571640,25307,4.2
CN3711900000000,37,119,Mecklenburg County, NC,Apr-17,597070,573024,24046,4.0
CN3711900000000,37,119,Mecklenburg County, NC,May-17,600493,575706,24787,4.1
CN3711900000000,37,119,Mecklenburg County, NC,Jun-17,603483,577438,26045,4.3
CN3711900000000,37,119,Mecklenburg County, NC,Jul-17,606205,579013,27192,4.5
CN3711900000000,37,119,Mecklenburg County, NC,Aug-17,601584,574281,27303,4.5
CN3711900000000,37,119,Mecklenburg County, NC,Sep-17,608864,584279,24585,4.0
CN3711900000000,37,119,Mecklenburg County, NC,Oct-17,610212,585351,24861,4.1
CN3711900000000,37,119,Mecklenburg County, NC,Nov-17,609571,583668,25903,4.2
CN3711900000000,37,119,Mecklenburg County, NC,Dec-17,606679,582170,24509,4.0
CN3711900000000,37,119,Mecklenburg County, NC,Jan-18,607098,580511,26587,4.4
CN3711900000000,37,119,Mecklenburg County, NC,Feb-18,609963,583807,26156,4.3
CN3711900000000,37,119,Mecklenburg County, NC,Mar-18,614909,589845,25064,4.1
CN3711900000000,37,119,Mecklenburg County, NC,Apr-18(p),612291,590382,21909,3.6
CN1705900000000,17,059,Gallatin County, IL,Mar-17,2551,2404,147,5.8
CN1705900000000,17,059,Gallatin County, IL,Apr-17,2531,2403,128,5.1
CN1705900000000,17,059,Gallatin County, IL,May-17,2516,2383,133,5.3
CN1705900000000,17,059,Gallatin County, IL,Jun-17,2495,2354,141,5.7
CN1705900000000,17,059,Gallatin County, IL,Jul-17,2406,2269,137,5.7
CN1705900000000,17,059,Gallatin County, IL,Aug-17,2366,2230,136,5.7
CN1705900000000,17,059,Gallatin County, IL,Sep-17,2375,2243,132,5.6
CN1705900000000,17,059,Gallatin County, IL,Oct-17,2364,2250,114,4.8
CN1705900000000,17,059,Gallatin County, IL,Nov-17,2371,2246,125,5.3
CN1705900000000,17,059,Gallatin County, IL,Dec-17,2381,2249,132,5.5
CN1705900000000,17,059,Gallatin County, IL,Jan-18,2380,2254,126,5.3
CN1705900000000,17,059,Gallatin County, IL,Feb-18,2398,2277,121,5.0
CN1705900000000,17,059,Gallatin County, IL,Mar-18,2436,2309,127,5.2
CN1705900000000,17,059,Gallatin County, IL,Apr-18(p),2503,2395,108,4.3
CN3911100000000,39,111,Monroe County, OH,Mar-17,5310,4803,507,9.5
CN3911100000000,39,111,Monroe County, OH,Apr-17,5213,4799,414,7.9
CN3911100000000,39,111,Monroe County, OH,May-17,5099,4732,367,7.2
CN3911100000000,39,111,Monroe County, OH,Jun-17,5207,4806,401,7.7
CN3911100000000,39,111,Monroe County, OH,Jul-17,5134,4742,392,7.6
CN3911100000000,39,111,Monroe County, OH,Aug-17,5201,4803,398,7.7
CN3911100000000,39,111,Monroe County, OH,Sep-17,5091,4724,367,7.2
CN3911100000000,39,111,Monroe County, OH,Oct-17,5087,4730,357,7.0
CN3911100000000,39,111,Monroe County, OH,Nov-17,5027,4646,381,7.6
CN3911100000000,39,111,Monroe County, OH,Dec-17,4974,4532,442,8.9
CN3911100000000,39,111,Monroe County, OH,Jan-18,4927,4372,555,11.3
CN3911100000000,39,111,Monroe County, OH,Feb-18,5132,4605,527,10.3
CN3911100000000,39,111,Monroe County, OH,Mar-18,5206,4755,451,8.7
CN3911100000000,39,111,Monroe County, OH,Apr-18(p),5143,4766,377,7.3
CN3202100000000,32,021,Mineral County, NV,Mar-17,2002,1885,117,5.8
CN3202100000000,32,021,Mineral County, NV,Apr-17,2016,1898,118,5.9
CN3202100000000,32,021,Mineral County, NV,May-17,2001,1894,107,5.3
CN3202100000000,32,021,Mineral County, NV,Jun-17,2016,1903,113,5.6
CN3202100000000,32,021,Mineral County, NV,Jul-17,2024,1918,106,5.2
CN3202100000000,32,021,Mineral County, NV,Aug-17,2001,1899,102,5.1
CN3202100000000,32,021,Mineral County, NV,Sep-17,1998,1902,96,4.8
CN3202100000000,32,021,Mineral County, NV,Oct-17,1969,1865,104,5.3
CN3202100000000,32,021,Mineral County, NV,Nov-17,1968,1864,104,5.3
CN3202100000000,32,021,Mineral County, NV,Dec-17,1956,1854,102,5.2
CN3202100000000,32,021,Mineral County, NV,Jan-18,2009,1886,123,6.1
CN3202100000000,32,021,Mineral County, NV,Feb-18,2050,1938,112,5.5
CN3202100000000,32,021,Mineral County, NV,Mar-18,2050,1942,108,5.3
CN3202100000000,32,021,Mineral County, NV,Apr-18(p),2031,1921,110,5.4
CN2110300000000,21,103,Henry County, KY,Mar-17,8028,7665,363,4.5
CN2110300000000,21,103,Henry County, KY,Apr-17,8081,7770,311,3.8
CN2110300000000,21,103,Henry County, KY,May-17,8108,7767,341,4.2
CN2110300000000,21,103,Henry County, KY,Jun-17,8208,7834,374,4.6
CN2110300000000,21,103,Henry County, KY,Jul-17,8160,7773,387,4.7
CN2110300000000,21,103,Henry County, KY,Aug-17,8009,7683,326,4.1
CN2110300000000,21,103,Henry County, KY,Sep-17,8004,7709,295,3.7
CN2110300000000,21,103,Henry County, KY,Oct-17,7996,7720,276,3.5
CN2110300000000,21,103,Henry County, KY,Nov-17,8054,7795,259,3.2
CN2110300000000,21,103,Henry County, KY,Dec-17,8030,7773,257,3.2
CN2110300000000,21,103,Henry County, KY,Jan-18,7964,7661,303,3.8
CN2110300000000,21,103,Henry County, KY,Feb-18,7988,7655,333,4.2
CN2110300000000,21,103,Henry County, KY,Mar-18,8063,7750,313,3.9
CN2110300000000,21,103,Henry County, KY,Apr-18(p),8093,7821,272,3.4
CN2012300000000,20,123,Mitchell County, KS,Mar-17,3491,3358,133,3.8
CN2012300000000,20,123,Mitchell County, KS,Apr-17,3399,3312,87,2.6
CN2012300000000,20,123,Mitchell County, KS,May-17,3400,3306,94,2.8
CN2012300000000,20,123,Mitchell County, KS,Jun-17,3504,3401,103,2.9
CN2012300000000,20,123,Mitchell County, KS,Jul-17,3565,3457,108,3.0
CN2012300000000,20,123,Mitchell County, KS,Aug-17,3476,3379,97,2.8
CN2012300000000,20,123,Mitchell County, KS,Sep-17,3443,3363,80,2.3
CN2012300000000,20,123,Mitchell County, KS,Oct-17,3436,3368,68,2.0
CN2012300000000,20,123,Mitchell County, KS,Nov-17,3412,3335,77,2.3
CN2012300000000,20,123,Mitchell County, KS,Dec-17,3390,3316,74,2.2
CN2012300000000,20,123,Mitchell County, KS,Jan-18,3364,3295,69,2.1
CN2012300000000,20,123,Mitchell County, KS,Feb-18,3352,3278,74,2.2
CN2012300000000,20,123,Mitchell County, KS,Mar-18,3372,3295,77,2.3
CN2012300000000,20,123,Mitchell County, KS,Apr-18(p),3285,3209,76,2.3
CN2107300000000,21,073,Franklin County, KY,Mar-17,24382,23249,1133,4.6
CN2107300000000,21,073,Franklin County, KY,Apr-17,24593,23615,978,4.0
CN2107300000000,21,073,Franklin County, KY,May-17,24436,23410,1026,4.2
CN2107300000000,21,073,Franklin County, KY,Jun-17,25402,24211,1191,4.7
CN2107300000000,21,073,Franklin County, KY,Jul-17,24648,23490,1158,4.7
CN2107300000000,21,073,Franklin County, KY,Aug-17,24512,23494,1018,4.2
CN2107300000000,21,073,Franklin County, KY,Sep-17,24788,23881,907,3.7
CN2107300000000,21,073,Franklin County, KY,Oct-17,24857,24014,843,3.4
CN2107300000000,21,073,Franklin County, KY,Nov-17,24581,23752,829,3.4
CN2107300000000,21,073,Franklin County, KY,Dec-17,25043,24248,795,3.2
CN2107300000000,21,073,Franklin County, KY,Jan-18,24410,23512,898,3.7
CN2107300000000,21,073,Franklin County, KY,Feb-18,24912,23909,1003,4.0
CN2107300000000,21,073,Franklin County, KY,Mar-18,24647,23697,950,3.9
CN2107300000000,21,073,Franklin County, KY,Apr-18(p),24965,24152,813,3.3
CN1900900000000,19,009,Audubon County, IA,Mar-17,3108,3000,108,3.5
CN1900900000000,19,009,Audubon County, IA,Apr-17,3223,3125,98,3.0
CN1900900000000,19,009,Audubon County, IA,May-17,3240,3152,88,2.7
CN1900900000000,19,009,Audubon County, IA,Jun-17,3280,3183,97,3.0
CN1900900000000,19,009,Audubon County, IA,Jul-17,3341,3247,94,2.8
CN1900900000000,19,009,Audubon County, IA,Aug-17,3236,3136,100,3.1
CN1900900000000,19,009,Audubon County, IA,Sep-17,3134,3045,89,2.8
CN1900900000000,19,009,Audubon County, IA,Oct-17,3172,3101,71,2.2
CN1900900000000,19,009,Audubon County, IA,Nov-17,3087,3010,77,2.5
CN1900900000000,19,009,Audubon County, IA,Dec-17,3085,2997,88,2.9
CN1900900000000,19,009,Audubon County, IA,Jan-18,3031,2914,117,3.9
CN1900900000000,19,009,Audubon County, IA,Feb-18,3025,2917,108,3.6
CN1900900000000,19,009,Audubon County, IA,Mar-18,2967,2873,94,3.2
CN1900900000000,19,009,Audubon County, IA,Apr-18(p),2981,2896,85,2.9
CN1802900000000,18,029,Dearborn County, IN,Mar-17,25464,24448,1016,4.0
CN1802900000000,18,029,Dearborn County, IN,Apr-17,25597,24773,824,3.2
CN1802900000000,18,029,Dearborn County, IN,May-17,25747,24875,872,3.4
CN1802900000000,18,029,Dearborn County, IN,Jun-17,26067,25111,956,3.7
CN1802900000000,18,029,Dearborn County, IN,Jul-17,26193,25183,1010,3.9
CN1802900000000,18,029,Dearborn County, IN,Aug-17,25784,24704,1080,4.2
CN1802900000000,18,029,Dearborn County, IN,Sep-17,25570,24617,953,3.7
CN1802900000000,18,029,Dearborn County, IN,Oct-17,25428,24539,889,3.5
CN1802900000000,18,029,Dearborn County, IN,Nov-17,25294,24399,895,3.5
CN1802900000000,18,029,Dearborn County, IN,Dec-17,25065,24192,873,3.5
CN1802900000000,18,029,Dearborn County, IN,Jan-18,25036,24014,1022,4.1
CN1802900000000,18,029,Dearborn County, IN,Feb-18,25466,24414,1052,4.1
CN1802900000000,18,029,Dearborn County, IN,Mar-18,25665,24725,940,3.7
CN1802900000000,18,029,Dearborn County, IN,Apr-18(p),25847,25005,842,3.3
CN3104100000000,31,041,Custer County, NE,Mar-17,6232,6097,135,2.2
CN3104100000000,31,041,Custer County, NE,Apr-17,6372,6245,127,2.0
CN3104100000000,31,041,Custer County, NE,May-17,6533,6402,131,2.0
CN3104100000000,31,041,Custer County, NE,Jun-17,6777,6628,149,2.2
CN3104100000000,31,041,Custer County, NE,Jul-17,6571,6421,150,2.3
CN3104100000000,31,041,Custer County, NE,Aug-17,6397,6252,145,2.3
CN3104100000000,31,041,Custer County, NE,Sep-17,6162,6038,124,2.0
CN3104100000000,31,041,Custer County, NE,Oct-17,6201,6074,127,2.0
CN3104100000000,31,041,Custer County, NE,Nov-17,6234,6120,114,1.8
CN3104100000000,31,041,Custer County, NE,Dec-17,6232,6105,127,2.0
CN3104100000000,31,041,Custer County, NE,Jan-18,6354,6212,142,2.2
CN3104100000000,31,041,Custer County, NE,Feb-18,6228,6108,120,1.9
CN3104100000000,31,041,Custer County, NE,Mar-18,6394,6258,136,2.1
CN3104100000000,31,041,Custer County, NE,Apr-18(p),6404,6260,144,2.2
CN2502500000000,25,025,Suffolk County, MA,Mar-17,433144,418453,14691,3.4
CN2502500000000,25,025,Suffolk County, MA,Apr-17,432587,418943,13644,3.2
CN2502500000000,25,025,Suffolk County, MA,May-17,431585,416435,15150,3.5
CN2502500000000,25,025,Suffolk County, MA,Jun-17,438085,420795,17290,3.9
CN2502500000000,25,025,Suffolk County, MA,Jul-17,438813,421689,17124,3.9
CN2502500000000,25,025,Suffolk County, MA,Aug-17,436179,420665,15514,3.6
CN2502500000000,25,025,Suffolk County, MA,Sep-17,430729,416209,14520,3.4
CN2502500000000,25,025,Suffolk County, MA,Oct-17,431488,418898,12590,2.9
CN2502500000000,25,025,Suffolk County, MA,Nov-17,432351,420107,12244,2.8
CN2502500000000,25,025,Suffolk County, MA,Dec-17,431120,419250,11870,2.8
CN2502500000000,25,025,Suffolk County, MA,Jan-18,432516,417903,14613,3.4
CN2502500000000,25,025,Suffolk County, MA,Feb-18,438304,423656,14648,3.3
CN2502500000000,25,025,Suffolk County, MA,Mar-18,441494,427306,14188,3.2
CN2502500000000,25,025,Suffolk County, MA,Apr-18(p),445285,432720,12565,2.8
CN2600500000000,26,005,Allegan County, MI,Mar-17,60801,58382,2419,4.0
CN2600500000000,26,005,Allegan County, MI,Apr-17,60541,58615,1926,3.2
CN2600500000000,26,005,Allegan County, MI,May-17,61315,59270,2045,3.3
CN2600500000000,26,005,Allegan County, MI,Jun-17,62355,60089,2266,3.6
CN2600500000000,26,005,Allegan County, MI,Jul-17,62402,59650,2752,4.4
CN2600500000000,26,005,Allegan County, MI,Aug-17,62010,59517,2493,4.0
CN2600500000000,26,005,Allegan County, MI,Sep-17,61520,59332,2188,3.6
CN2600500000000,26,005,Allegan County, MI,Oct-17,61356,59366,1990,3.2
CN2600500000000,26,005,Allegan County, MI,Nov-17,61169,59089,2080,3.4
CN2600500000000,26,005,Allegan County, MI,Dec-17,61142,58749,2393,3.9
CN2600500000000,26,005,Allegan County, MI,Jan-18,60752,57898,2854,4.7
CN2600500000000,26,005,Allegan County, MI,Feb-18,61593,58645,2948,4.8
CN2600500000000,26,005,Allegan County, MI,Mar-18,61437,58934,2503,4.1
CN2600500000000,26,005,Allegan County, MI,Apr-18(p),61310,59255,2055,3.4
CN4505700000000,45,057,Lancaster County, SC,Mar-17,38710,37042,1668,4.3
CN4505700000000,45,057,Lancaster County, SC,Apr-17,38758,37191,1567,4.0
CN4505700000000,45,057,Lancaster County, SC,May-17,38963,37360,1603,4.1
CN4505700000000,45,057,Lancaster County, SC,Jun-17,39416,37517,1899,4.8
CN4505700000000,45,057,Lancaster County, SC,Jul-17,39182,37273,1909,4.9
CN4505700000000,45,057,Lancaster County, SC,Aug-17,39439,37387,2052,5.2
CN4505700000000,45,057,Lancaster County, SC,Sep-17,39464,37609,1855,4.7
CN4505700000000,45,057,Lancaster County, SC,Oct-17,39632,37821,1811,4.6
CN4505700000000,45,057,Lancaster County, SC,Nov-17,39356,37584,1772,4.5
CN4505700000000,45,057,Lancaster County, SC,Dec-17,39445,37610,1835,4.7
CN4505700000000,45,057,Lancaster County, SC,Jan-18,39477,37330,2147,5.4
CN4505700000000,45,057,Lancaster County, SC,Feb-18,39522,37521,2001,5.1
CN4505700000000,45,057,Lancaster County, SC,Mar-18,39471,37723,1748,4.4
CN4505700000000,45,057,Lancaster County, SC,Apr-18(p),38968,37765,1203,3.1
CN5107300000000,51,073,Gloucester County, VA,Mar-17,19244,18575,669,3.5
CN5107300000000,51,073,Gloucester County, VA,Apr-17,19379,18780,599,3.1
CN5107300000000,51,073,Gloucester County, VA,May-17,19388,18746,642,3.3
CN5107300000000,51,073,Gloucester County, VA,Jun-17,19608,18949,659,3.4
CN5107300000000,51,073,Gloucester County, VA,Jul-17,19733,19071,662,3.4
CN5107300000000,51,073,Gloucester County, VA,Aug-17,19478,18821,657,3.4
CN5107300000000,51,073,Gloucester County, VA,Sep-17,19413,18803,610,3.1
CN5107300000000,51,073,Gloucester County, VA,Oct-17,19206,18616,590,3.1
CN5107300000000,51,073,Gloucester County, VA,Nov-17,19098,18500,598,3.1
CN5107300000000,51,073,Gloucester County, VA,Dec-17,19033,18467,566,3.0
CN5107300000000,51,073,Gloucester County, VA,Jan-18,18921,18278,643,3.4
CN5107300000000,51,073,Gloucester County, VA,Feb-18,19183,18604,579,3.0
CN5107300000000,51,073,Gloucester County, VA,Mar-18,19284,18703,581,3.0
CN5107300000000,51,073,Gloucester County, VA,Apr-18(p),19375,18886,489,2.5
CN1312700000000,13,127,Glynn County, GA,Mar-17,39784,37918,1866,4.7
CN1312700000000,13,127,Glynn County, GA,Apr-17,39908,38215,1693,4.2
CN1312700000000,13,127,Glynn County, GA,May-17,40100,38348,1752,4.4
CN1312700000000,13,127,Glynn County, GA,Jun-17,40447,38578,1869,4.6
CN1312700000000,13,127,Glynn County, GA,Jul-17,40788,38897,1891,4.6
CN1312700000000,13,127,Glynn County, GA,Aug-17,40136,38258,1878,4.7
CN1312700000000,13,127,Glynn County, GA,Sep-17,39821,37303,2518,6.3
CN1312700000000,13,127,Glynn County, GA,Oct-17,39499,37716,1783,4.5
CN1312700000000,13,127,Glynn County, GA,Nov-17,39305,37675,1630,4.1
CN1312700000000,13,127,Glynn County, GA,Dec-17,39446,37803,1643,4.2
CN1312700000000,13,127,Glynn County, GA,Jan-18,39565,37849,1716,4.3
CN1312700000000,13,127,Glynn County, GA,Feb-18,39984,38259,1725,4.3
CN1312700000000,13,127,Glynn County, GA,Mar-18,40213,38644,1569,3.9
CN1312700000000,13,127,Glynn County, GA,Apr-18(p),40318,38965,1353,3.4
CN5110300000000,51,103,Lancaster County, VA,Mar-17,5140,4773,367,7.1
CN5110300000000,51,103,Lancaster County, VA,Apr-17,5120,4826,294,5.7
CN5110300000000,51,103,Lancaster County, VA,May-17,5244,4967,277,5.3
CN5110300000000,51,103,Lancaster County, VA,Jun-17,5295,5065,230,4.3
CN5110300000000,51,103,Lancaster County, VA,Jul-17,5294,5065,229,4.3
CN5110300000000,51,103,Lancaster County, VA,Aug-17,5187,4962,225,4.3
CN5110300000000,51,103,Lancaster County, VA,Sep-17,5099,4902,197,3.9
CN5110300000000,51,103,Lancaster County, VA,Oct-17,5082,4889,193,3.8
CN5110300000000,51,103,Lancaster County, VA,Nov-17,5060,4862,198,3.9
CN5110300000000,51,103,Lancaster County, VA,Dec-17,5096,4859,237,4.7
CN5110300000000,51,103,Lancaster County, VA,Jan-18,5064,4669,395,7.8
CN5110300000000,51,103,Lancaster County, VA,Feb-18,5052,4657,395,7.8
CN5110300000000,51,103,Lancaster County, VA,Mar-18,5111,4797,314,6.1
CN5110300000000,51,103,Lancaster County, VA,Apr-18(p),5165,4906,259,5.0
CN7208500000000,72,085,Las Piedras Municipio, PR,Mar-17,11303,9970,1333,11.8
CN7208500000000,72,085,Las Piedras Municipio, PR,Apr-17,11258,9872,1386,12.3
CN7208500000000,72,085,Las Piedras Municipio, PR,May-17,11100,9841,1259,11.3
CN7208500000000,72,085,Las Piedras Municipio, PR,Jun-17,10960,9794,1166,10.6
CN7208500000000,72,085,Las Piedras Municipio, PR,Jul-17,11075,9778,1297,11.7
CN7208500000000,72,085,Las Piedras Municipio, PR,Aug-17,11136,9647,1489,13.4
CN7208500000000,72,085,Las Piedras Municipio, PR,Sep-17(y),11102,9736,1366,12.3
CN7208500000000,72,085,Las Piedras Municipio, PR,Oct-17,10741,9325,1416,13.2
CN7208500000000,72,085,Las Piedras Municipio, PR,Nov-17,11184,9885,1299,11.6
CN7208500000000,72,085,Las Piedras Municipio, PR,Dec-17,11175,9959,1216,10.9
CN7208500000000,72,085,Las Piedras Municipio, PR,Jan-18,11047,9778,1269,11.5
CN7208500000000,72,085,Las Piedras Municipio, PR,Feb-18,10933,9781,1152,10.5
CN7208500000000,72,085,Las Piedras Municipio, PR,Mar-18,10913,9797,1116,10.2
CN7208500000000,72,085,Las Piedras Municipio, PR,Apr-18(p),10939,9867,1072,9.8
CN1918300000000,19,183,Washington County, IA,Mar-17,12344,11935,409,3.3
CN1918300000000,19,183,Washington County, IA,Apr-17,12388,12033,355,2.9
CN1918300000000,19,183,Washington County, IA,May-17,12251,11920,331,2.7
CN1918300000000,19,183,Washington County, IA,Jun-17,12260,11896,364,3.0
CN1918300000000,19,183,Washington County, IA,Jul-17,12467,12112,355,2.8
CN1918300000000,19,183,Washington County, IA,Aug-17,12481,12115,366,2.9
CN1918300000000,19,183,Washington County, IA,Sep-17,12395,12091,304,2.5
CN1918300000000,19,183,Washington County, IA,Oct-17,12390,12131,259,2.1
CN1918300000000,19,183,Washington County, IA,Nov-17,12320,12066,254,2.1
CN1918300000000,19,183,Washington County, IA,Dec-17,12242,11939,303,2.5
CN1918300000000,19,183,Washington County, IA,Jan-18,12222,11777,445,3.6
CN1918300000000,19,183,Washington County, IA,Feb-18,12462,12016,446,3.6
CN1918300000000,19,183,Washington County, IA,Mar-18,12278,11949,329,2.7
CN1918300000000,19,183,Washington County, IA,Apr-18(p),12249,11974,275,2.2
CN2915100000000,29,151,Osage County, MO,Mar-17,7190,6979,211,2.9
CN2915100000000,29,151,Osage County, MO,Apr-17,7295,7096,199,2.7
CN2915100000000,29,151,Osage County, MO,May-17,7233,7017,216,3.0
CN2915100000000,29,151,Osage County, MO,Jun-17,7208,6966,242,3.4
CN2915100000000,29,151,Osage County, MO,Jul-17,7228,6972,256,3.5
CN2915100000000,29,151,Osage County, MO,Aug-17,7115,6848,267,3.8
CN2915100000000,29,151,Osage County, MO,Sep-17,7029,6852,177,2.5
CN2915100000000,29,151,Osage County, MO,Oct-17,7063,6929,134,1.9
CN2915100000000,29,151,Osage County, MO,Nov-17,7053,6881,172,2.4
CN2915100000000,29,151,Osage County, MO,Dec-17,6949,6780,169,2.4
CN2915100000000,29,151,Osage County, MO,Jan-18,6975,6755,220,3.2
CN2915100000000,29,151,Osage County, MO,Feb-18,7040,6832,208,3.0
CN2915100000000,29,151,Osage County, MO,Mar-18,7077,6870,207,2.9
CN2915100000000,29,151,Osage County, MO,Apr-18(p),7150,6969,181,2.5
CN5502500000000,55,025,Dane County, WI,Mar-17,320391,312515,7876,2.5
CN5502500000000,55,025,Dane County, WI,Apr-17,320225,313295,6930,2.2
CN5502500000000,55,025,Dane County, WI,May-17,319954,312348,7606,2.4
CN5502500000000,55,025,Dane County, WI,Jun-17,324193,315177,9016,2.8
CN5502500000000,55,025,Dane County, WI,Jul-17,326568,318317,8251,2.5
CN5502500000000,55,025,Dane County, WI,Aug-17,323775,316070,7705,2.4
CN5502500000000,55,025,Dane County, WI,Sep-17,324359,316999,7360,2.3
CN5502500000000,55,025,Dane County, WI,Oct-17,325343,318369,6974,2.1
CN5502500000000,55,025,Dane County, WI,Nov-17,325375,318522,6853,2.1
CN5502500000000,55,025,Dane County, WI,Dec-17,322346,316199,6147,1.9
CN5502500000000,55,025,Dane County, WI,Jan-18,320030,313003,7027,2.2
CN5502500000000,55,025,Dane County, WI,Feb-18,326015,318554,7461,2.3
CN5502500000000,55,025,Dane County, WI,Mar-18,327539,320260,7279,2.2
CN5502500000000,55,025,Dane County, WI,Apr-18(p),325704,319691,6013,1.8
CN5600500000000,56,005,Campbell County, WY,Mar-17,23413,22086,1327,5.7
CN5600500000000,56,005,Campbell County, WY,Apr-17,23386,22232,1154,4.9
CN5600500000000,56,005,Campbell County, WY,May-17,23022,21922,1100,4.8
CN5600500000000,56,005,Campbell County, WY,Jun-17,22981,21820,1161,5.1
CN5600500000000,56,005,Campbell County, WY,Jul-17,23101,22039,1062,4.6
CN5600500000000,56,005,Campbell County, WY,Aug-17,22993,21979,1014,4.4
CN5600500000000,56,005,Campbell County, WY,Sep-17,22741,21765,976,4.3
CN5600500000000,56,005,Campbell County, WY,Oct-17,22781,21856,925,4.1
CN5600500000000,56,005,Campbell County, WY,Nov-17,22995,22045,950,4.1
CN5600500000000,56,005,Campbell County, WY,Dec-17,22782,21846,936,4.1
CN5600500000000,56,005,Campbell County, WY,Jan-18,22558,21517,1041,4.6
CN5600500000000,56,005,Campbell County, WY,Feb-18,22531,21560,971,4.3
CN5600500000000,56,005,Campbell County, WY,Mar-18,22642,21688,954,4.2
CN5600500000000,56,005,Campbell County, WY,Apr-18(p),22807,21918,889,3.9
CN4900900000000,49,009,Daggett County, UT,Mar-17,441,418,23,5.2
CN4900900000000,49,009,Daggett County, UT,Apr-17,463,443,20,4.3
CN4900900000000,49,009,Daggett County, UT,May-17,459,440,19,4.1
CN4900900000000,49,009,Daggett County, UT,Jun-17,512,495,17,3.3
CN4900900000000,49,009,Daggett County, UT,Jul-17,474,449,25,5.3
CN4900900000000,49,009,Daggett County, UT,Aug-17,480,455,25,5.2
CN4900900000000,49,009,Daggett County, UT,Sep-17,464,444,20,4.3
CN4900900000000,49,009,Daggett County, UT,Oct-17,449,426,23,5.1
CN4900900000000,49,009,Daggett County, UT,Nov-17,391,371,20,5.1
CN4900900000000,49,009,Daggett County, UT,Dec-17,392,366,26,6.6
CN4900900000000,49,009,Daggett County, UT,Jan-18,389,365,24,6.2
CN4900900000000,49,009,Daggett County, UT,Feb-18,374,351,23,6.1
CN4900900000000,49,009,Daggett County, UT,Mar-18,417,396,21,5.0
CN4900900000000,49,009,Daggett County, UT,Apr-18(p),428,411,17,4.0
CN4717300000000,47,173,Union County, TN,Mar-17,7332,6984,348,4.7
CN4717300000000,47,173,Union County, TN,Apr-17,7330,7048,282,3.8
CN4717300000000,47,173,Union County, TN,May-17,7327,7066,261,3.6
CN4717300000000,47,173,Union County, TN,Jun-17,7424,7056,368,5.0
CN4717300000000,47,173,Union County, TN,Jul-17,7458,7090,368,4.9
CN4717300000000,47,173,Union County, TN,Aug-17,7346,7036,310,4.2
CN4717300000000,47,173,Union County, TN,Sep-17,7398,7130,268,3.6
CN4717300000000,47,173,Union County, TN,Oct-17,7374,7107,267,3.6
CN4717300000000,47,173,Union County, TN,Nov-17,7355,7090,265,3.6
CN4717300000000,47,173,Union County, TN,Dec-17,7318,7049,269,3.7
CN4717300000000,47,173,Union County, TN,Jan-18,7317,6991,326,4.5
CN4717300000000,47,173,Union County, TN,Feb-18,7421,7119,302,4.1
CN4717300000000,47,173,Union County, TN,Mar-18,7416,7121,295,4.0
CN4717300000000,47,173,Union County, TN,Apr-18(p),7412,7170,242,3.3
CN3709900000000,37,099,Jackson County, NC,Mar-17,18641,17652,989,5.3
CN3709900000000,37,099,Jackson County, NC,Apr-17,18872,18049,823,4.4
CN3709900000000,37,099,Jackson County, NC,May-17,19059,18190,869,4.6
CN3709900000000,37,099,Jackson County, NC,Jun-17,19279,18342,937,4.9
CN3709900000000,37,099,Jackson County, NC,Jul-17,19384,18400,984,5.1
CN3709900000000,37,099,Jackson County, NC,Aug-17,19200,18222,978,5.1
CN3709900000000,37,099,Jackson County, NC,Sep-17,19701,18898,803,4.1
CN3709900000000,37,099,Jackson County, NC,Oct-17,19322,18533,789,4.1
CN3709900000000,37,099,Jackson County, NC,Nov-17,19053,18211,842,4.4
CN3709900000000,37,099,Jackson County, NC,Dec-17,18617,17766,851,4.6
CN3709900000000,37,099,Jackson County, NC,Jan-18,18280,17277,1003,5.5
CN3709900000000,37,099,Jackson County, NC,Feb-18,18781,17778,1003,5.3
CN3709900000000,37,099,Jackson County, NC,Mar-18,18923,17972,951,5.0
CN3709900000000,37,099,Jackson County, NC,Apr-18(p),19182,18410,772,4.0
CN1717300000000,17,173,Shelby County, IL,Mar-17,10230,9739,491,4.8
CN1717300000000,17,173,Shelby County, IL,Apr-17,10324,9932,392,3.8
CN1717300000000,17,173,Shelby County, IL,May-17,10368,9978,390,3.8
CN1717300000000,17,173,Shelby County, IL,Jun-17,10445,10010,435,4.2
CN1717300000000,17,173,Shelby County, IL,Jul-17,10418,9990,428,4.1
CN1717300000000,17,173,Shelby County, IL,Aug-17,10325,9887,438,4.2
CN1717300000000,17,173,Shelby County, IL,Sep-17,10194,9799,395,3.9
CN1717300000000,17,173,Shelby County, IL,Oct-17,10165,9786,379,3.7
CN1717300000000,17,173,Shelby County, IL,Nov-17,10121,9715,406,4.0
CN1717300000000,17,173,Shelby County, IL,Dec-17,9950,9531,419,4.2
CN1717300000000,17,173,Shelby County, IL,Jan-18,10006,9541,465,4.6
CN1717300000000,17,173,Shelby County, IL,Feb-18,10060,9643,417,4.1
CN1717300000000,17,173,Shelby County, IL,Mar-18,10300,9867,433,4.2
CN1717300000000,17,173,Shelby County, IL,Apr-18(p),10426,10071,355,3.4
CN2812100000000,28,121,Rankin County, MS,Mar-17,75536,72880,2656,3.5
CN2812100000000,28,121,Rankin County, MS,Apr-17,75467,73017,2450,3.2
CN2812100000000,28,121,Rankin County, MS,May-17,75672,72689,2983,3.9
CN2812100000000,28,121,Rankin County, MS,Jun-17,76183,72957,3226,4.2
CN2812100000000,28,121,Rankin County, MS,Jul-17,76181,73186,2995,3.9
CN2812100000000,28,121,Rankin County, MS,Aug-17,74842,72257,2585,3.5
CN2812100000000,28,121,Rankin County, MS,Sep-17,75267,72716,2551,3.4
CN2812100000000,28,121,Rankin County, MS,Oct-17,75795,73353,2442,3.2
CN2812100000000,28,121,Rankin County, MS,Nov-17,76186,73795,2391,3.1
CN2812100000000,28,121,Rankin County, MS,Dec-17,76212,73860,2352,3.1
CN2812100000000,28,121,Rankin County, MS,Jan-18,75366,72986,2380,3.2
CN2812100000000,28,121,Rankin County, MS,Feb-18,75832,73456,2376,3.1
CN2812100000000,28,121,Rankin County, MS,Mar-18,75794,73513,2281,3.0
CN2812100000000,28,121,Rankin County, MS,Apr-18(p),75978,73634,2344,3.1
CN3001100000000,30,011,Carter County, MT,Mar-17,673,652,21,3.1
CN3001100000000,30,011,Carter County, MT,Apr-17,706,688,18,2.5
CN3001100000000,30,011,Carter County, MT,May-17,730,717,13,1.8
CN3001100000000,30,011,Carter County, MT,Jun-17,681,664,17,2.5
CN3001100000000,30,011,Carter County, MT,Jul-17,717,698,19,2.6
CN3001100000000,30,011,Carter County, MT,Aug-17,717,700,17,2.4
CN3001100000000,30,011,Carter County, MT,Sep-17,671,655,16,2.4
CN3001100000000,30,011,Carter County, MT,Oct-17,698,682,16,2.3
CN3001100000000,30,011,Carter County, MT,Nov-17,710,695,15,2.1
CN3001100000000,30,011,Carter County, MT,Dec-17,682,663,19,2.8
CN3001100000000,30,011,Carter County, MT,Jan-18,683,657,26,3.8
CN3001100000000,30,011,Carter County, MT,Feb-18,679,652,27,4.0
CN3001100000000,30,011,Carter County, MT,Mar-18,655,630,25,3.8
CN3001100000000,30,011,Carter County, MT,Apr-18(p),654,634,20,3.1
CN2907100000000,29,071,Franklin County, MO,Mar-17,52206,50052,2154,4.1
CN2907100000000,29,071,Franklin County, MO,Apr-17,52595,50466,2129,4.0
CN2907100000000,29,071,Franklin County, MO,May-17,52438,50509,1929,3.7
CN2907100000000,29,071,Franklin County, MO,Jun-17,52828,50956,1872,3.5
CN2907100000000,29,071,Franklin County, MO,Jul-17,53142,51157,1985,3.7
CN2907100000000,29,071,Franklin County, MO,Aug-17,52405,50443,1962,3.7
CN2907100000000,29,071,Franklin County, MO,Sep-17,52108,50553,1555,3.0
CN2907100000000,29,071,Franklin County, MO,Oct-17,51729,50478,1251,2.4
CN2907100000000,29,071,Franklin County, MO,Nov-17,52005,50357,1648,3.2
CN2907100000000,29,071,Franklin County, MO,Dec-17,51567,50003,1564,3.0
CN2907100000000,29,071,Franklin County, MO,Jan-18,51210,49174,2036,4.0
CN2907100000000,29,071,Franklin County, MO,Feb-18,52223,49964,2259,4.3
CN2907100000000,29,071,Franklin County, MO,Mar-18,52118,50057,2061,4.0
CN2907100000000,29,071,Franklin County, MO,Apr-18(p),52192,50470,1722,3.3
CN1304700000000,13,047,Catoosa County, GA,Mar-17,33004,31566,1438,4.4
CN1304700000000,13,047,Catoosa County, GA,Apr-17,32950,31658,1292,3.9
CN1304700000000,13,047,Catoosa County, GA,May-17,32897,31583,1314,4.0
CN1304700000000,13,047,Catoosa County, GA,Jun-17,33127,31644,1483,4.5
CN1304700000000,13,047,Catoosa County, GA,Jul-17,33237,31733,1504,4.5
CN1304700000000,13,047,Catoosa County, GA,Aug-17,32943,31554,1389,4.2
CN1304700000000,13,047,Catoosa County, GA,Sep-17,33561,32276,1285,3.8
CN1304700000000,13,047,Catoosa County, GA,Oct-17,33418,32147,1271,3.8
CN1304700000000,13,047,Catoosa County, GA,Nov-17,33505,32307,1198,3.6
CN1304700000000,13,047,Catoosa County, GA,Dec-17,33408,32203,1205,3.6
CN1304700000000,13,047,Catoosa County, GA,Jan-18,33494,32185,1309,3.9
CN1304700000000,13,047,Catoosa County, GA,Feb-18,34042,32711,1331,3.9
CN1304700000000,13,047,Catoosa County, GA,Mar-18,34073,32884,1189,3.5
CN1304700000000,13,047,Catoosa County, GA,Apr-18(p),34096,33055,1041,3.1
CN4601900000000,46,019,Butte County, SD,Mar-17,5012,4811,201,4.0
CN4601900000000,46,019,Butte County, SD,Apr-17,5010,4816,194,3.9
CN4601900000000,46,019,Butte County, SD,May-17,5019,4837,182,3.6
CN4601900000000,46,019,Butte County, SD,Jun-17,5130,4957,173,3.4
CN4601900000000,46,019,Butte County, SD,Jul-17,5111,4945,166,3.2
CN4601900000000,46,019,Butte County, SD,Aug-17,5059,4877,182,3.6
CN4601900000000,46,019,Butte County, SD,Sep-17,5013,4848,165,3.3
CN4601900000000,46,019,Butte County, SD,Oct-17,5017,4857,160,3.2
CN4601900000000,46,019,Butte County, SD,Nov-17,4993,4823,170,3.4
CN4601900000000,46,019,Butte County, SD,Dec-17,4980,4790,190,3.8
CN4601900000000,46,019,Butte County, SD,Jan-18,4988,4769,219,4.4
CN4601900000000,46,019,Butte County, SD,Feb-18,5048,4810,238,4.7
CN4601900000000,46,019,Butte County, SD,Mar-18,5059,4862,197,3.9
CN4601900000000,46,019,Butte County, SD,Apr-18(p),5057,4855,202,4.0
CN4206700000000,42,067,Juniata County, PA,Mar-17,12360,11664,696,5.6
CN4206700000000,42,067,Juniata County, PA,Apr-17,12395,11879,516,4.2
CN4206700000000,42,067,Juniata County, PA,May-17,12483,11969,514,4.1
CN4206700000000,42,067,Juniata County, PA,Jun-17,12766,12230,536,4.2
CN4206700000000,42,067,Juniata County, PA,Jul-17,12857,12288,569,4.4
CN4206700000000,42,067,Juniata County, PA,Aug-17,12665,12101,564,4.5
CN4206700000000,42,067,Juniata County, PA,Sep-17,12438,11998,440,3.5
CN4206700000000,42,067,Juniata County, PA,Oct-17,12190,11740,450,3.7
CN4206700000000,42,067,Juniata County, PA,Nov-17,12066,11570,496,4.1
CN4206700000000,42,067,Juniata County, PA,Dec-17,12170,11618,552,4.5
CN4206700000000,42,067,Juniata County, PA,Jan-18,12377,11606,771,6.2
CN4206700000000,42,067,Juniata County, PA,Feb-18,12345,11648,697,5.6
CN4206700000000,42,067,Juniata County, PA,Mar-18,12197,11604,593,4.9
CN4206700000000,42,067,Juniata County, PA,Apr-18(p),12157,11716,441,3.6
CN1206700000000,12,067,Lafayette County, FL,Mar-17,2972,2862,110,3.7
CN1206700000000,12,067,Lafayette County, FL,Apr-17,2986,2883,103,3.4
CN1206700000000,12,067,Lafayette County, FL,May-17,3024,2918,106,3.5
CN1206700000000,12,067,Lafayette County, FL,Jun-17,2963,2842,121,4.1
CN1206700000000,12,067,Lafayette County, FL,Jul-17,2922,2805,117,4.0
CN1206700000000,12,067,Lafayette County, FL,Aug-17,2975,2862,113,3.8
CN1206700000000,12,067,Lafayette County, FL,Sep-17,3025,2920,105,3.5
CN1206700000000,12,067,Lafayette County, FL,Oct-17,2939,2835,104,3.5
CN1206700000000,12,067,Lafayette County, FL,Nov-17,2920,2814,106,3.6
CN1206700000000,12,067,Lafayette County, FL,Dec-17,2874,2783,91,3.2
CN1206700000000,12,067,Lafayette County, FL,Jan-18,2908,2800,108,3.7
CN1206700000000,12,067,Lafayette County, FL,Feb-18,2928,2830,98,3.3
CN1206700000000,12,067,Lafayette County, FL,Mar-18,2952,2856,96,3.3
CN1206700000000,12,067,Lafayette County, FL,Apr-18(p),2930,2839,91,3.1
CN1601900000000,16,019,Bonneville County, ID,Mar-17,52432,50847,1585,3.0
CN1601900000000,16,019,Bonneville County, ID,Apr-17,52802,51488,1314,2.5
CN1601900000000,16,019,Bonneville County, ID,May-17,53498,52250,1248,2.3
CN1601900000000,16,019,Bonneville County, ID,Jun-17,54435,53109,1326,2.4
CN1601900000000,16,019,Bonneville County, ID,Jul-17,54230,52862,1368,2.5
CN1601900000000,16,019,Bonneville County, ID,Aug-17,53827,52486,1341,2.5
CN1601900000000,16,019,Bonneville County, ID,Sep-17,53311,51991,1320,2.5
CN1601900000000,16,019,Bonneville County, ID,Oct-17,53864,52613,1251,2.3
CN1601900000000,16,019,Bonneville County, ID,Nov-17,54247,52837,1410,2.6
CN1601900000000,16,019,Bonneville County, ID,Dec-17,54193,52922,1271,2.3
CN1601900000000,16,019,Bonneville County, ID,Jan-18,54602,52793,1809,3.3
CN1601900000000,16,019,Bonneville County, ID,Feb-18,54733,53126,1607,2.9
CN1601900000000,16,019,Bonneville County, ID,Mar-18,54539,53053,1486,2.7
CN1601900000000,16,019,Bonneville County, ID,Apr-18(p),54211,52912,1299,2.4
CN5001700000000,50,017,Orange County, VT,Mar-17,15890,15261,629,4.0
CN5001700000000,50,017,Orange County, VT,Apr-17,15665,15148,517,3.3
CN5001700000000,50,017,Orange County, VT,May-17,15818,15410,408,2.6
CN5001700000000,50,017,Orange County, VT,Jun-17,16187,15722,465,2.9
CN5001700000000,50,017,Orange County, VT,Jul-17,16121,15632,489,3.0
CN5001700000000,50,017,Orange County, VT,Aug-17,16254,15817,437,2.7
CN5001700000000,50,017,Orange County, VT,Sep-17,15939,15510,429,2.7
CN5001700000000,50,017,Orange County, VT,Oct-17,15924,15579,345,2.2
CN5001700000000,50,017,Orange County, VT,Nov-17,15941,15546,395,2.5
CN5001700000000,50,017,Orange County, VT,Dec-17,15833,15421,412,2.6
CN5001700000000,50,017,Orange County, VT,Jan-18,16001,15339,662,4.1
CN5001700000000,50,017,Orange County, VT,Feb-18,16066,15513,553,3.4
CN5001700000000,50,017,Orange County, VT,Mar-18,16147,15606,541,3.4
CN5001700000000,50,017,Orange County, VT,Apr-18(p),16006,15514,492,3.1
CN1323300000000,13,233,Polk County, GA,Mar-17,18413,17433,980,5.3
CN1323300000000,13,233,Polk County, GA,Apr-17,18431,17478,953,5.2
CN1323300000000,13,233,Polk County, GA,May-17,18460,17506,954,5.2
CN1323300000000,13,233,Polk County, GA,Jun-17,18479,17482,997,5.4
CN1323300000000,13,233,Polk County, GA,Jul-17,18639,17546,1093,5.9
CN1323300000000,13,233,Polk County, GA,Aug-17,18405,17442,963,5.2
CN1323300000000,13,233,Polk County, GA,Sep-17,18640,17745,895,4.8
CN1323300000000,13,233,Polk County, GA,Oct-17,18485,17596,889,4.8
CN1323300000000,13,233,Polk County, GA,Nov-17,18470,17624,846,4.6
CN1323300000000,13,233,Polk County, GA,Dec-17,18433,17575,858,4.7
CN1323300000000,13,233,Polk County, GA,Jan-18,18632,17734,898,4.8
CN1323300000000,13,233,Polk County, GA,Feb-18,18848,17916,932,4.9
CN1323300000000,13,233,Polk County, GA,Mar-18,18809,18004,805,4.3
CN1323300000000,13,233,Polk County, GA,Apr-18(p),18676,17946,730,3.9
CN5513100000000,55,131,Washington County, WI,Mar-17,77643,75327,2316,3.0
CN5513100000000,55,131,Washington County, WI,Apr-17,77210,75272,1938,2.5
CN5513100000000,55,131,Washington County, WI,May-17,77489,75469,2020,2.6
CN5513100000000,55,131,Washington County, WI,Jun-17,78475,76040,2435,3.1
CN5513100000000,55,131,Washington County, WI,Jul-17,78993,76667,2326,2.9
CN5513100000000,55,131,Washington County, WI,Aug-17,78700,76449,2251,2.9
CN5513100000000,55,131,Washington County, WI,Sep-17,78256,76244,2012,2.6
CN5513100000000,55,131,Washington County, WI,Oct-17,77821,75927,1894,2.4
CN5513100000000,55,131,Washington County, WI,Nov-17,77754,75900,1854,2.4
CN5513100000000,55,131,Washington County, WI,Dec-17,77188,75493,1695,2.2
CN5513100000000,55,131,Washington County, WI,Jan-18,77502,75493,2009,2.6
CN5513100000000,55,131,Washington County, WI,Feb-18,78609,76456,2153,2.7
CN5513100000000,55,131,Washington County, WI,Mar-18,78899,76833,2066,2.6
CN5513100000000,55,131,Washington County, WI,Apr-18(p),78401,76736,1665,2.1
CN3502800000000,35,028,Los Alamos County, NM,Mar-17,8924,8591,333,3.7
CN3502800000000,35,028,Los Alamos County, NM,Apr-17,8873,8579,294,3.3
CN3502800000000,35,028,Los Alamos County, NM,May-17,8880,8568,312,3.5
CN3502800000000,35,028,Los Alamos County, NM,Jun-17,9122,8744,378,4.1
CN3502800000000,35,028,Los Alamos County, NM,Jul-17,9339,8940,399,4.3
CN3502800000000,35,028,Los Alamos County, NM,Aug-17,9229,8876,353,3.8
CN3502800000000,35,028,Los Alamos County, NM,Sep-17,9257,8917,340,3.7
CN3502800000000,35,028,Los Alamos County, NM,Oct-17,9005,8675,330,3.7
CN3502800000000,35,028,Los Alamos County, NM,Nov-17,9083,8751,332,3.7
CN3502800000000,35,028,Los Alamos County, NM,Dec-17,9109,8799,310,3.4
CN3502800000000,35,028,Los Alamos County, NM,Jan-18,9228,8910,318,3.4
CN3502800000000,35,028,Los Alamos County, NM,Feb-18,9157,8845,312,3.4
CN3502800000000,35,028,Los Alamos County, NM,Mar-18,9127,8828,299,3.3
CN3502800000000,35,028,Los Alamos County, NM,Apr-18(p),9171,8916,255,2.8
CN2801500000000,28,015,Carroll County, MS,Mar-17,3619,3419,200,5.5
CN2801500000000,28,015,Carroll County, MS,Apr-17,3636,3453,183,5.0
CN2801500000000,28,015,Carroll County, MS,May-17,3678,3453,225,6.1
CN2801500000000,28,015,Carroll County, MS,Jun-17,3690,3451,239,6.5
CN2801500000000,28,015,Carroll County, MS,Jul-17,3646,3424,222,6.1
CN2801500000000,28,015,Carroll County, MS,Aug-17,3578,3385,193,5.4
CN2801500000000,28,015,Carroll County, MS,Sep-17,3613,3422,191,5.3
CN2801500000000,28,015,Carroll County, MS,Oct-17,3576,3387,189,5.3
CN2801500000000,28,015,Carroll County, MS,Nov-17,3545,3348,197,5.6
CN2801500000000,28,015,Carroll County, MS,Dec-17,3518,3323,195,5.5
CN2801500000000,28,015,Carroll County, MS,Jan-18,3468,3264,204,5.9
CN2801500000000,28,015,Carroll County, MS,Feb-18,3505,3303,202,5.8
CN2801500000000,28,015,Carroll County, MS,Mar-18,3539,3355,184,5.2
CN2801500000000,28,015,Carroll County, MS,Apr-18(p),3559,3373,186,5.2
CN1907700000000,19,077,Guthrie County, IA,Mar-17,5516,5300,216,3.9
CN1907700000000,19,077,Guthrie County, IA,Apr-17,5570,5384,186,3.3
CN1907700000000,19,077,Guthrie County, IA,May-17,5609,5429,180,3.2
CN1907700000000,19,077,Guthrie County, IA,Jun-17,5687,5491,196,3.4
CN1907700000000,19,077,Guthrie County, IA,Jul-17,5792,5621,171,3.0
CN1907700000000,19,077,Guthrie County, IA,Aug-17,5689,5522,167,2.9
CN1907700000000,19,077,Guthrie County, IA,Sep-17,5554,5404,150,2.7
CN1907700000000,19,077,Guthrie County, IA,Oct-17,5582,5460,122,2.2
CN1907700000000,19,077,Guthrie County, IA,Nov-17,5544,5416,128,2.3
CN1907700000000,19,077,Guthrie County, IA,Dec-17,5547,5400,147,2.7
CN1907700000000,19,077,Guthrie County, IA,Jan-18,5514,5282,232,4.2
CN1907700000000,19,077,Guthrie County, IA,Feb-18,5559,5332,227,4.1
CN1907700000000,19,077,Guthrie County, IA,Mar-18,5464,5266,198,3.6
CN1907700000000,19,077,Guthrie County, IA,Apr-18(p),5457,5318,139,2.5
CN2001700000000,20,017,Chase County, KS,Mar-17,1385,1344,41,3.0
CN2001700000000,20,017,Chase County, KS,Apr-17,1381,1346,35,2.5
CN2001700000000,20,017,Chase County, KS,May-17,1382,1346,36,2.6
CN2001700000000,20,017,Chase County, KS,Jun-17,1486,1446,40,2.7
CN2001700000000,20,017,Chase County, KS,Jul-17,1465,1425,40,2.7
CN2001700000000,20,017,Chase County, KS,Aug-17,1401,1364,37,2.6
CN2001700000000,20,017,Chase County, KS,Sep-17,1402,1372,30,2.1
CN2001700000000,20,017,Chase County, KS,Oct-17,1399,1371,28,2.0
CN2001700000000,20,017,Chase County, KS,Nov-17,1383,1351,32,2.3
CN2001700000000,20,017,Chase County, KS,Dec-17,1368,1336,32,2.3
CN2001700000000,20,017,Chase County, KS,Jan-18,1410,1365,45,3.2
CN2001700000000,20,017,Chase County, KS,Feb-18,1409,1368,41,2.9
CN2001700000000,20,017,Chase County, KS,Mar-18,1447,1406,41,2.8
CN2001700000000,20,017,Chase County, KS,Apr-18(p),1452,1412,40,2.8
CN2904500000000,29,045,Clark County, MO,Mar-17,3217,3013,204,6.3
CN2904500000000,29,045,Clark County, MO,Apr-17,3286,3117,169,5.1
CN2904500000000,29,045,Clark County, MO,May-17,3229,3046,183,5.7
CN2904500000000,29,045,Clark County, MO,Jun-17,3223,3037,186,5.8
CN2904500000000,29,045,Clark County, MO,Jul-17,3044,2847,197,6.5
CN2904500000000,29,045,Clark County, MO,Aug-17,3140,2950,190,6.1
CN2904500000000,29,045,Clark County, MO,Sep-17,3063,2921,142,4.6
CN2904500000000,29,045,Clark County, MO,Oct-17,3103,2988,115,3.7
CN2904500000000,29,045,Clark County, MO,Nov-17,3098,2963,135,4.4
CN2904500000000,29,045,Clark County, MO,Dec-17,3060,2902,158,5.2
CN2904500000000,29,045,Clark County, MO,Jan-18,3050,2891,159,5.2
CN2904500000000,29,045,Clark County, MO,Feb-18,3118,2950,168,5.4
CN2904500000000,29,045,Clark County, MO,Mar-18,3117,2960,157,5.0
CN2904500000000,29,045,Clark County, MO,Apr-18(p),3141,3014,127,4.0
CN5406300000000,54,063,Monroe County, WV,Mar-17,6041,5723,318,5.3
CN5406300000000,54,063,Monroe County, WV,Apr-17,6124,5896,228,3.7
CN5406300000000,54,063,Monroe County, WV,May-17,6037,5819,218,3.6
CN5406300000000,54,063,Monroe County, WV,Jun-17,6122,5879,243,4.0
CN5406300000000,54,063,Monroe County, WV,Jul-17,6011,5770,241,4.0
CN5406300000000,54,063,Monroe County, WV,Aug-17,6052,5788,264,4.4
CN5406300000000,54,063,Monroe County, WV,Sep-17,6117,5885,232,3.8
CN5406300000000,54,063,Monroe County, WV,Oct-17,6073,5850,223,3.7
CN5406300000000,54,063,Monroe County, WV,Nov-17,5932,5688,244,4.1
CN5406300000000,54,063,Monroe County, WV,Dec-17,5759,5512,247,4.3
CN5406300000000,54,063,Monroe County, WV,Jan-18,5923,5609,314,5.3
CN5406300000000,54,063,Monroe County, WV,Feb-18,6097,5760,337,5.5
CN5406300000000,54,063,Monroe County, WV,Mar-18,6022,5701,321,5.3
CN5406300000000,54,063,Monroe County, WV,Apr-18(p),6100,5817,283,4.6
CN3604100000000,36,041,Hamilton County, NY,Mar-17,2167,1936,231,10.7
CN3604100000000,36,041,Hamilton County, NY,Apr-17,2167,1931,236,10.9
CN3604100000000,36,041,Hamilton County, NY,May-17,2271,2113,158,7.0
CN3604100000000,36,041,Hamilton County, NY,Jun-17,2473,2353,120,4.9
CN3604100000000,36,041,Hamilton County, NY,Jul-17,2682,2574,108,4.0
CN3604100000000,36,041,Hamilton County, NY,Aug-17,2701,2595,106,3.9
CN3604100000000,36,041,Hamilton County, NY,Sep-17,2379,2270,109,4.6
CN3604100000000,36,041,Hamilton County, NY,Oct-17,2282,2169,113,5.0
CN3604100000000,36,041,Hamilton County, NY,Nov-17,2193,1977,216,9.8
CN3604100000000,36,041,Hamilton County, NY,Dec-17,2209,1954,255,11.5
CN3604100000000,36,041,Hamilton County, NY,Jan-18,2225,1971,254,11.4
CN3604100000000,36,041,Hamilton County, NY,Feb-18,2167,1897,270,12.5
CN3604100000000,36,041,Hamilton County, NY,Mar-18,2140,1874,266,12.4
CN3604100000000,36,041,Hamilton County, NY,Apr-18(p),2117,1863,254,12.0
CN1608700000000,16,087,Washington County, ID,Mar-17,4556,4282,274,6.0
CN1608700000000,16,087,Washington County, ID,Apr-17,4549,4328,221,4.9
CN1608700000000,16,087,Washington County, ID,May-17,4560,4375,185,4.1
CN1608700000000,16,087,Washington County, ID,Jun-17,4678,4481,197,4.2
CN1608700000000,16,087,Washington County, ID,Jul-17,4716,4486,230,4.9
CN1608700000000,16,087,Washington County, ID,Aug-17,4677,4495,182,3.9
CN1608700000000,16,087,Washington County, ID,Sep-17,4652,4477,175,3.8
CN1608700000000,16,087,Washington County, ID,Oct-17,4648,4482,166,3.6
CN1608700000000,16,087,Washington County, ID,Nov-17,4648,4463,185,4.0
CN1608700000000,16,087,Washington County, ID,Dec-17,4577,4388,189,4.1
CN1608700000000,16,087,Washington County, ID,Jan-18,4557,4304,253,5.6
CN1608700000000,16,087,Washington County, ID,Feb-18,4584,4324,260,5.7
CN1608700000000,16,087,Washington County, ID,Mar-18,4592,4351,241,5.2
CN1608700000000,16,087,Washington County, ID,Apr-18(p),4547,4345,202,4.4
CN4611700000000,46,117,Stanley County, SD,Mar-17,1844,1769,75,4.1
CN4611700000000,46,117,Stanley County, SD,Apr-17,1842,1785,57,3.1
CN4611700000000,46,117,Stanley County, SD,May-17,1889,1836,53,2.8
CN4611700000000,46,117,Stanley County, SD,Jun-17,1926,1874,52,2.7
CN4611700000000,46,117,Stanley County, SD,Jul-17,1905,1854,51,2.7
CN4611700000000,46,117,Stanley County, SD,Aug-17,1869,1815,54,2.9
CN4611700000000,46,117,Stanley County, SD,Sep-17,1849,1799,50,2.7
CN4611700000000,46,117,Stanley County, SD,Oct-17,1849,1794,55,3.0
CN4611700000000,46,117,Stanley County, SD,Nov-17,1839,1785,54,2.9
CN4611700000000,46,117,Stanley County, SD,Dec-17,1850,1785,65,3.5
CN4611700000000,46,117,Stanley County, SD,Jan-18,1858,1781,77,4.1
CN4611700000000,46,117,Stanley County, SD,Feb-18,1844,1768,76,4.1
CN4611700000000,46,117,Stanley County, SD,Mar-18,1847,1781,66,3.6
CN4611700000000,46,117,Stanley County, SD,Apr-18(p),1811,1759,52,2.9
CN3717900000000,37,179,Union County, NC,Mar-17,118787,113995,4792,4.0
CN3717900000000,37,179,Union County, NC,Apr-17,118397,114141,4256,3.6
CN3717900000000,37,179,Union County, NC,May-17,118893,114406,4487,3.8
CN3717900000000,37,179,Union County, NC,Jun-17,119475,114615,4860,4.1
CN3717900000000,37,179,Union County, NC,Jul-17,120520,115379,5141,4.3
CN3717900000000,37,179,Union County, NC,Aug-17,119321,114156,5165,4.3
CN3717900000000,37,179,Union County, NC,Sep-17,120668,116154,4514,3.7
CN3717900000000,37,179,Union County, NC,Oct-17,120818,116353,4465,3.7
CN3717900000000,37,179,Union County, NC,Nov-17,120511,115824,4687,3.9
CN3717900000000,37,179,Union County, NC,Dec-17,120177,115641,4536,3.8
CN3717900000000,37,179,Union County, NC,Jan-18,120072,115303,4769,4.0
CN3717900000000,37,179,Union County, NC,Feb-18,121070,116292,4778,3.9
CN3717900000000,37,179,Union County, NC,Mar-18,121819,117229,4590,3.8
CN3717900000000,37,179,Union County, NC,Apr-18(p),121346,117403,3943,3.2
CN5100500000000,51,005,Alleghany County, VA,Mar-17,6924,6588,336,4.9
CN5100500000000,51,005,Alleghany County, VA,Apr-17,6898,6609,289,4.2
CN5100500000000,51,005,Alleghany County, VA,May-17,6928,6616,312,4.5
CN5100500000000,51,005,Alleghany County, VA,Jun-17,6929,6583,346,5.0
CN5100500000000,51,005,Alleghany County, VA,Jul-17,6746,6409,337,5.0
CN5100500000000,51,005,Alleghany County, VA,Aug-17,6795,6460,335,4.9
CN5100500000000,51,005,Alleghany County, VA,Sep-17,6909,6602,307,4.4
CN5100500000000,51,005,Alleghany County, VA,Oct-17,6774,6486,288,4.3
CN5100500000000,51,005,Alleghany County, VA,Nov-17,6726,6418,308,4.6
CN5100500000000,51,005,Alleghany County, VA,Dec-17,6742,6425,317,4.7
CN5100500000000,51,005,Alleghany County, VA,Jan-18,6720,6361,359,5.3
CN5100500000000,51,005,Alleghany County, VA,Feb-18,6794,6457,337,5.0
CN5100500000000,51,005,Alleghany County, VA,Mar-18,6815,6514,301,4.4
CN5100500000000,51,005,Alleghany County, VA,Apr-18(p),6868,6626,242,3.5
CN2809100000000,28,091,Marion County, MS,Mar-17,10391,9795,596,5.7
CN2809100000000,28,091,Marion County, MS,Apr-17,10342,9780,562,5.4
CN2809100000000,28,091,Marion County, MS,May-17,10341,9735,606,5.9
CN2809100000000,28,091,Marion County, MS,Jun-17,10388,9716,672,6.5
CN2809100000000,28,091,Marion County, MS,Jul-17,10222,9570,652,6.4
CN2809100000000,28,091,Marion County, MS,Aug-17,10044,9521,523,5.2
CN2809100000000,28,091,Marion County, MS,Sep-17,10123,9630,493,4.9
CN2809100000000,28,091,Marion County, MS,Oct-17,10053,9595,458,4.6
CN2809100000000,28,091,Marion County, MS,Nov-17,10065,9618,447,4.4
CN2809100000000,28,091,Marion County, MS,Dec-17,10136,9685,451,4.4
CN2809100000000,28,091,Marion County, MS,Jan-18,10078,9606,472,4.7
CN2809100000000,28,091,Marion County, MS,Feb-18,10193,9705,488,4.8
CN2809100000000,28,091,Marion County, MS,Mar-18,10205,9708,497,4.9
CN2809100000000,28,091,Marion County, MS,Apr-18(p),10243,9760,483,4.7
CN1710500000000,17,105,Livingston County, IL,Mar-17,16435,15602,833,5.1
CN1710500000000,17,105,Livingston County, IL,Apr-17,16731,16078,653,3.9
CN1710500000000,17,105,Livingston County, IL,May-17,16679,16025,654,3.9
CN1710500000000,17,105,Livingston County, IL,Jun-17,16950,16232,718,4.2
CN1710500000000,17,105,Livingston County, IL,Jul-17,16848,16108,740,4.4
CN1710500000000,17,105,Livingston County, IL,Aug-17,16794,16055,739,4.4
CN1710500000000,17,105,Livingston County, IL,Sep-17,16740,16122,618,3.7
CN1710500000000,17,105,Livingston County, IL,Oct-17,16705,16100,605,3.6
CN1710500000000,17,105,Livingston County, IL,Nov-17,16479,15856,623,3.8
CN1710500000000,17,105,Livingston County, IL,Dec-17,16307,15701,606,3.7
CN1710500000000,17,105,Livingston County, IL,Jan-18,16219,15493,726,4.5
CN1710500000000,17,105,Livingston County, IL,Feb-18,16349,15670,679,4.2
CN1710500000000,17,105,Livingston County, IL,Mar-18,16660,15970,690,4.1
CN1710500000000,17,105,Livingston County, IL,Apr-18(p),16919,16370,549,3.2
CN2100500000000,21,005,Anderson County, KY,Mar-17,11441,10889,552,4.8
CN2100500000000,21,005,Anderson County, KY,Apr-17,11558,11070,488,4.2
CN2100500000000,21,005,Anderson County, KY,May-17,11471,10974,497,4.3
CN2100500000000,21,005,Anderson County, KY,Jun-17,11887,11357,530,4.5
CN2100500000000,21,005,Anderson County, KY,Jul-17,11600,11023,577,5.0
CN2100500000000,21,005,Anderson County, KY,Aug-17,11491,11026,465,4.0
CN2100500000000,21,005,Anderson County, KY,Sep-17,11643,11205,438,3.8
CN2100500000000,21,005,Anderson County, KY,Oct-17,11643,11261,382,3.3
CN2100500000000,21,005,Anderson County, KY,Nov-17,11498,11145,353,3.1
CN2100500000000,21,005,Anderson County, KY,Dec-17,11731,11371,360,3.1
CN2100500000000,21,005,Anderson County, KY,Jan-18,11432,11022,410,3.6
CN2100500000000,21,005,Anderson County, KY,Feb-18,11672,11205,467,4.0
CN2100500000000,21,005,Anderson County, KY,Mar-18,11534,11094,440,3.8
CN2100500000000,21,005,Anderson County, KY,Apr-18(p),11682,11311,371,3.2
CN5407100000000,54,071,Pendleton County, WV,Mar-17,3622,3474,148,4.1
CN5407100000000,54,071,Pendleton County, WV,Apr-17,3720,3596,124,3.3
CN5407100000000,54,071,Pendleton County, WV,May-17,3705,3593,112,3.0
CN5407100000000,54,071,Pendleton County, WV,Jun-17,3760,3621,139,3.7
CN5407100000000,54,071,Pendleton County, WV,Jul-17,3732,3594,138,3.7
CN5407100000000,54,071,Pendleton County, WV,Aug-17,3707,3571,136,3.7
CN5407100000000,54,071,Pendleton County, WV,Sep-17,3699,3582,117,3.2
CN5407100000000,54,071,Pendleton County, WV,Oct-17,3679,3570,109,3.0
CN5407100000000,54,071,Pendleton County, WV,Nov-17,3631,3508,123,3.4
CN5407100000000,54,071,Pendleton County, WV,Dec-17,3487,3366,121,3.5
CN5407100000000,54,071,Pendleton County, WV,Jan-18,3631,3481,150,4.1
CN5407100000000,54,071,Pendleton County, WV,Feb-18,3722,3537,185,5.0
CN5407100000000,54,071,Pendleton County, WV,Mar-18,3667,3503,164,4.5
CN5407100000000,54,071,Pendleton County, WV,Apr-18(p),3729,3602,127,3.4
CN4805500000000,48,055,Caldwell County, TX,Mar-17,18382,17595,787,4.3
CN4805500000000,48,055,Caldwell County, TX,Apr-17,18367,17707,660,3.6
CN4805500000000,48,055,Caldwell County, TX,May-17,18383,17700,683,3.7
CN4805500000000,48,055,Caldwell County, TX,Jun-17,18474,17690,784,4.2
CN4805500000000,48,055,Caldwell County, TX,Jul-17,18500,17720,780,4.2
CN4805500000000,48,055,Caldwell County, TX,Aug-17,18395,17635,760,4.1
CN4805500000000,48,055,Caldwell County, TX,Sep-17,18474,17826,648,3.5
CN4805500000000,48,055,Caldwell County, TX,Oct-17,18411,17799,612,3.3
CN4805500000000,48,055,Caldwell County, TX,Nov-17,18572,17929,643,3.5
CN4805500000000,48,055,Caldwell County, TX,Dec-17,18530,17932,598,3.2
CN4805500000000,48,055,Caldwell County, TX,Jan-18,18627,17947,680,3.7
CN4805500000000,48,055,Caldwell County, TX,Feb-18,18943,18244,699,3.7
CN4805500000000,48,055,Caldwell County, TX,Mar-18,19060,18297,763,4.0
CN4805500000000,48,055,Caldwell County, TX,Apr-18(p),18985,18347,638,3.4
CN4707500000000,47,075,Haywood County, TN,Mar-17,7838,7403,435,5.5
CN4707500000000,47,075,Haywood County, TN,Apr-17,7855,7485,370,4.7
CN4707500000000,47,075,Haywood County, TN,May-17,7798,7437,361,4.6
CN4707500000000,47,075,Haywood County, TN,Jun-17,7762,7333,429,5.5
CN4707500000000,47,075,Haywood County, TN,Jul-17,7838,7440,398,5.1
CN4707500000000,47,075,Haywood County, TN,Aug-17,7962,7559,403,5.1
CN4707500000000,47,075,Haywood County, TN,Sep-17,7924,7552,372,4.7
CN4707500000000,47,075,Haywood County, TN,Oct-17,7867,7512,355,4.5
CN4707500000000,47,075,Haywood County, TN,Nov-17,7883,7526,357,4.5
CN4707500000000,47,075,Haywood County, TN,Dec-17,7912,7537,375,4.7
CN4707500000000,47,075,Haywood County, TN,Jan-18,7906,7458,448,5.7
CN4707500000000,47,075,Haywood County, TN,Feb-18,7993,7547,446,5.6
CN4707500000000,47,075,Haywood County, TN,Mar-18,7914,7492,422,5.3
CN4707500000000,47,075,Haywood County, TN,Apr-18(p),7940,7586,354,4.5
CN5410100000000,54,101,Webster County, WV,Mar-17,3436,3199,237,6.9
CN5410100000000,54,101,Webster County, WV,Apr-17,3399,3204,195,5.7
CN5410100000000,54,101,Webster County, WV,May-17,3391,3206,185,5.5
CN5410100000000,54,101,Webster County, WV,Jun-17,3421,3221,200,5.8
CN5410100000000,54,101,Webster County, WV,Jul-17,3291,3100,191,5.8
CN5410100000000,54,101,Webster County, WV,Aug-17,3287,3091,196,6.0
CN5410100000000,54,101,Webster County, WV,Sep-17,3387,3204,183,5.4
CN5410100000000,54,101,Webster County, WV,Oct-17,3385,3207,178,5.3
CN5410100000000,54,101,Webster County, WV,Nov-17,3318,3113,205,6.2
CN5410100000000,54,101,Webster County, WV,Dec-17,3206,3005,201,6.3
CN5410100000000,54,101,Webster County, WV,Jan-18,3340,3107,233,7.0
CN5410100000000,54,101,Webster County, WV,Feb-18,3453,3186,267,7.7
CN5410100000000,54,101,Webster County, WV,Mar-18,3403,3174,229,6.7
CN5410100000000,54,101,Webster County, WV,Apr-18(p),3399,3190,209,6.1
CN4710500000000,47,105,Loudon County, TN,Mar-17,22517,21614,903,4.0
CN4710500000000,47,105,Loudon County, TN,Apr-17,22513,21780,733,3.3
CN4710500000000,47,105,Loudon County, TN,May-17,22455,21759,696,3.1
CN4710500000000,47,105,Loudon County, TN,Jun-17,22718,21793,925,4.1
CN4710500000000,47,105,Loudon County, TN,Jul-17,22807,21930,877,3.8
CN4710500000000,47,105,Loudon County, TN,Aug-17,22665,21849,816,3.6
CN4710500000000,47,105,Loudon County, TN,Sep-17,22881,22135,746,3.3
CN4710500000000,47,105,Loudon County, TN,Oct-17,22680,21974,706,3.1
CN4710500000000,47,105,Loudon County, TN,Nov-17,22738,22027,711,3.1
CN4710500000000,47,105,Loudon County, TN,Dec-17,22542,21856,686,3.0
CN4710500000000,47,105,Loudon County, TN,Jan-18,22426,21595,831,3.7
CN4710500000000,47,105,Loudon County, TN,Feb-18,22832,22025,807,3.5
CN4710500000000,47,105,Loudon County, TN,Mar-18,22738,21949,789,3.5
CN4710500000000,47,105,Loudon County, TN,Apr-18(p),22707,22083,624,2.7
CN3805100000000,38,051,McIntosh County, ND,Mar-17,1240,1197,43,3.5
CN3805100000000,38,051,McIntosh County, ND,Apr-17,1258,1220,38,3.0
CN3805100000000,38,051,McIntosh County, ND,May-17,1257,1228,29,2.3
CN3805100000000,38,051,McIntosh County, ND,Jun-17,1313,1281,32,2.4
CN3805100000000,38,051,McIntosh County, ND,Jul-17,1271,1244,27,2.1
CN3805100000000,38,051,McIntosh County, ND,Aug-17,1285,1258,27,2.1
CN3805100000000,38,051,McIntosh County, ND,Sep-17,1270,1243,27,2.1
CN3805100000000,38,051,McIntosh County, ND,Oct-17,1273,1248,25,2.0
CN3805100000000,38,051,McIntosh County, ND,Nov-17,1216,1191,25,2.1
CN3805100000000,38,051,McIntosh County, ND,Dec-17,1215,1193,22,1.8
CN3805100000000,38,051,McIntosh County, ND,Jan-18,1200,1163,37,3.1
CN3805100000000,38,051,McIntosh County, ND,Feb-18,1192,1157,35,2.9
CN3805100000000,38,051,McIntosh County, ND,Mar-18,1219,1178,41,3.4
CN3805100000000,38,051,McIntosh County, ND,Apr-18(p),1220,1182,38,3.1
CN2202700000000,22,027,Claiborne Parish, LA,Mar-17,5807,5471,336,5.8
CN2202700000000,22,027,Claiborne Parish, LA,Apr-17,5859,5538,321,5.5
CN2202700000000,22,027,Claiborne Parish, LA,May-17,5868,5552,316,5.4
CN2202700000000,22,027,Claiborne Parish, LA,Jun-17,6032,5670,362,6.0
CN2202700000000,22,027,Claiborne Parish, LA,Jul-17,6008,5672,336,5.6
CN2202700000000,22,027,Claiborne Parish, LA,Aug-17,5914,5588,326,5.5
CN2202700000000,22,027,Claiborne Parish, LA,Sep-17,5887,5593,294,5.0
CN2202700000000,22,027,Claiborne Parish, LA,Oct-17,5888,5628,260,4.4
CN2202700000000,22,027,Claiborne Parish, LA,Nov-17,5869,5612,257,4.4
CN2202700000000,22,027,Claiborne Parish, LA,Dec-17,5867,5610,257,4.4
CN2202700000000,22,027,Claiborne Parish, LA,Jan-18,5926,5655,271,4.6
CN2202700000000,22,027,Claiborne Parish, LA,Feb-18,5883,5627,256,4.4
CN2202700000000,22,027,Claiborne Parish, LA,Mar-18,5878,5605,273,4.6
CN2202700000000,22,027,Claiborne Parish, LA,Apr-18(p),5853,5583,270,4.6
CN2808300000000,28,083,Leflore County, MS,Mar-17,10498,9692,806,7.7
CN2808300000000,28,083,Leflore County, MS,Apr-17,10463,9789,674,6.4
CN2808300000000,28,083,Leflore County, MS,May-17,10593,9839,754,7.1
CN2808300000000,28,083,Leflore County, MS,Jun-17,10717,9841,876,8.2
CN2808300000000,28,083,Leflore County, MS,Jul-17,10595,9774,821,7.7
CN2808300000000,28,083,Leflore County, MS,Aug-17,10382,9644,738,7.1
CN2808300000000,28,083,Leflore County, MS,Sep-17,10412,9722,690,6.6
CN2808300000000,28,083,Leflore County, MS,Oct-17,10220,9612,608,5.9
CN2808300000000,28,083,Leflore County, MS,Nov-17,10177,9569,608,6.0
CN2808300000000,28,083,Leflore County, MS,Dec-17,10178,9477,701,6.9
CN2808300000000,28,083,Leflore County, MS,Jan-18,10091,9330,761,7.5
CN2808300000000,28,083,Leflore County, MS,Feb-18,10142,9409,733,7.2
CN2808300000000,28,083,Leflore County, MS,Mar-18,10165,9500,665,6.5
CN2808300000000,28,083,Leflore County, MS,Apr-18(p),10172,9551,621,6.1
CN2300700000000,23,007,Franklin County, ME,Mar-17,14885,14249,636,4.3
CN2300700000000,23,007,Franklin County, ME,Apr-17,14779,14154,625,4.2
CN2300700000000,23,007,Franklin County, ME,May-17,14252,13530,722,5.1
CN2300700000000,23,007,Franklin County, ME,Jun-17,14360,13735,625,4.4
CN2300700000000,23,007,Franklin County, ME,Jul-17,14583,13957,626,4.3
CN2300700000000,23,007,Franklin County, ME,Aug-17,14470,13932,538,3.7
CN2300700000000,23,007,Franklin County, ME,Sep-17,14314,13825,489,3.4
CN2300700000000,23,007,Franklin County, ME,Oct-17,14548,14066,482,3.3
CN2300700000000,23,007,Franklin County, ME,Nov-17,14531,13996,535,3.7
CN2300700000000,23,007,Franklin County, ME,Dec-17,14763,14339,424,2.9
CN2300700000000,23,007,Franklin County, ME,Jan-18,14809,14253,556,3.8
CN2300700000000,23,007,Franklin County, ME,Feb-18,14810,14283,527,3.6
CN2300700000000,23,007,Franklin County, ME,Mar-18,14837,14338,499,3.4
CN2300700000000,23,007,Franklin County, ME,Apr-18(p),14635,14100,535,3.7
CN3903100000000,39,031,Coshocton County, OH,Mar-17,14993,13923,1070,7.1
CN3903100000000,39,031,Coshocton County, OH,Apr-17,14831,13898,933,6.3
CN3903100000000,39,031,Coshocton County, OH,May-17,14785,13891,894,6.0
CN3903100000000,39,031,Coshocton County, OH,Jun-17,14963,13921,1042,7.0
CN3903100000000,39,031,Coshocton County, OH,Jul-17,14865,13818,1047,7.0
CN3903100000000,39,031,Coshocton County, OH,Aug-17,15012,13967,1045,7.0
CN3903100000000,39,031,Coshocton County, OH,Sep-17,14934,13976,958,6.4
CN3903100000000,39,031,Coshocton County, OH,Oct-17,14779,13929,850,5.8
CN3903100000000,39,031,Coshocton County, OH,Nov-17,14489,13604,885,6.1
CN3903100000000,39,031,Coshocton County, OH,Dec-17,14239,13346,893,6.3
CN3903100000000,39,031,Coshocton County, OH,Jan-18,14030,13038,992,7.1
CN3903100000000,39,031,Coshocton County, OH,Feb-18,14393,13490,903,6.3
CN3903100000000,39,031,Coshocton County, OH,Mar-18,14633,13726,907,6.2
CN3903100000000,39,031,Coshocton County, OH,Apr-18(p),14563,13686,877,6.0
CN3103300000000,31,033,Cheyenne County, NE,Mar-17,5100,4941,159,3.1
CN3103300000000,31,033,Cheyenne County, NE,Apr-17,5140,4976,164,3.2
CN3103300000000,31,033,Cheyenne County, NE,May-17,5184,5028,156,3.0
CN3103300000000,31,033,Cheyenne County, NE,Jun-17,5303,5142,161,3.0
CN3103300000000,31,033,Cheyenne County, NE,Jul-17,5246,5094,152,2.9
CN3103300000000,31,033,Cheyenne County, NE,Aug-17,5152,5004,148,2.9
CN3103300000000,31,033,Cheyenne County, NE,Sep-17,5011,4876,135,2.7
CN3103300000000,31,033,Cheyenne County, NE,Oct-17,5037,4908,129,2.6
CN3103300000000,31,033,Cheyenne County, NE,Nov-17,5042,4917,125,2.5
CN3103300000000,31,033,Cheyenne County, NE,Dec-17,5040,4906,134,2.7
CN3103300000000,31,033,Cheyenne County, NE,Jan-18,5082,4950,132,2.6
CN3103300000000,31,033,Cheyenne County, NE,Feb-18,5101,4974,127,2.5
CN3103300000000,31,033,Cheyenne County, NE,Mar-18,5134,4996,138,2.7
CN3103300000000,31,033,Cheyenne County, NE,Apr-18(p),5113,4972,141,2.8
CN2501700000000,25,017,Middlesex County, MA,Mar-17,885988,857846,28142,3.2
CN2501700000000,25,017,Middlesex County, MA,Apr-17,884267,858624,25643,2.9
CN2501700000000,25,017,Middlesex County, MA,May-17,881478,854043,27435,3.1
CN2501700000000,25,017,Middlesex County, MA,Jun-17,894526,863743,30783,3.4
CN2501700000000,25,017,Middlesex County, MA,Jul-17,895879,865431,30448,3.4
CN2501700000000,25,017,Middlesex County, MA,Aug-17,891031,863306,27725,3.1
CN2501700000000,25,017,Middlesex County, MA,Sep-17,879978,853969,26009,3.0
CN2501700000000,25,017,Middlesex County, MA,Oct-17,881752,858694,23058,2.6
CN2501700000000,25,017,Middlesex County, MA,Nov-17,883950,861627,22323,2.5
CN2501700000000,25,017,Middlesex County, MA,Dec-17,881917,859999,21918,2.5
CN2501700000000,25,017,Middlesex County, MA,Jan-18,885568,858394,27174,3.1
CN2501700000000,25,017,Middlesex County, MA,Feb-18,896301,868308,27993,3.1
CN2501700000000,25,017,Middlesex County, MA,Mar-18,902794,875862,26932,3.0
CN2501700000000,25,017,Middlesex County, MA,Apr-18(p),910340,886280,24060,2.6
CN2019100000000,20,191,Sumner County, KS,Mar-17,10703,10311,392,3.7
CN2019100000000,20,191,Sumner County, KS,Apr-17,10724,10344,380,3.5
CN2019100000000,20,191,Sumner County, KS,May-17,10695,10296,399,3.7
CN2019100000000,20,191,Sumner County, KS,Jun-17,10881,10427,454,4.2
CN2019100000000,20,191,Sumner County, KS,Jul-17,10974,10482,492,4.5
CN2019100000000,20,191,Sumner County, KS,Aug-17,10821,10348,473,4.4
CN2019100000000,20,191,Sumner County, KS,Sep-17,10687,10314,373,3.5
CN2019100000000,20,191,Sumner County, KS,Oct-17,10733,10397,336,3.1
CN2019100000000,20,191,Sumner County, KS,Nov-17,10716,10358,358,3.3
CN2019100000000,20,191,Sumner County, KS,Dec-17,10663,10326,337,3.2
CN2019100000000,20,191,Sumner County, KS,Jan-18,10639,10283,356,3.3
CN2019100000000,20,191,Sumner County, KS,Feb-18,10648,10254,394,3.7
CN2019100000000,20,191,Sumner County, KS,Mar-18,10582,10214,368,3.5
CN2019100000000,20,191,Sumner County, KS,Apr-18(p),10545,10190,355,3.4
CN1205900000000,12,059,Holmes County, FL,Mar-17,6826,6514,312,4.6
CN1205900000000,12,059,Holmes County, FL,Apr-17,6806,6510,296,4.3
CN1205900000000,12,059,Holmes County, FL,May-17,6862,6555,307,4.5
CN1205900000000,12,059,Holmes County, FL,Jun-17,6764,6411,353,5.2
CN1205900000000,12,059,Holmes County, FL,Jul-17,6763,6408,355,5.2
CN1205900000000,12,059,Holmes County, FL,Aug-17,6723,6389,334,5.0
CN1205900000000,12,059,Holmes County, FL,Sep-17,7041,6723,318,4.5
CN1205900000000,12,059,Holmes County, FL,Oct-17,6848,6555,293,4.3
CN1205900000000,12,059,Holmes County, FL,Nov-17,6768,6472,296,4.4
CN1205900000000,12,059,Holmes County, FL,Dec-17,6754,6471,283,4.2
CN1205900000000,12,059,Holmes County, FL,Jan-18,6792,6461,331,4.9
CN1205900000000,12,059,Holmes County, FL,Feb-18,6844,6552,292,4.3
CN1205900000000,12,059,Holmes County, FL,Mar-18,6879,6588,291,4.2
CN1205900000000,12,059,Holmes County, FL,Apr-18(p),6843,6586,257,3.8
CN2601300000000,26,013,Baraga County, MI,Mar-17,3232,2926,306,9.5
CN2601300000000,26,013,Baraga County, MI,Apr-17,3141,2861,280,8.9
CN2601300000000,26,013,Baraga County, MI,May-17,3163,2909,254,8.0
CN2601300000000,26,013,Baraga County, MI,Jun-17,3241,2967,274,8.5
CN2601300000000,26,013,Baraga County, MI,Jul-17,3264,2994,270,8.3
CN2601300000000,26,013,Baraga County, MI,Aug-17,3197,2954,243,7.6
CN2601300000000,26,013,Baraga County, MI,Sep-17,3132,2941,191,6.1
CN2601300000000,26,013,Baraga County, MI,Oct-17,3088,2907,181,5.9
CN2601300000000,26,013,Baraga County, MI,Nov-17,3072,2879,193,6.3
CN2601300000000,26,013,Baraga County, MI,Dec-17,3127,2888,239,7.6
CN2601300000000,26,013,Baraga County, MI,Jan-18,3124,2872,252,8.1
CN2601300000000,26,013,Baraga County, MI,Feb-18,3193,2916,277,8.7
CN2601300000000,26,013,Baraga County, MI,Mar-18,3197,2927,270,8.4
CN2601300000000,26,013,Baraga County, MI,Apr-18(p),3135,2857,278,8.9
CN2008500000000,20,085,Jackson County, KS,Mar-17,7164,6933,231,3.2
CN2008500000000,20,085,Jackson County, KS,Apr-17,7106,6898,208,2.9
CN2008500000000,20,085,Jackson County, KS,May-17,7147,6918,229,3.2
CN2008500000000,20,085,Jackson County, KS,Jun-17,7281,7019,262,3.6
CN2008500000000,20,085,Jackson County, KS,Jul-17,7378,7115,263,3.6
CN2008500000000,20,085,Jackson County, KS,Aug-17,7215,6989,226,3.1
CN2008500000000,20,085,Jackson County, KS,Sep-17,7114,6924,190,2.7
CN2008500000000,20,085,Jackson County, KS,Oct-17,7101,6926,175,2.5
CN2008500000000,20,085,Jackson County, KS,Nov-17,7159,6962,197,2.8
CN2008500000000,20,085,Jackson County, KS,Dec-17,7084,6904,180,2.5
CN2008500000000,20,085,Jackson County, KS,Jan-18,7132,6893,239,3.4
CN2008500000000,20,085,Jackson County, KS,Feb-18,7159,6897,262,3.7
CN2008500000000,20,085,Jackson County, KS,Mar-18,7108,6893,215,3.0
CN2008500000000,20,085,Jackson County, KS,Apr-18(p),7070,6874,196,2.8
CN4103700000000,41,037,Lake County, OR,Mar-17,3391,3155,236,7.0
CN4103700000000,41,037,Lake County, OR,Apr-17,3478,3274,204,5.9
CN4103700000000,41,037,Lake County, OR,May-17,3519,3343,176,5.0
CN4103700000000,41,037,Lake County, OR,Jun-17,3615,3401,214,5.9
CN4103700000000,41,037,Lake County, OR,Jul-17,3771,3588,183,4.9
CN4103700000000,41,037,Lake County, OR,Aug-17,3787,3606,181,4.8
CN4103700000000,41,037,Lake County, OR,Sep-17,3700,3546,154,4.2
CN4103700000000,41,037,Lake County, OR,Oct-17,3553,3394,159,4.5
CN4103700000000,41,037,Lake County, OR,Nov-17,3479,3292,187,5.4
CN4103700000000,41,037,Lake County, OR,Dec-17,3463,3256,207,6.0
CN4103700000000,41,037,Lake County, OR,Jan-18,3456,3205,251,7.3
CN4103700000000,41,037,Lake County, OR,Feb-18,3455,3207,248,7.2
CN4103700000000,41,037,Lake County, OR,Mar-18,3430,3204,226,6.6
CN4103700000000,41,037,Lake County, OR,Apr-18(p),3466,3268,198,5.7
CN4400900000000,44,009,Washington County, RI,Mar-17,68426,65183,3243,4.7
CN4400900000000,44,009,Washington County, RI,Apr-17,68053,65592,2461,3.6
CN4400900000000,44,009,Washington County, RI,May-17,68263,65873,2390,3.5
CN4400900000000,44,009,Washington County, RI,Jun-17,69984,67390,2594,3.7
CN4400900000000,44,009,Washington County, RI,Jul-17,70622,67772,2850,4.0
CN4400900000000,44,009,Washington County, RI,Aug-17,70303,67635,2668,3.8
CN4400900000000,44,009,Washington County, RI,Sep-17,69242,66918,2324,3.4
CN4400900000000,44,009,Washington County, RI,Oct-17,69117,66718,2399,3.5
CN4400900000000,44,009,Washington County, RI,Nov-17,69374,66711,2663,3.8
CN4400900000000,44,009,Washington County, RI,Dec-17,69265,66597,2668,3.9
CN4400900000000,44,009,Washington County, RI,Jan-18,68881,65439,3442,5.0
CN4400900000000,44,009,Washington County, RI,Feb-18,69190,65687,3503,5.1
CN4400900000000,44,009,Washington County, RI,Mar-18,68952,65838,3114,4.5
CN4400900000000,44,009,Washington County, RI,Apr-18(p),68841,66429,2412,3.5
CN1919100000000,19,191,Winneshiek County, IA,Mar-17,12009,11479,530,4.4
CN1919100000000,19,191,Winneshiek County, IA,Apr-17,12184,11823,361,3.0
CN1919100000000,19,191,Winneshiek County, IA,May-17,12171,11885,286,2.3
CN1919100000000,19,191,Winneshiek County, IA,Jun-17,11508,11172,336,2.9
CN1919100000000,19,191,Winneshiek County, IA,Jul-17,11635,11316,319,2.7
CN1919100000000,19,191,Winneshiek County, IA,Aug-17,11333,11020,313,2.8
CN1919100000000,19,191,Winneshiek County, IA,Sep-17,12139,11875,264,2.2
CN1919100000000,19,191,Winneshiek County, IA,Oct-17,12125,11906,219,1.8
CN1919100000000,19,191,Winneshiek County, IA,Nov-17,11892,11665,227,1.9
CN1919100000000,19,191,Winneshiek County, IA,Dec-17,11728,11387,341,2.9
CN1919100000000,19,191,Winneshiek County, IA,Jan-18,11248,10670,578,5.1
CN1919100000000,19,191,Winneshiek County, IA,Feb-18,11678,11156,522,4.5
CN1919100000000,19,191,Winneshiek County, IA,Mar-18,11665,11206,459,3.9
CN1919100000000,19,191,Winneshiek County, IA,Apr-18(p),11924,11568,356,3.0
CN4014700000000,40,147,Washington County, OK,Mar-17,23113,22055,1058,4.6
CN4014700000000,40,147,Washington County, OK,Apr-17,22976,22014,962,4.2
CN4014700000000,40,147,Washington County, OK,May-17,22983,21917,1066,4.6
CN4014700000000,40,147,Washington County, OK,Jun-17,23409,22294,1115,4.8
CN4014700000000,40,147,Washington County, OK,Jul-17,23546,22510,1036,4.4
CN4014700000000,40,147,Washington County, OK,Aug-17,23243,22212,1031,4.4
CN4014700000000,40,147,Washington County, OK,Sep-17,23285,22274,1011,4.3
CN4014700000000,40,147,Washington County, OK,Oct-17,22979,21965,1014,4.4
CN4014700000000,40,147,Washington County, OK,Nov-17,22990,21946,1044,4.5
CN4014700000000,40,147,Washington County, OK,Dec-17,22917,21803,1114,4.9
CN4014700000000,40,147,Washington County, OK,Jan-18,22664,21470,1194,5.3
CN4014700000000,40,147,Washington County, OK,Feb-18,23020,21907,1113,4.8
CN4014700000000,40,147,Washington County, OK,Mar-18,23099,21996,1103,4.8
CN4014700000000,40,147,Washington County, OK,Apr-18(p),22957,21927,1030,4.5
CN4506500000000,45,065,McCormick County, SC,Mar-17,3382,3231,151,4.5
CN4506500000000,45,065,McCormick County, SC,Apr-17,3361,3231,130,3.9
CN4506500000000,45,065,McCormick County, SC,May-17,3352,3217,135,4.0
CN4506500000000,45,065,McCormick County, SC,Jun-17,3388,3224,164,4.8
CN4506500000000,45,065,McCormick County, SC,Jul-17,3370,3213,157,4.7
CN4506500000000,45,065,McCormick County, SC,Aug-17,3363,3201,162,4.8
CN4506500000000,45,065,McCormick County, SC,Sep-17,3380,3225,155,4.6
CN4506500000000,45,065,McCormick County, SC,Oct-17,3394,3244,150,4.4
CN4506500000000,45,065,McCormick County, SC,Nov-17,3386,3251,135,4.0
CN4506500000000,45,065,McCormick County, SC,Dec-17,3411,3269,142,4.2
CN4506500000000,45,065,McCormick County, SC,Jan-18,3433,3241,192,5.6
CN4506500000000,45,065,McCormick County, SC,Feb-18,3460,3288,172,5.0
CN4506500000000,45,065,McCormick County, SC,Mar-18,3416,3274,142,4.2
CN4506500000000,45,065,McCormick County, SC,Apr-18(p),3363,3273,90,2.7
CN3008900000000,30,089,Sanders County, MT,Mar-17,4771,4345,426,8.9
CN3008900000000,30,089,Sanders County, MT,Apr-17,4768,4431,337,7.1
CN3008900000000,30,089,Sanders County, MT,May-17,4828,4541,287,5.9
CN3008900000000,30,089,Sanders County, MT,Jun-17,4941,4630,311,6.3
CN3008900000000,30,089,Sanders County, MT,Jul-17,4823,4565,258,5.3
CN3008900000000,30,089,Sanders County, MT,Aug-17,4862,4593,269,5.5
CN3008900000000,30,089,Sanders County, MT,Sep-17,4831,4572,259,5.4
CN3008900000000,30,089,Sanders County, MT,Oct-17,4898,4603,295,6.0
CN3008900000000,30,089,Sanders County, MT,Nov-17,4857,4526,331,6.8
CN3008900000000,30,089,Sanders County, MT,Dec-17,4703,4356,347,7.4
CN3008900000000,30,089,Sanders County, MT,Jan-18,4817,4327,490,10.2
CN3008900000000,30,089,Sanders County, MT,Feb-18,4783,4341,442,9.2
CN3008900000000,30,089,Sanders County, MT,Mar-18,4817,4386,431,8.9
CN3008900000000,30,089,Sanders County, MT,Apr-18(p),4799,4484,315,6.6
CN7209300000000,72,093,Maricao Municipio, PR,Mar-17,2129,1652,477,22.4
CN7209300000000,72,093,Maricao Municipio, PR,Apr-17,2083,1597,486,23.3
CN7209300000000,72,093,Maricao Municipio, PR,May-17,2121,1671,450,21.2
CN7209300000000,72,093,Maricao Municipio, PR,Jun-17,2105,1716,389,18.5
CN7209300000000,72,093,Maricao Municipio, PR,Jul-17,2120,1732,388,18.3
CN7209300000000,72,093,Maricao Municipio, PR,Aug-17,2152,1735,417,19.4
CN7209300000000,72,093,Maricao Municipio, PR,Sep-17(y),2027,1654,373,18.4
CN7209300000000,72,093,Maricao Municipio, PR,Oct-17,1909,1576,333,17.4
CN7209300000000,72,093,Maricao Municipio, PR,Nov-17,2021,1691,330,16.3
CN7209300000000,72,093,Maricao Municipio, PR,Dec-17,2024,1682,342,16.9
CN7209300000000,72,093,Maricao Municipio, PR,Jan-18,2049,1661,388,18.9
CN7209300000000,72,093,Maricao Municipio, PR,Feb-18,1980,1599,381,19.2
CN7209300000000,72,093,Maricao Municipio, PR,Mar-18,1972,1603,369,18.7
CN7209300000000,72,093,Maricao Municipio, PR,Apr-18(p),1935,1606,329,17.0
CN4844700000000,48,447,Throckmorton County, TX,Mar-17,713,684,29,4.1
CN4844700000000,48,447,Throckmorton County, TX,Apr-17,724,689,35,4.8
CN4844700000000,48,447,Throckmorton County, TX,May-17,721,689,32,4.4
CN4844700000000,48,447,Throckmorton County, TX,Jun-17,715,684,31,4.3
CN4844700000000,48,447,Throckmorton County, TX,Jul-17,687,655,32,4.7
CN4844700000000,48,447,Throckmorton County, TX,Aug-17,699,665,34,4.9
CN4844700000000,48,447,Throckmorton County, TX,Sep-17,671,641,30,4.5
CN4844700000000,48,447,Throckmorton County, TX,Oct-17,682,656,26,3.8
CN4844700000000,48,447,Throckmorton County, TX,Nov-17,663,639,24,3.6
CN4844700000000,48,447,Throckmorton County, TX,Dec-17,669,650,19,2.8
CN4844700000000,48,447,Throckmorton County, TX,Jan-18,651,628,23,3.5
CN4844700000000,48,447,Throckmorton County, TX,Feb-18,660,635,25,3.8
CN4844700000000,48,447,Throckmorton County, TX,Mar-18,689,664,25,3.6
CN4844700000000,48,447,Throckmorton County, TX,Apr-18(p),661,639,22,3.3
CN1908500000000,19,085,Harrison County, IA,Mar-17,7309,7086,223,3.1
CN1908500000000,19,085,Harrison County, IA,Apr-17,7344,7140,204,2.8
CN1908500000000,19,085,Harrison County, IA,May-17,7361,7172,189,2.6
CN1908500000000,19,085,Harrison County, IA,Jun-17,7419,7216,203,2.7
CN1908500000000,19,085,Harrison County, IA,Jul-17,7530,7347,183,2.4
CN1908500000000,19,085,Harrison County, IA,Aug-17,7430,7229,201,2.7
CN1908500000000,19,085,Harrison County, IA,Sep-17,7324,7149,175,2.4
CN1908500000000,19,085,Harrison County, IA,Oct-17,7350,7212,138,1.9
CN1908500000000,19,085,Harrison County, IA,Nov-17,7312,7162,150,2.1
CN1908500000000,19,085,Harrison County, IA,Dec-17,7314,7127,187,2.6
CN1908500000000,19,085,Harrison County, IA,Jan-18,7252,7014,238,3.3
CN1908500000000,19,085,Harrison County, IA,Feb-18,7285,7062,223,3.1
CN1908500000000,19,085,Harrison County, IA,Mar-18,7261,7066,195,2.7
CN1908500000000,19,085,Harrison County, IA,Apr-18(p),7267,7101,166,2.3
CN3904900000000,39,049,Franklin County, OH,Mar-17,671318,644396,26922,4.0
CN3904900000000,39,049,Franklin County, OH,Apr-17,672826,648144,24682,3.7
CN3904900000000,39,049,Franklin County, OH,May-17,679558,654065,25493,3.8
CN3904900000000,39,049,Franklin County, OH,Jun-17,687628,658293,29335,4.3
CN3904900000000,39,049,Franklin County, OH,Jul-17,693990,664654,29336,4.2
CN3904900000000,39,049,Franklin County, OH,Aug-17,689623,660482,29141,4.2
CN3904900000000,39,049,Franklin County, OH,Sep-17,683349,656781,26568,3.9
CN3904900000000,39,049,Franklin County, OH,Oct-17,682548,657272,25276,3.7
CN3904900000000,39,049,Franklin County, OH,Nov-17,681715,656533,25182,3.7
CN3904900000000,39,049,Franklin County, OH,Dec-17,683700,658625,25075,3.7
CN3904900000000,39,049,Franklin County, OH,Jan-18,670545,645269,25276,3.8
CN3904900000000,39,049,Franklin County, OH,Feb-18,679194,654629,24565,3.6
CN3904900000000,39,049,Franklin County, OH,Mar-18,686315,663049,23266,3.4
CN3904900000000,39,049,Franklin County, OH,Apr-18(p),685697,662955,22742,3.3
CN7205900000000,72,059,Guayanilla Municipio, PR,Mar-17,5239,4332,907,17.3
CN7205900000000,72,059,Guayanilla Municipio, PR,Apr-17,5168,4224,944,18.3
CN7205900000000,72,059,Guayanilla Municipio, PR,May-17,5193,4357,836,16.1
CN7205900000000,72,059,Guayanilla Municipio, PR,Jun-17,5160,4446,714,13.8
CN7205900000000,72,059,Guayanilla Municipio, PR,Jul-17,5306,4543,763,14.4
CN7205900000000,72,059,Guayanilla Municipio, PR,Aug-17,5316,4424,892,16.8
CN7205900000000,72,059,Guayanilla Municipio, PR,Sep-17(y),5018,4187,831,16.6
CN7205900000000,72,059,Guayanilla Municipio, PR,Oct-17,4813,4011,802,16.7
CN7205900000000,72,059,Guayanilla Municipio, PR,Nov-17,5013,4235,778,15.5
CN7205900000000,72,059,Guayanilla Municipio, PR,Dec-17,5057,4293,764,15.1
CN7205900000000,72,059,Guayanilla Municipio, PR,Jan-18,4959,4157,802,16.2
CN7205900000000,72,059,Guayanilla Municipio, PR,Feb-18,4848,4100,748,15.4
CN7205900000000,72,059,Guayanilla Municipio, PR,Mar-18,4867,4118,749,15.4
CN7205900000000,72,059,Guayanilla Municipio, PR,Apr-18(p),4949,4198,751,15.2
CN4816100000000,48,161,Freestone County, TX,Mar-17,6939,6451,488,7.0
CN4816100000000,48,161,Freestone County, TX,Apr-17,6891,6448,443,6.4
CN4816100000000,48,161,Freestone County, TX,May-17,6853,6439,414,6.0
CN4816100000000,48,161,Freestone County, TX,Jun-17,6840,6391,449,6.6
CN4816100000000,48,161,Freestone County, TX,Jul-17,6708,6277,431,6.4
CN4816100000000,48,161,Freestone County, TX,Aug-17,6709,6289,420,6.3
CN4816100000000,48,161,Freestone County, TX,Sep-17,6655,6280,375,5.6
CN4816100000000,48,161,Freestone County, TX,Oct-17,6566,6218,348,5.3
CN4816100000000,48,161,Freestone County, TX,Nov-17,6534,6177,357,5.5
CN4816100000000,48,161,Freestone County, TX,Dec-17,6513,6176,337,5.2
CN4816100000000,48,161,Freestone County, TX,Jan-18,6621,6235,386,5.8
CN4816100000000,48,161,Freestone County, TX,Feb-18,6723,6346,377,5.6
CN4816100000000,48,161,Freestone County, TX,Mar-18,6853,6414,439,6.4
CN4816100000000,48,161,Freestone County, TX,Apr-18(p),6848,6429,419,6.1
CN4607900000000,46,079,Lake County, SD,Mar-17,6517,6233,284,4.4
CN4607900000000,46,079,Lake County, SD,Apr-17,6581,6327,254,3.9
CN4607900000000,46,079,Lake County, SD,May-17,6520,6277,243,3.7
CN4607900000000,46,079,Lake County, SD,Jun-17,6455,6214,241,3.7
CN4607900000000,46,079,Lake County, SD,Jul-17,6405,6171,234,3.7
CN4607900000000,46,079,Lake County, SD,Aug-17,6361,6115,246,3.9
CN4607900000000,46,079,Lake County, SD,Sep-17,6444,6220,224,3.5
CN4607900000000,46,079,Lake County, SD,Oct-17,6563,6333,230,3.5
CN4607900000000,46,079,Lake County, SD,Nov-17,6555,6314,241,3.7
CN4607900000000,46,079,Lake County, SD,Dec-17,6445,6176,269,4.2
CN4607900000000,46,079,Lake County, SD,Jan-18,6390,6101,289,4.5
CN4607900000000,46,079,Lake County, SD,Feb-18,6528,6240,288,4.4
CN4607900000000,46,079,Lake County, SD,Mar-18,6560,6289,271,4.1
CN4607900000000,46,079,Lake County, SD,Apr-18(p),6647,6387,260,3.9
CN4705900000000,47,059,Greene County, TN,Mar-17,30680,29234,1446,4.7
CN4705900000000,47,059,Greene County, TN,Apr-17,30649,29491,1158,3.8
CN4705900000000,47,059,Greene County, TN,May-17,30566,29491,1075,3.5
CN4705900000000,47,059,Greene County, TN,Jun-17,30915,29466,1449,4.7
CN4705900000000,47,059,Greene County, TN,Jul-17,31010,29569,1441,4.6
CN4705900000000,47,059,Greene County, TN,Aug-17,30957,29562,1395,4.5
CN4705900000000,47,059,Greene County, TN,Sep-17,31101,29777,1324,4.3
CN4705900000000,47,059,Greene County, TN,Oct-17,30975,29712,1263,4.1
CN4705900000000,47,059,Greene County, TN,Nov-17,30782,29687,1095,3.6
CN4705900000000,47,059,Greene County, TN,Dec-17,30763,29529,1234,4.0
CN4705900000000,47,059,Greene County, TN,Jan-18,30801,29316,1485,4.8
CN4705900000000,47,059,Greene County, TN,Feb-18,31070,29637,1433,4.6
CN4705900000000,47,059,Greene County, TN,Mar-18,30918,29621,1297,4.2
CN4705900000000,47,059,Greene County, TN,Apr-18(p),30978,29984,994,3.2
CN1813500000000,18,135,Randolph County, IN,Mar-17,11861,11327,534,4.5
CN1813500000000,18,135,Randolph County, IN,Apr-17,11739,11292,447,3.8
CN1813500000000,18,135,Randolph County, IN,May-17,12205,11753,452,3.7
CN1813500000000,18,135,Randolph County, IN,Jun-17,12224,11737,487,4.0
CN1813500000000,18,135,Randolph County, IN,Jul-17,11561,11078,483,4.2
CN1813500000000,18,135,Randolph County, IN,Aug-17,11828,11302,526,4.4
CN1813500000000,18,135,Randolph County, IN,Sep-17,11748,11298,450,3.8
CN1813500000000,18,135,Randolph County, IN,Oct-17,11967,11552,415,3.5
CN1813500000000,18,135,Randolph County, IN,Nov-17,11865,11451,414,3.5
CN1813500000000,18,135,Randolph County, IN,Dec-17,11628,11221,407,3.5
CN1813500000000,18,135,Randolph County, IN,Jan-18,11198,10706,492,4.4
CN1813500000000,18,135,Randolph County, IN,Feb-18,11307,10770,537,4.7
CN1813500000000,18,135,Randolph County, IN,Mar-18,11506,11044,462,4.0
CN1813500000000,18,135,Randolph County, IN,Apr-18(p),11504,11101,403,3.5
CN1911500000000,19,115,Louisa County, IA,Mar-17,6054,5815,239,3.9
CN1911500000000,19,115,Louisa County, IA,Apr-17,6081,5887,194,3.2
CN1911500000000,19,115,Louisa County, IA,May-17,6060,5873,187,3.1
CN1911500000000,19,115,Louisa County, IA,Jun-17,6162,5956,206,3.3
CN1911500000000,19,115,Louisa County, IA,Jul-17,6168,5973,195,3.2
CN1911500000000,19,115,Louisa County, IA,Aug-17,6065,5874,191,3.1
CN1911500000000,19,115,Louisa County, IA,Sep-17,6024,5856,168,2.8
CN1911500000000,19,115,Louisa County, IA,Oct-17,6047,5911,136,2.2
CN1911500000000,19,115,Louisa County, IA,Nov-17,5986,5840,146,2.4
CN1911500000000,19,115,Louisa County, IA,Dec-17,5946,5781,165,2.8
CN1911500000000,19,115,Louisa County, IA,Jan-18,5894,5669,225,3.8
CN1911500000000,19,115,Louisa County, IA,Feb-18,5969,5741,228,3.8
CN1911500000000,19,115,Louisa County, IA,Mar-18,5959,5771,188,3.2
CN1911500000000,19,115,Louisa County, IA,Apr-18(p),5966,5812,154,2.6
CN5301500000000,53,015,Cowlitz County, WA,Mar-17,46177,43285,2892,6.3
CN5301500000000,53,015,Cowlitz County, WA,Apr-17,45742,43034,2708,5.9
CN5301500000000,53,015,Cowlitz County, WA,May-17,45694,43028,2666,5.8
CN5301500000000,53,015,Cowlitz County, WA,Jun-17,45796,43155,2641,5.8
CN5301500000000,53,015,Cowlitz County, WA,Jul-17,45681,43033,2648,5.8
CN5301500000000,53,015,Cowlitz County, WA,Aug-17,45749,43063,2686,5.9
CN5301500000000,53,015,Cowlitz County, WA,Sep-17,45842,43288,2554,5.6
CN5301500000000,53,015,Cowlitz County, WA,Oct-17,46232,43770,2462,5.3
CN5301500000000,53,015,Cowlitz County, WA,Nov-17,46388,43727,2661,5.7
CN5301500000000,53,015,Cowlitz County, WA,Dec-17,46608,43684,2924,6.3
CN5301500000000,53,015,Cowlitz County, WA,Jan-18,46050,42909,3141,6.8
CN5301500000000,53,015,Cowlitz County, WA,Feb-18,46013,42836,3177,6.9
CN5301500000000,53,015,Cowlitz County, WA,Mar-18,46220,43142,3078,6.7
CN5301500000000,53,015,Cowlitz County, WA,Apr-18(p),45789,42933,2856,6.2
CN2918600000000,29,186,Ste. Genevieve County, MO,Mar-17,8890,8536,354,4.0
CN2918600000000,29,186,Ste. Genevieve County, MO,Apr-17,9008,8704,304,3.4
CN2918600000000,29,186,Ste. Genevieve County, MO,May-17,8980,8677,303,3.4
CN2918600000000,29,186,Ste. Genevieve County, MO,Jun-17,9189,8822,367,4.0
CN2918600000000,29,186,Ste. Genevieve County, MO,Jul-17,8977,8602,375,4.2
CN2918600000000,29,186,Ste. Genevieve County, MO,Aug-17,8994,8646,348,3.9
CN2918600000000,29,186,Ste. Genevieve County, MO,Sep-17,8950,8688,262,2.9
CN2918600000000,29,186,Ste. Genevieve County, MO,Oct-17,8868,8686,182,2.1
CN2918600000000,29,186,Ste. Genevieve County, MO,Nov-17,8876,8628,248,2.8
CN2918600000000,29,186,Ste. Genevieve County, MO,Dec-17,8815,8545,270,3.1
CN2918600000000,29,186,Ste. Genevieve County, MO,Jan-18,8776,8425,351,4.0
CN2918600000000,29,186,Ste. Genevieve County, MO,Feb-18,8895,8525,370,4.2
CN2918600000000,29,186,Ste. Genevieve County, MO,Mar-18,8859,8550,309,3.5
CN2918600000000,29,186,Ste. Genevieve County, MO,Apr-18(p),8957,8687,270,3.0
CN2703500000000,27,035,Crow Wing County, MN,Mar-17,31356,29391,1965,6.3
CN2703500000000,27,035,Crow Wing County, MN,Apr-17,31684,30301,1383,4.4
CN2703500000000,27,035,Crow Wing County, MN,May-17,32385,31290,1095,3.4
CN2703500000000,27,035,Crow Wing County, MN,Jun-17,33780,32613,1167,3.5
CN2703500000000,27,035,Crow Wing County, MN,Jul-17,33391,32270,1121,3.4
CN2703500000000,27,035,Crow Wing County, MN,Aug-17,33255,32123,1132,3.4
CN2703500000000,27,035,Crow Wing County, MN,Sep-17,32678,31675,1003,3.1
CN2703500000000,27,035,Crow Wing County, MN,Oct-17,32263,31409,854,2.6
CN2703500000000,27,035,Crow Wing County, MN,Nov-17,32890,31447,1443,4.4
CN2703500000000,27,035,Crow Wing County, MN,Dec-17,33205,31383,1822,5.5
CN2703500000000,27,035,Crow Wing County, MN,Jan-18,33482,31389,2093,6.3
CN2703500000000,27,035,Crow Wing County, MN,Feb-18,33352,31417,1935,5.8
CN2703500000000,27,035,Crow Wing County, MN,Mar-18,33215,31363,1852,5.6
CN2703500000000,27,035,Crow Wing County, MN,Apr-18(p),33847,32437,1410,4.2
CN1706700000000,17,067,Hancock County, IL,Mar-17,8546,8080,466,5.5
CN1706700000000,17,067,Hancock County, IL,Apr-17,8705,8328,377,4.3
CN1706700000000,17,067,Hancock County, IL,May-17,8659,8269,390,4.5
CN1706700000000,17,067,Hancock County, IL,Jun-17,8770,8353,417,4.8
CN1706700000000,17,067,Hancock County, IL,Jul-17,8429,7990,439,5.2
CN1706700000000,17,067,Hancock County, IL,Aug-17,8509,8053,456,5.4
CN1706700000000,17,067,Hancock County, IL,Sep-17,8389,7985,404,4.8
CN1706700000000,17,067,Hancock County, IL,Oct-17,8397,8046,351,4.2
CN1706700000000,17,067,Hancock County, IL,Nov-17,8320,7956,364,4.4
CN1706700000000,17,067,Hancock County, IL,Dec-17,8139,7776,363,4.5
CN1706700000000,17,067,Hancock County, IL,Jan-18,8082,7664,418,5.2
CN1706700000000,17,067,Hancock County, IL,Feb-18,8170,7795,375,4.6
CN1706700000000,17,067,Hancock County, IL,Mar-18,8445,8070,375,4.4
CN1706700000000,17,067,Hancock County, IL,Apr-18(p),8600,8297,303,3.5
CN2302300000000,23,023,Sagadahoc County, ME,Mar-17,19201,18612,589,3.1
CN2302300000000,23,023,Sagadahoc County, ME,Apr-17,19261,18702,559,2.9
CN2302300000000,23,023,Sagadahoc County, ME,May-17,19380,18837,543,2.8
CN2302300000000,23,023,Sagadahoc County, ME,Jun-17,19615,19048,567,2.9
CN2302300000000,23,023,Sagadahoc County, ME,Jul-17,19876,19333,543,2.7
CN2302300000000,23,023,Sagadahoc County, ME,Aug-17,19851,19363,488,2.5
CN2302300000000,23,023,Sagadahoc County, ME,Sep-17,19521,19070,451,2.3
CN2302300000000,23,023,Sagadahoc County, ME,Oct-17,19509,19068,441,2.3
CN2302300000000,23,023,Sagadahoc County, ME,Nov-17,19325,18850,475,2.5
CN2302300000000,23,023,Sagadahoc County, ME,Dec-17,19122,18733,389,2.0
CN2302300000000,23,023,Sagadahoc County, ME,Jan-18,19094,18580,514,2.7
CN2302300000000,23,023,Sagadahoc County, ME,Feb-18,19143,18645,498,2.6
CN2302300000000,23,023,Sagadahoc County, ME,Mar-18,19461,18961,500,2.6
CN2302300000000,23,023,Sagadahoc County, ME,Apr-18(p),19585,19097,488,2.5
CN2400300000000,24,003,Anne Arundel County, MD,Mar-17,306513,295740,10773,3.5
CN2400300000000,24,003,Anne Arundel County, MD,Apr-17,307274,296829,10445,3.4
CN2400300000000,24,003,Anne Arundel County, MD,May-17,308578,298021,10557,3.4
CN2400300000000,24,003,Anne Arundel County, MD,Jun-17,312121,299984,12137,3.9
CN2400300000000,24,003,Anne Arundel County, MD,Jul-17,314736,302829,11907,3.8
CN2400300000000,24,003,Anne Arundel County, MD,Aug-17,311806,300221,11585,3.7
CN2400300000000,24,003,Anne Arundel County, MD,Sep-17,310808,300488,10320,3.3
CN2400300000000,24,003,Anne Arundel County, MD,Oct-17,310422,299810,10612,3.4
CN2400300000000,24,003,Anne Arundel County, MD,Nov-17,310333,299693,10640,3.4
CN2400300000000,24,003,Anne Arundel County, MD,Dec-17,307260,297640,9620,3.1
CN2400300000000,24,003,Anne Arundel County, MD,Jan-18,307641,295676,11965,3.9
CN2400300000000,24,003,Anne Arundel County, MD,Feb-18,309084,296940,12144,3.9
CN2400300000000,24,003,Anne Arundel County, MD,Mar-18,310643,298644,11999,3.9
CN2400300000000,24,003,Anne Arundel County, MD,Apr-18(p),308954,298926,10028,3.2
CN2607300000000,26,073,Isabella County, MI,Mar-17,35305,33736,1569,4.4
CN2607300000000,26,073,Isabella County, MI,Apr-17,35370,34106,1264,3.6
CN2607300000000,26,073,Isabella County, MI,May-17,35477,34018,1459,4.1
CN2607300000000,26,073,Isabella County, MI,Jun-17,35583,33733,1850,5.2
CN2607300000000,26,073,Isabella County, MI,Jul-17,35870,33754,2116,5.9
CN2607300000000,26,073,Isabella County, MI,Aug-17,35713,33874,1839,5.1
CN2607300000000,26,073,Isabella County, MI,Sep-17,35659,34107,1552,4.4
CN2607300000000,26,073,Isabella County, MI,Oct-17,35403,33978,1425,4.0
CN2607300000000,26,073,Isabella County, MI,Nov-17,35512,34077,1435,4.0
CN2607300000000,26,073,Isabella County, MI,Dec-17,35271,33811,1460,4.1
CN2607300000000,26,073,Isabella County, MI,Jan-18,35290,33485,1805,5.1
CN2607300000000,26,073,Isabella County, MI,Feb-18,35733,33781,1952,5.5
CN2607300000000,26,073,Isabella County, MI,Mar-18,35525,33882,1643,4.6
CN2607300000000,26,073,Isabella County, MI,Apr-18(p),35650,34235,1415,4.0
CN2117100000000,21,171,Monroe County, KY,Mar-17,4896,4684,212,4.3
CN2117100000000,21,171,Monroe County, KY,Apr-17,4986,4794,192,3.9
CN2117100000000,21,171,Monroe County, KY,May-17,4963,4765,198,4.0
CN2117100000000,21,171,Monroe County, KY,Jun-17,4985,4774,211,4.2
CN2117100000000,21,171,Monroe County, KY,Jul-17,4744,4546,198,4.2
CN2117100000000,21,171,Monroe County, KY,Aug-17,4675,4507,168,3.6
CN2117100000000,21,171,Monroe County, KY,Sep-17,4835,4676,159,3.3
CN2117100000000,21,171,Monroe County, KY,Oct-17,4834,4682,152,3.1
CN2117100000000,21,171,Monroe County, KY,Nov-17,4833,4691,142,2.9
CN2117100000000,21,171,Monroe County, KY,Dec-17,4806,4673,133,2.8
CN2117100000000,21,171,Monroe County, KY,Jan-18,4871,4703,168,3.4
CN2117100000000,21,171,Monroe County, KY,Feb-18,4848,4633,215,4.4
CN2117100000000,21,171,Monroe County, KY,Mar-18,4875,4674,201,4.1
CN2117100000000,21,171,Monroe County, KY,Apr-18(p),4925,4754,171,3.5
CN2206100000000,22,061,Lincoln Parish, LA,Mar-17,21816,20638,1178,5.4
CN2206100000000,22,061,Lincoln Parish, LA,Apr-17,22020,20929,1091,5.0
CN2206100000000,22,061,Lincoln Parish, LA,May-17,21973,20885,1088,5.0
CN2206100000000,22,061,Lincoln Parish, LA,Jun-17,21475,20098,1377,6.4
CN2206100000000,22,061,Lincoln Parish, LA,Jul-17,21177,19907,1270,6.0
CN2206100000000,22,061,Lincoln Parish, LA,Aug-17,20989,19750,1239,5.9
CN2206100000000,22,061,Lincoln Parish, LA,Sep-17,21751,20686,1065,4.9
CN2206100000000,22,061,Lincoln Parish, LA,Oct-17,21987,21075,912,4.1
CN2206100000000,22,061,Lincoln Parish, LA,Nov-17,22082,21125,957,4.3
CN2206100000000,22,061,Lincoln Parish, LA,Dec-17,21884,21016,868,4.0
CN2206100000000,22,061,Lincoln Parish, LA,Jan-18,21683,20705,978,4.5
CN2206100000000,22,061,Lincoln Parish, LA,Feb-18,22454,21572,882,3.9
CN2206100000000,22,061,Lincoln Parish, LA,Mar-18,22593,21608,985,4.4
CN2206100000000,22,061,Lincoln Parish, LA,Apr-18(p),22795,21813,982,4.3
CN3605900000000,36,059,Nassau County, NY,Mar-17,703607,675964,27643,3.9
CN3605900000000,36,059,Nassau County, NY,Apr-17,705081,678596,26485,3.8
CN3605900000000,36,059,Nassau County, NY,May-17,710808,682867,27941,3.9
CN3605900000000,36,059,Nassau County, NY,Jun-17,725034,694838,30196,4.2
CN3605900000000,36,059,Nassau County, NY,Jul-17,728245,696511,31734,4.4
CN3605900000000,36,059,Nassau County, NY,Aug-17,717878,686526,31352,4.4
CN3605900000000,36,059,Nassau County, NY,Sep-17,712932,682677,30255,4.2
CN3605900000000,36,059,Nassau County, NY,Oct-17,705745,676934,28811,4.1
CN3605900000000,36,059,Nassau County, NY,Nov-17,699615,670804,28811,4.1
CN3605900000000,36,059,Nassau County, NY,Dec-17,695697,668059,27638,4.0
CN3605900000000,36,059,Nassau County, NY,Jan-18,696187,664607,31580,4.5
CN3605900000000,36,059,Nassau County, NY,Feb-18,691836,659341,32495,4.7
CN3605900000000,36,059,Nassau County, NY,Mar-18,694968,665505,29463,4.2
CN3605900000000,36,059,Nassau County, NY,Apr-18(p),701139,674299,26840,3.8
CN2106500000000,21,065,Estill County, KY,Mar-17,5515,5170,345,6.3
CN2106500000000,21,065,Estill County, KY,Apr-17,5501,5195,306,5.6
CN2106500000000,21,065,Estill County, KY,May-17,5499,5180,319,5.8
CN2106500000000,21,065,Estill County, KY,Jun-17,5430,5068,362,6.7
CN2106500000000,21,065,Estill County, KY,Jul-17,5272,4939,333,6.3
CN2106500000000,21,065,Estill County, KY,Aug-17,5088,4789,299,5.9
CN2106500000000,21,065,Estill County, KY,Sep-17,5393,5093,300,5.6
CN2106500000000,21,065,Estill County, KY,Oct-17,5343,5074,269,5.0
CN2106500000000,21,065,Estill County, KY,Nov-17,5356,5089,267,5.0
CN2106500000000,21,065,Estill County, KY,Dec-17,5368,5086,282,5.3
CN2106500000000,21,065,Estill County, KY,Jan-18,5403,5083,320,5.9
CN2106500000000,21,065,Estill County, KY,Feb-18,5579,5220,359,6.4
CN2106500000000,21,065,Estill County, KY,Mar-18,5626,5298,328,5.8
CN2106500000000,21,065,Estill County, KY,Apr-18(p),5576,5311,265,4.8
CN4823300000000,48,233,Hutchinson County, TX,Mar-17,9712,9129,583,6.0
CN4823300000000,48,233,Hutchinson County, TX,Apr-17,9676,9075,601,6.2
CN4823300000000,48,233,Hutchinson County, TX,May-17,9632,9035,597,6.2
CN4823300000000,48,233,Hutchinson County, TX,Jun-17,9566,8927,639,6.7
CN4823300000000,48,233,Hutchinson County, TX,Jul-17,9275,8672,603,6.5
CN4823300000000,48,233,Hutchinson County, TX,Aug-17,9167,8599,568,6.2
CN4823300000000,48,233,Hutchinson County, TX,Sep-17,9089,8584,505,5.6
CN4823300000000,48,233,Hutchinson County, TX,Oct-17,9026,8566,460,5.1
CN4823300000000,48,233,Hutchinson County, TX,Nov-17,9036,8567,469,5.2
CN4823300000000,48,233,Hutchinson County, TX,Dec-17,9111,8639,472,5.2
CN4823300000000,48,233,Hutchinson County, TX,Jan-18,9201,8676,525,5.7
CN4823300000000,48,233,Hutchinson County, TX,Feb-18,9255,8751,504,5.4
CN4823300000000,48,233,Hutchinson County, TX,Mar-18,9307,8824,483,5.2
CN4823300000000,48,233,Hutchinson County, TX,Apr-18(p),9004,8553,451,5.0
CN2714100000000,27,141,Sherburne County, MN,Mar-17,51618,49118,2500,4.8
CN2714100000000,27,141,Sherburne County, MN,Apr-17,51378,49468,1910,3.7
CN2714100000000,27,141,Sherburne County, MN,May-17,51271,49652,1619,3.2
CN2714100000000,27,141,Sherburne County, MN,Jun-17,51698,49857,1841,3.6
CN2714100000000,27,141,Sherburne County, MN,Jul-17,52138,50417,1721,3.3
CN2714100000000,27,141,Sherburne County, MN,Aug-17,51951,50220,1731,3.3
CN2714100000000,27,141,Sherburne County, MN,Sep-17,51746,50256,1490,2.9
CN2714100000000,27,141,Sherburne County, MN,Oct-17,51335,50057,1278,2.5
CN2714100000000,27,141,Sherburne County, MN,Nov-17,51494,49986,1508,2.9
CN2714100000000,27,141,Sherburne County, MN,Dec-17,51566,49570,1996,3.9
CN2714100000000,27,141,Sherburne County, MN,Jan-18,52388,49878,2510,4.8
CN2714100000000,27,141,Sherburne County, MN,Feb-18,52612,50232,2380,4.5
CN2714100000000,27,141,Sherburne County, MN,Mar-18,52471,50196,2275,4.3
CN2714100000000,27,141,Sherburne County, MN,Apr-18(p),52276,50458,1818,3.5
CN4901700000000,49,017,Garfield County, UT,Mar-17,2648,2365,283,10.7
CN4901700000000,49,017,Garfield County, UT,Apr-17,2984,2783,201,6.7
CN4901700000000,49,017,Garfield County, UT,May-17,3136,2955,181,5.8
CN4901700000000,49,017,Garfield County, UT,Jun-17,3331,3169,162,4.9
CN4901700000000,49,017,Garfield County, UT,Jul-17,3311,3163,148,4.5
CN4901700000000,49,017,Garfield County, UT,Aug-17,3307,3166,141,4.3
CN4901700000000,49,017,Garfield County, UT,Sep-17,3211,3089,122,3.8
CN4901700000000,49,017,Garfield County, UT,Oct-17,3066,2944,122,4.0
CN4901700000000,49,017,Garfield County, UT,Nov-17,2695,2513,182,6.8
CN4901700000000,49,017,Garfield County, UT,Dec-17,2642,2302,340,12.9
CN4901700000000,49,017,Garfield County, UT,Jan-18,2603,2178,425,16.3
CN4901700000000,49,017,Garfield County, UT,Feb-18,2524,2147,377,14.9
CN4901700000000,49,017,Garfield County, UT,Mar-18,2724,2425,299,11.0
CN4901700000000,49,017,Garfield County, UT,Apr-18(p),2984,2797,187,6.3
CN4812700000000,48,127,Dimmit County, TX,Mar-17,6339,5958,381,6.0
CN4812700000000,48,127,Dimmit County, TX,Apr-17,6192,5841,351,5.7
CN4812700000000,48,127,Dimmit County, TX,May-17,6199,5882,317,5.1
CN4812700000000,48,127,Dimmit County, TX,Jun-17,6127,5774,353,5.8
CN4812700000000,48,127,Dimmit County, TX,Jul-17,6505,6166,339,5.2
CN4812700000000,48,127,Dimmit County, TX,Aug-17,6554,6220,334,5.1
CN4812700000000,48,127,Dimmit County, TX,Sep-17,6812,6525,287,4.2
CN4812700000000,48,127,Dimmit County, TX,Oct-17,6875,6606,269,3.9
CN4812700000000,48,127,Dimmit County, TX,Nov-17,6854,6591,263,3.8
CN4812700000000,48,127,Dimmit County, TX,Dec-17,6802,6555,247,3.6
CN4812700000000,48,127,Dimmit County, TX,Jan-18,6918,6644,274,4.0
CN4812700000000,48,127,Dimmit County, TX,Feb-18,6927,6668,259,3.7
CN4812700000000,48,127,Dimmit County, TX,Mar-18,6850,6609,241,3.5
CN4812700000000,48,127,Dimmit County, TX,Apr-18(p),7075,6857,218,3.1
CN4005700000000,40,057,Harmon County, OK,Mar-17,1269,1220,49,3.9
CN4005700000000,40,057,Harmon County, OK,Apr-17,1304,1247,57,4.4
CN4005700000000,40,057,Harmon County, OK,May-17,1305,1242,63,4.8
CN4005700000000,40,057,Harmon County, OK,Jun-17,1301,1242,59,4.5
CN4005700000000,40,057,Harmon County, OK,Jul-17,1250,1197,53,4.2
CN4005700000000,40,057,Harmon County, OK,Aug-17,1279,1229,50,3.9
CN4005700000000,40,057,Harmon County, OK,Sep-17,1239,1190,49,4.0
CN4005700000000,40,057,Harmon County, OK,Oct-17,1319,1270,49,3.7
CN4005700000000,40,057,Harmon County, OK,Nov-17,1331,1294,37,2.8
CN4005700000000,40,057,Harmon County, OK,Dec-17,1290,1256,34,2.6
CN4005700000000,40,057,Harmon County, OK,Jan-18,1264,1229,35,2.8
CN4005700000000,40,057,Harmon County, OK,Feb-18,1233,1198,35,2.8
CN4005700000000,40,057,Harmon County, OK,Mar-18,1209,1174,35,2.9
CN4005700000000,40,057,Harmon County, OK,Apr-18(p),1197,1160,37,3.1
CN3402300000000,34,023,Middlesex County, NJ,Mar-17,439380,422081,17299,3.9
CN3402300000000,34,023,Middlesex County, NJ,Apr-17,439862,423013,16849,3.8
CN3402300000000,34,023,Middlesex County, NJ,May-17,440917,423506,17411,3.9
CN3402300000000,34,023,Middlesex County, NJ,Jun-17,449231,430555,18676,4.2
CN3402300000000,34,023,Middlesex County, NJ,Jul-17,453281,432041,21240,4.7
CN3402300000000,34,023,Middlesex County, NJ,Aug-17,449702,429382,20320,4.5
CN3402300000000,34,023,Middlesex County, NJ,Sep-17,441888,423404,18484,4.2
CN3402300000000,34,023,Middlesex County, NJ,Oct-17,439943,422668,17275,3.9
CN3402300000000,34,023,Middlesex County, NJ,Nov-17,439355,422553,16802,3.8
CN3402300000000,34,023,Middlesex County, NJ,Dec-17,437509,422097,15412,3.5
CN3402300000000,34,023,Middlesex County, NJ,Jan-18,435080,417489,17591,4.0
CN3402300000000,34,023,Middlesex County, NJ,Feb-18,438887,420625,18262,4.2
CN3402300000000,34,023,Middlesex County, NJ,Mar-18,436713,419190,17523,4.0
CN3402300000000,34,023,Middlesex County, NJ,Apr-18(p),434013,418647,15366,3.5
CN1329300000000,13,293,Upson County, GA,Mar-17,11376,10732,644,5.7
CN1329300000000,13,293,Upson County, GA,Apr-17,11299,10693,606,5.4
CN1329300000000,13,293,Upson County, GA,May-17,11305,10691,614,5.4
CN1329300000000,13,293,Upson County, GA,Jun-17,11315,10656,659,5.8
CN1329300000000,13,293,Upson County, GA,Jul-17,11277,10635,642,5.7
CN1329300000000,13,293,Upson County, GA,Aug-17,11210,10583,627,5.6
CN1329300000000,13,293,Upson County, GA,Sep-17,11342,10739,603,5.3
CN1329300000000,13,293,Upson County, GA,Oct-17,11252,10661,591,5.3
CN1329300000000,13,293,Upson County, GA,Nov-17,11196,10665,531,4.7
CN1329300000000,13,293,Upson County, GA,Dec-17,11289,10690,599,5.3
CN1329300000000,13,293,Upson County, GA,Jan-18,11401,10753,648,5.7
CN1329300000000,13,293,Upson County, GA,Feb-18,11364,10773,591,5.2
CN1329300000000,13,293,Upson County, GA,Mar-18,11340,10805,535,4.7
CN1329300000000,13,293,Upson County, GA,Apr-18(p),11267,10799,468,4.2
CN4716500000000,47,165,Sumner County, TN,Mar-17,94910,91859,3051,3.2
CN4716500000000,47,165,Sumner County, TN,Apr-17,95029,92469,2560,2.7
CN4716500000000,47,165,Sumner County, TN,May-17,95224,92792,2432,2.6
CN4716500000000,47,165,Sumner County, TN,Jun-17,96810,93653,3157,3.3
CN4716500000000,47,165,Sumner County, TN,Jul-17,97154,94156,2998,3.1
CN4716500000000,47,165,Sumner County, TN,Aug-17,96028,93149,2879,3.0
CN4716500000000,47,165,Sumner County, TN,Sep-17,96884,94345,2539,2.6
CN4716500000000,47,165,Sumner County, TN,Oct-17,96744,94309,2435,2.5
CN4716500000000,47,165,Sumner County, TN,Nov-17,96373,93866,2507,2.6
CN4716500000000,47,165,Sumner County, TN,Dec-17,96221,93819,2402,2.5
CN4716500000000,47,165,Sumner County, TN,Jan-18,96015,93204,2811,2.9
CN4716500000000,47,165,Sumner County, TN,Feb-18,97141,94396,2745,2.8
CN4716500000000,47,165,Sumner County, TN,Mar-18,97469,94763,2706,2.8
CN4716500000000,47,165,Sumner County, TN,Apr-18(p),98060,95830,2230,2.3
CN0104100000000,01,041,Crenshaw County, AL,Mar-17,6462,6151,311,4.8
CN0104100000000,01,041,Crenshaw County, AL,Apr-17,6324,6059,265,4.2
CN0104100000000,01,041,Crenshaw County, AL,May-17,6354,6096,258,4.1
CN0104100000000,01,041,Crenshaw County, AL,Jun-17,6362,6062,300,4.7
CN0104100000000,01,041,Crenshaw County, AL,Jul-17,6541,6204,337,5.2
CN0104100000000,01,041,Crenshaw County, AL,Aug-17,6480,6217,263,4.1
CN0104100000000,01,041,Crenshaw County, AL,Sep-17,6639,6393,246,3.7
CN0104100000000,01,041,Crenshaw County, AL,Oct-17,6575,6339,236,3.6
CN0104100000000,01,041,Crenshaw County, AL,Nov-17,6424,6204,220,3.4
CN0104100000000,01,041,Crenshaw County, AL,Dec-17,6225,5995,230,3.7
CN0104100000000,01,041,Crenshaw County, AL,Jan-18,6183,5916,267,4.3
CN0104100000000,01,041,Crenshaw County, AL,Feb-18,6280,6006,274,4.4
CN0104100000000,01,041,Crenshaw County, AL,Mar-18,6317,6065,252,4.0
CN0104100000000,01,041,Crenshaw County, AL,Apr-18(p),6322,6106,216,3.4
CN2903700000000,29,037,Cass County, MO,Mar-17,54277,52196,2081,3.8
CN2903700000000,29,037,Cass County, MO,Apr-17,54365,52650,1715,3.2
CN2903700000000,29,037,Cass County, MO,May-17,54261,52477,1784,3.3
CN2903700000000,29,037,Cass County, MO,Jun-17,54895,52989,1906,3.5
CN2903700000000,29,037,Cass County, MO,Jul-17,55573,53406,2167,3.9
CN2903700000000,29,037,Cass County, MO,Aug-17,54913,52645,2268,4.1
CN2903700000000,29,037,Cass County, MO,Sep-17,54629,53031,1598,2.9
CN2903700000000,29,037,Cass County, MO,Oct-17,54407,52964,1443,2.7
CN2903700000000,29,037,Cass County, MO,Nov-17,54192,52632,1560,2.9
CN2903700000000,29,037,Cass County, MO,Dec-17,54136,52461,1675,3.1
CN2903700000000,29,037,Cass County, MO,Jan-18,54008,51899,2109,3.9
CN2903700000000,29,037,Cass County, MO,Feb-18,54407,52348,2059,3.8
CN2903700000000,29,037,Cass County, MO,Mar-18,54408,52475,1933,3.6
CN2903700000000,29,037,Cass County, MO,Apr-18(p),54431,52729,1702,3.1
CN5511500000000,55,115,Shawano County, WI,Mar-17,21185,20338,847,4.0
CN5511500000000,55,115,Shawano County, WI,Apr-17,21467,20769,698,3.3
CN5511500000000,55,115,Shawano County, WI,May-17,21598,20960,638,3.0
CN5511500000000,55,115,Shawano County, WI,Jun-17,22481,21710,771,3.4
CN5511500000000,55,115,Shawano County, WI,Jul-17,21952,21258,694,3.2
CN5511500000000,55,115,Shawano County, WI,Aug-17,21612,20962,650,3.0
CN5511500000000,55,115,Shawano County, WI,Sep-17,21509,20927,582,2.7
CN5511500000000,55,115,Shawano County, WI,Oct-17,21593,21050,543,2.5
CN5511500000000,55,115,Shawano County, WI,Nov-17,21773,21199,574,2.6
CN5511500000000,55,115,Shawano County, WI,Dec-17,21829,21238,591,2.7
CN5511500000000,55,115,Shawano County, WI,Jan-18,21687,20979,708,3.3
CN5511500000000,55,115,Shawano County, WI,Feb-18,21528,20743,785,3.6
CN5511500000000,55,115,Shawano County, WI,Mar-18,21731,20978,753,3.5
CN5511500000000,55,115,Shawano County, WI,Apr-18(p),21808,21138,670,3.1
CN2018300000000,20,183,Smith County, KS,Mar-17,1947,1886,61,3.1
CN2018300000000,20,183,Smith County, KS,Apr-17,1932,1877,55,2.8
CN2018300000000,20,183,Smith County, KS,May-17,1949,1892,57,2.9
CN2018300000000,20,183,Smith County, KS,Jun-17,2010,1953,57,2.8
CN2018300000000,20,183,Smith County, KS,Jul-17,1915,1855,60,3.1
CN2018300000000,20,183,Smith County, KS,Aug-17,1936,1881,55,2.8
CN2018300000000,20,183,Smith County, KS,Sep-17,1989,1942,47,2.4
CN2018300000000,20,183,Smith County, KS,Oct-17,2057,2015,42,2.0
CN2018300000000,20,183,Smith County, KS,Nov-17,2012,1964,48,2.4
CN2018300000000,20,183,Smith County, KS,Dec-17,1995,1950,45,2.3
CN2018300000000,20,183,Smith County, KS,Jan-18,1969,1917,52,2.6
CN2018300000000,20,183,Smith County, KS,Feb-18,1968,1915,53,2.7
CN2018300000000,20,183,Smith County, KS,Mar-18,1899,1846,53,2.8
CN2018300000000,20,183,Smith County, KS,Apr-18(p),1776,1727,49,2.8
CN3113100000000,31,131,Otoe County, NE,Mar-17,8105,7813,292,3.6
CN3113100000000,31,131,Otoe County, NE,Apr-17,8198,7938,260,3.2
CN3113100000000,31,131,Otoe County, NE,May-17,8241,7984,257,3.1
CN3113100000000,31,131,Otoe County, NE,Jun-17,8371,8067,304,3.6
CN3113100000000,31,131,Otoe County, NE,Jul-17,8343,8023,320,3.8
CN3113100000000,31,131,Otoe County, NE,Aug-17,8151,7867,284,3.5
CN3113100000000,31,131,Otoe County, NE,Sep-17,7940,7702,238,3.0
CN3113100000000,31,131,Otoe County, NE,Oct-17,7985,7760,225,2.8
CN3113100000000,31,131,Otoe County, NE,Nov-17,7997,7775,222,2.8
CN3113100000000,31,131,Otoe County, NE,Dec-17,7959,7728,231,2.9
CN3113100000000,31,131,Otoe County, NE,Jan-18,8035,7757,278,3.5
CN3113100000000,31,131,Otoe County, NE,Feb-18,8048,7783,265,3.3
CN3113100000000,31,131,Otoe County, NE,Mar-18,8076,7832,244,3.0
CN3113100000000,31,131,Otoe County, NE,Apr-18(p),8045,7804,241,3.0
CN1321700000000,13,217,Newton County, GA,Mar-17,51278,48505,2773,5.4
CN1321700000000,13,217,Newton County, GA,Apr-17,51226,48605,2621,5.1
CN1321700000000,13,217,Newton County, GA,May-17,51389,48713,2676,5.2
CN1321700000000,13,217,Newton County, GA,Jun-17,51612,48689,2923,5.7
CN1321700000000,13,217,Newton County, GA,Jul-17,51911,48991,2920,5.6
CN1321700000000,13,217,Newton County, GA,Aug-17,51567,48763,2804,5.4
CN1321700000000,13,217,Newton County, GA,Sep-17,51939,49398,2541,4.9
CN1321700000000,13,217,Newton County, GA,Oct-17,51754,49239,2515,4.9
CN1321700000000,13,217,Newton County, GA,Nov-17,51895,49415,2480,4.8
CN1321700000000,13,217,Newton County, GA,Dec-17,51899,49401,2498,4.8
CN1321700000000,13,217,Newton County, GA,Jan-18,52035,49326,2709,5.2
CN1321700000000,13,217,Newton County, GA,Feb-18,52714,50062,2652,5.0
CN1321700000000,13,217,Newton County, GA,Mar-18,52694,50239,2455,4.7
CN1321700000000,13,217,Newton County, GA,Apr-18(p),52307,50092,2215,4.2
CN0505300000000,05,053,Grant County, AR,Mar-17,8283,8034,249,3.0
CN0505300000000,05,053,Grant County, AR,Apr-17,8329,8104,225,2.7
CN0505300000000,05,053,Grant County, AR,May-17,8387,8126,261,3.1
CN0505300000000,05,053,Grant County, AR,Jun-17,8485,8196,289,3.4
CN0505300000000,05,053,Grant County, AR,Jul-17,8600,8295,305,3.5
CN0505300000000,05,053,Grant County, AR,Aug-17,8454,8178,276,3.3
CN0505300000000,05,053,Grant County, AR,Sep-17,8408,8153,255,3.0
CN0505300000000,05,053,Grant County, AR,Oct-17,8394,8164,230,2.7
CN0505300000000,05,053,Grant County, AR,Nov-17,8351,8113,238,2.8
CN0505300000000,05,053,Grant County, AR,Dec-17,8291,8039,252,3.0
CN0505300000000,05,053,Grant County, AR,Jan-18,8162,7868,294,3.6
CN0505300000000,05,053,Grant County, AR,Feb-18,8237,7955,282,3.4
CN0505300000000,05,053,Grant County, AR,Mar-18,8298,8030,268,3.2
CN0505300000000,05,053,Grant County, AR,Apr-18(p),8274,8033,241,2.9
CN1318700000000,13,187,Lumpkin County, GA,Mar-17,16681,16005,676,4.1
CN1318700000000,13,187,Lumpkin County, GA,Apr-17,17099,16457,642,3.8
CN1318700000000,13,187,Lumpkin County, GA,May-17,16696,16055,641,3.8
CN1318700000000,13,187,Lumpkin County, GA,Jun-17,16528,15760,768,4.6
CN1318700000000,13,187,Lumpkin County, GA,Jul-17,16550,15821,729,4.4
CN1318700000000,13,187,Lumpkin County, GA,Aug-17,16797,16095,702,4.2
CN1318700000000,13,187,Lumpkin County, GA,Sep-17,17079,16421,658,3.9
CN1318700000000,13,187,Lumpkin County, GA,Oct-17,16944,16327,617,3.6
CN1318700000000,13,187,Lumpkin County, GA,Nov-17,16942,16346,596,3.5
CN1318700000000,13,187,Lumpkin County, GA,Dec-17,16845,16255,590,3.5
CN1318700000000,13,187,Lumpkin County, GA,Jan-18,16919,16286,633,3.7
CN1318700000000,13,187,Lumpkin County, GA,Feb-18,17141,16465,676,3.9
CN1318700000000,13,187,Lumpkin County, GA,Mar-18,17157,16568,589,3.4
CN1318700000000,13,187,Lumpkin County, GA,Apr-18(p),17330,16810,520,3.0
CN5508500000000,55,085,Oneida County, WI,Mar-17,17870,16917,953,5.3
CN5508500000000,55,085,Oneida County, WI,Apr-17,17867,17121,746,4.2
CN5508500000000,55,085,Oneida County, WI,May-17,18247,17674,573,3.1
CN5508500000000,55,085,Oneida County, WI,Jun-17,19171,18497,674,3.5
CN5508500000000,55,085,Oneida County, WI,Jul-17,19790,19156,634,3.2
CN5508500000000,55,085,Oneida County, WI,Aug-17,19405,18751,654,3.4
CN5508500000000,55,085,Oneida County, WI,Sep-17,18682,18135,547,2.9
CN5508500000000,55,085,Oneida County, WI,Oct-17,18294,17782,512,2.8
CN5508500000000,55,085,Oneida County, WI,Nov-17,18033,17448,585,3.2
CN5508500000000,55,085,Oneida County, WI,Dec-17,18025,17296,729,4.0
CN5508500000000,55,085,Oneida County, WI,Jan-18,17611,16872,739,4.2
CN5508500000000,55,085,Oneida County, WI,Feb-18,17791,16920,871,4.9
CN5508500000000,55,085,Oneida County, WI,Mar-18,17809,16959,850,4.8
CN5508500000000,55,085,Oneida County, WI,Apr-18(p),17960,17207,753,4.2
CN4845500000000,48,455,Trinity County, TX,Mar-17,5516,5192,324,5.9
CN4845500000000,48,455,Trinity County, TX,Apr-17,5511,5206,305,5.5
CN4845500000000,48,455,Trinity County, TX,May-17,5449,5163,286,5.2
CN4845500000000,48,455,Trinity County, TX,Jun-17,5477,5184,293,5.3
CN4845500000000,48,455,Trinity County, TX,Jul-17,5331,5038,293,5.5
CN4845500000000,48,455,Trinity County, TX,Aug-17,5334,5030,304,5.7
CN4845500000000,48,455,Trinity County, TX,Sep-17,5313,5023,290,5.5
CN4845500000000,48,455,Trinity County, TX,Oct-17,5257,4998,259,4.9
CN4845500000000,48,455,Trinity County, TX,Nov-17,5227,4956,271,5.2
CN4845500000000,48,455,Trinity County, TX,Dec-17,5200,4946,254,4.9
CN4845500000000,48,455,Trinity County, TX,Jan-18,5193,4898,295,5.7
CN4845500000000,48,455,Trinity County, TX,Feb-18,5287,4985,302,5.7
CN4845500000000,48,455,Trinity County, TX,Mar-18,5379,5082,297,5.5
CN4845500000000,48,455,Trinity County, TX,Apr-18(p),5387,5115,272,5.0
CN4104500000000,41,045,Malheur County, OR,Mar-17,12414,11807,607,4.9
CN4104500000000,41,045,Malheur County, OR,Apr-17,12765,12264,501,3.9
CN4104500000000,41,045,Malheur County, OR,May-17,12610,12127,483,3.8
CN4104500000000,41,045,Malheur County, OR,Jun-17,12679,12083,596,4.7
CN4104500000000,41,045,Malheur County, OR,Jul-17,12905,12081,824,6.4
CN4104500000000,41,045,Malheur County, OR,Aug-17,12787,12152,635,5.0
CN4104500000000,41,045,Malheur County, OR,Sep-17,12863,12355,508,3.9
CN4104500000000,41,045,Malheur County, OR,Oct-17,12871,12382,489,3.8
CN4104500000000,41,045,Malheur County, OR,Nov-17,12630,12109,521,4.1
CN4104500000000,41,045,Malheur County, OR,Dec-17,12417,11845,572,4.6
CN4104500000000,41,045,Malheur County, OR,Jan-18,12372,11673,699,5.6
CN4104500000000,41,045,Malheur County, OR,Feb-18,12383,11726,657,5.3
CN4104500000000,41,045,Malheur County, OR,Mar-18,12264,11677,587,4.8
CN4104500000000,41,045,Malheur County, OR,Apr-18(p),12450,11940,510,4.1
CN4829300000000,48,293,Limestone County, TX,Mar-17,8421,7923,498,5.9
CN4829300000000,48,293,Limestone County, TX,Apr-17,8388,7944,444,5.3
CN4829300000000,48,293,Limestone County, TX,May-17,8349,7914,435,5.2
CN4829300000000,48,293,Limestone County, TX,Jun-17,8426,7948,478,5.7
CN4829300000000,48,293,Limestone County, TX,Jul-17,8292,7802,490,5.9
CN4829300000000,48,293,Limestone County, TX,Aug-17,8289,7806,483,5.8
CN4829300000000,48,293,Limestone County, TX,Sep-17,8290,7851,439,5.3
CN4829300000000,48,293,Limestone County, TX,Oct-17,8229,7829,400,4.9
CN4829300000000,48,293,Limestone County, TX,Nov-17,8226,7809,417,5.1
CN4829300000000,48,293,Limestone County, TX,Dec-17,8196,7802,394,4.8
CN4829300000000,48,293,Limestone County, TX,Jan-18,8183,7746,437,5.3
CN4829300000000,48,293,Limestone County, TX,Feb-18,8232,7807,425,5.2
CN4829300000000,48,293,Limestone County, TX,Mar-18,8260,7821,439,5.3
CN4829300000000,48,293,Limestone County, TX,Apr-18(p),8220,7830,390,4.7
CN1912300000000,19,123,Mahaska County, IA,Mar-17,11482,11045,437,3.8
CN1912300000000,19,123,Mahaska County, IA,Apr-17,11547,11178,369,3.2
CN1912300000000,19,123,Mahaska County, IA,May-17,11515,11177,338,2.9
CN1912300000000,19,123,Mahaska County, IA,Jun-17,11514,11135,379,3.3
CN1912300000000,19,123,Mahaska County, IA,Jul-17,11495,11142,353,3.1
CN1912300000000,19,123,Mahaska County, IA,Aug-17,11340,10959,381,3.4
CN1912300000000,19,123,Mahaska County, IA,Sep-17,11540,11197,343,3.0
CN1912300000000,19,123,Mahaska County, IA,Oct-17,11436,11124,312,2.7
CN1912300000000,19,123,Mahaska County, IA,Nov-17,11385,11093,292,2.6
CN1912300000000,19,123,Mahaska County, IA,Dec-17,11328,11008,320,2.8
CN1912300000000,19,123,Mahaska County, IA,Jan-18,11318,10865,453,4.0
CN1912300000000,19,123,Mahaska County, IA,Feb-18,11386,10975,411,3.6
CN1912300000000,19,123,Mahaska County, IA,Mar-18,11352,11001,351,3.1
CN1912300000000,19,123,Mahaska County, IA,Apr-18(p),11438,11152,286,2.5
CN4811900000000,48,119,Delta County, TX,Mar-17,2623,2532,91,3.5
CN4811900000000,48,119,Delta County, TX,Apr-17,2623,2550,73,2.8
CN4811900000000,48,119,Delta County, TX,May-17,2621,2543,78,3.0
CN4811900000000,48,119,Delta County, TX,Jun-17,2627,2537,90,3.4
CN4811900000000,48,119,Delta County, TX,Jul-17,2604,2512,92,3.5
CN4811900000000,48,119,Delta County, TX,Aug-17,2597,2513,84,3.2
CN4811900000000,48,119,Delta County, TX,Sep-17,2621,2542,79,3.0
CN4811900000000,48,119,Delta County, TX,Oct-17,2595,2520,75,2.9
CN4811900000000,48,119,Delta County, TX,Nov-17,2592,2518,74,2.9
CN4811900000000,48,119,Delta County, TX,Dec-17,2590,2513,77,3.0
CN4811900000000,48,119,Delta County, TX,Jan-18,2599,2513,86,3.3
CN4811900000000,48,119,Delta County, TX,Feb-18,2653,2559,94,3.5
CN4811900000000,48,119,Delta County, TX,Mar-18,2672,2583,89,3.3
CN4811900000000,48,119,Delta County, TX,Apr-18(p),2650,2567,83,3.1
CN2101300000000,21,013,Bell County, KY,Mar-17,9093,8305,788,8.7
CN2101300000000,21,013,Bell County, KY,Apr-17,8861,8174,687,7.8
CN2101300000000,21,013,Bell County, KY,May-17,8917,8187,730,8.2
CN2101300000000,21,013,Bell County, KY,Jun-17,8935,8148,787,8.8
CN2101300000000,21,013,Bell County, KY,Jul-17,8732,7986,746,8.5
CN2101300000000,21,013,Bell County, KY,Aug-17,8646,7949,697,8.1
CN2101300000000,21,013,Bell County, KY,Sep-17,8692,8087,605,7.0
CN2101300000000,21,013,Bell County, KY,Oct-17,8615,8087,528,6.1
CN2101300000000,21,013,Bell County, KY,Nov-17,8582,8065,517,6.0
CN2101300000000,21,013,Bell County, KY,Dec-17,8647,8118,529,6.1
CN2101300000000,21,013,Bell County, KY,Jan-18,8602,8054,548,6.4
CN2101300000000,21,013,Bell County, KY,Feb-18,8680,8075,605,7.0
CN2101300000000,21,013,Bell County, KY,Mar-18,8787,8221,566,6.4
CN2101300000000,21,013,Bell County, KY,Apr-18(p),8713,8201,512,5.9
CN1711300000000,17,113,McLean County, IL,Mar-17,88899,85064,3835,4.3
CN1711300000000,17,113,McLean County, IL,Apr-17,89819,86668,3151,3.5
CN1711300000000,17,113,McLean County, IL,May-17,88038,84842,3196,3.6
CN1711300000000,17,113,McLean County, IL,Jun-17,86719,83054,3665,4.2
CN1711300000000,17,113,McLean County, IL,Jul-17,88106,84277,3829,4.3
CN1711300000000,17,113,McLean County, IL,Aug-17,87375,83715,3660,4.2
CN1711300000000,17,113,McLean County, IL,Sep-17,88683,85529,3154,3.6
CN1711300000000,17,113,McLean County, IL,Oct-17,89060,85879,3181,3.6
CN1711300000000,17,113,McLean County, IL,Nov-17,88955,85740,3215,3.6
CN1711300000000,17,113,McLean County, IL,Dec-17,87747,84609,3138,3.6
CN1711300000000,17,113,McLean County, IL,Jan-18,86587,83110,3477,4.0
CN1711300000000,17,113,McLean County, IL,Feb-18,89001,85828,3173,3.6
CN1711300000000,17,113,McLean County, IL,Mar-18,89886,86514,3372,3.8
CN1711300000000,17,113,McLean County, IL,Apr-18(p),90371,87615,2756,3.0
CN4210500000000,42,105,Potter County, PA,Mar-17,7297,6721,576,7.9
CN4210500000000,42,105,Potter County, PA,Apr-17,7244,6763,481,6.6
CN4210500000000,42,105,Potter County, PA,May-17,7326,6874,452,6.2
CN4210500000000,42,105,Potter County, PA,Jun-17,7431,6995,436,5.9
CN4210500000000,42,105,Potter County, PA,Jul-17,7465,7016,449,6.0
CN4210500000000,42,105,Potter County, PA,Aug-17,7315,6865,450,6.2
CN4210500000000,42,105,Potter County, PA,Sep-17,7152,6792,360,5.0
CN4210500000000,42,105,Potter County, PA,Oct-17,6996,6648,348,5.0
CN4210500000000,42,105,Potter County, PA,Nov-17,6919,6524,395,5.7
CN4210500000000,42,105,Potter County, PA,Dec-17,7001,6571,430,6.1
CN4210500000000,42,105,Potter County, PA,Jan-18,7102,6552,550,7.7
CN4210500000000,42,105,Potter County, PA,Feb-18,7140,6604,536,7.5
CN4210500000000,42,105,Potter County, PA,Mar-18,6962,6515,447,6.4
CN4210500000000,42,105,Potter County, PA,Apr-18(p),6899,6535,364,5.3
CN1806300000000,18,063,Hendricks County, IN,Mar-17,85435,82929,2506,2.9
CN1806300000000,18,063,Hendricks County, IN,Apr-17,86042,83989,2053,2.4
CN1806300000000,18,063,Hendricks County, IN,May-17,86297,84016,2281,2.6
CN1806300000000,18,063,Hendricks County, IN,Jun-17,87562,85010,2552,2.9
CN1806300000000,18,063,Hendricks County, IN,Jul-17,87806,85154,2652,3.0
CN1806300000000,18,063,Hendricks County, IN,Aug-17,87106,84189,2917,3.3
CN1806300000000,18,063,Hendricks County, IN,Sep-17,86581,84197,2384,2.8
CN1806300000000,18,063,Hendricks County, IN,Oct-17,85951,83689,2262,2.6
CN1806300000000,18,063,Hendricks County, IN,Nov-17,85989,83712,2277,2.6
CN1806300000000,18,063,Hendricks County, IN,Dec-17,85296,83182,2114,2.5
CN1806300000000,18,063,Hendricks County, IN,Jan-18,85412,82965,2447,2.9
CN1806300000000,18,063,Hendricks County, IN,Feb-18,86453,83886,2567,3.0
CN1806300000000,18,063,Hendricks County, IN,Mar-18,87387,85050,2337,2.7
CN1806300000000,18,063,Hendricks County, IN,Apr-18(p),87742,85625,2117,2.4
CN5152000000000,51,520,Bristol city, VA,Mar-17,7530,7185,345,4.6
CN5152000000000,51,520,Bristol city, VA,Apr-17,7498,7184,314,4.2
CN5152000000000,51,520,Bristol city, VA,May-17,7527,7197,330,4.4
CN5152000000000,51,520,Bristol city, VA,Jun-17,7459,7102,357,4.8
CN5152000000000,51,520,Bristol city, VA,Jul-17,7457,7094,363,4.9
CN5152000000000,51,520,Bristol city, VA,Aug-17,7471,7107,364,4.9
CN5152000000000,51,520,Bristol city, VA,Sep-17,7477,7155,322,4.3
CN5152000000000,51,520,Bristol city, VA,Oct-17,7430,7124,306,4.1
CN5152000000000,51,520,Bristol city, VA,Nov-17,7437,7126,311,4.2
CN5152000000000,51,520,Bristol city, VA,Dec-17,7403,7105,298,4.0
CN5152000000000,51,520,Bristol city, VA,Jan-18,7432,7120,312,4.2
CN5152000000000,51,520,Bristol city, VA,Feb-18,7526,7222,304,4.0
CN5152000000000,51,520,Bristol city, VA,Mar-18,7601,7288,313,4.1
CN5152000000000,51,520,Bristol city, VA,Apr-18(p),7571,7318,253,3.3
CN1305500000000,13,055,Chattooga County, GA,Mar-17,10670,10139,531,5.0
CN1305500000000,13,055,Chattooga County, GA,Apr-17,10562,10087,475,4.5
CN1305500000000,13,055,Chattooga County, GA,May-17,10569,10073,496,4.7
CN1305500000000,13,055,Chattooga County, GA,Jun-17,10589,10064,525,5.0
CN1305500000000,13,055,Chattooga County, GA,Jul-17,10610,10088,522,4.9
CN1305500000000,13,055,Chattooga County, GA,Aug-17,10649,10119,530,5.0
CN1305500000000,13,055,Chattooga County, GA,Sep-17,10720,10247,473,4.4
CN1305500000000,13,055,Chattooga County, GA,Oct-17,10659,10208,451,4.2
CN1305500000000,13,055,Chattooga County, GA,Nov-17,10662,10226,436,4.1
CN1305500000000,13,055,Chattooga County, GA,Dec-17,10675,10236,439,4.1
CN1305500000000,13,055,Chattooga County, GA,Jan-18,10835,10303,532,4.9
CN1305500000000,13,055,Chattooga County, GA,Feb-18,10822,10291,531,4.9
CN1305500000000,13,055,Chattooga County, GA,Mar-18,10789,10360,429,4.0
CN1305500000000,13,055,Chattooga County, GA,Apr-18(p),10673,10303,370,3.5
CN3009700000000,30,097,Sweet Grass County, MT,Mar-17,1731,1664,67,3.9
CN3009700000000,30,097,Sweet Grass County, MT,Apr-17,1762,1719,43,2.4
CN3009700000000,30,097,Sweet Grass County, MT,May-17,1807,1766,41,2.3
CN3009700000000,30,097,Sweet Grass County, MT,Jun-17,1823,1770,53,2.9
CN3009700000000,30,097,Sweet Grass County, MT,Jul-17,1866,1815,51,2.7
CN3009700000000,30,097,Sweet Grass County, MT,Aug-17,1827,1772,55,3.0
CN3009700000000,30,097,Sweet Grass County, MT,Sep-17,1791,1736,55,3.1
CN3009700000000,30,097,Sweet Grass County, MT,Oct-17,1809,1752,57,3.2
CN3009700000000,30,097,Sweet Grass County, MT,Nov-17,1786,1731,55,3.1
CN3009700000000,30,097,Sweet Grass County, MT,Dec-17,1765,1708,57,3.2
CN3009700000000,30,097,Sweet Grass County, MT,Jan-18,1789,1706,83,4.6
CN3009700000000,30,097,Sweet Grass County, MT,Feb-18,1781,1700,81,4.5
CN3009700000000,30,097,Sweet Grass County, MT,Mar-18,1748,1679,69,3.9
CN3009700000000,30,097,Sweet Grass County, MT,Apr-18(p),1756,1703,53,3.0
CN1210500000000,12,105,Polk County, FL,Mar-17,294310,280789,13521,4.6
CN1210500000000,12,105,Polk County, FL,Apr-17,292679,279954,12725,4.3
CN1210500000000,12,105,Polk County, FL,May-17,293681,280655,13026,4.4
CN1210500000000,12,105,Polk County, FL,Jun-17,294103,279800,14303,4.9
CN1210500000000,12,105,Polk County, FL,Jul-17,293402,278814,14588,5.0
CN1210500000000,12,105,Polk County, FL,Aug-17,293900,279483,14417,4.9
CN1210500000000,12,105,Polk County, FL,Sep-17,297649,284255,13394,4.5
CN1210500000000,12,105,Polk County, FL,Oct-17,293779,281130,12649,4.3
CN1210500000000,12,105,Polk County, FL,Nov-17,294797,282004,12793,4.3
CN1210500000000,12,105,Polk County, FL,Dec-17,294579,282645,11934,4.1
CN1210500000000,12,105,Polk County, FL,Jan-18,297091,283402,13689,4.6
CN1210500000000,12,105,Polk County, FL,Feb-18,299275,286757,12518,4.2
CN1210500000000,12,105,Polk County, FL,Mar-18,299025,286719,12306,4.1
CN1210500000000,12,105,Polk County, FL,Apr-18(p),297852,286743,11109,3.7
CN5400300000000,54,003,Berkeley County, WV,Mar-17,53175,51167,2008,3.8
CN5400300000000,54,003,Berkeley County, WV,Apr-17,53951,52135,1816,3.4
CN5400300000000,54,003,Berkeley County, WV,May-17,54101,52339,1762,3.3
CN5400300000000,54,003,Berkeley County, WV,Jun-17,55550,53420,2130,3.8
CN5400300000000,54,003,Berkeley County, WV,Jul-17,55232,53190,2042,3.7
CN5400300000000,54,003,Berkeley County, WV,Aug-17,54852,52616,2236,4.1
CN5400300000000,54,003,Berkeley County, WV,Sep-17,54871,52918,1953,3.6
CN5400300000000,54,003,Berkeley County, WV,Oct-17,54968,53046,1922,3.5
CN5400300000000,54,003,Berkeley County, WV,Nov-17,55109,53159,1950,3.5
CN5400300000000,54,003,Berkeley County, WV,Dec-17,54906,52943,1963,3.6
CN5400300000000,54,003,Berkeley County, WV,Jan-18,54405,52182,2223,4.1
CN5400300000000,54,003,Berkeley County, WV,Feb-18,55034,52347,2687,4.9
CN5400300000000,54,003,Berkeley County, WV,Mar-18,54234,51753,2481,4.6
CN5400300000000,54,003,Berkeley County, WV,Apr-18(p),54833,52470,2363,4.3
CN2702700000000,27,027,Clay County, MN,Mar-17,35884,34426,1458,4.1
CN2702700000000,27,027,Clay County, MN,Apr-17,36025,34905,1120,3.1
CN2702700000000,27,027,Clay County, MN,May-17,35963,34961,1002,2.8
CN2702700000000,27,027,Clay County, MN,Jun-17,35746,34582,1164,3.3
CN2702700000000,27,027,Clay County, MN,Jul-17,35805,34717,1088,3.0
CN2702700000000,27,027,Clay County, MN,Aug-17,35550,34462,1088,3.1
CN2702700000000,27,027,Clay County, MN,Sep-17,35952,35033,919,2.6
CN2702700000000,27,027,Clay County, MN,Oct-17,36067,35347,720,2.0
CN2702700000000,27,027,Clay County, MN,Nov-17,35962,35112,850,2.4
CN2702700000000,27,027,Clay County, MN,Dec-17,35709,34574,1135,3.2
CN2702700000000,27,027,Clay County, MN,Jan-18,36125,34637,1488,4.1
CN2702700000000,27,027,Clay County, MN,Feb-18,36550,35091,1459,4.0
CN2702700000000,27,027,Clay County, MN,Mar-18,36437,35011,1426,3.9
CN2702700000000,27,027,Clay County, MN,Apr-18(p),36287,35112,1175,3.2
CN1600100000000,16,001,Ada County, ID,Mar-17,230151,223217,6934,3.0
CN1600100000000,16,001,Ada County, ID,Apr-17,229753,223626,6127,2.7
CN1600100000000,16,001,Ada County, ID,May-17,231487,225718,5769,2.5
CN1600100000000,16,001,Ada County, ID,Jun-17,233530,227229,6301,2.7
CN1600100000000,16,001,Ada County, ID,Jul-17,234648,228298,6350,2.7
CN1600100000000,16,001,Ada County, ID,Aug-17,234165,227804,6361,2.7
CN1600100000000,16,001,Ada County, ID,Sep-17,233251,227272,5979,2.6
CN1600100000000,16,001,Ada County, ID,Oct-17,234318,228501,5817,2.5
CN1600100000000,16,001,Ada County, ID,Nov-17,238082,231608,6474,2.7
CN1600100000000,16,001,Ada County, ID,Dec-17,237861,232122,5739,2.4
CN1600100000000,16,001,Ada County, ID,Jan-18,239709,232029,7680,3.2
CN1600100000000,16,001,Ada County, ID,Feb-18,239604,232949,6655,2.8
CN1600100000000,16,001,Ada County, ID,Mar-18,239470,233228,6242,2.6
CN1600100000000,16,001,Ada County, ID,Apr-18(p),238405,232779,5626,2.4
CN3915500000000,39,155,Trumbull County, OH,Mar-17,91547,82932,8615,9.4
CN3915500000000,39,155,Trumbull County, OH,Apr-17,89366,83411,5955,6.7
CN3915500000000,39,155,Trumbull County, OH,May-17,89449,83931,5518,6.2
CN3915500000000,39,155,Trumbull County, OH,Jun-17,90167,84150,6017,6.7
CN3915500000000,39,155,Trumbull County, OH,Jul-17,91287,83564,7723,8.5
CN3915500000000,39,155,Trumbull County, OH,Aug-17,89555,83484,6071,6.8
CN3915500000000,39,155,Trumbull County, OH,Sep-17,90643,83399,7244,8.0
CN3915500000000,39,155,Trumbull County, OH,Oct-17,89236,83987,5249,5.9
CN3915500000000,39,155,Trumbull County, OH,Nov-17,88801,83566,5235,5.9
CN3915500000000,39,155,Trumbull County, OH,Dec-17,88122,82716,5406,6.1
CN3915500000000,39,155,Trumbull County, OH,Jan-18,88233,80832,7401,8.4
CN3915500000000,39,155,Trumbull County, OH,Feb-18,87777,82283,5494,6.3
CN3915500000000,39,155,Trumbull County, OH,Mar-18,88155,82903,5252,6.0
CN3915500000000,39,155,Trumbull County, OH,Apr-18(p),87854,83037,4817,5.5
CN5175000000000,51,750,Radford city, VA,Mar-17,8468,8000,468,5.5
CN5175000000000,51,750,Radford city, VA,Apr-17,8429,8065,364,4.3
CN5175000000000,51,750,Radford city, VA,May-17,8277,7895,382,4.6
CN5175000000000,51,750,Radford city, VA,Jun-17,8138,7682,456,5.6
CN5175000000000,51,750,Radford city, VA,Jul-17,8173,7720,453,5.5
CN5175000000000,51,750,Radford city, VA,Aug-17,8314,7843,471,5.7
CN5175000000000,51,750,Radford city, VA,Sep-17,8424,8016,408,4.8
CN5175000000000,51,750,Radford city, VA,Oct-17,8303,7941,362,4.4
CN5175000000000,51,750,Radford city, VA,Nov-17,8265,7884,381,4.6
CN5175000000000,51,750,Radford city, VA,Dec-17,8162,7835,327,4.0
CN5175000000000,51,750,Radford city, VA,Jan-18,7915,7549,366,4.6
CN5175000000000,51,750,Radford city, VA,Feb-18,8303,7972,331,4.0
CN5175000000000,51,750,Radford city, VA,Mar-18,8338,8007,331,4.0
CN5175000000000,51,750,Radford city, VA,Apr-18(p),8357,8075,282,3.4
CN1808900000000,18,089,Lake County, IN,Mar-17,228742,216576,12166,5.3
CN1808900000000,18,089,Lake County, IN,Apr-17,229962,219510,10452,4.5
CN1808900000000,18,089,Lake County, IN,May-17,230094,219733,10361,4.5
CN1808900000000,18,089,Lake County, IN,Jun-17,231325,220232,11093,4.8
CN1808900000000,18,089,Lake County, IN,Jul-17,232766,220924,11842,5.1
CN1808900000000,18,089,Lake County, IN,Aug-17,229829,217246,12583,5.5
CN1808900000000,18,089,Lake County, IN,Sep-17,230462,219253,11209,4.9
CN1808900000000,18,089,Lake County, IN,Oct-17,229719,219233,10486,4.6
CN1808900000000,18,089,Lake County, IN,Nov-17,227147,216880,10267,4.5
CN1808900000000,18,089,Lake County, IN,Dec-17,224833,214062,10771,4.8
CN1808900000000,18,089,Lake County, IN,Jan-18,223921,212109,11812,5.3
CN1808900000000,18,089,Lake County, IN,Feb-18,227625,214979,12646,5.6
CN1808900000000,18,089,Lake County, IN,Mar-18,229693,218024,11669,5.1
CN1808900000000,18,089,Lake County, IN,Apr-18(p),231567,221430,10137,4.4
CN1607900000000,16,079,Shoshone County, ID,Mar-17,5306,4876,430,8.1
CN1607900000000,16,079,Shoshone County, ID,Apr-17,4922,4549,373,7.6
CN1607900000000,16,079,Shoshone County, ID,May-17,4879,4585,294,6.0
CN1607900000000,16,079,Shoshone County, ID,Jun-17,5075,4793,282,5.6
CN1607900000000,16,079,Shoshone County, ID,Jul-17,5107,4836,271,5.3
CN1607900000000,16,079,Shoshone County, ID,Aug-17,5067,4815,252,5.0
CN1607900000000,16,079,Shoshone County, ID,Sep-17,4926,4683,243,4.9
CN1607900000000,16,079,Shoshone County, ID,Oct-17,4862,4604,258,5.3
CN1607900000000,16,079,Shoshone County, ID,Nov-17,4888,4598,290,5.9
CN1607900000000,16,079,Shoshone County, ID,Dec-17,5036,4731,305,6.1
CN1607900000000,16,079,Shoshone County, ID,Jan-18,5410,5041,369,6.8
CN1607900000000,16,079,Shoshone County, ID,Feb-18,5034,4681,353,7.0
CN1607900000000,16,079,Shoshone County, ID,Mar-18,5045,4692,353,7.0
CN1607900000000,16,079,Shoshone County, ID,Apr-18(p),4854,4545,309,6.4
CN1801100000000,18,011,Boone County, IN,Mar-17,34750,33754,996,2.9
CN1801100000000,18,011,Boone County, IN,Apr-17,34949,34162,787,2.3
CN1801100000000,18,011,Boone County, IN,May-17,35261,34372,889,2.5
CN1801100000000,18,011,Boone County, IN,Jun-17,35655,34610,1045,2.9
CN1801100000000,18,011,Boone County, IN,Jul-17,35596,34514,1082,3.0
CN1801100000000,18,011,Boone County, IN,Aug-17,35281,34099,1182,3.4
CN1801100000000,18,011,Boone County, IN,Sep-17,35006,34059,947,2.7
CN1801100000000,18,011,Boone County, IN,Oct-17,34863,33972,891,2.6
CN1801100000000,18,011,Boone County, IN,Nov-17,34981,34060,921,2.6
CN1801100000000,18,011,Boone County, IN,Dec-17,34604,33772,832,2.4
CN1801100000000,18,011,Boone County, IN,Jan-18,34583,33624,959,2.8
CN1801100000000,18,011,Boone County, IN,Feb-18,35080,34079,1001,2.9
CN1801100000000,18,011,Boone County, IN,Mar-18,35426,34542,884,2.5
CN1801100000000,18,011,Boone County, IN,Apr-18(p),35526,34706,820,2.3
CN2402900000000,24,029,Kent County, MD,Mar-17,10535,10062,473,4.5
CN2402900000000,24,029,Kent County, MD,Apr-17,10731,10342,389,3.6
CN2402900000000,24,029,Kent County, MD,May-17,10242,9835,407,4.0
CN2402900000000,24,029,Kent County, MD,Jun-17,10565,10101,464,4.4
CN2402900000000,24,029,Kent County, MD,Jul-17,10617,10150,467,4.4
CN2402900000000,24,029,Kent County, MD,Aug-17,9996,9557,439,4.4
CN2402900000000,24,029,Kent County, MD,Sep-17,10030,9647,383,3.8
CN2402900000000,24,029,Kent County, MD,Oct-17,10387,9981,406,3.9
CN2402900000000,24,029,Kent County, MD,Nov-17,10055,9634,421,4.2
CN2402900000000,24,029,Kent County, MD,Dec-17,10201,9760,441,4.3
CN2402900000000,24,029,Kent County, MD,Jan-18,10420,9763,657,6.3
CN2402900000000,24,029,Kent County, MD,Feb-18,10540,9876,664,6.3
CN2402900000000,24,029,Kent County, MD,Mar-18,10564,9999,565,5.3
CN2402900000000,24,029,Kent County, MD,Apr-18(p),10491,10047,444,4.2
CN2914300000000,29,143,New Madrid County, MO,Mar-17,7996,7391,605,7.6
CN2914300000000,29,143,New Madrid County, MO,Apr-17,8308,7740,568,6.8
CN2914300000000,29,143,New Madrid County, MO,May-17,8103,7565,538,6.6
CN2914300000000,29,143,New Madrid County, MO,Jun-17,8054,7497,557,6.9
CN2914300000000,29,143,New Madrid County, MO,Jul-17,7822,7244,578,7.4
CN2914300000000,29,143,New Madrid County, MO,Aug-17,7663,7138,525,6.9
CN2914300000000,29,143,New Madrid County, MO,Sep-17,7661,7247,414,5.4
CN2914300000000,29,143,New Madrid County, MO,Oct-17,7742,7397,345,4.5
CN2914300000000,29,143,New Madrid County, MO,Nov-17,7732,7357,375,4.8
CN2914300000000,29,143,New Madrid County, MO,Dec-17,7637,7239,398,5.2
CN2914300000000,29,143,New Madrid County, MO,Jan-18,7734,7282,452,5.8
CN2914300000000,29,143,New Madrid County, MO,Feb-18,7874,7395,479,6.1
CN2914300000000,29,143,New Madrid County, MO,Mar-18,7829,7361,468,6.0
CN2914300000000,29,143,New Madrid County, MO,Apr-18(p),7900,7493,407,5.2
CN4610900000000,46,109,Roberts County, SD,Mar-17,4831,4529,302,6.3
CN4610900000000,46,109,Roberts County, SD,Apr-17,4788,4558,230,4.8
CN4610900000000,46,109,Roberts County, SD,May-17,4814,4620,194,4.0
CN4610900000000,46,109,Roberts County, SD,Jun-17,4961,4753,208,4.2
CN4610900000000,46,109,Roberts County, SD,Jul-17,4738,4535,203,4.3
CN4610900000000,46,109,Roberts County, SD,Aug-17,4762,4555,207,4.3
CN4610900000000,46,109,Roberts County, SD,Sep-17,4791,4614,177,3.7
CN4610900000000,46,109,Roberts County, SD,Oct-17,4892,4706,186,3.8
CN4610900000000,46,109,Roberts County, SD,Nov-17,4811,4601,210,4.4
CN4610900000000,46,109,Roberts County, SD,Dec-17,4779,4508,271,5.7
CN4610900000000,46,109,Roberts County, SD,Jan-18,4809,4488,321,6.7
CN4610900000000,46,109,Roberts County, SD,Feb-18,4834,4514,320,6.6
CN4610900000000,46,109,Roberts County, SD,Mar-18,4862,4567,295,6.1
CN4610900000000,46,109,Roberts County, SD,Apr-18(p),4809,4540,269,5.6
CN2602100000000,26,021,Berrien County, MI,Mar-17,73434,69805,3629,4.9
CN2602100000000,26,021,Berrien County, MI,Apr-17,72868,69902,2966,4.1
CN2602100000000,26,021,Berrien County, MI,May-17,74426,71185,3241,4.4
CN2602100000000,26,021,Berrien County, MI,Jun-17,76226,72530,3696,4.8
CN2602100000000,26,021,Berrien County, MI,Jul-17,75585,71240,4345,5.7
CN2602100000000,26,021,Berrien County, MI,Aug-17,74994,71028,3966,5.3
CN2602100000000,26,021,Berrien County, MI,Sep-17,73657,70331,3326,4.5
CN2602100000000,26,021,Berrien County, MI,Oct-17,72881,69820,3061,4.2
CN2602100000000,26,021,Berrien County, MI,Nov-17,72964,69643,3321,4.6
CN2602100000000,26,021,Berrien County, MI,Dec-17,72764,69066,3698,5.1
CN2602100000000,26,021,Berrien County, MI,Jan-18,72243,68058,4185,5.8
CN2602100000000,26,021,Berrien County, MI,Feb-18,73530,69129,4401,6.0
CN2602100000000,26,021,Berrien County, MI,Mar-18,73643,69816,3827,5.2
CN2602100000000,26,021,Berrien County, MI,Apr-18(p),73139,69910,3229,4.4
CN3102500000000,31,025,Cass County, NE,Mar-17,13129,12655,474,3.6
CN3102500000000,31,025,Cass County, NE,Apr-17,13098,12714,384,2.9
CN3102500000000,31,025,Cass County, NE,May-17,13118,12750,368,2.8
CN3102500000000,31,025,Cass County, NE,Jun-17,13256,12809,447,3.4
CN3102500000000,31,025,Cass County, NE,Jul-17,13374,12908,466,3.5
CN3102500000000,31,025,Cass County, NE,Aug-17,13177,12775,402,3.1
CN3102500000000,31,025,Cass County, NE,Sep-17,13023,12668,355,2.7
CN3102500000000,31,025,Cass County, NE,Oct-17,13123,12785,338,2.6
CN3102500000000,31,025,Cass County, NE,Nov-17,13124,12814,310,2.4
CN3102500000000,31,025,Cass County, NE,Dec-17,13094,12730,364,2.8
CN3102500000000,31,025,Cass County, NE,Jan-18,13088,12621,467,3.6
CN3102500000000,31,025,Cass County, NE,Feb-18,13185,12740,445,3.4
CN3102500000000,31,025,Cass County, NE,Mar-18,13237,12796,441,3.3
CN3102500000000,31,025,Cass County, NE,Apr-18(p),13276,12883,393,3.0
CN1718100000000,17,181,Union County, IL,Mar-17,7500,6971,529,7.1
CN1718100000000,17,181,Union County, IL,Apr-17,7427,6997,430,5.8
CN1718100000000,17,181,Union County, IL,May-17,7294,6862,432,5.9
CN1718100000000,17,181,Union County, IL,Jun-17,7183,6768,415,5.8
CN1718100000000,17,181,Union County, IL,Jul-17,7260,6824,436,6.0
CN1718100000000,17,181,Union County, IL,Aug-17,7216,6789,427,5.9
CN1718100000000,17,181,Union County, IL,Sep-17,7334,6966,368,5.0
CN1718100000000,17,181,Union County, IL,Oct-17,7344,6972,372,5.1
CN1718100000000,17,181,Union County, IL,Nov-17,7352,6952,400,5.4
CN1718100000000,17,181,Union County, IL,Dec-17,7322,6860,462,6.3
CN1718100000000,17,181,Union County, IL,Jan-18,7309,6789,520,7.1
CN1718100000000,17,181,Union County, IL,Feb-18,7375,6874,501,6.8
CN1718100000000,17,181,Union County, IL,Mar-18,7510,7014,496,6.6
CN1718100000000,17,181,Union County, IL,Apr-18(p),7562,7165,397,5.2
CN0217000000000,02,170,Matanuska-Susitna Borough, AK,Mar-17,47579,42980,4599,9.7
CN0217000000000,02,170,Matanuska-Susitna Borough, AK,Apr-17,47194,42986,4208,8.9
CN0217000000000,02,170,Matanuska-Susitna Borough, AK,May-17,47444,43442,4002,8.4
CN0217000000000,02,170,Matanuska-Susitna Borough, AK,Jun-17,47778,43564,4214,8.8
CN0217000000000,02,170,Matanuska-Susitna Borough, AK,Jul-17,47546,43675,3871,8.1
CN0217000000000,02,170,Matanuska-Susitna Borough, AK,Aug-17,46540,42931,3609,7.8
CN0217000000000,02,170,Matanuska-Susitna Borough, AK,Sep-17,46679,42992,3687,7.9
CN0217000000000,02,170,Matanuska-Susitna Borough, AK,Oct-17,46937,43205,3732,8.0
CN0217000000000,02,170,Matanuska-Susitna Borough, AK,Nov-17,47502,43525,3977,8.4
CN0217000000000,02,170,Matanuska-Susitna Borough, AK,Dec-17,47689,43573,4116,8.6
CN0217000000000,02,170,Matanuska-Susitna Borough, AK,Jan-18,47638,43045,4593,9.6
CN0217000000000,02,170,Matanuska-Susitna Borough, AK,Feb-18,47486,42727,4759,10.0
CN0217000000000,02,170,Matanuska-Susitna Borough, AK,Mar-18,47357,42772,4585,9.7
CN0217000000000,02,170,Matanuska-Susitna Borough, AK,Apr-18(p),46914,42686,4228,9.0
CN4834900000000,48,349,Navarro County, TX,Mar-17,22672,21592,1080,4.8
CN4834900000000,48,349,Navarro County, TX,Apr-17,22955,22103,852,3.7
CN4834900000000,48,349,Navarro County, TX,May-17,22912,22070,842,3.7
CN4834900000000,48,349,Navarro County, TX,Jun-17,22561,21600,961,4.3
CN4834900000000,48,349,Navarro County, TX,Jul-17,22719,21784,935,4.1
CN4834900000000,48,349,Navarro County, TX,Aug-17,22564,21667,897,4.0
CN4834900000000,48,349,Navarro County, TX,Sep-17,22897,22089,808,3.5
CN4834900000000,48,349,Navarro County, TX,Oct-17,22807,22079,728,3.2
CN4834900000000,48,349,Navarro County, TX,Nov-17,22853,22085,768,3.4
CN4834900000000,48,349,Navarro County, TX,Dec-17,22668,21951,717,3.2
CN4834900000000,48,349,Navarro County, TX,Jan-18,22378,21430,948,4.2
CN4834900000000,48,349,Navarro County, TX,Feb-18,22811,21901,910,4.0
CN4834900000000,48,349,Navarro County, TX,Mar-18,22715,21673,1042,4.6
CN4834900000000,48,349,Navarro County, TX,Apr-18(p),23164,22302,862,3.7
CN4605300000000,46,053,Gregory County, SD,Mar-17,2031,1951,80,3.9
CN4605300000000,46,053,Gregory County, SD,Apr-17,2025,1951,74,3.7
CN4605300000000,46,053,Gregory County, SD,May-17,2040,1969,71,3.5
CN4605300000000,46,053,Gregory County, SD,Jun-17,2135,2063,72,3.4
CN4605300000000,46,053,Gregory County, SD,Jul-17,2062,1994,68,3.3
CN4605300000000,46,053,Gregory County, SD,Aug-17,1974,1905,69,3.5
CN4605300000000,46,053,Gregory County, SD,Sep-17,2000,1937,63,3.2
CN4605300000000,46,053,Gregory County, SD,Oct-17,2019,1958,61,3.0
CN4605300000000,46,053,Gregory County, SD,Nov-17,2006,1943,63,3.1
CN4605300000000,46,053,Gregory County, SD,Dec-17,2032,1963,69,3.4
CN4605300000000,46,053,Gregory County, SD,Jan-18,1972,1893,79,4.0
CN4605300000000,46,053,Gregory County, SD,Feb-18,2008,1930,78,3.9
CN4605300000000,46,053,Gregory County, SD,Mar-18,2048,1977,71,3.5
CN4605300000000,46,053,Gregory County, SD,Apr-18(p),2009,1936,73,3.6
CN3905700000000,39,057,Greene County, OH,Mar-17,81420,77990,3430,4.2
CN3905700000000,39,057,Greene County, OH,Apr-17,81321,78251,3070,3.8
CN3905700000000,39,057,Greene County, OH,May-17,81612,78357,3255,4.0
CN3905700000000,39,057,Greene County, OH,Jun-17,82408,78578,3830,4.6
CN3905700000000,39,057,Greene County, OH,Jul-17,83376,79526,3850,4.6
CN3905700000000,39,057,Greene County, OH,Aug-17,82869,79130,3739,4.5
CN3905700000000,39,057,Greene County, OH,Sep-17,82118,78780,3338,4.1
CN3905700000000,39,057,Greene County, OH,Oct-17,82649,79466,3183,3.9
CN3905700000000,39,057,Greene County, OH,Nov-17,83013,79852,3161,3.8
CN3905700000000,39,057,Greene County, OH,Dec-17,83073,79875,3198,3.8
CN3905700000000,39,057,Greene County, OH,Jan-18,81106,77733,3373,4.2
CN3905700000000,39,057,Greene County, OH,Feb-18,82971,79742,3229,3.9
CN3905700000000,39,057,Greene County, OH,Mar-18,83599,80634,2965,3.5
CN3905700000000,39,057,Greene County, OH,Apr-18(p),83234,80395,2839,3.4
CN4700700000000,47,007,Bledsoe County, TN,Mar-17,4329,4052,277,6.4
CN4700700000000,47,007,Bledsoe County, TN,Apr-17,4307,4079,228,5.3
CN4700700000000,47,007,Bledsoe County, TN,May-17,4274,4060,214,5.0
CN4700700000000,47,007,Bledsoe County, TN,Jun-17,4271,3997,274,6.4
CN4700700000000,47,007,Bledsoe County, TN,Jul-17,4255,3992,263,6.2
CN4700700000000,47,007,Bledsoe County, TN,Aug-17,4372,4132,240,5.5
CN4700700000000,47,007,Bledsoe County, TN,Sep-17,4378,4159,219,5.0
CN4700700000000,47,007,Bledsoe County, TN,Oct-17,4356,4130,226,5.2
CN4700700000000,47,007,Bledsoe County, TN,Nov-17,4314,4092,222,5.1
CN4700700000000,47,007,Bledsoe County, TN,Dec-17,4297,4071,226,5.3
CN4700700000000,47,007,Bledsoe County, TN,Jan-18,4312,4044,268,6.2
CN4700700000000,47,007,Bledsoe County, TN,Feb-18,4366,4101,265,6.1
CN4700700000000,47,007,Bledsoe County, TN,Mar-18,4337,4087,250,5.8
CN4700700000000,47,007,Bledsoe County, TN,Apr-18(p),4354,4147,207,4.8
CN2000900000000,20,009,Barton County, KS,Mar-17,14121,13614,507,3.6
CN2000900000000,20,009,Barton County, KS,Apr-17,14056,13559,497,3.5
CN2000900000000,20,009,Barton County, KS,May-17,13972,13476,496,3.5
CN2000900000000,20,009,Barton County, KS,Jun-17,14282,13740,542,3.8
CN2000900000000,20,009,Barton County, KS,Jul-17,14382,13810,572,4.0
CN2000900000000,20,009,Barton County, KS,Aug-17,14154,13628,526,3.7
CN2000900000000,20,009,Barton County, KS,Sep-17,14029,13592,437,3.1
CN2000900000000,20,009,Barton County, KS,Oct-17,14079,13687,392,2.8
CN2000900000000,20,009,Barton County, KS,Nov-17,14051,13614,437,3.1
CN2000900000000,20,009,Barton County, KS,Dec-17,13933,13495,438,3.1
CN2000900000000,20,009,Barton County, KS,Jan-18,13932,13456,476,3.4
CN2000900000000,20,009,Barton County, KS,Feb-18,14014,13508,506,3.6
CN2000900000000,20,009,Barton County, KS,Mar-18,13991,13533,458,3.3
CN2000900000000,20,009,Barton County, KS,Apr-18(p),13815,13391,424,3.1
CN2011500000000,20,115,Marion County, KS,Mar-17,5984,5786,198,3.3
CN2011500000000,20,115,Marion County, KS,Apr-17,5927,5730,197,3.3
CN2011500000000,20,115,Marion County, KS,May-17,6248,6037,211,3.4
CN2011500000000,20,115,Marion County, KS,Jun-17,6457,6224,233,3.6
CN2011500000000,20,115,Marion County, KS,Jul-17,6500,6128,372,5.7
CN2011500000000,20,115,Marion County, KS,Aug-17,6347,6052,295,4.6
CN2011500000000,20,115,Marion County, KS,Sep-17,6447,6239,208,3.2
CN2011500000000,20,115,Marion County, KS,Oct-17,6484,6309,175,2.7
CN2011500000000,20,115,Marion County, KS,Nov-17,6470,6270,200,3.1
CN2011500000000,20,115,Marion County, KS,Dec-17,6433,6245,188,2.9
CN2011500000000,20,115,Marion County, KS,Jan-18,6369,6184,185,2.9
CN2011500000000,20,115,Marion County, KS,Feb-18,6371,6180,191,3.0
CN2011500000000,20,115,Marion County, KS,Mar-18,6377,6190,187,2.9
CN2011500000000,20,115,Marion County, KS,Apr-18(p),6226,6045,181,2.9
CN1316100000000,13,161,Jeff Davis County, GA,Mar-17,6172,5816,356,5.8
CN1316100000000,13,161,Jeff Davis County, GA,Apr-17,6091,5750,341,5.6
CN1316100000000,13,161,Jeff Davis County, GA,May-17,6121,5774,347,5.7
CN1316100000000,13,161,Jeff Davis County, GA,Jun-17,6186,5764,422,6.8
CN1316100000000,13,161,Jeff Davis County, GA,Jul-17,6222,5811,411,6.6
CN1316100000000,13,161,Jeff Davis County, GA,Aug-17,6184,5799,385,6.2
CN1316100000000,13,161,Jeff Davis County, GA,Sep-17,6165,5816,349,5.7
CN1316100000000,13,161,Jeff Davis County, GA,Oct-17,6146,5782,364,5.9
CN1316100000000,13,161,Jeff Davis County, GA,Nov-17,6046,5731,315,5.2
CN1316100000000,13,161,Jeff Davis County, GA,Dec-17,6116,5775,341,5.6
CN1316100000000,13,161,Jeff Davis County, GA,Jan-18,6214,5861,353,5.7
CN1316100000000,13,161,Jeff Davis County, GA,Feb-18,6064,5733,331,5.5
CN1316100000000,13,161,Jeff Davis County, GA,Mar-18,6038,5736,302,5.0
CN1316100000000,13,161,Jeff Davis County, GA,Apr-18(p),5975,5716,259,4.3
CN4711300000000,47,113,Madison County, TN,Mar-17,48404,46368,2036,4.2
CN4711300000000,47,113,Madison County, TN,Apr-17,47678,45978,1700,3.6
CN4711300000000,47,113,Madison County, TN,May-17,47694,45972,1722,3.6
CN4711300000000,47,113,Madison County, TN,Jun-17,48670,46584,2086,4.3
CN4711300000000,47,113,Madison County, TN,Jul-17,49224,47269,1955,4.0
CN4711300000000,47,113,Madison County, TN,Aug-17,48395,46521,1874,3.9
CN4711300000000,47,113,Madison County, TN,Sep-17,48413,46734,1679,3.5
CN4711300000000,47,113,Madison County, TN,Oct-17,48318,46560,1758,3.6
CN4711300000000,47,113,Madison County, TN,Nov-17,48178,46466,1712,3.6
CN4711300000000,47,113,Madison County, TN,Dec-17,48286,46623,1663,3.4
CN4711300000000,47,113,Madison County, TN,Jan-18,47833,45906,1927,4.0
CN4711300000000,47,113,Madison County, TN,Feb-18,48747,46795,1952,4.0
CN4711300000000,47,113,Madison County, TN,Mar-18,48749,46941,1808,3.7
CN4711300000000,47,113,Madison County, TN,Apr-18(p),49130,47560,1570,3.2
CN1700700000000,17,007,Boone County, IL,Mar-17,25980,23527,2453,9.4
CN1700700000000,17,007,Boone County, IL,Apr-17,26151,24376,1775,6.8
CN1700700000000,17,007,Boone County, IL,May-17,25819,24383,1436,5.6
CN1700700000000,17,007,Boone County, IL,Jun-17,26038,24656,1382,5.3
CN1700700000000,17,007,Boone County, IL,Jul-17,26189,24767,1422,5.4
CN1700700000000,17,007,Boone County, IL,Aug-17,25814,24454,1360,5.3
CN1700700000000,17,007,Boone County, IL,Sep-17,25633,24486,1147,4.5
CN1700700000000,17,007,Boone County, IL,Oct-17,25669,24552,1117,4.4
CN1700700000000,17,007,Boone County, IL,Nov-17,25761,24584,1177,4.6
CN1700700000000,17,007,Boone County, IL,Dec-17,25944,24613,1331,5.1
CN1700700000000,17,007,Boone County, IL,Jan-18,25806,24280,1526,5.9
CN1700700000000,17,007,Boone County, IL,Feb-18,25915,24512,1403,5.4
CN1700700000000,17,007,Boone County, IL,Mar-18,26156,24748,1408,5.4
CN1700700000000,17,007,Boone County, IL,Apr-18(p),26077,25007,1070,4.1
CN5000900000000,50,009,Essex County, VT,Mar-17,2668,2515,153,5.7
CN5000900000000,50,009,Essex County, VT,Apr-17,2637,2489,148,5.6
CN5000900000000,50,009,Essex County, VT,May-17,2672,2576,96,3.6
CN5000900000000,50,009,Essex County, VT,Jun-17,2730,2616,114,4.2
CN5000900000000,50,009,Essex County, VT,Jul-17,2757,2639,118,4.3
CN5000900000000,50,009,Essex County, VT,Aug-17,2750,2642,108,3.9
CN5000900000000,50,009,Essex County, VT,Sep-17,2702,2598,104,3.8
CN5000900000000,50,009,Essex County, VT,Oct-17,2639,2541,98,3.7
CN5000900000000,50,009,Essex County, VT,Nov-17,2622,2522,100,3.8
CN5000900000000,50,009,Essex County, VT,Dec-17,2605,2490,115,4.4
CN5000900000000,50,009,Essex County, VT,Jan-18,2653,2496,157,5.9
CN5000900000000,50,009,Essex County, VT,Feb-18,2649,2519,130,4.9
CN5000900000000,50,009,Essex County, VT,Mar-18,2655,2526,129,4.9
CN5000900000000,50,009,Essex County, VT,Apr-18(p),2617,2507,110,4.2
CN2111100000000,21,111,Jefferson County, KY,Mar-17,392455,373137,19318,4.9
CN2111100000000,21,111,Jefferson County, KY,Apr-17,391317,374004,17313,4.4
CN2111100000000,21,111,Jefferson County, KY,May-17,393203,375019,18184,4.6
CN2111100000000,21,111,Jefferson County, KY,Jun-17,399968,380127,19841,5.0
CN2111100000000,21,111,Jefferson County, KY,Jul-17,403639,382878,20761,5.1
CN2111100000000,21,111,Jefferson County, KY,Aug-17,397098,379349,17749,4.5
CN2111100000000,21,111,Jefferson County, KY,Sep-17,398018,382453,15565,3.9
CN2111100000000,21,111,Jefferson County, KY,Oct-17,392926,378504,14422,3.7
CN2111100000000,21,111,Jefferson County, KY,Nov-17,394420,380745,13675,3.5
CN2111100000000,21,111,Jefferson County, KY,Dec-17,394322,380983,13339,3.4
CN2111100000000,21,111,Jefferson County, KY,Jan-18,388854,374438,14416,3.7
CN2111100000000,21,111,Jefferson County, KY,Feb-18,395423,379244,16179,4.1
CN2111100000000,21,111,Jefferson County, KY,Mar-18,399746,383877,15869,4.0
CN2111100000000,21,111,Jefferson County, KY,Apr-18(p),400034,385666,14368,3.6
CN4818700000000,48,187,Guadalupe County, TX,Mar-17,77189,74472,2717,3.5
CN4818700000000,48,187,Guadalupe County, TX,Apr-17,77210,74832,2378,3.1
CN4818700000000,48,187,Guadalupe County, TX,May-17,77043,74588,2455,3.2
CN4818700000000,48,187,Guadalupe County, TX,Jun-17,77457,74756,2701,3.5
CN4818700000000,48,187,Guadalupe County, TX,Jul-17,77997,75265,2732,3.5
CN4818700000000,48,187,Guadalupe County, TX,Aug-17,77627,74939,2688,3.5
CN4818700000000,48,187,Guadalupe County, TX,Sep-17,78457,76026,2431,3.1
CN4818700000000,48,187,Guadalupe County, TX,Oct-17,77719,75486,2233,2.9
CN4818700000000,48,187,Guadalupe County, TX,Nov-17,77865,75524,2341,3.0
CN4818700000000,48,187,Guadalupe County, TX,Dec-17,77878,75643,2235,2.9
CN4818700000000,48,187,Guadalupe County, TX,Jan-18,77821,75292,2529,3.2
CN4818700000000,48,187,Guadalupe County, TX,Feb-18,79046,76455,2591,3.3
CN4818700000000,48,187,Guadalupe County, TX,Mar-18,78866,76294,2572,3.3
CN4818700000000,48,187,Guadalupe County, TX,Apr-18(p),78914,76584,2330,3.0
CN0510900000000,05,109,Pike County, AR,Mar-17,4236,4074,162,3.8
CN0510900000000,05,109,Pike County, AR,Apr-17,4301,4159,142,3.3
CN0510900000000,05,109,Pike County, AR,May-17,4371,4211,160,3.7
CN0510900000000,05,109,Pike County, AR,Jun-17,4488,4296,192,4.3
CN0510900000000,05,109,Pike County, AR,Jul-17,4265,4070,195,4.6
CN0510900000000,05,109,Pike County, AR,Aug-17,4346,4173,173,4.0
CN0510900000000,05,109,Pike County, AR,Sep-17,4272,4108,164,3.8
CN0510900000000,05,109,Pike County, AR,Oct-17,4295,4136,159,3.7
CN0510900000000,05,109,Pike County, AR,Nov-17,4271,4110,161,3.8
CN0510900000000,05,109,Pike County, AR,Dec-17,4269,4084,185,4.3
CN0510900000000,05,109,Pike County, AR,Jan-18,4232,4010,222,5.2
CN0510900000000,05,109,Pike County, AR,Feb-18,4273,4072,201,4.7
CN0510900000000,05,109,Pike County, AR,Mar-18,4314,4123,191,4.4
CN0510900000000,05,109,Pike County, AR,Apr-18(p),4363,4193,170,3.9
CN0806900000000,08,069,Larimer County, CO,Mar-17,190637,186050,4587,2.4
CN0806900000000,08,069,Larimer County, CO,Apr-17,192842,188556,4286,2.2
CN0806900000000,08,069,Larimer County, CO,May-17,195611,191365,4246,2.2
CN0806900000000,08,069,Larimer County, CO,Jun-17,195047,190170,4877,2.5
CN0806900000000,08,069,Larimer County, CO,Jul-17,196900,192293,4607,2.3
CN0806900000000,08,069,Larimer County, CO,Aug-17,197196,192526,4670,2.4
CN0806900000000,08,069,Larimer County, CO,Sep-17,199979,195413,4566,2.3
CN0806900000000,08,069,Larimer County, CO,Oct-17,199844,195057,4787,2.4
CN0806900000000,08,069,Larimer County, CO,Nov-17,198303,193428,4875,2.5
CN0806900000000,08,069,Larimer County, CO,Dec-17,196349,191451,4898,2.5
CN0806900000000,08,069,Larimer County, CO,Jan-18,194303,188600,5703,2.9
CN0806900000000,08,069,Larimer County, CO,Feb-18,198233,192423,5810,2.9
CN0806900000000,08,069,Larimer County, CO,Mar-18,198584,193595,4989,2.5
CN0806900000000,08,069,Larimer County, CO,Apr-18(p),199954,195554,4400,2.2
CN2709500000000,27,095,Mille Lacs County, MN,Mar-17,13084,12055,1029,7.9
CN2709500000000,27,095,Mille Lacs County, MN,Apr-17,12879,12149,730,5.7
CN2709500000000,27,095,Mille Lacs County, MN,May-17,12721,12197,524,4.1
CN2709500000000,27,095,Mille Lacs County, MN,Jun-17,12790,12244,546,4.3
CN2709500000000,27,095,Mille Lacs County, MN,Jul-17,12928,12392,536,4.1
CN2709500000000,27,095,Mille Lacs County, MN,Aug-17,12867,12320,547,4.3
CN2709500000000,27,095,Mille Lacs County, MN,Sep-17,12800,12321,479,3.7
CN2709500000000,27,095,Mille Lacs County, MN,Oct-17,12752,12324,428,3.4
CN2709500000000,27,095,Mille Lacs County, MN,Nov-17,12893,12289,604,4.7
CN2709500000000,27,095,Mille Lacs County, MN,Dec-17,13064,12191,873,6.7
CN2709500000000,27,095,Mille Lacs County, MN,Jan-18,13349,12249,1100,8.2
CN2709500000000,27,095,Mille Lacs County, MN,Feb-18,13347,12327,1020,7.6
CN2709500000000,27,095,Mille Lacs County, MN,Mar-18,13309,12306,1003,7.5
CN2709500000000,27,095,Mille Lacs County, MN,Apr-18(p),13167,12386,781,5.9
CN2118900000000,21,189,Owsley County, KY,Mar-17,1197,1091,106,8.9
CN2118900000000,21,189,Owsley County, KY,Apr-17,1173,1083,90,7.7
CN2118900000000,21,189,Owsley County, KY,May-17,1161,1069,92,7.9
CN2118900000000,21,189,Owsley County, KY,Jun-17,1154,1046,108,9.4
CN2118900000000,21,189,Owsley County, KY,Jul-17,1123,1025,98,8.7
CN2118900000000,21,189,Owsley County, KY,Aug-17,1098,1011,87,7.9
CN2118900000000,21,189,Owsley County, KY,Sep-17,1089,1009,80,7.3
CN2118900000000,21,189,Owsley County, KY,Oct-17,1095,1023,72,6.6
CN2118900000000,21,189,Owsley County, KY,Nov-17,1093,1024,69,6.3
CN2118900000000,21,189,Owsley County, KY,Dec-17,1085,1015,70,6.5
CN2118900000000,21,189,Owsley County, KY,Jan-18,1106,1031,75,6.8
CN2118900000000,21,189,Owsley County, KY,Feb-18,1130,1037,93,8.2
CN2118900000000,21,189,Owsley County, KY,Mar-18,1132,1046,86,7.6
CN2118900000000,21,189,Owsley County, KY,Apr-18(p),1127,1051,76,6.7
CN5307500000000,53,075,Whitman County, WA,Mar-17,23963,22885,1078,4.5
CN5307500000000,53,075,Whitman County, WA,Apr-17,24037,23100,937,3.9
CN5307500000000,53,075,Whitman County, WA,May-17,24597,23629,968,3.9
CN5307500000000,53,075,Whitman County, WA,Jun-17,21271,20208,1063,5.0
CN5307500000000,53,075,Whitman County, WA,Jul-17,20916,19833,1083,5.2
CN5307500000000,53,075,Whitman County, WA,Aug-17,21464,20479,985,4.6
CN5307500000000,53,075,Whitman County, WA,Sep-17,24332,23388,944,3.9
CN5307500000000,53,075,Whitman County, WA,Oct-17,24561,23588,973,4.0
CN5307500000000,53,075,Whitman County, WA,Nov-17,24472,23464,1008,4.1
CN5307500000000,53,075,Whitman County, WA,Dec-17,24222,23151,1071,4.4
CN5307500000000,53,075,Whitman County, WA,Jan-18,23589,22466,1123,4.8
CN5307500000000,53,075,Whitman County, WA,Feb-18,23661,22511,1150,4.9
CN5307500000000,53,075,Whitman County, WA,Mar-18,23719,22604,1115,4.7
CN5307500000000,53,075,Whitman County, WA,Apr-18(p),23581,22523,1058,4.5
CN5111100000000,51,111,Lunenburg County, VA,Mar-17,5217,4964,253,4.8
CN5111100000000,51,111,Lunenburg County, VA,Apr-17,5231,5012,219,4.2
CN5111100000000,51,111,Lunenburg County, VA,May-17,5228,5012,216,4.1
CN5111100000000,51,111,Lunenburg County, VA,Jun-17,5305,5068,237,4.5
CN5111100000000,51,111,Lunenburg County, VA,Jul-17,5264,5038,226,4.3
CN5111100000000,51,111,Lunenburg County, VA,Aug-17,5151,4928,223,4.3
CN5111100000000,51,111,Lunenburg County, VA,Sep-17,5208,5002,206,4.0
CN5111100000000,51,111,Lunenburg County, VA,Oct-17,5148,4949,199,3.9
CN5111100000000,51,111,Lunenburg County, VA,Nov-17,5130,4929,201,3.9
CN5111100000000,51,111,Lunenburg County, VA,Dec-17,5160,4963,197,3.8
CN5111100000000,51,111,Lunenburg County, VA,Jan-18,5132,4897,235,4.6
CN5111100000000,51,111,Lunenburg County, VA,Feb-18,5149,4943,206,4.0
CN5111100000000,51,111,Lunenburg County, VA,Mar-18,5148,4947,201,3.9
CN5111100000000,51,111,Lunenburg County, VA,Apr-18(p),5177,5012,165,3.2
CN3603300000000,36,033,Franklin County, NY,Mar-17,20131,18766,1365,6.8
CN3603300000000,36,033,Franklin County, NY,Apr-17,19871,18614,1257,6.3
CN3603300000000,36,033,Franklin County, NY,May-17,19634,18489,1145,5.8
CN3603300000000,36,033,Franklin County, NY,Jun-17,20011,18883,1128,5.6
CN3603300000000,36,033,Franklin County, NY,Jul-17,20292,19195,1097,5.4
CN3603300000000,36,033,Franklin County, NY,Aug-17,20255,19153,1102,5.4
CN3603300000000,36,033,Franklin County, NY,Sep-17,19976,18875,1101,5.5
CN3603300000000,36,033,Franklin County, NY,Oct-17,19819,18765,1054,5.3
CN3603300000000,36,033,Franklin County, NY,Nov-17,19885,18702,1183,5.9
CN3603300000000,36,033,Franklin County, NY,Dec-17,19781,18524,1257,6.4
CN3603300000000,36,033,Franklin County, NY,Jan-18,20166,18685,1481,7.3
CN3603300000000,36,033,Franklin County, NY,Feb-18,20069,18554,1515,7.5
CN3603300000000,36,033,Franklin County, NY,Mar-18,19637,18283,1354,6.9
CN3603300000000,36,033,Franklin County, NY,Apr-18(p),19517,18266,1251,6.4
CN4839100000000,48,391,Refugio County, TX,Mar-17,3211,3045,166,5.2
CN4839100000000,48,391,Refugio County, TX,Apr-17,3179,3025,154,4.8
CN4839100000000,48,391,Refugio County, TX,May-17,3186,3036,150,4.7
CN4839100000000,48,391,Refugio County, TX,Jun-17,3151,2984,167,5.3
CN4839100000000,48,391,Refugio County, TX,Jul-17,3100,2938,162,5.2
CN4839100000000,48,391,Refugio County, TX,Aug-17,3067,2903,164,5.3
CN4839100000000,48,391,Refugio County, TX,Sep-17,3083,2852,231,7.5
CN4839100000000,48,391,Refugio County, TX,Oct-17,3044,2845,199,6.5
CN4839100000000,48,391,Refugio County, TX,Nov-17,3027,2833,194,6.4
CN4839100000000,48,391,Refugio County, TX,Dec-17,2977,2799,178,6.0
CN4839100000000,48,391,Refugio County, TX,Jan-18,2946,2763,183,6.2
CN4839100000000,48,391,Refugio County, TX,Feb-18,2966,2793,173,5.8
CN4839100000000,48,391,Refugio County, TX,Mar-18,3009,2841,168,5.6
CN4839100000000,48,391,Refugio County, TX,Apr-18(p),3244,3085,159,4.9
CN1306300000000,13,063,Clayton County, GA,Mar-17,134024,126004,8020,6.0
CN1306300000000,13,063,Clayton County, GA,Apr-17,133773,126212,7561,5.7
CN1306300000000,13,063,Clayton County, GA,May-17,134160,126485,7675,5.7
CN1306300000000,13,063,Clayton County, GA,Jun-17,134540,126374,8166,6.1
CN1306300000000,13,063,Clayton County, GA,Jul-17,135609,127233,8376,6.2
CN1306300000000,13,063,Clayton County, GA,Aug-17,134761,126671,8090,6.0
CN1306300000000,13,063,Clayton County, GA,Sep-17,135653,128345,7308,5.4
CN1306300000000,13,063,Clayton County, GA,Oct-17,135074,127879,7195,5.3
CN1306300000000,13,063,Clayton County, GA,Nov-17,135478,128368,7110,5.2
CN1306300000000,13,063,Clayton County, GA,Dec-17,135561,128313,7248,5.3
CN1306300000000,13,063,Clayton County, GA,Jan-18,135753,128036,7717,5.7
CN1306300000000,13,063,Clayton County, GA,Feb-18,137770,130128,7642,5.5
CN1306300000000,13,063,Clayton County, GA,Mar-18,137716,130612,7104,5.2
CN1306300000000,13,063,Clayton County, GA,Apr-18(p),136502,130144,6358,4.7
CN1707500000000,17,075,Iroquois County, IL,Mar-17,14633,13876,757,5.2
CN1707500000000,17,075,Iroquois County, IL,Apr-17,14769,14190,579,3.9
CN1707500000000,17,075,Iroquois County, IL,May-17,14893,14341,552,3.7
CN1707500000000,17,075,Iroquois County, IL,Jun-17,15159,14575,584,3.9
CN1707500000000,17,075,Iroquois County, IL,Jul-17,14940,14341,599,4.0
CN1707500000000,17,075,Iroquois County, IL,Aug-17,14700,14093,607,4.1
CN1707500000000,17,075,Iroquois County, IL,Sep-17,14600,14049,551,3.8
CN1707500000000,17,075,Iroquois County, IL,Oct-17,14700,14152,548,3.7
CN1707500000000,17,075,Iroquois County, IL,Nov-17,14605,14045,560,3.8
CN1707500000000,17,075,Iroquois County, IL,Dec-17,14343,13751,592,4.1
CN1707500000000,17,075,Iroquois County, IL,Jan-18,14149,13449,700,4.9
CN1707500000000,17,075,Iroquois County, IL,Feb-18,14174,13538,636,4.5
CN1707500000000,17,075,Iroquois County, IL,Mar-18,14632,13979,653,4.5
CN1707500000000,17,075,Iroquois County, IL,Apr-18(p),14867,14384,483,3.2
CN3704700000000,37,047,Columbus County, NC,Mar-17,22521,21324,1197,5.3
CN3704700000000,37,047,Columbus County, NC,Apr-17,22440,21314,1126,5.0
CN3704700000000,37,047,Columbus County, NC,May-17,22554,21389,1165,5.2
CN3704700000000,37,047,Columbus County, NC,Jun-17,22637,21379,1258,5.6
CN3704700000000,37,047,Columbus County, NC,Jul-17,22759,21449,1310,5.8
CN3704700000000,37,047,Columbus County, NC,Aug-17,22224,20900,1324,6.0
CN3704700000000,37,047,Columbus County, NC,Sep-17,22368,21226,1142,5.1
CN3704700000000,37,047,Columbus County, NC,Oct-17,22235,21088,1147,5.2
CN3704700000000,37,047,Columbus County, NC,Nov-17,22093,20862,1231,5.6
CN3704700000000,37,047,Columbus County, NC,Dec-17,21930,20719,1211,5.5
CN3704700000000,37,047,Columbus County, NC,Jan-18,21987,20590,1397,6.4
CN3704700000000,37,047,Columbus County, NC,Feb-18,22065,20772,1293,5.9
CN3704700000000,37,047,Columbus County, NC,Mar-18,22242,21027,1215,5.5
CN3704700000000,37,047,Columbus County, NC,Apr-18(p),22203,21171,1032,4.6
CN3002900000000,30,029,Flathead County, MT,Mar-17,45812,42745,3067,6.7
CN3002900000000,30,029,Flathead County, MT,Apr-17,45703,43139,2564,5.6
CN3002900000000,30,029,Flathead County, MT,May-17,46224,44037,2187,4.7
CN3002900000000,30,029,Flathead County, MT,Jun-17,48240,45990,2250,4.7
CN3002900000000,30,029,Flathead County, MT,Jul-17,49305,47281,2024,4.1
CN3002900000000,30,029,Flathead County, MT,Aug-17,48681,46689,1992,4.1
CN3002900000000,30,029,Flathead County, MT,Sep-17,46873,44924,1949,4.2
CN3002900000000,30,029,Flathead County, MT,Oct-17,46618,44471,2147,4.6
CN3002900000000,30,029,Flathead County, MT,Nov-17,46311,43837,2474,5.3
CN3002900000000,30,029,Flathead County, MT,Dec-17,46632,44063,2569,5.5
CN3002900000000,30,029,Flathead County, MT,Jan-18,46552,43368,3184,6.8
CN3002900000000,30,029,Flathead County, MT,Feb-18,46471,43371,3100,6.7
CN3002900000000,30,029,Flathead County, MT,Mar-18,46654,43757,2897,6.2
CN3002900000000,30,029,Flathead County, MT,Apr-18(p),46601,44211,2390,5.1
CN4833100000000,48,331,Milam County, TX,Mar-17,10282,9742,540,5.3
CN4833100000000,48,331,Milam County, TX,Apr-17,10209,9717,492,4.8
CN4833100000000,48,331,Milam County, TX,May-17,10128,9647,481,4.7
CN4833100000000,48,331,Milam County, TX,Jun-17,10163,9639,524,5.2
CN4833100000000,48,331,Milam County, TX,Jul-17,9943,9412,531,5.3
CN4833100000000,48,331,Milam County, TX,Aug-17,9950,9429,521,5.2
CN4833100000000,48,331,Milam County, TX,Sep-17,9975,9506,469,4.7
CN4833100000000,48,331,Milam County, TX,Oct-17,9921,9486,435,4.4
CN4833100000000,48,331,Milam County, TX,Nov-17,9884,9429,455,4.6
CN4833100000000,48,331,Milam County, TX,Dec-17,9896,9463,433,4.4
CN4833100000000,48,331,Milam County, TX,Jan-18,9973,9460,513,5.1
CN4833100000000,48,331,Milam County, TX,Feb-18,10238,9566,672,6.6
CN4833100000000,48,331,Milam County, TX,Mar-18,10275,9662,613,6.0
CN4833100000000,48,331,Milam County, TX,Apr-18(p),10073,9501,572,5.7
CN2609900000000,26,099,Macomb County, MI,Mar-17,439225,419514,19711,4.5
CN2609900000000,26,099,Macomb County, MI,Apr-17,434233,419902,14331,3.3
CN2609900000000,26,099,Macomb County, MI,May-17,438554,424030,14524,3.3
CN2609900000000,26,099,Macomb County, MI,Jun-17,442052,424787,17265,3.9
CN2609900000000,26,099,Macomb County, MI,Jul-17,447991,426511,21480,4.8
CN2609900000000,26,099,Macomb County, MI,Aug-17,447617,426049,21568,4.8
CN2609900000000,26,099,Macomb County, MI,Sep-17,446876,427819,19057,4.3
CN2609900000000,26,099,Macomb County, MI,Oct-17,443600,424851,18749,4.2
CN2609900000000,26,099,Macomb County, MI,Nov-17,441685,425119,16566,3.8
CN2609900000000,26,099,Macomb County, MI,Dec-17,441214,423783,17431,4.0
CN2609900000000,26,099,Macomb County, MI,Jan-18,434547,414315,20232,4.7
CN2609900000000,26,099,Macomb County, MI,Feb-18,437193,417841,19352,4.4
CN2609900000000,26,099,Macomb County, MI,Mar-18,439229,421076,18153,4.1
CN2609900000000,26,099,Macomb County, MI,Apr-18(p),436627,421170,15457,3.5
CN0805100000000,08,051,Gunnison County, CO,Mar-17,10787,10571,216,2.0
CN0805100000000,08,051,Gunnison County, CO,Apr-17,10218,10027,191,1.9
CN0805100000000,08,051,Gunnison County, CO,May-17,10038,9812,226,2.3
CN0805100000000,08,051,Gunnison County, CO,Jun-17,10798,10577,221,2.0
CN0805100000000,08,051,Gunnison County, CO,Jul-17,11232,11046,186,1.7
CN0805100000000,08,051,Gunnison County, CO,Aug-17,11152,10977,175,1.6
CN0805100000000,08,051,Gunnison County, CO,Sep-17,10970,10796,174,1.6
CN0805100000000,08,051,Gunnison County, CO,Oct-17,10686,10474,212,2.0
CN0805100000000,08,051,Gunnison County, CO,Nov-17,10542,10288,254,2.4
CN0805100000000,08,051,Gunnison County, CO,Dec-17,10970,10736,234,2.1
CN0805100000000,08,051,Gunnison County, CO,Jan-18,11057,10792,265,2.4
CN0805100000000,08,051,Gunnison County, CO,Feb-18,11463,11192,271,2.4
CN0805100000000,08,051,Gunnison County, CO,Mar-18,11471,11222,249,2.2
CN0805100000000,08,051,Gunnison County, CO,Apr-18(p),10880,10663,217,2.0
CN3109300000000,31,093,Howard County, NE,Mar-17,3270,3168,102,3.1
CN3109300000000,31,093,Howard County, NE,Apr-17,3314,3218,96,2.9
CN3109300000000,31,093,Howard County, NE,May-17,3311,3222,89,2.7
CN3109300000000,31,093,Howard County, NE,Jun-17,3390,3296,94,2.8
CN3109300000000,31,093,Howard County, NE,Jul-17,3370,3272,98,2.9
CN3109300000000,31,093,Howard County, NE,Aug-17,3294,3207,87,2.6
CN3109300000000,31,093,Howard County, NE,Sep-17,3259,3183,76,2.3
CN3109300000000,31,093,Howard County, NE,Oct-17,3246,3169,77,2.4
CN3109300000000,31,093,Howard County, NE,Nov-17,3242,3167,75,2.3
CN3109300000000,31,093,Howard County, NE,Dec-17,3224,3146,78,2.4
CN3109300000000,31,093,Howard County, NE,Jan-18,3362,3159,203,6.0
CN3109300000000,31,093,Howard County, NE,Feb-18,3251,3153,98,3.0
CN3109300000000,31,093,Howard County, NE,Mar-18,3286,3195,91,2.8
CN3109300000000,31,093,Howard County, NE,Apr-18(p),3305,3211,94,2.8
CN4205900000000,42,059,Greene County, PA,Mar-17,17097,16015,1082,6.3
CN4205900000000,42,059,Greene County, PA,Apr-17,16904,15965,939,5.6
CN4205900000000,42,059,Greene County, PA,May-17,16835,15853,982,5.8
CN4205900000000,42,059,Greene County, PA,Jun-17,16829,15768,1061,6.3
CN4205900000000,42,059,Greene County, PA,Jul-17,16861,15765,1096,6.5
CN4205900000000,42,059,Greene County, PA,Aug-17,16678,15606,1072,6.4
CN4205900000000,42,059,Greene County, PA,Sep-17,16693,15896,797,4.8
CN4205900000000,42,059,Greene County, PA,Oct-17,16676,15890,786,4.7
CN4205900000000,42,059,Greene County, PA,Nov-17,16716,15890,826,4.9
CN4205900000000,42,059,Greene County, PA,Dec-17,16559,15721,838,5.1
CN4205900000000,42,059,Greene County, PA,Jan-18,16627,15593,1034,6.2
CN4205900000000,42,059,Greene County, PA,Feb-18,16670,15654,1016,6.1
CN4205900000000,42,059,Greene County, PA,Mar-18,16381,15491,890,5.4
CN4205900000000,42,059,Greene County, PA,Apr-18(p),16304,15551,753,4.6
CN1328500000000,13,285,Troup County, GA,Mar-17,37332,35664,1668,4.5
CN1328500000000,13,285,Troup County, GA,Apr-17,37346,35804,1542,4.1
CN1328500000000,13,285,Troup County, GA,May-17,37664,36032,1632,4.3
CN1328500000000,13,285,Troup County, GA,Jun-17,37568,35794,1774,4.7
CN1328500000000,13,285,Troup County, GA,Jul-17,38084,36140,1944,5.1
CN1328500000000,13,285,Troup County, GA,Aug-17,37731,36006,1725,4.6
CN1328500000000,13,285,Troup County, GA,Sep-17,38054,36503,1551,4.1
CN1328500000000,13,285,Troup County, GA,Oct-17,37782,36275,1507,4.0
CN1328500000000,13,285,Troup County, GA,Nov-17,37838,36340,1498,4.0
CN1328500000000,13,285,Troup County, GA,Dec-17,37943,36433,1510,4.0
CN1328500000000,13,285,Troup County, GA,Jan-18,38291,36557,1734,4.5
CN1328500000000,13,285,Troup County, GA,Feb-18,37855,36318,1537,4.1
CN1328500000000,13,285,Troup County, GA,Mar-18,37773,36360,1413,3.7
CN1328500000000,13,285,Troup County, GA,Apr-18(p),37687,36375,1312,3.5
CN1322500000000,13,225,Peach County, GA,Mar-17,11618,10967,651,5.6
CN1322500000000,13,225,Peach County, GA,Apr-17,11610,10983,627,5.4
CN1322500000000,13,225,Peach County, GA,May-17,11618,10990,628,5.4
CN1322500000000,13,225,Peach County, GA,Jun-17,11670,10973,697,6.0
CN1322500000000,13,225,Peach County, GA,Jul-17,11691,10996,695,5.9
CN1322500000000,13,225,Peach County, GA,Aug-17,11664,10979,685,5.9
CN1322500000000,13,225,Peach County, GA,Sep-17,11711,11055,656,5.6
CN1322500000000,13,225,Peach County, GA,Oct-17,11829,11010,819,6.9
CN1322500000000,13,225,Peach County, GA,Nov-17,11643,11043,600,5.2
CN1322500000000,13,225,Peach County, GA,Dec-17,11670,11063,607,5.2
CN1322500000000,13,225,Peach County, GA,Jan-18,11921,11178,743,6.2
CN1322500000000,13,225,Peach County, GA,Feb-18,11790,11173,617,5.2
CN1322500000000,13,225,Peach County, GA,Mar-18,11812,11226,586,5.0
CN1322500000000,13,225,Peach County, GA,Apr-18(p),11748,11233,515,4.4
CN5300700000000,53,007,Chelan County, WA,Mar-17,42801,40303,2498,5.8
CN5300700000000,53,007,Chelan County, WA,Apr-17,42515,40448,2067,4.9
CN5300700000000,53,007,Chelan County, WA,May-17,42265,40123,2142,5.1
CN5300700000000,53,007,Chelan County, WA,Jun-17,46736,44826,1910,4.1
CN5300700000000,53,007,Chelan County, WA,Jul-17,53254,51499,1755,3.3
CN5300700000000,53,007,Chelan County, WA,Aug-17,48462,46496,1966,4.1
CN5300700000000,53,007,Chelan County, WA,Sep-17,46266,44599,1667,3.6
CN5300700000000,53,007,Chelan County, WA,Oct-17,45243,43532,1711,3.8
CN5300700000000,53,007,Chelan County, WA,Nov-17,42763,40723,2040,4.8
CN5300700000000,53,007,Chelan County, WA,Dec-17,41921,39532,2389,5.7
CN5300700000000,53,007,Chelan County, WA,Jan-18,41263,38587,2676,6.5
CN5300700000000,53,007,Chelan County, WA,Feb-18,41566,38841,2725,6.6
CN5300700000000,53,007,Chelan County, WA,Mar-18,42558,40004,2554,6.0
CN5300700000000,53,007,Chelan County, WA,Apr-18(p),42042,39902,2140,5.1
CN5512300000000,55,123,Vernon County, WI,Mar-17,15763,15164,599,3.8
CN5512300000000,55,123,Vernon County, WI,Apr-17,16026,15537,489,3.1
CN5512300000000,55,123,Vernon County, WI,May-17,16195,15747,448,2.8
CN5512300000000,55,123,Vernon County, WI,Jun-17,16710,16199,511,3.1
CN5512300000000,55,123,Vernon County, WI,Jul-17,15995,15543,452,2.8
CN5512300000000,55,123,Vernon County, WI,Aug-17,15694,15276,418,2.7
CN5512300000000,55,123,Vernon County, WI,Sep-17,15979,15565,414,2.6
CN5512300000000,55,123,Vernon County, WI,Oct-17,16201,15802,399,2.5
CN5512300000000,55,123,Vernon County, WI,Nov-17,16325,15932,393,2.4
CN5512300000000,55,123,Vernon County, WI,Dec-17,16216,15810,406,2.5
CN5512300000000,55,123,Vernon County, WI,Jan-18,16223,15691,532,3.3
CN5512300000000,55,123,Vernon County, WI,Feb-18,16122,15559,563,3.5
CN5512300000000,55,123,Vernon County, WI,Mar-18,16258,15706,552,3.4
CN5512300000000,55,123,Vernon County, WI,Apr-18(p),16384,15949,435,2.7
CN0604100000000,06,041,Marin County, CA,Mar-17,141038,136799,4239,3.0
CN0604100000000,06,041,Marin County, CA,Apr-17,140424,136529,3895,2.8
CN0604100000000,06,041,Marin County, CA,May-17,140667,136942,3725,2.6
CN0604100000000,06,041,Marin County, CA,Jun-17,141961,137697,4264,3.0
CN0604100000000,06,041,Marin County, CA,Jul-17,142626,138053,4573,3.2
CN0604100000000,06,041,Marin County, CA,Aug-17,141830,137393,4437,3.1
CN0604100000000,06,041,Marin County, CA,Sep-17,141870,138123,3747,2.6
CN0604100000000,06,041,Marin County, CA,Oct-17,142141,138510,3631,2.6
CN0604100000000,06,041,Marin County, CA,Nov-17,141812,138363,3449,2.4
CN0604100000000,06,041,Marin County, CA,Dec-17,140973,137682,3291,2.3
CN0604100000000,06,041,Marin County, CA,Jan-18,141425,137749,3676,2.6
CN0604100000000,06,041,Marin County, CA,Feb-18,141898,138337,3561,2.5
CN0604100000000,06,041,Marin County, CA,Mar-18,140885,137615,3270,2.3
CN0604100000000,06,041,Marin County, CA,Apr-18(p),139230,136248,2982,2.1
CN5507700000000,55,077,Marquette County, WI,Mar-17,7547,7202,345,4.6
CN5507700000000,55,077,Marquette County, WI,Apr-17,7667,7392,275,3.6
CN5507700000000,55,077,Marquette County, WI,May-17,7628,7384,244,3.2
CN5507700000000,55,077,Marquette County, WI,Jun-17,7833,7540,293,3.7
CN5507700000000,55,077,Marquette County, WI,Jul-17,7695,7420,275,3.6
CN5507700000000,55,077,Marquette County, WI,Aug-17,7631,7362,269,3.5
CN5507700000000,55,077,Marquette County, WI,Sep-17,7668,7441,227,3.0
CN5507700000000,55,077,Marquette County, WI,Oct-17,7643,7433,210,2.7
CN5507700000000,55,077,Marquette County, WI,Nov-17,7640,7405,235,3.1
CN5507700000000,55,077,Marquette County, WI,Dec-17,7623,7354,269,3.5
CN5507700000000,55,077,Marquette County, WI,Jan-18,7630,7315,315,4.1
CN5507700000000,55,077,Marquette County, WI,Feb-18,7710,7334,376,4.9
CN5507700000000,55,077,Marquette County, WI,Mar-18,7727,7409,318,4.1
CN5507700000000,55,077,Marquette County, WI,Apr-18(p),7820,7568,252,3.2
CN1317900000000,13,179,Liberty County, GA,Mar-17,25987,24592,1395,5.4
CN1317900000000,13,179,Liberty County, GA,Apr-17,25868,24586,1282,5.0
CN1317900000000,13,179,Liberty County, GA,May-17,25846,24560,1286,5.0
CN1317900000000,13,179,Liberty County, GA,Jun-17,25484,24140,1344,5.3
CN1317900000000,13,179,Liberty County, GA,Jul-17,25904,24519,1385,5.3
CN1317900000000,13,179,Liberty County, GA,Aug-17,26021,24650,1371,5.3
CN1317900000000,13,179,Liberty County, GA,Sep-17,26059,24764,1295,5.0
CN1317900000000,13,179,Liberty County, GA,Oct-17,25817,24571,1246,4.8
CN1317900000000,13,179,Liberty County, GA,Nov-17,25865,24639,1226,4.7
CN1317900000000,13,179,Liberty County, GA,Dec-17,25896,24630,1266,4.9
CN1317900000000,13,179,Liberty County, GA,Jan-18,26081,24759,1322,5.1
CN1317900000000,13,179,Liberty County, GA,Feb-18,26575,25241,1334,5.0
CN1317900000000,13,179,Liberty County, GA,Mar-18,26549,25296,1253,4.7
CN1317900000000,13,179,Liberty County, GA,Apr-18(p),26123,25032,1091,4.2
CN2713300000000,27,133,Rock County, MN,Mar-17,5907,5773,134,2.3
CN2713300000000,27,133,Rock County, MN,Apr-17,5962,5854,108,1.8
CN2713300000000,27,133,Rock County, MN,May-17,5948,5840,108,1.8
CN2713300000000,27,133,Rock County, MN,Jun-17,5967,5840,127,2.1
CN2713300000000,27,133,Rock County, MN,Jul-17,5889,5762,127,2.2
CN2713300000000,27,133,Rock County, MN,Aug-17,5743,5623,120,2.1
CN2713300000000,27,133,Rock County, MN,Sep-17,5802,5700,102,1.8
CN2713300000000,27,133,Rock County, MN,Oct-17,5991,5905,86,1.4
CN2713300000000,27,133,Rock County, MN,Nov-17,5943,5837,106,1.8
CN2713300000000,27,133,Rock County, MN,Dec-17,5928,5807,121,2.0
CN2713300000000,27,133,Rock County, MN,Jan-18,5938,5744,194,3.3
CN2713300000000,27,133,Rock County, MN,Feb-18,5937,5747,190,3.2
CN2713300000000,27,133,Rock County, MN,Mar-18,5968,5790,178,3.0
CN2713300000000,27,133,Rock County, MN,Apr-18(p),5993,5843,150,2.5
CN5601300000000,56,013,Fremont County, WY,Mar-17,19565,18291,1274,6.5
CN5601300000000,56,013,Fremont County, WY,Apr-17,19378,18306,1072,5.5
CN5601300000000,56,013,Fremont County, WY,May-17,19299,18308,991,5.1
CN5601300000000,56,013,Fremont County, WY,Jun-17,19773,18708,1065,5.4
CN5601300000000,56,013,Fremont County, WY,Jul-17,19278,18268,1010,5.2
CN5601300000000,56,013,Fremont County, WY,Aug-17,19403,18455,948,4.9
CN5601300000000,56,013,Fremont County, WY,Sep-17,19210,18340,870,4.5
CN5601300000000,56,013,Fremont County, WY,Oct-17,19301,18408,893,4.6
CN5601300000000,56,013,Fremont County, WY,Nov-17,19434,18481,953,4.9
CN5601300000000,56,013,Fremont County, WY,Dec-17,19181,18177,1004,5.2
CN5601300000000,56,013,Fremont County, WY,Jan-18,19108,17924,1184,6.2
CN5601300000000,56,013,Fremont County, WY,Feb-18,19170,18070,1100,5.7
CN5601300000000,56,013,Fremont County, WY,Mar-18,19245,18192,1053,5.5
CN5601300000000,56,013,Fremont County, WY,Apr-18(p),18946,18020,926,4.9
CN2802300000000,28,023,Clarke County, MS,Mar-17,6181,5802,379,6.1
CN2802300000000,28,023,Clarke County, MS,Apr-17,6090,5753,337,5.5
CN2802300000000,28,023,Clarke County, MS,May-17,6066,5682,384,6.3
CN2802300000000,28,023,Clarke County, MS,Jun-17,6117,5687,430,7.0
CN2802300000000,28,023,Clarke County, MS,Jul-17,6056,5627,429,7.1
CN2802300000000,28,023,Clarke County, MS,Aug-17,5935,5599,336,5.7
CN2802300000000,28,023,Clarke County, MS,Sep-17,5965,5622,343,5.8
CN2802300000000,28,023,Clarke County, MS,Oct-17,5872,5537,335,5.7
CN2802300000000,28,023,Clarke County, MS,Nov-17,5854,5526,328,5.6
CN2802300000000,28,023,Clarke County, MS,Dec-17,5942,5611,331,5.6
CN2802300000000,28,023,Clarke County, MS,Jan-18,5913,5578,335,5.7
CN2802300000000,28,023,Clarke County, MS,Feb-18,5970,5637,333,5.6
CN2802300000000,28,023,Clarke County, MS,Mar-18,5949,5631,318,5.3
CN2802300000000,28,023,Clarke County, MS,Apr-18(p),5945,5625,320,5.4
CN0211000000000,02,110,Juneau Borough/city, AK,Mar-17,16852,15973,879,5.2
CN0211000000000,02,110,Juneau Borough/city, AK,Apr-17,17209,16405,804,4.7
CN0211000000000,02,110,Juneau Borough/city, AK,May-17,18179,17419,760,4.2
CN0211000000000,02,110,Juneau Borough/city, AK,Jun-17,17764,16930,834,4.7
CN0211000000000,02,110,Juneau Borough/city, AK,Jul-17,18024,17214,810,4.5
CN0211000000000,02,110,Juneau Borough/city, AK,Aug-17,18138,17393,745,4.1
CN0211000000000,02,110,Juneau Borough/city, AK,Sep-17,17732,16931,801,4.5
CN0211000000000,02,110,Juneau Borough/city, AK,Oct-17,17431,16634,797,4.6
CN0211000000000,02,110,Juneau Borough/city, AK,Nov-17,17164,16332,832,4.8
CN0211000000000,02,110,Juneau Borough/city, AK,Dec-17,17042,16199,843,4.9
CN0211000000000,02,110,Juneau Borough/city, AK,Jan-18,16895,15980,915,5.4
CN0211000000000,02,110,Juneau Borough/city, AK,Feb-18,16914,16008,906,5.4
CN0211000000000,02,110,Juneau Borough/city, AK,Mar-18,16999,16113,886,5.2
CN0211000000000,02,110,Juneau Borough/city, AK,Apr-18(p),17137,16292,845,4.9
CN5501700000000,55,017,Chippewa County, WI,Mar-17,33787,32294,1493,4.4
CN5501700000000,55,017,Chippewa County, WI,Apr-17,33804,32689,1115,3.3
CN5501700000000,55,017,Chippewa County, WI,May-17,33524,32569,955,2.8
CN5501700000000,55,017,Chippewa County, WI,Jun-17,33831,32672,1159,3.4
CN5501700000000,55,017,Chippewa County, WI,Jul-17,33872,32800,1072,3.2
CN5501700000000,55,017,Chippewa County, WI,Aug-17,33471,32385,1086,3.2
CN5501700000000,55,017,Chippewa County, WI,Sep-17,33638,32662,976,2.9
CN5501700000000,55,017,Chippewa County, WI,Oct-17,33742,32868,874,2.6
CN5501700000000,55,017,Chippewa County, WI,Nov-17,33812,32901,911,2.7
CN5501700000000,55,017,Chippewa County, WI,Dec-17,33818,32669,1149,3.4
CN5501700000000,55,017,Chippewa County, WI,Jan-18,33325,32008,1317,4.0
CN5501700000000,55,017,Chippewa County, WI,Feb-18,33945,32498,1447,4.3
CN5501700000000,55,017,Chippewa County, WI,Mar-18,34280,32840,1440,4.2
CN5501700000000,55,017,Chippewa County, WI,Apr-18(p),34168,33022,1146,3.4
CN1311900000000,13,119,Franklin County, GA,Mar-17,10074,9589,485,4.8
CN1311900000000,13,119,Franklin County, GA,Apr-17,10064,9588,476,4.7
CN1311900000000,13,119,Franklin County, GA,May-17,10051,9581,470,4.7
CN1311900000000,13,119,Franklin County, GA,Jun-17,10052,9550,502,5.0
CN1311900000000,13,119,Franklin County, GA,Jul-17,10059,9506,553,5.5
CN1311900000000,13,119,Franklin County, GA,Aug-17,9934,9446,488,4.9
CN1311900000000,13,119,Franklin County, GA,Sep-17,10001,9568,433,4.3
CN1311900000000,13,119,Franklin County, GA,Oct-17,10003,9556,447,4.5
CN1311900000000,13,119,Franklin County, GA,Nov-17,9979,9555,424,4.2
CN1311900000000,13,119,Franklin County, GA,Dec-17,9985,9566,419,4.2
CN1311900000000,13,119,Franklin County, GA,Jan-18,10220,9762,458,4.5
CN1311900000000,13,119,Franklin County, GA,Feb-18,10340,9891,449,4.3
CN1311900000000,13,119,Franklin County, GA,Mar-18,10329,9925,404,3.9
CN1311900000000,13,119,Franklin County, GA,Apr-18(p),10314,9967,347,3.4
CN3715300000000,37,153,Richmond County, NC,Mar-17,17036,16025,1011,5.9
CN3715300000000,37,153,Richmond County, NC,Apr-17,16943,16020,923,5.4
CN3715300000000,37,153,Richmond County, NC,May-17,16681,15719,962,5.8
CN3715300000000,37,153,Richmond County, NC,Jun-17,16649,15639,1010,6.1
CN3715300000000,37,153,Richmond County, NC,Jul-17,16623,15558,1065,6.4
CN3715300000000,37,153,Richmond County, NC,Aug-17,16360,15315,1045,6.4
CN3715300000000,37,153,Richmond County, NC,Sep-17,16803,15856,947,5.6
CN3715300000000,37,153,Richmond County, NC,Oct-17,16599,15654,945,5.7
CN3715300000000,37,153,Richmond County, NC,Nov-17,16605,15581,1024,6.2
CN3715300000000,37,153,Richmond County, NC,Dec-17,16512,15521,991,6.0
CN3715300000000,37,153,Richmond County, NC,Jan-18,16639,15540,1099,6.6
CN3715300000000,37,153,Richmond County, NC,Feb-18,16779,15676,1103,6.6
CN3715300000000,37,153,Richmond County, NC,Mar-18,16775,15750,1025,6.1
CN3715300000000,37,153,Richmond County, NC,Apr-18(p),16672,15784,888,5.3
CN4822500000000,48,225,Houston County, TX,Mar-17,10410,9980,430,4.1
CN4822500000000,48,225,Houston County, TX,Apr-17,10383,9984,399,3.8
CN4822500000000,48,225,Houston County, TX,May-17,10374,9972,402,3.9
CN4822500000000,48,225,Houston County, TX,Jun-17,10653,10209,444,4.2
CN4822500000000,48,225,Houston County, TX,Jul-17,10561,10030,531,5.0
CN4822500000000,48,225,Houston County, TX,Aug-17,10675,10167,508,4.8
CN4822500000000,48,225,Houston County, TX,Sep-17,10809,10373,436,4.0
CN4822500000000,48,225,Houston County, TX,Oct-17,10820,10399,421,3.9
CN4822500000000,48,225,Houston County, TX,Nov-17,10796,10369,427,4.0
CN4822500000000,48,225,Houston County, TX,Dec-17,10843,10435,408,3.8
CN4822500000000,48,225,Houston County, TX,Jan-18,11012,10558,454,4.1
CN4822500000000,48,225,Houston County, TX,Feb-18,11170,10729,441,3.9
CN4822500000000,48,225,Houston County, TX,Mar-18,11299,10854,445,3.9
CN4822500000000,48,225,Houston County, TX,Apr-18(p),11200,10812,388,3.5
CN2007700000000,20,077,Harper County, KS,Mar-17,2686,2582,104,3.9
CN2007700000000,20,077,Harper County, KS,Apr-17,2618,2522,96,3.7
CN2007700000000,20,077,Harper County, KS,May-17,2638,2540,98,3.7
CN2007700000000,20,077,Harper County, KS,Jun-17,2691,2587,104,3.9
CN2007700000000,20,077,Harper County, KS,Jul-17,2623,2510,113,4.3
CN2007700000000,20,077,Harper County, KS,Aug-17,2586,2475,111,4.3
CN2007700000000,20,077,Harper County, KS,Sep-17,2671,2583,88,3.3
CN2007700000000,20,077,Harper County, KS,Oct-17,2671,2591,80,3.0
CN2007700000000,20,077,Harper County, KS,Nov-17,2650,2564,86,3.2
CN2007700000000,20,077,Harper County, KS,Dec-17,2640,2565,75,2.8
CN2007700000000,20,077,Harper County, KS,Jan-18,2686,2605,81,3.0
CN2007700000000,20,077,Harper County, KS,Feb-18,2673,2589,84,3.1
CN2007700000000,20,077,Harper County, KS,Mar-18,2655,2577,78,2.9
CN2007700000000,20,077,Harper County, KS,Apr-18(p),2566,2488,78,3.0
CN0810700000000,08,107,Routt County, CO,Mar-17,15942,15607,335,2.1
CN0810700000000,08,107,Routt County, CO,Apr-17,15224,14907,317,2.1
CN0810700000000,08,107,Routt County, CO,May-17,14240,13827,413,2.9
CN0810700000000,08,107,Routt County, CO,Jun-17,15305,14887,418,2.7
CN0810700000000,08,107,Routt County, CO,Jul-17,15941,15595,346,2.2
CN0810700000000,08,107,Routt County, CO,Aug-17,15739,15391,348,2.2
CN0810700000000,08,107,Routt County, CO,Sep-17,15180,14848,332,2.2
CN0810700000000,08,107,Routt County, CO,Oct-17,15174,14790,384,2.5
CN0810700000000,08,107,Routt County, CO,Nov-17,15221,14789,432,2.8
CN0810700000000,08,107,Routt County, CO,Dec-17,16737,16339,398,2.4
CN0810700000000,08,107,Routt County, CO,Jan-18,16815,16413,402,2.4
CN0810700000000,08,107,Routt County, CO,Feb-18,16897,16481,416,2.5
CN0810700000000,08,107,Routt County, CO,Mar-18,16676,16300,376,2.3
CN0810700000000,08,107,Routt County, CO,Apr-18(p),15933,15579,354,2.2
CN3403100000000,34,031,Passaic County, NJ,Mar-17,246918,232730,14188,5.7
CN3403100000000,34,031,Passaic County, NJ,Apr-17,245797,232592,13205,5.4
CN3403100000000,34,031,Passaic County, NJ,May-17,244739,231761,12978,5.3
CN3403100000000,34,031,Passaic County, NJ,Jun-17,246551,232629,13922,5.6
CN3403100000000,34,031,Passaic County, NJ,Jul-17,247264,231753,15511,6.3
CN3403100000000,34,031,Passaic County, NJ,Aug-17,245029,229854,15175,6.2
CN3403100000000,34,031,Passaic County, NJ,Sep-17,243466,229734,13732,5.6
CN3403100000000,34,031,Passaic County, NJ,Oct-17,243999,231036,12963,5.3
CN3403100000000,34,031,Passaic County, NJ,Nov-17,244741,231918,12823,5.2
CN3403100000000,34,031,Passaic County, NJ,Dec-17,244151,231739,12412,5.1
CN3403100000000,34,031,Passaic County, NJ,Jan-18,242916,228451,14465,6.0
CN3403100000000,34,031,Passaic County, NJ,Feb-18,245196,230386,14810,6.0
CN3403100000000,34,031,Passaic County, NJ,Mar-18,243176,228892,14284,5.9
CN3403100000000,34,031,Passaic County, NJ,Apr-18(p),240359,227977,12382,5.2
CN4004900000000,40,049,Garvin County, OK,Mar-17,12585,12026,559,4.4
CN4004900000000,40,049,Garvin County, OK,Apr-17,12437,11933,504,4.1
CN4004900000000,40,049,Garvin County, OK,May-17,12567,12012,555,4.4
CN4004900000000,40,049,Garvin County, OK,Jun-17,12587,12011,576,4.6
CN4004900000000,40,049,Garvin County, OK,Jul-17,12447,11929,518,4.2
CN4004900000000,40,049,Garvin County, OK,Aug-17,12654,12129,525,4.1
CN4004900000000,40,049,Garvin County, OK,Sep-17,12800,12310,490,3.8
CN4004900000000,40,049,Garvin County, OK,Oct-17,12762,12302,460,3.6
CN4004900000000,40,049,Garvin County, OK,Nov-17,12848,12383,465,3.6
CN4004900000000,40,049,Garvin County, OK,Dec-17,12688,12237,451,3.6
CN4004900000000,40,049,Garvin County, OK,Jan-18,12668,12168,500,3.9
CN4004900000000,40,049,Garvin County, OK,Feb-18,12812,12323,489,3.8
CN4004900000000,40,049,Garvin County, OK,Mar-18,12804,12333,471,3.7
CN4004900000000,40,049,Garvin County, OK,Apr-18(p),12674,12203,471,3.7
CN4204100000000,42,041,Cumberland County, PA,Mar-17,129158,124252,4906,3.8
CN4204100000000,42,041,Cumberland County, PA,Apr-17,130162,125617,4545,3.5
CN4204100000000,42,041,Cumberland County, PA,May-17,130378,125285,5093,3.9
CN4204100000000,42,041,Cumberland County, PA,Jun-17,131912,126583,5329,4.0
CN4204100000000,42,041,Cumberland County, PA,Jul-17,133253,127605,5648,4.2
CN4204100000000,42,041,Cumberland County, PA,Aug-17,131882,126353,5529,4.2
CN4204100000000,42,041,Cumberland County, PA,Sep-17,130067,125417,4650,3.6
CN4204100000000,42,041,Cumberland County, PA,Oct-17,128808,124434,4374,3.4
CN4204100000000,42,041,Cumberland County, PA,Nov-17,128577,124155,4422,3.4
CN4204100000000,42,041,Cumberland County, PA,Dec-17,127753,123436,4317,3.4
CN4204100000000,42,041,Cumberland County, PA,Jan-18,127582,122515,5067,4.0
CN4204100000000,42,041,Cumberland County, PA,Feb-18,127793,122697,5096,4.0
CN4204100000000,42,041,Cumberland County, PA,Mar-18,126968,122635,4333,3.4
CN4204100000000,42,041,Cumberland County, PA,Apr-18(p),127427,123506,3921,3.1
CN0103300000000,01,033,Colbert County, AL,Mar-17,23442,22105,1337,5.7
CN0103300000000,01,033,Colbert County, AL,Apr-17,23255,22120,1135,4.9
CN0103300000000,01,033,Colbert County, AL,May-17,23095,22016,1079,4.7
CN0103300000000,01,033,Colbert County, AL,Jun-17,23136,21813,1323,5.7
CN0103300000000,01,033,Colbert County, AL,Jul-17,22988,21748,1240,5.4
CN0103300000000,01,033,Colbert County, AL,Aug-17,22863,21700,1163,5.1
CN0103300000000,01,033,Colbert County, AL,Sep-17,22999,21969,1030,4.5
CN0103300000000,01,033,Colbert County, AL,Oct-17,23014,22025,989,4.3
CN0103300000000,01,033,Colbert County, AL,Nov-17,22920,22006,914,4.0
CN0103300000000,01,033,Colbert County, AL,Dec-17,22661,21709,952,4.2
CN0103300000000,01,033,Colbert County, AL,Jan-18,22553,21410,1143,5.1
CN0103300000000,01,033,Colbert County, AL,Feb-18,22851,21699,1152,5.0
CN0103300000000,01,033,Colbert County, AL,Mar-18,22976,21939,1037,4.5
CN0103300000000,01,033,Colbert County, AL,Apr-18(p),23185,22218,967,4.2
CN4806300000000,48,063,Camp County, TX,Mar-17,5130,4812,318,6.2
CN4806300000000,48,063,Camp County, TX,Apr-17,5063,4763,300,5.9
CN4806300000000,48,063,Camp County, TX,May-17,5038,4745,293,5.8
CN4806300000000,48,063,Camp County, TX,Jun-17,5057,4756,301,6.0
CN4806300000000,48,063,Camp County, TX,Jul-17,5036,4743,293,5.8
CN4806300000000,48,063,Camp County, TX,Aug-17,5036,4760,276,5.5
CN4806300000000,48,063,Camp County, TX,Sep-17,5038,4795,243,4.8
CN4806300000000,48,063,Camp County, TX,Oct-17,4967,4748,219,4.4
CN4806300000000,48,063,Camp County, TX,Nov-17,5003,4775,228,4.6
CN4806300000000,48,063,Camp County, TX,Dec-17,4996,4767,229,4.6
CN4806300000000,48,063,Camp County, TX,Jan-18,5039,4775,264,5.2
CN4806300000000,48,063,Camp County, TX,Feb-18,5114,4845,269,5.3
CN4806300000000,48,063,Camp County, TX,Mar-18,5191,4926,265,5.1
CN4806300000000,48,063,Camp County, TX,Apr-18(p),5036,4805,231,4.6
CN3114900000000,31,149,Rock County, NE,Mar-17,860,835,25,2.9
CN3114900000000,31,149,Rock County, NE,Apr-17,905,881,24,2.7
CN3114900000000,31,149,Rock County, NE,May-17,945,924,21,2.2
CN3114900000000,31,149,Rock County, NE,Jun-17,970,949,21,2.2
CN3114900000000,31,149,Rock County, NE,Jul-17,926,905,21,2.3
CN3114900000000,31,149,Rock County, NE,Aug-17,894,874,20,2.2
CN3114900000000,31,149,Rock County, NE,Sep-17,824,808,16,1.9
CN3114900000000,31,149,Rock County, NE,Oct-17,854,834,20,2.3
CN3114900000000,31,149,Rock County, NE,Nov-17,871,849,22,2.5
CN3114900000000,31,149,Rock County, NE,Dec-17,869,846,23,2.6
CN3114900000000,31,149,Rock County, NE,Jan-18,892,866,26,2.9
CN3114900000000,31,149,Rock County, NE,Feb-18,867,845,22,2.5
CN3114900000000,31,149,Rock County, NE,Mar-18,875,855,20,2.3
CN3114900000000,31,149,Rock County, NE,Apr-18(p),883,862,21,2.4
CN4706700000000,47,067,Hancock County, TN,Mar-17,2089,1957,132,6.3
CN4706700000000,47,067,Hancock County, TN,Apr-17,2026,1920,106,5.2
CN4706700000000,47,067,Hancock County, TN,May-17,2013,1902,111,5.5
CN4706700000000,47,067,Hancock County, TN,Jun-17,1972,1837,135,6.8
CN4706700000000,47,067,Hancock County, TN,Jul-17,1988,1858,130,6.5
CN4706700000000,47,067,Hancock County, TN,Aug-17,2111,1988,123,5.8
CN4706700000000,47,067,Hancock County, TN,Sep-17,2097,1994,103,4.9
CN4706700000000,47,067,Hancock County, TN,Oct-17,2058,1965,93,4.5
CN4706700000000,47,067,Hancock County, TN,Nov-17,2036,1949,87,4.3
CN4706700000000,47,067,Hancock County, TN,Dec-17,2038,1951,87,4.3
CN4706700000000,47,067,Hancock County, TN,Jan-18,2049,1941,108,5.3
CN4706700000000,47,067,Hancock County, TN,Feb-18,2066,1965,101,4.9
CN4706700000000,47,067,Hancock County, TN,Mar-18,2062,1967,95,4.6
CN4706700000000,47,067,Hancock County, TN,Apr-18(p),2070,1995,75,3.6
CN0605900000000,06,059,Orange County, CA,Mar-17,1614880,1555658,59222,3.7
CN0605900000000,06,059,Orange County, CA,Apr-17,1609645,1555582,54063,3.4
CN0605900000000,06,059,Orange County, CA,May-17,1608091,1556535,51556,3.2
CN0605900000000,06,059,Orange County, CA,Jun-17,1613819,1554196,59623,3.7
CN0605900000000,06,059,Orange County, CA,Jul-17,1624380,1560292,64088,3.9
CN0605900000000,06,059,Orange County, CA,Aug-17,1619737,1557758,61979,3.8
CN0605900000000,06,059,Orange County, CA,Sep-17,1632752,1579404,53348,3.3
CN0605900000000,06,059,Orange County, CA,Oct-17,1626133,1574263,51870,3.2
CN0605900000000,06,059,Orange County, CA,Nov-17,1627650,1577655,49995,3.1
CN0605900000000,06,059,Orange County, CA,Dec-17,1628598,1581334,47264,2.9
CN0605900000000,06,059,Orange County, CA,Jan-18,1620302,1568627,51675,3.2
CN0605900000000,06,059,Orange County, CA,Feb-18,1625815,1575505,50310,3.1
CN0605900000000,06,059,Orange County, CA,Mar-18,1614614,1568605,46009,2.8
CN0605900000000,06,059,Orange County, CA,Apr-18(p),1604425,1562581,41844,2.6
CN5117100000000,51,171,Shenandoah County, VA,Mar-17,20793,20054,739,3.6
CN5117100000000,51,171,Shenandoah County, VA,Apr-17,20985,20325,660,3.1
CN5117100000000,51,171,Shenandoah County, VA,May-17,21106,20389,717,3.4
CN5117100000000,51,171,Shenandoah County, VA,Jun-17,21391,20634,757,3.5
CN5117100000000,51,171,Shenandoah County, VA,Jul-17,21613,20700,913,4.2
CN5117100000000,51,171,Shenandoah County, VA,Aug-17,21186,20437,749,3.5
CN5117100000000,51,171,Shenandoah County, VA,Sep-17,21111,20366,745,3.5
CN5117100000000,51,171,Shenandoah County, VA,Oct-17,20993,20315,678,3.2
CN5117100000000,51,171,Shenandoah County, VA,Nov-17,20880,20200,680,3.3
CN5117100000000,51,171,Shenandoah County, VA,Dec-17,20834,20187,647,3.1
CN5117100000000,51,171,Shenandoah County, VA,Jan-18,20956,20203,753,3.6
CN5117100000000,51,171,Shenandoah County, VA,Feb-18,20969,20278,691,3.3
CN5117100000000,51,171,Shenandoah County, VA,Mar-18,20992,20297,695,3.3
CN5117100000000,51,171,Shenandoah County, VA,Apr-18(p),21114,20528,586,2.8
CN1812700000000,18,127,Porter County, IN,Mar-17,85224,81497,3727,4.4
CN1812700000000,18,127,Porter County, IN,Apr-17,85718,82597,3121,3.6
CN1812700000000,18,127,Porter County, IN,May-17,85807,82731,3076,3.6
CN1812700000000,18,127,Porter County, IN,Jun-17,86215,82876,3339,3.9
CN1812700000000,18,127,Porter County, IN,Jul-17,86569,83091,3478,4.0
CN1812700000000,18,127,Porter County, IN,Aug-17,85452,81700,3752,4.4
CN1812700000000,18,127,Porter County, IN,Sep-17,85583,82444,3139,3.7
CN1812700000000,18,127,Porter County, IN,Oct-17,85419,82471,2948,3.5
CN1812700000000,18,127,Porter County, IN,Nov-17,84587,81609,2978,3.5
CN1812700000000,18,127,Porter County, IN,Dec-17,83589,80533,3056,3.7
CN1812700000000,18,127,Porter County, IN,Jan-18,83267,79786,3481,4.2
CN1812700000000,18,127,Porter County, IN,Feb-18,84670,80889,3781,4.5
CN1812700000000,18,127,Porter County, IN,Mar-18,85352,82029,3323,3.9
CN1812700000000,18,127,Porter County, IN,Apr-18(p),86215,83288,2927,3.4
CN1901700000000,19,017,Bremer County, IA,Mar-17,13719,13248,471,3.4
CN1901700000000,19,017,Bremer County, IA,Apr-17,13773,13393,380,2.8
CN1901700000000,19,017,Bremer County, IA,May-17,13672,13318,354,2.6
CN1901700000000,19,017,Bremer County, IA,Jun-17,13612,13214,398,2.9
CN1901700000000,19,017,Bremer County, IA,Jul-17,13717,13345,372,2.7
CN1901700000000,19,017,Bremer County, IA,Aug-17,13513,13134,379,2.8
CN1901700000000,19,017,Bremer County, IA,Sep-17,13682,13353,329,2.4
CN1901700000000,19,017,Bremer County, IA,Oct-17,13677,13405,272,2.0
CN1901700000000,19,017,Bremer County, IA,Nov-17,13588,13311,277,2.0
CN1901700000000,19,017,Bremer County, IA,Dec-17,13484,13150,334,2.5
CN1901700000000,19,017,Bremer County, IA,Jan-18,13364,12938,426,3.2
CN1901700000000,19,017,Bremer County, IA,Feb-18,13589,13185,404,3.0
CN1901700000000,19,017,Bremer County, IA,Mar-18,13518,13164,354,2.6
CN1901700000000,19,017,Bremer County, IA,Apr-18(p),13574,13271,303,2.2
CN2201900000000,22,019,Calcasieu Parish, LA,Mar-17,106273,102011,4262,4.0
CN2201900000000,22,019,Calcasieu Parish, LA,Apr-17,107131,103063,4068,3.8
CN2201900000000,22,019,Calcasieu Parish, LA,May-17,107772,103523,4249,3.9
CN2201900000000,22,019,Calcasieu Parish, LA,Jun-17,110581,105704,4877,4.4
CN2201900000000,22,019,Calcasieu Parish, LA,Jul-17,111648,106982,4666,4.2
CN2201900000000,22,019,Calcasieu Parish, LA,Aug-17,110936,106275,4661,4.2
CN2201900000000,22,019,Calcasieu Parish, LA,Sep-17,110883,106497,4386,4.0
CN2201900000000,22,019,Calcasieu Parish, LA,Oct-17,111066,107339,3727,3.4
CN2201900000000,22,019,Calcasieu Parish, LA,Nov-17,111173,107452,3721,3.3
CN2201900000000,22,019,Calcasieu Parish, LA,Dec-17,109625,106127,3498,3.2
CN2201900000000,22,019,Calcasieu Parish, LA,Jan-18,110368,106499,3869,3.5
CN2201900000000,22,019,Calcasieu Parish, LA,Feb-18,112253,108771,3482,3.1
CN2201900000000,22,019,Calcasieu Parish, LA,Mar-18,112820,109072,3748,3.3
CN2201900000000,22,019,Calcasieu Parish, LA,Apr-18(p),112891,109112,3779,3.3
CN2212500000000,22,125,West Feliciana Parish, LA,Mar-17,5321,5095,226,4.2
CN2212500000000,22,125,West Feliciana Parish, LA,Apr-17,5321,5103,218,4.1
CN2212500000000,22,125,West Feliciana Parish, LA,May-17,5313,5100,213,4.0
CN2212500000000,22,125,West Feliciana Parish, LA,Jun-17,5378,5129,249,4.6
CN2212500000000,22,125,West Feliciana Parish, LA,Jul-17,5384,5143,241,4.5
CN2212500000000,22,125,West Feliciana Parish, LA,Aug-17,5364,5108,256,4.8
CN2212500000000,22,125,West Feliciana Parish, LA,Sep-17,5360,5131,229,4.3
CN2212500000000,22,125,West Feliciana Parish, LA,Oct-17,5333,5138,195,3.7
CN2212500000000,22,125,West Feliciana Parish, LA,Nov-17,5353,5163,190,3.5
CN2212500000000,22,125,West Feliciana Parish, LA,Dec-17,5311,5126,185,3.5
CN2212500000000,22,125,West Feliciana Parish, LA,Jan-18,5327,5120,207,3.9
CN2212500000000,22,125,West Feliciana Parish, LA,Feb-18,5401,5204,197,3.6
CN2212500000000,22,125,West Feliciana Parish, LA,Mar-18,5437,5226,211,3.9
CN2212500000000,22,125,West Feliciana Parish, LA,Apr-18(p),5437,5238,199,3.7
CN3804300000000,38,043,Kidder County, ND,Mar-17,1339,1274,65,4.9
CN3804300000000,38,043,Kidder County, ND,Apr-17,1341,1294,47,3.5
CN3804300000000,38,043,Kidder County, ND,May-17,1331,1294,37,2.8
CN3804300000000,38,043,Kidder County, ND,Jun-17,1453,1410,43,3.0
CN3804300000000,38,043,Kidder County, ND,Jul-17,1410,1373,37,2.6
CN3804300000000,38,043,Kidder County, ND,Aug-17,1392,1353,39,2.8
CN3804300000000,38,043,Kidder County, ND,Sep-17,1388,1354,34,2.4
CN3804300000000,38,043,Kidder County, ND,Oct-17,1388,1359,29,2.1
CN3804300000000,38,043,Kidder County, ND,Nov-17,1325,1284,41,3.1
CN3804300000000,38,043,Kidder County, ND,Dec-17,1315,1252,63,4.8
CN3804300000000,38,043,Kidder County, ND,Jan-18,1313,1223,90,6.9
CN3804300000000,38,043,Kidder County, ND,Feb-18,1266,1188,78,6.2
CN3804300000000,38,043,Kidder County, ND,Mar-18,1285,1211,74,5.8
CN3804300000000,38,043,Kidder County, ND,Apr-18(p),1278,1215,63,4.9
CN2112900000000,21,129,Lee County, KY,Mar-17,2058,1871,187,9.1
CN2112900000000,21,129,Lee County, KY,Apr-17,1982,1819,163,8.2
CN2112900000000,21,129,Lee County, KY,May-17,1974,1801,173,8.8
CN2112900000000,21,129,Lee County, KY,Jun-17,1960,1765,195,9.9
CN2112900000000,21,129,Lee County, KY,Jul-17,1950,1767,183,9.4
CN2112900000000,21,129,Lee County, KY,Aug-17,1902,1749,153,8.0
CN2112900000000,21,129,Lee County, KY,Sep-17,1897,1758,139,7.3
CN2112900000000,21,129,Lee County, KY,Oct-17,1890,1757,133,7.0
CN2112900000000,21,129,Lee County, KY,Nov-17,1861,1739,122,6.6
CN2112900000000,21,129,Lee County, KY,Dec-17,1861,1737,124,6.7
CN2112900000000,21,129,Lee County, KY,Jan-18,1906,1763,143,7.5
CN2112900000000,21,129,Lee County, KY,Feb-18,1970,1812,158,8.0
CN2112900000000,21,129,Lee County, KY,Mar-18,1967,1828,139,7.1
CN2112900000000,21,129,Lee County, KY,Apr-18(p),1941,1825,116,6.0
CN2301500000000,23,015,Lincoln County, ME,Mar-17,16454,15754,700,4.3
CN2301500000000,23,015,Lincoln County, ME,Apr-17,16538,15959,579,3.5
CN2301500000000,23,015,Lincoln County, ME,May-17,17039,16481,558,3.3
CN2301500000000,23,015,Lincoln County, ME,Jun-17,18033,17473,560,3.1
CN2301500000000,23,015,Lincoln County, ME,Jul-17,18531,18001,530,2.9
CN2301500000000,23,015,Lincoln County, ME,Aug-17,18438,17982,456,2.5
CN2301500000000,23,015,Lincoln County, ME,Sep-17,17381,16930,451,2.6
CN2301500000000,23,015,Lincoln County, ME,Oct-17,17099,16669,430,2.5
CN2301500000000,23,015,Lincoln County, ME,Nov-17,16497,16016,481,2.9
CN2301500000000,23,015,Lincoln County, ME,Dec-17,16403,15961,442,2.7
CN2301500000000,23,015,Lincoln County, ME,Jan-18,16192,15600,592,3.7
CN2301500000000,23,015,Lincoln County, ME,Feb-18,16374,15760,614,3.7
CN2301500000000,23,015,Lincoln County, ME,Mar-18,16538,15966,572,3.5
CN2301500000000,23,015,Lincoln County, ME,Apr-18(p),16674,16129,545,3.3
CN2608100000000,26,081,Kent County, MI,Mar-17,353107,341552,11555,3.3
CN2608100000000,26,081,Kent County, MI,Apr-17,352769,343036,9733,2.8
CN2608100000000,26,081,Kent County, MI,May-17,356011,344863,11148,3.1
CN2608100000000,26,081,Kent County, MI,Jun-17,360329,347355,12974,3.6
CN2608100000000,26,081,Kent County, MI,Jul-17,358284,341922,16362,4.6
CN2608100000000,26,081,Kent County, MI,Aug-17,356395,341958,14437,4.1
CN2608100000000,26,081,Kent County, MI,Sep-17,354268,341939,12329,3.5
CN2608100000000,26,081,Kent County, MI,Oct-17,353680,342295,11385,3.2
CN2608100000000,26,081,Kent County, MI,Nov-17,356907,345202,11705,3.3
CN2608100000000,26,081,Kent County, MI,Dec-17,355924,343684,12240,3.4
CN2608100000000,26,081,Kent County, MI,Jan-18,353930,340158,13772,3.9
CN2608100000000,26,081,Kent County, MI,Feb-18,358517,344644,13873,3.9
CN2608100000000,26,081,Kent County, MI,Mar-18,360311,348144,12167,3.4
CN2608100000000,26,081,Kent County, MI,Apr-18(p),361376,350658,10718,3.0
CN5106500000000,51,065,Fluvanna County, VA,Mar-17,13572,13139,433,3.2
CN5106500000000,51,065,Fluvanna County, VA,Apr-17,13597,13226,371,2.7
CN5106500000000,51,065,Fluvanna County, VA,May-17,13577,13154,423,3.1
CN5106500000000,51,065,Fluvanna County, VA,Jun-17,13558,13123,435,3.2
CN5106500000000,51,065,Fluvanna County, VA,Jul-17,13417,12980,437,3.3
CN5106500000000,51,065,Fluvanna County, VA,Aug-17,13263,12833,430,3.2
CN5106500000000,51,065,Fluvanna County, VA,Sep-17,13767,13371,396,2.9
CN5106500000000,51,065,Fluvanna County, VA,Oct-17,13598,13224,374,2.8
CN5106500000000,51,065,Fluvanna County, VA,Nov-17,13669,13299,370,2.7
CN5106500000000,51,065,Fluvanna County, VA,Dec-17,13567,13216,351,2.6
CN5106500000000,51,065,Fluvanna County, VA,Jan-18,13467,13063,404,3.0
CN5106500000000,51,065,Fluvanna County, VA,Feb-18,13871,13506,365,2.6
CN5106500000000,51,065,Fluvanna County, VA,Mar-18,13999,13616,383,2.7
CN5106500000000,51,065,Fluvanna County, VA,Apr-18(p),14090,13774,316,2.2
CN2123500000000,21,235,Whitley County, KY,Mar-17,13821,12949,872,6.3
CN2123500000000,21,235,Whitley County, KY,Apr-17,13661,12895,766,5.6
CN2123500000000,21,235,Whitley County, KY,May-17,13703,12873,830,6.1
CN2123500000000,21,235,Whitley County, KY,Jun-17,13942,13004,938,6.7
CN2123500000000,21,235,Whitley County, KY,Jul-17,13968,13063,905,6.5
CN2123500000000,21,235,Whitley County, KY,Aug-17,13728,12925,803,5.8
CN2123500000000,21,235,Whitley County, KY,Sep-17,13810,13102,708,5.1
CN2123500000000,21,235,Whitley County, KY,Oct-17,13586,12940,646,4.8
CN2123500000000,21,235,Whitley County, KY,Nov-17,13603,12958,645,4.7
CN2123500000000,21,235,Whitley County, KY,Dec-17,13587,12963,624,4.6
CN2123500000000,21,235,Whitley County, KY,Jan-18,13580,12921,659,4.9
CN2123500000000,21,235,Whitley County, KY,Feb-18,13815,13055,760,5.5
CN2123500000000,21,235,Whitley County, KY,Mar-18,13929,13217,712,5.1
CN2123500000000,21,235,Whitley County, KY,Apr-18(p),13850,13228,622,4.5
CN2401100000000,24,011,Caroline County, MD,Mar-17,18081,17226,855,4.7
CN2401100000000,24,011,Caroline County, MD,Apr-17,18190,17456,734,4.0
CN2401100000000,24,011,Caroline County, MD,May-17,17809,17095,714,4.0
CN2401100000000,24,011,Caroline County, MD,Jun-17,18203,17433,770,4.2
CN2401100000000,24,011,Caroline County, MD,Jul-17,18304,17546,758,4.1
CN2401100000000,24,011,Caroline County, MD,Aug-17,17838,17094,744,4.2
CN2401100000000,24,011,Caroline County, MD,Sep-17,17823,17161,662,3.7
CN2401100000000,24,011,Caroline County, MD,Oct-17,17910,17243,667,3.7
CN2401100000000,24,011,Caroline County, MD,Nov-17,17757,17063,694,3.9
CN2401100000000,24,011,Caroline County, MD,Dec-17,17612,16931,681,3.9
CN2401100000000,24,011,Caroline County, MD,Jan-18,17755,16838,917,5.2
CN2401100000000,24,011,Caroline County, MD,Feb-18,17939,17032,907,5.1
CN2401100000000,24,011,Caroline County, MD,Mar-18,17968,17121,847,4.7
CN2401100000000,24,011,Caroline County, MD,Apr-18(p),17887,17230,657,3.7
